GEOID,Total,NH_White,Hispanic,NH_Black,NH_Native_Amer,NH_Asian,NH_Pacitic,NH_Other,Minority_total
1001020100,1775,1376,76,213,5,8,0,6,399
1001020200,2055,834,43,1098,2,12,1,5,1221
1001020300,3216,2220,100,714,7,14,5,14,996
1001020400,4246,3522,158,320,17,32,1,5,724
1001020501,4322,3211,156,628,23,93,2,5,1111
1001020502,3284,1851,165,887,12,207,3,32,1433
1001020503,3616,2487,139,698,4,120,2,15,1129
1001020600,3729,2464,305,775,5,16,1,16,1265
1001020700,3409,2299,123,777,4,20,4,18,1110
1001020801,3143,2643,58,295,15,8,1,0,500
1001020803,4635,3482,150,749,21,14,0,9,1153
1001020804,6064,3994,261,1137,22,295,1,38,2070
1001020805,3122,2627,84,259,6,7,0,3,495
1001020901,3268,2847,81,176,9,9,0,1,421
1001020902,3091,2336,99,539,13,9,0,4,755
1001021000,2645,1983,38,507,6,0,0,6,662
1001021100,3185,1406,81,1580,13,9,1,8,1779
1003010100,3745,2956,27,524,99,3,4,5,789
1003010200,3000,2489,57,220,61,7,0,6,511
1003010300,8380,6293,191,1347,73,40,0,27,2087
1003010400,5722,4845,122,360,59,20,0,17,877
1003010500,4850,3709,110,662,81,40,0,15,1141
1003010600,3234,1189,73,1811,17,3,0,8,2045
1003010704,5307,4387,235,344,28,37,1,7,920
1003010706,4038,3446,124,181,13,83,0,13,592
1003010707,4994,4389,200,123,24,56,2,15,605
1003010708,11585,9069,527,980,47,322,14,51,2516
1003010709,11650,9676,487,722,34,150,9,27,1974
1003010710,6156,4590,303,812,28,107,12,25,1566
1003010711,4230,3242,234,445,20,40,3,16,988
1003010800,7807,5651,284,1455,13,72,0,40,2156
1003010903,6599,4867,395,902,34,58,1,20,1732
1003010904,7747,6666,362,142,81,27,4,30,1081
1003010906,4754,3831,418,246,26,20,3,1,923
1003010907,4081,3275,441,109,20,33,3,15,806
1003010908,5979,4507,629,441,28,62,0,28,1472
1003011000,5459,4408,490,262,29,12,3,5,1051
1003011102,5684,4791,320,205,13,54,13,14,893
1003011103,3523,3073,188,89,12,30,0,9,450
1003011104,7875,6786,393,326,25,66,3,9,1089
1003011201,4895,4413,177,98,5,44,4,3,482
1003011202,6773,5226,183,1044,19,40,10,18,1547
1003011300,5170,4530,190,192,15,7,2,9,640
1003011409,5915,4318,492,790,33,28,1,15,1597
1003011410,7483,6186,634,191,45,32,5,41,1297
1003011411,5666,4261,923,130,29,54,2,18,1405
1003011412,4041,3366,248,140,18,30,2,34,675
1003011413,3982,3473,164,66,10,65,1,15,509
1003011414,3461,3235,47,12,18,15,0,11,226
1003011415,2019,1902,40,0,4,10,1,2,117
1003011416,1714,1584,29,6,16,6,2,7,130
1003011417,2525,2270,98,20,9,18,0,7,255
1003011418,1773,1586,48,29,12,8,1,14,187
1003011419,5154,4608,154,83,15,45,0,29,546
1003011501,7216,5566,593,560,30,37,5,35,1650
1003011503,7482,5356,693,906,37,97,1,37,2126
1003011504,6431,4403,851,806,36,79,1,32,2028
1003011601,7517,6540,365,92,42,34,6,33,977
1003011603,3298,2897,74,113,21,21,1,1,401
1003011604,2853,2640,73,15,12,17,2,11,213
1003990000,0,0,0,0,0,0,0,0,0
1005950100,3126,1447,189,1381,6,15,0,17,1679
1005950200,3363,1109,57,2145,2,2,0,5,2254
1005950300,1370,588,36,711,7,2,0,0,782
1005950400,3998,1823,567,1517,6,21,0,8,2175
1005950500,3105,2146,75,732,16,17,0,6,959
1005950600,1858,947,82,773,0,16,0,3,911
1005950700,1590,613,105,828,4,0,0,7,977
1005950800,2175,1018,51,1041,2,9,0,8,1157
1005950900,4638,1395,348,2722,15,21,0,9,3243
1007010001,2634,2195,113,226,4,3,4,5,439
1007010005,4204,3587,194,280,3,12,3,10,617
1007010006,1728,1559,43,30,6,1,1,11,169
1007010007,2376,2008,53,254,8,0,1,4,368
1007010008,2770,2143,108,405,11,2,0,8,627
1007010009,2475,1035,137,1241,0,0,0,0,1440
1007010010,2853,1910,48,815,3,7,0,4,943
1007010011,3253,2005,44,1139,4,1,0,5,1248
1009050103,1749,1352,326,15,2,5,1,2,397
1009050104,2036,1722,164,19,6,7,0,11,314
1009050105,5525,4207,814,233,10,46,1,8,1318
1009050106,3023,1957,752,196,5,14,0,8,1066
1009050107,2975,2483,390,7,3,2,0,0,492
1009050200,3879,2885,840,23,14,16,0,7,994
1009050301,2880,2384,396,8,18,4,1,3,496
1009050302,2509,2022,389,15,15,1,0,1,487
1009050400,4550,3996,288,12,12,6,3,3,554
1009050501,4272,3425,658,19,21,25,0,6,847
1009050502,3196,2811,133,26,13,4,0,14,385
1009050601,4166,3867,55,38,17,6,0,6,299
1009050603,4007,3757,60,16,5,0,0,3,250
1009050604,5323,4848,80,116,25,9,2,11,475
1009050701,5834,5183,268,56,12,14,1,12,651
1009050702,3210,2865,158,27,10,15,2,5,345
1011952100,1272,85,11,1155,0,1,0,9,1187
1011952201,2423,303,258,1811,0,1,0,1,2120
1011952202,4341,868,209,3201,1,7,3,9,3473
1011952500,2321,1025,25,1221,0,0,4,12,1296
1013952700,2515,1084,37,1276,3,51,0,9,1431
1013952800,1411,863,56,438,2,13,2,1,548
1013952900,1959,824,31,1005,0,59,0,0,1135
1013953000,1230,709,9,480,1,0,0,4,521
1013953100,2526,511,35,1890,0,0,0,3,2015
1013953200,3987,2301,46,1506,11,15,2,12,1686
1013953300,1712,1430,18,202,2,2,0,10,282
1013953400,2392,962,24,1338,4,0,0,1,1430
1013953500,1319,995,4,254,0,3,1,6,324
1015000200,2929,1019,176,1574,7,31,0,16,1910
1015000300,2314,400,55,1748,5,1,3,11,1914
1015000400,2423,797,71,1464,24,6,0,7,1626
1015000500,1097,93,16,952,6,4,1,6,1004
1015000600,1780,431,29,1264,6,4,0,0,1349
1015000700,2952,1182,140,1454,3,37,3,9,1770
1015000800,1752,942,96,647,8,4,0,18,810
1015000900,3417,2412,241,637,8,32,0,2,1005
1015001000,5718,3503,337,1450,19,185,16,17,2215
1015001101,1772,1310,150,204,0,48,1,2,462
1015001102,1442,672,148,501,5,30,0,11,770
1015001103,3663,2498,267,617,5,68,1,21,1165
1015001201,3361,1917,241,1028,12,28,4,6,1444
1015001202,4304,2901,588,585,10,32,1,12,1403
1015001300,2006,1711,87,71,11,2,0,7,295
1015001400,3160,2342,88,573,10,5,0,6,818
1015001501,3421,2681,245,367,10,9,2,9,740
1015001502,1724,1393,76,175,9,5,0,1,331
1015001600,3513,2421,190,640,14,16,4,16,1092
1015001700,6023,3801,223,1619,13,66,7,13,2222
1015001801,2440,1959,101,221,22,23,0,1,481
1015001802,4371,3307,166,568,22,44,19,16,1064
1015002001,2739,2357,136,126,9,8,4,4,382
1015002002,4763,4087,167,275,19,40,0,3,676
1015002101,5300,1604,151,3185,10,237,1,12,3696
1015002102,3243,2527,114,369,10,32,9,10,716
1015002104,3914,2615,134,864,3,52,4,21,1299
1015002105,2887,1815,107,758,6,22,5,13,1072
1015002200,3625,3252,70,166,19,17,2,4,373
1015002300,3717,2985,112,400,13,4,3,11,732
1015002400,4402,4072,52,89,27,9,4,9,330
1015002502,4553,4212,41,98,9,17,0,11,341
1015002503,3861,3228,67,390,14,23,3,2,633
1015002504,3181,2817,55,157,7,15,10,3,364
1015002600,4664,4252,71,129,11,8,5,7,412
1015981901,8,3,2,0,0,0,0,0,5
1015981902,2,1,0,0,0,0,0,0,1
1015981903,0,0,0,0,0,0,0,0,0
1017953800,3156,2279,43,734,10,10,0,2,877
1017953900,3292,1416,147,1630,1,34,0,1,1876
1017954001,2230,1247,29,888,13,5,0,8,983
1017954002,3908,1397,109,2326,11,8,1,0,2511
1017954200,3309,2291,62,833,13,17,0,6,1018
1017954300,5637,2885,129,2090,6,250,1,58,2752
1017954600,3844,2588,198,903,2,36,4,14,1256
1017954700,4489,2862,115,1340,7,16,0,14,1627
1017954800,4907,1651,405,2697,8,9,5,12,3256
1019955701,3365,2928,50,226,34,11,0,10,437
1019955702,3702,3546,22,17,7,8,0,4,156
1019955801,2084,1828,76,81,18,1,0,2,256
1019955802,3087,2866,53,18,19,7,0,4,221
1019955900,4171,3658,71,258,6,17,1,13,513
1019956000,4053,3642,70,185,14,7,0,6,411
1019956101,1931,1841,19,14,4,1,0,3,90
1019956102,2578,2254,39,188,7,3,0,4,324
1021060101,5136,3323,419,1185,14,41,2,26,1813
1021060103,3310,2616,362,190,9,19,0,12,694
1021060104,3348,2450,160,523,12,55,0,6,898
1021060200,2751,2570,76,37,3,5,0,2,181
1021060300,3910,3426,293,58,5,9,0,0,484
1021060401,5749,4653,476,408,6,17,2,24,1096
1021060403,3818,2340,1166,186,15,5,1,10,1478
1021060404,5517,4097,911,304,26,10,0,2,1420
1021060500,2995,2253,63,581,10,2,0,5,742
1021060600,3294,2922,169,142,1,2,0,13,372
1021060701,2552,1931,243,274,0,5,0,14,621
1021060702,2634,2297,80,152,11,6,0,7,337
1023956700,2783,536,22,2166,8,0,0,6,2247
1023956800,4175,2536,54,1492,6,18,0,4,1639
1023956900,3628,2958,25,551,5,0,0,2,670
1023957000,2079,1009,12,1008,5,1,0,1,1070
1025957500,1531,1139,13,361,0,1,0,0,392
1025957601,934,652,10,237,3,1,0,0,282
1025957603,2111,1062,24,984,4,5,0,2,1049
1025957604,2688,1430,17,1159,3,16,0,5,1258
1025957700,1087,572,18,450,1,4,0,0,515
1025957800,4865,2324,32,2371,21,18,0,9,2541
1025957901,3274,2098,25,1033,20,15,0,4,1176
1025957902,3794,1797,47,1814,17,27,1,12,1997
1025958003,2803,896,20,1814,5,4,0,5,1907
1027958900,5629,4154,236,989,18,10,2,14,1475
1027959000,3205,2276,146,633,20,27,1,11,929
1027959100,2940,2756,51,29,4,4,1,1,184
1027959200,2462,2075,16,291,3,5,0,0,387
1029959500,2547,2428,15,8,5,5,0,0,119
1029959600,4206,3643,54,309,16,5,2,3,563
1029959700,3523,3104,163,128,11,3,0,3,419
1029959800,4780,4565,52,12,10,8,0,10,215
1031010100,2143,1857,35,86,45,3,6,1,286
1031010200,1853,1615,20,122,23,2,0,0,238
1031010300,5151,4100,256,418,61,43,1,45,1051
1031010400,1914,1450,46,322,18,4,0,0,464
1031010500,4412,2756,87,1357,38,2,0,17,1656
1031010600,1522,1401,26,7,19,7,0,6,121
1031010700,2200,1951,62,76,29,7,0,9,249
1031010800,3196,2675,199,146,18,22,0,4,521
1031010900,2159,1258,198,537,12,16,0,3,901
1031011000,3748,1978,675,788,19,51,0,13,1770
1031011100,2077,1200,264,431,9,46,5,5,877
1031011203,5259,3943,370,411,37,192,15,5,1316
1031011204,4116,3015,288,375,9,161,3,25,1101
1031011205,4206,2100,863,795,24,145,12,17,2106
1031011206,4877,2643,631,1112,26,147,14,30,2234
1031011300,4632,1817,867,1660,18,44,1,15,2815
1033020100,3599,2453,142,798,10,18,0,14,1146
1033020200,1883,1318,94,353,6,5,1,5,565
1033020300,2273,965,65,1105,1,18,0,6,1308
1033020400,1504,1322,39,71,3,9,1,9,182
1033020500,5150,4208,138,536,19,8,0,13,942
1033020600,4769,2897,112,1531,13,12,0,17,1872
1033020703,6796,4736,247,1308,34,164,0,19,2060
1033020704,4727,3552,179,727,12,53,0,15,1175
1033020705,1388,917,72,322,9,5,0,0,471
1033020706,5857,4629,213,708,28,74,0,13,1228
1033020801,4182,3207,106,726,19,12,1,2,975
1033020802,3422,2741,82,416,33,6,4,3,681
1033020901,4287,3894,95,105,22,25,0,7,393
1033020902,3712,3305,75,174,11,11,1,4,407
1033021000,3678,3097,73,342,3,12,1,8,581
1035960200,1472,694,16,735,8,0,0,0,778
1035960300,1579,1143,13,315,20,4,0,3,436
1035960400,2936,1490,39,1305,16,4,0,4,1446
1035960500,1591,695,136,712,10,16,0,4,896
1035960600,4019,1813,52,2029,17,9,0,5,2206
1037961000,3697,1370,130,2062,0,6,0,19,2327
1037961100,3625,3245,33,201,19,0,0,12,380
1037961200,3065,2192,38,737,6,2,0,16,873
1039961600,4467,4185,46,106,14,23,0,6,282
1039961700,3749,3247,57,292,18,10,0,6,502
1039961800,3114,2250,50,682,19,16,0,6,864
1039961900,2192,1713,43,317,2,31,0,5,479
1039962000,3911,2670,85,949,8,49,0,12,1241
1039962100,1798,1108,79,480,12,32,0,8,690
1039962300,3315,3106,32,36,12,21,0,4,209
1039962400,3440,3049,46,228,8,10,0,6,391
1039962500,1550,1308,32,129,9,9,0,3,242
1039962600,1373,1033,38,206,3,3,0,5,340
1039962700,1690,875,29,708,8,10,0,6,815
1039962800,1693,1578,23,15,12,2,0,0,115
1039962900,1830,1732,12,26,7,8,0,0,98
1039963000,3448,2803,82,389,8,16,0,4,645
1041963400,1850,1053,61,668,1,2,0,3,797
1041963500,1962,1606,34,248,8,5,0,2,356
1041963600,2829,2080,6,615,15,21,0,9,749
1041963700,3621,2493,52,891,10,45,2,3,1128
1041963800,1561,1057,11,420,4,8,0,5,504
1041963900,1371,1044,23,243,10,2,0,5,327
1043964100,5974,5318,345,13,18,21,1,14,656
1043964201,3663,3209,303,8,13,14,1,3,454
1043964202,4140,3799,176,10,21,8,0,6,341
1043964300,5372,4893,165,9,11,18,10,16,479
1043964400,4562,4160,137,14,25,9,4,10,402
1043964500,4629,4287,111,18,12,6,2,1,342
1043964600,4046,3681,197,9,12,6,2,3,365
1043964700,5369,4662,362,24,12,38,24,6,707
1043964800,4638,3949,406,54,11,42,0,5,689
1043964901,3371,3004,140,29,9,20,2,11,367
1043964902,4064,3538,241,36,9,58,1,7,526
1043965001,2652,2345,130,31,2,52,1,5,307
1043965002,4751,4050,325,96,11,84,1,4,701
1043965100,4255,3619,292,29,16,56,5,8,636
1043965200,2395,2143,102,6,14,19,10,7,252
1043965300,4944,4535,168,25,22,16,0,3,409
1043965401,3171,2854,132,59,18,15,0,5,317
1043965402,4556,3978,215,102,20,19,0,11,578
1043965501,1484,1106,17,303,3,4,0,4,378
1043965502,4423,4071,112,19,15,11,0,11,352
1043965600,2455,2312,32,11,6,2,0,4,143
1043965700,2952,2785,38,9,7,4,0,7,167
1045020000,4474,2970,712,314,23,140,17,21,1504
1045020100,3911,3259,142,364,12,18,2,9,652
1045020200,2186,1999,50,69,5,3,2,0,187
1045020300,2375,1946,71,272,2,10,1,2,429
1045020400,2423,1965,88,269,12,12,0,8,458
1045020500,1934,1205,73,557,3,14,1,6,729
1045020700,3358,1143,114,1900,13,27,2,7,2215
1045020801,3163,1733,148,1057,15,28,4,9,1430
1045020802,4328,2677,164,1175,26,70,1,18,1651
1045021101,4770,2809,622,894,24,122,6,12,1961
1045021102,4153,2263,487,935,21,127,0,27,1890
1045021200,2391,1713,179,308,16,37,0,13,678
1045021300,4231,3380,120,491,17,13,3,11,851
1045021400,5629,3540,284,1495,28,27,3,21,2089
1047956101,3889,1541,49,2195,0,6,0,4,2348
1047956102,2639,1731,28,815,0,10,3,9,908
1047956201,2103,1254,15,782,5,8,1,2,849
1047956202,2251,1562,15,609,10,9,0,2,689
1047956300,3616,287,18,3224,5,4,0,4,3329
1047956400,2645,74,19,2502,3,21,2,0,2571
1047956500,2883,38,13,2738,3,2,0,2,2845
1047956600,2787,304,15,2380,2,7,2,6,2483
1047956701,1899,815,16,1029,6,15,0,1,1084
1047956702,1471,590,28,825,0,15,0,1,881
1047956800,2709,595,29,1955,8,45,2,0,2114
1047956900,2303,370,7,1876,5,1,1,0,1933
1047957000,1080,403,15,644,0,1,1,6,677
1047957100,1157,339,3,780,1,0,0,1,818
1047957200,1592,20,6,1546,1,0,0,0,1572
1047957301,2284,89,13,2137,4,0,0,0,2195
1047957302,1154,351,7,775,3,1,0,0,803
1049960101,1847,1696,30,6,24,0,0,4,151
1049960102,3709,3347,46,9,56,9,1,1,362
1049960200,3518,3170,79,7,66,10,0,6,348
1049960301,956,742,126,6,6,0,0,1,214
1049960302,1343,1093,94,44,23,4,0,10,250
1049960303,4567,3976,228,32,86,5,0,5,591
1049960401,1289,1135,50,3,19,3,0,4,154
1049960402,5587,4768,434,23,59,16,0,4,819
1049960500,5125,4467,160,35,100,12,2,1,658
1049960601,1547,1262,166,18,15,4,0,0,285
1049960602,4855,3976,628,17,49,13,2,1,879
1049960701,2320,1423,807,8,20,3,1,0,897
1049960702,1294,1075,141,0,12,0,3,1,219
1049960703,5153,2311,2675,10,17,1,0,4,2842
1049960800,4595,2676,1529,182,23,17,1,3,1919
1049960900,3995,2849,596,290,36,32,2,19,1146
1049961000,3950,3332,369,32,35,8,1,2,618
1049961100,3336,2352,779,68,6,14,1,3,984
1049961200,2425,1965,257,48,17,34,0,1,460
1049961300,5981,3408,2073,142,30,37,2,14,2573
1049961400,4216,3506,477,39,16,15,0,2,710
1051030101,3711,3399,36,58,16,18,0,7,312
1051030102,2353,1911,81,273,3,11,2,0,442
1051030103,5534,3174,145,2117,8,8,0,7,2360
1051030200,4970,4233,81,415,9,12,1,20,737
1051030300,2766,2573,29,93,4,6,1,8,193
1051030401,3332,2110,122,957,5,10,2,15,1222
1051030402,4757,3590,130,800,11,39,1,22,1167
1051030500,5272,4393,103,517,10,18,0,15,879
1051030600,7432,5048,369,1653,21,38,8,21,2384
1051030701,8391,6333,214,1319,28,128,4,26,2058
1051030702,4073,3385,83,352,15,42,0,5,688
1051030801,2255,1413,43,661,26,15,2,7,842
1051030802,4317,2445,105,1510,20,66,3,11,1872
1051030901,6862,4691,193,1647,22,24,0,25,2171
1051030902,4120,2827,135,894,6,38,0,18,1293
1051031001,4017,2196,471,1094,4,56,2,15,1821
1051031002,3610,2445,119,854,9,25,1,18,1165
1051031100,4267,3165,101,732,25,47,1,6,1102
1051031200,1781,864,71,784,6,8,0,1,917
1051031300,4157,2345,162,1396,22,60,0,28,1812
1053969801,1453,1348,10,19,20,0,0,0,105
1053969802,4099,2628,104,1124,22,14,1,3,1471
1053969900,4399,3422,109,617,62,7,3,4,977
1053970100,4600,3331,89,963,29,24,4,4,1269
1053970200,1578,419,27,1065,10,9,6,3,1159
1053970300,3748,3030,70,425,68,4,0,3,718
1053970400,4511,2189,96,1331,721,1,0,10,2322
1053970500,4976,2694,112,1633,315,16,4,9,2282
1053970600,3707,795,39,2679,66,0,0,9,2912
1053970700,3686,2148,95,1066,175,33,4,4,1538
1055000200,3080,1589,185,1174,4,7,0,3,1491
1055000300,2350,282,109,1846,1,1,0,12,2068
1055000400,3947,3410,115,241,6,30,0,9,537
1055000500,1810,1294,147,242,6,11,0,6,516
1055000600,1813,1208,150,313,6,0,1,8,605
1055000700,1134,550,111,354,14,0,2,11,584
1055000800,910,169,203,500,9,1,0,2,741
1055000900,2506,1525,248,547,2,3,0,3,981
1055001000,1208,292,180,663,0,4,0,6,916
1055001100,5108,4406,72,320,3,150,1,14,702
1055001200,3101,1780,340,797,12,53,3,6,1321
1055001300,2346,811,309,1024,9,53,2,9,1535
1055001600,3271,938,168,2010,5,34,0,17,2333
1055001700,1504,748,54,627,7,7,0,6,756
1055010100,2033,1421,150,350,6,6,0,6,612
1055010201,2702,2017,144,345,7,20,0,3,685
1055010202,2563,2152,153,118,1,11,0,0,411
1055010300,2849,2561,80,91,6,5,0,11,288
1055010401,3452,2324,153,639,9,166,5,20,1128
1055010402,6148,5245,123,360,18,141,5,10,903
1055010503,4360,3952,101,77,11,33,0,1,408
1055010504,4746,4285,97,128,15,42,0,1,461
1055010505,2817,2552,38,101,13,25,0,9,265
1055010506,2344,2129,46,52,11,20,0,5,215
1055010601,5600,5247,59,79,17,23,3,14,353
1055010602,4004,3754,38,14,17,10,1,8,250
1055010700,3589,2945,77,362,31,6,0,4,644
1055010800,2791,2530,72,11,15,4,0,5,261
1055010900,1789,1654,42,21,4,6,2,0,135
1055011001,4660,4301,122,24,14,12,2,2,359
1055011002,4797,4077,404,35,17,21,12,11,720
1055011100,5401,4950,196,24,24,6,0,17,451
1055011200,2703,633,409,1510,12,10,0,21,2070
1057020000,1501,1374,49,37,1,2,0,2,127
1057020100,3499,3206,94,92,5,11,0,3,293
1057020200,4117,3097,118,707,11,29,0,2,1020
1057020300,3625,2607,83,773,15,3,1,12,1018
1057020400,3579,3268,52,111,11,4,0,10,311
1059972900,3971,2880,718,174,22,34,0,11,1091
1059973000,6028,2900,2665,298,19,3,0,19,3128
1059973100,2499,2283,120,18,7,0,0,2,216
1059973200,4243,2240,1370,490,9,10,0,7,2003
1059973300,3282,2174,893,102,15,3,0,14,1108
1059973400,2682,2392,158,26,12,3,2,7,290
1059973500,2213,2048,66,14,12,6,0,1,165
1059973600,1744,1667,37,4,17,0,0,1,77
1059973701,1418,1312,57,1,0,1,0,5,106
1059973702,957,909,16,0,0,4,0,0,48
1059973703,3076,2776,159,12,15,3,0,10,300
1061050100,4890,3944,346,346,55,11,0,11,946
1061050200,2091,1753,50,157,10,7,0,4,338
1061050300,5173,4093,128,635,35,40,0,7,1080
1061050400,6004,4899,253,535,24,12,3,38,1105
1061050500,4499,3492,314,431,15,10,3,8,1007
1061050600,4002,3473,205,127,27,6,1,4,529
1063060000,1366,258,13,1061,1,0,0,4,1108
1063060101,2068,298,20,1710,2,6,0,1,1770
1063060102,2097,369,17,1675,0,1,0,3,1728
1063060200,2199,360,11,1781,2,0,0,3,1839
1065040000,3624,2230,80,1225,11,5,0,8,1394
1065040100,1627,967,16,596,4,2,0,0,660
1065040200,1396,748,2,600,4,2,0,5,648
1065040300,1946,294,4,1616,6,0,1,6,1652
1065040401,3153,906,18,2165,5,9,2,2,2247
1065040402,1559,207,11,1301,0,0,2,0,1352
1065040500,1480,620,18,810,4,0,0,2,860
1067030100,1675,838,38,742,4,4,0,3,837
1067030200,2532,1200,69,1162,5,16,0,9,1332
1067030300,2994,2292,47,497,12,8,0,7,702
1067030400,1796,1175,70,455,9,9,0,6,621
1067030500,6630,5041,86,1230,14,32,0,21,1589
1067030600,1519,1296,24,146,6,4,0,3,223
1069040100,5916,5015,239,347,38,43,6,7,901
1069040203,3289,2624,127,243,3,126,0,7,665
1069040204,5884,4504,225,702,17,145,5,28,1380
1069040205,5732,4535,214,542,17,170,2,33,1197
1069040206,4597,3453,171,629,13,135,6,7,1144
1069040301,3883,1747,263,1639,28,36,0,31,2136
1069040302,3916,1551,320,1745,4,89,0,14,2365
1069040400,2562,2056,55,351,8,22,2,0,506
1069040500,3566,2487,111,778,10,23,0,17,1079
1069040600,1985,270,60,1574,4,6,0,13,1715
1069040700,2638,1090,159,1215,4,17,0,14,1548
1069040801,4852,3642,257,613,13,90,2,14,1210
1069040802,4480,2987,489,796,0,13,2,17,1493
1069040900,5532,3479,210,1504,16,114,6,20,2053
1069041000,5071,1383,156,3274,8,28,4,13,3688
1069041100,3674,1812,326,1273,8,46,3,11,1862
1069041200,2294,722,50,1413,9,10,2,9,1572
1069041400,3311,628,82,2461,1,13,0,15,2683
1069041500,4184,967,98,2994,8,7,2,5,3217
1069041600,5438,3458,225,1479,13,55,3,22,1980
1069041700,1343,1058,25,188,4,1,2,3,285
1069041800,2050,1401,26,508,10,4,2,9,649
1069041901,2783,2249,65,337,11,0,0,6,534
1069041902,4635,3686,77,620,20,22,2,17,949
1069042000,5197,4347,141,465,27,17,1,7,850
1069042100,8390,7100,310,542,27,28,7,15,1290
1071950101,2882,2618,29,4,31,7,0,0,264
1071950102,3194,2827,57,0,39,8,0,10,367
1071950200,3360,2837,56,203,45,14,0,12,523
1071950301,2628,2245,56,78,38,3,2,2,383
1071950302,3089,2294,213,309,38,6,0,13,795
1071950400,1987,1727,55,1,62,2,0,3,260
1071950500,3416,3122,48,17,57,10,0,8,294
1071950601,3109,2665,56,111,59,2,0,3,444
1071950602,2451,1740,135,388,20,18,0,16,711
1071950700,4654,3883,316,121,30,49,0,9,771
1071950800,4135,3440,209,196,28,28,0,4,695
1071950901,1692,1423,88,86,16,0,0,0,269
1071950902,4462,4020,110,70,21,37,0,7,442
1071951000,4349,3858,51,7,96,12,0,11,491
1071951101,4295,3860,139,14,40,8,0,7,435
1071951102,2876,2564,63,19,60,10,0,4,312
1073000100,2809,329,329,2088,1,16,0,5,2480
1073000300,1757,194,74,1419,6,13,0,3,1563
1073000400,2912,185,267,2349,16,1,37,0,2727
1073000500,3037,117,169,2697,1,1,0,7,2920
1073000700,2252,16,43,2136,1,1,0,3,2236
1073000800,3306,61,249,2936,3,0,0,6,3245
1073001100,4420,122,71,4161,8,0,3,6,4298
1073001200,2496,119,252,2060,4,5,1,17,2377
1073001400,1791,26,243,1479,4,5,0,4,1765
1073001500,2452,153,111,2118,0,4,0,13,2299
1073001600,2661,348,132,2110,1,9,1,6,2313
1073001902,1522,140,147,1185,0,5,0,0,1382
1073002000,3478,662,185,2506,8,11,0,13,2816
1073002100,2986,499,202,2196,6,23,1,9,2487
1073002200,2391,195,119,2010,5,6,0,11,2196
1073002303,2998,132,77,2704,10,3,0,16,2866
1073002305,3050,2019,95,808,3,24,1,6,1031
1073002306,3489,2709,97,484,6,64,0,16,780
1073002401,2693,1540,145,822,3,84,0,11,1153
1073002402,1246,68,42,1084,1,0,5,4,1178
1073002701,1454,1043,55,261,2,37,0,8,411
1073002702,2034,278,43,1658,0,12,0,6,1756
1073002900,1838,64,36,1666,8,0,0,1,1774
1073003001,3200,1009,71,2023,10,4,0,11,2191
1073003002,2568,39,82,2386,6,8,0,1,2529
1073003100,3051,88,111,2780,6,2,0,11,2963
1073003200,1125,4,19,1082,2,1,0,3,1121
1073003300,754,20,14,712,0,1,0,1,734
1073003400,1955,74,36,1782,9,1,0,4,1881
1073003500,2206,168,87,1911,3,2,0,10,2038
1073003600,4359,122,94,4065,4,3,0,10,4237
1073003700,4423,141,109,4073,9,8,0,10,4282
1073003802,4607,132,155,4219,2,2,2,9,4475
1073003803,3547,62,107,3316,10,5,0,5,3485
1073003900,976,34,63,868,0,0,0,1,942
1073004000,2984,123,107,2674,14,9,3,6,2861
1073004200,1741,127,107,1473,1,5,0,2,1614
1073004501,3159,1566,147,919,14,426,2,7,1593
1073004502,3423,1334,185,1385,14,395,1,18,2089
1073004701,3482,2673,135,464,8,57,0,19,809
1073004702,3136,2656,83,246,1,51,0,7,480
1073004800,2011,1744,72,97,0,37,0,6,267
1073004901,1211,826,54,215,0,69,0,5,385
1073004902,3555,2159,149,659,4,402,38,8,1396
1073005000,3374,2019,393,489,6,289,0,26,1355
1073005101,1081,39,76,929,0,0,0,0,1042
1073005103,2575,72,274,2154,1,7,0,9,2503
1073005104,2435,389,297,1627,0,56,0,0,2046
1073005200,3365,24,149,3152,2,0,0,1,3341
1073005302,3484,1424,99,1806,8,33,0,7,2060
1073005500,1943,269,155,1452,6,4,0,16,1674
1073005600,5053,3870,345,628,6,59,0,13,1183
1073005701,1990,56,52,1843,9,0,0,1,1934
1073005702,3079,69,81,2845,8,10,0,4,3010
1073005800,2803,878,239,1512,7,115,2,0,1925
1073005903,5149,994,380,3612,10,32,0,18,4155
1073005905,5577,753,482,4168,2,10,1,15,4824
1073005907,2060,382,36,1581,6,14,0,8,1678
1073005908,3644,467,252,2802,11,11,0,14,3177
1073005909,2514,205,42,2204,18,7,0,0,2309
1073005910,5109,326,63,4621,0,13,2,8,4783
1073010001,5681,2623,549,2269,13,19,3,21,3058
1073010002,5155,2675,237,2007,5,9,2,15,2480
1073010100,1381,23,47,1277,0,0,1,3,1358
1073010200,2285,428,351,1424,8,2,0,10,1857
1073010301,2448,317,301,1775,6,1,0,8,2131
1073010302,3870,77,131,3563,5,0,0,8,3793
1073010401,3556,611,564,2264,7,3,0,3,2945
1073010402,1982,337,76,1533,2,0,2,13,1645
1073010500,1581,191,224,1094,5,1,1,3,1390
1073010603,2277,42,31,2176,4,0,0,2,2235
1073010604,4595,89,91,4347,3,8,2,8,4506
1073010605,936,45,22,838,0,0,1,0,891
1073010701,1817,1072,211,409,1,53,2,4,745
1073010702,4898,3890,322,426,6,89,6,11,1008
1073010703,2552,2309,43,63,0,35,0,3,243
1073010704,5279,2338,181,2472,1,139,0,21,2941
1073010705,4125,3593,155,168,5,75,0,5,532
1073010706,4893,2799,336,1315,11,278,1,26,2094
1073010801,7112,6561,143,132,2,69,0,15,551
1073010802,3633,3488,46,1,2,26,0,3,145
1073010803,6514,3982,297,1853,10,125,1,11,2532
1073010804,3312,3117,51,17,4,47,0,5,195
1073010806,6486,5945,114,146,0,111,0,5,541
1073010807,1450,1131,49,197,0,11,0,2,319
1073010900,4719,934,940,2602,11,30,63,17,3785
1073011002,1974,885,151,861,1,7,1,8,1089
1073011003,2194,1559,200,288,7,14,0,7,635
1073011004,3643,2825,189,417,10,33,1,23,818
1073011108,5172,3761,112,962,7,163,0,2,1411
1073011109,4273,3756,85,232,2,39,0,9,517
1073011110,5813,3559,302,1615,16,26,1,22,2254
1073011112,3987,1267,168,2365,5,37,0,22,2720
1073011113,4006,1110,144,2575,3,40,0,17,2896
1073011114,8019,6524,165,933,19,99,0,13,1495
1073011115,5736,4369,260,666,23,158,7,19,1367
1073011116,2819,2350,57,277,7,27,0,8,469
1073011117,6020,3508,201,1994,5,106,1,12,2512
1073011205,2172,1218,161,700,5,9,0,2,954
1073011206,5413,3699,292,1171,9,21,1,23,1714
1073011207,5103,878,236,3849,8,7,6,9,4225
1073011208,4559,2021,279,2051,0,39,5,9,2538
1073011209,3236,369,156,2624,5,8,4,17,2867
1073011210,3710,922,714,1974,6,16,0,12,2788
1073011301,3562,2557,336,443,17,13,4,17,1005
1073011303,3913,3499,69,177,7,8,0,3,414
1073011304,3748,3349,50,173,5,17,0,6,399
1073011401,2517,1901,44,435,7,7,0,17,616
1073011402,4178,3897,49,42,13,17,0,1,281
1073011500,6035,5618,85,28,26,8,4,4,417
1073011600,3863,3283,104,265,10,17,0,3,580
1073011704,4343,3912,86,125,13,28,0,0,431
1073011706,2304,1819,310,84,19,0,0,4,485
1073011707,3825,2740,181,661,18,85,4,17,1085
1073011708,6297,4423,130,1399,10,115,3,28,1874
1073011709,4956,3243,892,558,9,55,1,10,1713
1073011710,3721,3212,117,194,7,28,7,13,509
1073011803,4902,533,235,3985,8,5,0,17,4369
1073011804,2987,344,130,2438,1,5,2,6,2643
1073011805,3552,965,183,2274,4,15,0,11,2587
1073011806,3651,707,206,2571,5,12,4,11,2944
1073011901,2926,1205,729,908,9,2,0,11,1721
1073011904,2044,109,53,1847,0,1,0,5,1935
1073012001,4249,1402,172,2534,9,7,1,16,2847
1073012003,2246,1140,184,804,5,36,0,2,1106
1073012004,5670,2313,293,2824,0,62,0,12,3357
1073012103,4277,1558,95,2489,13,12,2,5,2719
1073012104,2806,1384,132,1162,12,3,1,13,1422
1073012200,4022,2707,51,1161,8,4,0,8,1315
1073012302,3918,3428,73,244,12,0,0,1,490
1073012304,2527,988,34,1428,14,1,0,7,1539
1073012306,3581,469,31,3016,4,6,0,1,3112
1073012307,3900,1503,72,2220,5,1,3,3,2397
1073012401,3660,208,62,3325,3,3,2,9,3452
1073012402,3089,713,118,2122,14,5,0,24,2376
1073012403,3414,1324,166,1799,14,11,0,15,2090
1073012500,4160,1919,237,1819,12,22,1,13,2241
1073012602,3106,1571,262,1127,6,17,1,12,1535
1073012701,4081,2308,989,630,12,34,0,4,1773
1073012703,7347,5737,342,514,13,464,12,16,1610
1073012704,2505,2059,92,241,1,16,1,18,446
1073012802,3109,2720,140,72,3,59,0,23,389
1073012804,3747,3301,109,117,5,89,0,18,446
1073012805,2255,1501,145,349,0,163,1,9,754
1073012905,4767,4399,97,95,0,86,0,10,368
1073012907,5151,3389,266,1172,6,115,0,16,1762
1073012908,4352,2037,704,1184,5,205,16,14,2315
1073012910,4703,3673,146,527,13,177,0,16,1030
1073012911,6757,6139,119,90,2,213,1,15,618
1073012913,4421,1428,618,1894,12,258,0,32,2993
1073012914,2206,1892,81,123,1,58,0,0,314
1073012916,3948,3312,97,242,2,195,0,9,636
1073012917,3066,2208,170,451,4,113,0,19,858
1073012918,2472,920,307,1076,2,86,0,7,1552
1073012919,2841,904,278,1440,6,61,4,12,1937
1073012920,3239,2093,191,469,5,340,3,18,1146
1073012921,3572,3120,107,43,7,213,0,4,452
1073013002,1811,35,73,1674,0,8,1,0,1776
1073013100,3870,68,52,3663,4,2,1,16,3802
1073013200,2189,120,92,1919,2,0,0,7,2069
1073013300,3074,217,521,2290,5,1,0,2,2857
1073013400,4420,265,161,3914,14,6,0,6,4155
1073013601,2918,133,255,2463,3,5,1,4,2785
1073013801,1907,168,328,1371,7,5,1,2,1739
1073013901,1565,339,102,1059,1,4,0,16,1226
1073013902,2269,1105,101,969,11,20,0,3,1164
1073014001,3864,3527,42,92,9,9,4,17,337
1073014002,3510,2476,60,862,3,19,0,6,1034
1073014104,3820,1497,184,2024,3,24,0,17,2323
1073014105,5057,1142,239,3544,4,20,2,6,3915
1073014106,3002,2452,58,327,18,7,3,16,550
1073014107,2093,1953,22,2,14,4,1,6,140
1073014205,3213,1525,111,1451,6,43,0,3,1688
1073014206,5256,2861,262,1928,6,31,0,13,2395
1073014207,6349,3373,151,2482,22,92,0,28,2976
1073014208,6433,4532,318,1107,5,231,0,34,1901
1073014209,4612,2332,353,1128,5,638,0,18,2280
1073014301,3014,1540,269,1108,7,8,1,2,1474
1073014303,6557,4027,221,1605,16,463,0,18,2530
1073014304,4504,1984,195,1899,13,243,2,35,2520
1073014404,5918,3825,367,1006,14,501,0,39,2093
1073014405,4226,2883,196,746,5,212,0,13,1343
1073014406,6219,5226,197,376,0,227,0,19,993
1073014408,4235,1730,208,1543,13,593,3,28,2505
1073014409,3341,2761,107,260,3,89,1,8,580
1073014410,5568,3788,219,944,4,429,0,25,1780
1073014412,4329,3797,132,122,2,94,0,15,532
1073014414,7006,5624,201,519,7,334,0,22,1382
1073014415,3918,2311,121,672,0,656,0,16,1607
1075030000,4412,3752,33,493,11,2,3,9,660
1075030101,3340,2831,35,373,7,1,0,11,509
1075030102,2211,1877,100,145,3,3,0,2,334
1075030200,4009,3464,40,410,7,0,0,0,545
1077010100,2278,1399,138,499,8,123,2,7,879
1077010200,1829,1266,29,449,2,12,1,1,563
1077010300,1250,95,32,1051,3,0,2,5,1155
1077010400,3429,2432,135,597,13,57,0,14,997
1077010600,2672,1921,131,408,12,23,3,9,751
1077010700,1582,836,228,417,5,0,3,2,746
1077010800,3670,2133,475,843,15,19,0,1,1537
1077010901,3695,2760,308,425,9,54,0,5,935
1077010902,3814,2661,152,752,3,51,0,9,1153
1077011000,4483,2732,198,1256,13,12,4,13,1751
1077011101,5618,4683,149,482,25,43,4,30,935
1077011102,4518,3762,143,379,10,35,0,6,756
1077011200,4089,3417,96,421,10,10,0,9,672
1077011300,2190,2086,21,12,9,0,0,1,104
1077011401,3358,3143,24,63,18,4,3,11,215
1077011402,2948,2728,80,47,9,1,0,11,220
1077011502,5501,5159,98,74,17,14,0,10,342
1077011503,3013,2658,67,122,11,39,3,7,355
1077011504,4347,3767,86,212,10,130,2,2,580
1077011602,4798,4503,63,28,10,5,1,16,295
1077011603,4773,4447,95,48,10,16,0,6,326
1077011605,2713,2386,54,114,3,32,0,10,327
1077011606,4214,3767,77,134,16,28,0,7,447
1077011700,4467,4168,83,43,20,12,0,6,299
1077011801,4576,4313,63,27,21,11,0,3,263
1077011802,3739,3269,53,261,13,17,3,3,470
1079979100,1523,596,43,794,18,0,0,4,927
1079979201,1874,633,31,1135,6,10,0,8,1241
1079979202,2251,1423,83,496,73,0,2,1,828
1079979300,4550,3610,51,20,348,11,0,3,940
1079979400,4399,3286,181,474,150,25,1,8,1113
1079979501,2647,2204,91,59,91,4,0,3,443
1079979502,3245,2722,57,23,161,7,0,8,523
1079979600,5409,4525,220,86,158,16,0,9,884
1079979700,1990,1537,46,116,93,0,2,6,453
1079979800,3345,2720,62,51,209,3,0,8,625
1079979900,1840,1458,30,48,133,8,2,11,382
1081040201,3760,2392,276,387,6,571,0,6,1368
1081040202,3084,2111,223,410,11,165,0,13,973
1081040300,2576,1851,145,341,9,133,0,7,725
1081040401,3532,1997,218,653,8,453,7,6,1535
1081040402,2055,1717,94,114,3,66,1,7,338
1081040403,1965,1503,55,188,4,145,0,11,462
1081040501,6514,5324,100,313,7,613,6,9,1190
1081040502,4536,2415,211,1046,10,680,0,11,2121
1081040602,8254,4146,240,2680,21,787,2,29,4108
1081040603,1379,659,263,393,0,6,0,2,720
1081040605,1754,1507,52,92,1,38,0,0,247
1081040606,2855,1597,170,464,5,384,7,25,1258
1081040607,1307,697,254,242,2,76,0,7,610
1081040700,5173,2005,196,2862,3,51,1,11,3168
1081040801,2743,1949,163,246,2,263,0,9,794
1081040802,2132,1544,84,139,0,302,1,7,588
1081040901,4226,2908,148,701,7,295,0,19,1318
1081040903,1961,986,93,521,3,276,2,8,975
1081040904,5637,3601,396,849,9,510,1,18,2036
1081041001,7376,5214,216,582,13,1041,0,13,2162
1081041002,4218,1995,242,1815,11,28,5,3,2223
1081041101,2070,883,279,768,2,71,4,3,1187
1081041102,4000,1994,205,1185,3,509,2,0,2006
1081041103,2280,624,965,562,1,69,1,6,1656
1081041104,3084,2106,209,649,8,23,1,1,978
1081041200,4986,3835,107,728,8,91,3,22,1151
1081041300,3353,1833,182,1144,6,39,1,14,1520
1081041400,3388,296,265,2749,0,1,1,8,3092
1081041600,3573,830,92,2449,4,83,0,4,2743
1081041701,3293,1580,130,1220,7,200,3,8,1713
1081041702,2869,1752,216,751,3,38,0,6,1117
1081041703,5114,2932,305,1610,12,88,0,24,2182
1081041801,2618,1980,98,401,8,5,2,13,638
1081041802,2764,1759,46,785,5,19,0,4,1005
1081041803,2649,2378,52,106,8,7,2,4,271
1081041901,2299,1964,87,119,10,15,0,10,335
1081041902,3513,2702,119,507,8,9,0,6,811
1081041903,3585,2883,125,409,16,10,5,4,702
1081042002,8883,6062,482,1694,23,165,10,29,2821
1081042003,3507,2801,147,380,15,11,3,12,706
1081042005,4218,3002,159,810,2,18,1,19,1216
1081042006,1827,1409,52,280,8,13,0,1,418
1081042007,3123,2109,173,668,9,15,0,8,1014
1081042008,5961,3439,449,1631,25,47,27,11,2522
1081042009,1642,1271,73,213,1,9,1,3,371
1081042101,3993,2780,89,919,8,16,2,7,1213
1081042103,2366,1723,79,464,9,3,0,1,643
1081042104,6246,4750,111,1013,21,87,6,13,1496
1083020101,4452,3764,264,174,27,11,3,15,688
1083020103,3115,2714,153,69,17,17,0,3,401
1083020104,4037,3617,148,58,18,21,0,14,420
1083020201,5043,3716,750,263,20,14,0,9,1327
1083020202,5219,4667,182,127,36,16,0,17,552
1083020300,3800,3493,114,36,15,6,0,4,307
1083020402,5798,4536,557,385,28,29,0,5,1262
1083020403,3234,2739,145,159,23,16,2,4,495
1083020404,3047,2560,185,156,17,16,0,3,487
1083020500,3057,2145,203,580,20,5,0,11,912
1083020600,4392,2470,1054,616,18,25,0,15,1922
1083020700,2582,1522,313,558,3,10,14,10,1060
1083020803,6099,3894,301,1465,13,78,9,27,2205
1083020804,5428,4319,188,572,26,43,0,22,1109
1083020805,5310,3591,210,1289,30,13,3,5,1719
1083020806,3944,3453,108,157,9,35,8,8,491
1083020900,4293,3124,236,582,18,69,6,18,1169
1083021000,2386,981,257,993,1,23,9,10,1405
1083021101,3408,1995,491,706,16,1,0,12,1413
1083021102,3899,2686,299,710,7,48,0,16,1213
1083021201,8733,5784,445,1216,48,712,0,44,2949
1083021202,6460,4600,326,1004,18,149,4,31,1860
1083021203,5834,3322,319,1302,30,500,12,16,2512
1085780800,3359,1258,74,1974,2,9,0,0,2101
1085781000,2710,836,28,1787,7,0,0,4,1874
1085781100,1535,137,10,1351,0,0,0,0,1398
1085781200,2707,576,28,2037,0,6,0,1,2131
1087231400,1342,565,58,670,13,3,0,3,777
1087231500,3054,1518,99,1305,5,6,0,8,1536
1087231601,1132,201,19,883,3,0,0,1,931
1087231602,1602,66,6,1490,3,1,0,3,1536
1087231603,1112,130,22,936,0,0,0,1,982
1087231700,2191,101,61,1965,1,39,2,13,2090
1087231800,1089,6,4,1063,8,0,0,0,1083
1087231900,1657,12,8,1577,2,11,2,4,1645
1087232000,1583,31,12,1491,4,8,0,7,1552
1087232100,1553,5,11,1510,1,0,0,0,1548
1087232200,1884,430,46,1352,5,6,0,0,1454
1087232300,1333,122,15,1153,3,0,0,5,1211
1089000203,5584,604,292,4481,17,18,1,38,4980
1089000301,3965,573,374,2824,15,8,1,18,3392
1089000302,3580,330,299,2796,8,9,2,24,3250
1089000403,4779,680,247,3600,12,35,7,14,4099
1089000501,1909,270,153,1349,3,26,15,5,1639
1089000502,2291,259,197,1733,17,16,2,3,2032
1089000503,1767,276,154,1219,4,10,3,12,1491
1089000601,1531,392,114,907,6,17,4,7,1139
1089000602,2129,508,207,1298,6,7,12,2,1621
1089000701,3167,428,303,2282,9,5,1,11,2739
1089000702,2765,772,161,1730,6,9,0,6,1993
1089000901,4522,3613,186,391,17,63,3,12,909
1089000902,2023,1613,97,152,7,23,2,4,410
1089001000,2978,2496,147,121,16,49,2,5,482
1089001200,2887,212,232,2254,12,11,1,9,2675
1089001301,3574,712,202,2337,13,126,5,7,2862
1089001302,1968,475,138,1231,6,27,8,2,1493
1089001401,2347,1625,197,316,5,64,2,19,722
1089001403,2653,1216,153,1007,1,128,1,13,1437
1089001404,3077,1738,192,754,21,151,12,37,1339
1089001500,5895,2976,669,1719,43,255,22,14,2919
1089001700,1920,1750,46,17,2,25,0,6,170
1089001801,3802,3443,93,25,26,26,2,8,359
1089001901,3489,3040,101,42,6,171,3,3,449
1089001902,2278,1970,60,103,2,65,1,3,308
1089001903,2419,2077,110,42,4,94,0,2,342
1089002000,2225,1946,79,53,12,25,10,6,279
1089002100,3182,1018,484,1450,19,22,1,27,2164
1089002200,2161,941,453,607,10,33,11,7,1220
1089002300,5509,2134,1489,1429,41,52,21,23,3375
1089002400,5064,1485,1465,1792,17,88,2,16,3579
1089002501,3210,730,1210,1110,6,22,6,13,2480
1089002502,3339,1172,689,1246,16,38,1,12,2167
1089002600,4035,3232,135,394,12,71,14,11,803
1089002701,2730,2218,105,206,17,46,2,5,512
1089002721,4042,3351,99,289,6,77,11,23,691
1089002722,3129,2535,109,176,14,100,5,14,594
1089002801,5142,3672,275,762,26,134,6,22,1470
1089002803,5257,3693,337,449,26,364,3,43,1564
1089002804,2720,2261,87,121,11,112,0,10,459
1089002911,4489,3776,179,115,19,148,0,17,713
1089002912,2448,2106,104,45,10,69,0,10,342
1089002922,4210,3513,175,88,24,143,0,18,697
1089002923,3578,2713,189,306,20,100,1,9,865
1089002924,3075,2115,301,356,11,107,0,7,960
1089003000,2837,1254,168,1236,13,29,0,7,1583
1089003100,3699,2574,133,808,17,50,5,7,1125
1089010101,4975,3926,236,288,93,21,0,15,1049
1089010102,5486,3815,201,982,38,46,3,17,1671
1089010200,6041,4828,175,528,76,46,2,19,1213
1089010302,4389,3418,118,448,67,23,4,23,971
1089010303,3571,2879,132,233,39,34,4,3,692
1089010304,5751,4553,226,469,54,47,1,32,1198
1089010403,3096,2381,153,299,28,17,0,8,715
1089010404,3034,2447,144,134,46,10,0,13,587
1089010405,3673,2605,177,574,36,13,0,27,1068
1089010406,2987,1935,112,660,39,29,2,33,1052
1089010502,4002,1922,230,1504,18,58,4,22,2080
1089010503,6342,3207,381,2224,31,51,16,43,3135
1089010504,7570,4413,359,2153,40,125,3,41,3157
1089010612,7139,3920,439,2010,38,316,10,55,3219
1089010623,7376,4445,488,1788,40,203,26,28,2931
1089010625,4834,659,245,3586,15,114,6,13,4175
1089010626,3584,1815,209,1247,16,147,0,20,1769
1089010627,4502,2656,252,1128,21,200,0,16,1846
1089010628,3341,2288,155,619,10,63,1,6,1053
1089010629,5136,3562,262,855,25,86,2,27,1574
1089010630,3195,2103,84,719,24,110,0,12,1092
1089010631,4782,2985,212,1174,29,107,9,27,1797
1089010703,4658,3122,228,892,39,65,5,10,1536
1089010704,6164,3703,309,1654,43,94,7,34,2461
1089010705,3248,1544,129,1345,18,28,2,17,1704
1089010706,4794,3105,196,1070,49,59,1,8,1689
1089010801,5691,4233,223,827,31,76,0,21,1458
1089010802,5526,4298,194,548,37,54,8,25,1228
1089010902,3081,2472,65,270,34,22,2,14,609
1089010903,6582,5467,328,257,33,171,1,26,1115
1089010904,4628,3642,218,292,11,161,1,24,986
1089010905,8213,7076,274,251,27,235,3,27,1137
1089011012,6040,4690,231,432,17,329,4,33,1350
1089011013,4960,3553,257,606,15,193,10,40,1407
1089011021,5297,2762,358,1484,22,346,15,22,2535
1089011023,6113,4249,311,628,17,538,4,26,1864
1089011024,4809,3276,212,522,12,510,5,30,1533
1089011025,6838,3857,542,1452,16,533,20,32,2981
1089011026,3835,2686,207,399,26,324,3,17,1149
1089011027,3105,2057,146,420,12,260,9,33,1048
1089011028,4073,2208,372,1064,7,168,1,19,1865
1089011100,865,506,51,225,4,28,3,0,359
1089011201,5559,2878,377,1722,19,216,5,48,2681
1089011202,4837,2773,263,1242,14,250,13,31,2064
1089011203,5480,2638,553,1655,12,231,11,33,2842
1089011301,4017,3187,169,253,53,44,8,16,830
1089011302,5111,4302,233,141,27,103,2,16,809
1089011400,4443,3964,111,38,83,7,3,9,479
1091972901,1619,445,48,1074,1,22,1,3,1174
1091972902,3344,952,121,2194,0,11,0,5,2392
1091973001,1338,393,11,903,0,0,0,7,945
1091973002,2829,1622,52,1091,0,2,0,8,1207
1091973100,1717,622,7,1055,4,0,0,1,1095
1091973200,2396,746,22,1593,0,1,0,1,1650
1091973300,1918,1031,13,823,1,0,0,10,887
1091973400,4162,2564,94,1400,0,18,0,6,1598
1093964001,3198,2901,155,16,8,6,2,1,297
1093964002,1423,1325,29,3,4,2,1,0,98
1093964100,2609,2432,68,7,3,8,0,0,177
1093964200,1370,1252,17,48,0,5,0,4,118
1093964300,4502,3917,181,148,16,16,4,15,585
1093964401,3713,3129,115,325,24,5,4,5,584
1093964402,1905,1722,64,48,1,8,0,0,183
1093964500,1954,1866,18,2,1,3,0,5,88
1093964600,3065,2596,77,234,12,8,0,3,469
1093964701,2457,2135,96,109,12,1,2,6,322
1093964702,3145,2818,43,154,1,13,1,4,327
1095030101,1489,1177,209,8,12,7,1,6,312
1095030102,1397,1269,63,1,6,0,0,7,128
1095030203,4013,3682,110,10,11,13,4,3,331
1095030204,1823,1655,25,15,9,6,1,10,168
1095030205,1250,1146,22,4,8,9,0,0,104
1095030206,3732,3373,100,28,11,22,0,13,359
1095030301,2175,1973,59,15,15,3,0,3,202
1095030302,4363,4005,64,21,26,20,1,9,358
1095030401,4817,4295,182,13,25,54,1,2,522
1095030402,3502,3241,73,7,19,13,0,9,261
1095030501,2782,2577,78,6,13,8,3,3,205
1095030502,4868,4368,207,25,15,50,0,6,500
1095030601,2927,2603,113,40,9,18,0,6,324
1095030602,4015,2967,387,455,18,25,0,2,1048
1095030701,3689,2639,578,226,18,51,0,7,1050
1095030702,3993,3317,408,108,14,24,0,5,676
1095030801,5137,3328,1413,146,25,44,1,4,1809
1095030803,2377,1710,552,21,10,15,0,4,667
1095030804,5732,2213,3052,274,16,23,0,16,3519
1095030902,4887,3582,996,91,10,37,4,11,1305
1095030903,5980,3061,2182,462,22,45,7,7,2919
1095030904,5765,4089,1349,110,24,30,2,4,1676
1095031001,3471,2846,483,10,16,5,0,20,625
1095031002,2635,1917,630,12,12,1,0,3,718
1095031100,5066,3436,1234,122,30,34,32,25,1630
1095031200,5727,4197,1089,63,24,22,71,14,1530
1097000200,1247,724,16,448,3,12,0,8,523
1097000401,1177,6,6,1140,5,0,0,0,1171
1097000402,872,9,11,831,0,0,0,0,863
1097000500,1487,10,12,1415,4,0,1,11,1477
1097000600,1512,14,129,1340,4,0,3,0,1498
1097000701,1783,9,9,1720,1,0,0,2,1774
1097000702,2038,15,9,1964,1,0,0,0,2023
1097000801,2824,131,28,2542,9,42,1,17,2693
1097000802,1288,1,14,1243,4,0,0,3,1287
1097000901,1543,1008,57,403,5,12,0,2,535
1097000902,1914,1507,43,276,8,14,1,4,407
1097000903,1454,599,43,744,5,4,3,1,855
1097001001,1513,872,50,525,5,2,0,5,641
1097001002,1777,880,45,759,5,4,3,7,897
1097001100,2141,105,16,1955,4,3,0,6,2036
1097001200,2447,594,13,1801,0,0,2,4,1853
1097001302,2402,42,20,2253,6,0,0,4,2360
1097001400,1890,42,13,1779,0,0,0,10,1848
1097001501,1142,9,16,1088,1,0,0,4,1133
1097001502,1040,12,17,980,0,3,0,0,1028
1097001800,2340,756,134,1328,9,20,0,5,1584
1097001901,2012,858,40,1010,13,10,1,9,1154
1097001902,3190,1122,81,1858,5,20,0,8,2068
1097002000,1801,1053,48,600,6,24,3,5,748
1097002100,3778,505,67,3074,10,15,0,18,3273
1097002200,2478,369,66,1984,9,10,3,5,2109
1097002301,1897,165,53,1580,3,5,0,7,1732
1097002302,1584,42,10,1492,0,6,0,5,1542
1097002400,3269,480,75,2595,9,25,0,9,2789
1097002501,3448,2821,110,329,12,35,0,6,627
1097002502,2542,2003,86,335,8,12,5,4,539
1097002600,2400,212,43,2080,4,0,0,9,2188
1097002700,2251,316,41,1815,6,4,1,1,1935
1097002800,4562,1729,152,2482,13,43,3,8,2833
1097002900,4106,1457,218,2178,9,118,8,26,2649
1097003000,3515,1709,142,1386,12,124,5,18,1806
1097003100,4357,3022,174,851,7,104,0,10,1335
1097003202,2820,893,207,1477,3,137,0,5,1927
1097003203,3656,1622,211,1529,12,111,7,11,2034
1097003205,2856,383,90,2069,5,185,10,9,2473
1097003206,1052,181,62,746,3,35,1,0,871
1097003207,2989,889,167,1619,16,176,4,12,2100
1097003301,2871,1471,147,979,6,110,9,17,1400
1097003302,4987,3923,192,636,8,66,3,34,1064
1097003402,3776,543,40,3085,8,9,0,11,3233
1097003404,2767,349,64,2233,15,4,0,7,2418
1097003405,1941,531,39,1276,6,19,0,12,1410
1097003406,2944,960,67,1775,3,20,0,13,1984
1097003408,3915,981,79,2700,4,27,0,15,2934
1097003409,3016,1519,98,1277,12,15,1,8,1497
1097003410,4576,1854,183,2307,24,30,1,36,2722
1097003501,3660,2878,132,473,18,33,3,9,782
1097003502,2715,2439,79,81,11,40,3,8,276
1097003602,1253,153,35,1031,3,12,1,4,1100
1097003606,3907,2407,125,1026,23,153,0,13,1500
1097003607,3662,1602,230,1575,13,67,0,24,2060
1097003608,1279,344,47,845,2,20,1,5,935
1097003703,3894,2067,170,1356,5,153,0,13,1827
1097003704,4577,3309,145,750,17,192,7,10,1268
1097003705,4343,2806,165,1014,9,122,0,15,1537
1097003706,3179,2197,114,682,3,58,3,7,982
1097003707,4393,1928,188,1927,16,126,0,24,2465
1097003708,4370,2816,153,1033,16,154,0,19,1554
1097003710,4217,2378,193,1405,10,55,0,10,1839
1097003711,2727,1496,148,809,10,117,1,6,1231
1097003712,3760,2349,153,1010,9,109,1,11,1411
1097003800,1477,782,27,591,18,0,0,7,695
1097003901,1924,93,18,1781,2,1,0,0,1831
1097003902,809,12,4,760,2,0,0,1,797
1097004000,2100,18,19,2023,1,2,0,1,2082
1097004100,638,2,3,612,1,3,0,0,636
1097004800,979,41,3,892,6,1,0,4,938
1097004900,2985,128,39,2736,2,2,0,15,2857
1097005000,1661,409,17,1182,3,0,1,0,1252
1097005100,1476,454,61,878,6,10,0,5,1022
1097005200,1618,868,31,640,13,3,1,11,750
1097005300,2259,1301,66,755,13,14,0,8,958
1097005400,4733,3668,121,515,56,87,1,12,1065
1097005500,3005,1862,81,815,54,8,0,16,1143
1097005601,3068,2798,32,90,29,3,1,0,270
1097005602,4593,3387,73,811,79,28,2,14,1206
1097005701,4439,3700,48,419,53,61,6,15,739
1097005702,3211,2375,47,517,107,8,0,5,836
1097005800,4554,1511,40,1577,1214,2,3,10,3043
1097005900,4645,3836,70,361,135,10,1,16,809
1097006000,5016,3464,76,860,289,17,1,11,1552
1097006102,2985,2116,100,566,44,11,0,13,869
1097006103,4800,860,82,3685,26,11,0,11,3940
1097006104,4467,3564,79,503,73,5,0,14,903
1097006106,2940,2072,45,632,41,33,0,11,868
1097006107,4253,3072,76,840,58,14,0,12,1181
1097006201,3960,3445,85,198,56,6,0,13,515
1097006202,1918,1632,36,135,8,10,1,3,286
1097006303,3574,3048,118,269,7,12,0,10,526
1097006304,4462,3197,331,657,13,18,3,10,1265
1097006305,3088,2566,70,201,41,26,1,2,522
1097006306,4737,2805,147,1519,17,67,0,16,1932
1097006307,3253,2329,88,661,28,31,0,2,924
1097006402,4870,3069,210,1245,38,31,4,8,1801
1097006403,1789,1087,123,470,9,36,0,6,702
1097006407,6959,5790,183,600,43,86,0,4,1169
1097006408,4098,2529,186,942,29,182,7,10,1569
1097006409,7317,4533,488,1453,32,382,0,26,2784
1097006410,3663,2263,104,961,21,169,3,9,1400
1097006411,5045,2923,295,1432,34,157,5,5,2122
1097006412,4923,3602,182,744,22,178,1,9,1321
1097006413,4110,2973,159,609,43,148,0,14,1137
1097006501,5349,4218,242,474,26,78,1,45,1131
1097006503,3726,2713,201,585,11,103,3,13,1013
1097006504,4215,3653,122,190,23,26,3,5,562
1097006505,5262,4479,155,339,30,30,1,20,783
1097006600,5294,4426,102,462,27,69,0,18,868
1097006702,3772,2397,165,588,28,367,23,9,1375
1097006703,2668,1810,61,471,10,199,0,0,858
1097006704,4216,2690,289,673,19,366,4,14,1526
1097006802,3112,2410,164,308,20,43,3,12,702
1097006803,3104,2067,106,461,14,306,2,15,1037
1097006804,5433,3828,132,874,23,380,7,20,1605
1097006902,4131,2622,216,928,24,93,2,16,1509
1097006903,3367,1712,159,1177,11,155,0,15,1655
1097006904,4296,3352,285,354,29,62,0,8,944
1097007000,4621,3921,161,217,23,68,18,21,700
1097007101,4575,3192,230,729,42,139,1,9,1383
1097007102,3201,1174,76,1693,29,73,0,15,2027
1097007103,3377,2798,89,273,17,32,1,10,579
1097007201,2855,2259,67,88,26,305,1,5,596
1097007203,1778,1615,42,5,19,12,3,1,163
1097007204,1531,1335,31,54,4,2,0,16,196
1097007300,4030,2748,161,383,13,516,1,15,1282
1097007400,2878,1131,47,1550,9,38,0,16,1747
1097007500,1346,21,9,1280,0,0,1,9,1325
1097007600,1972,69,10,1854,2,1,0,3,1903
1097007700,1154,16,2,1111,3,0,0,2,1138
1097980000,2022,1387,208,269,0,153,0,2,635
1097990000,0,0,0,0,0,0,0,0,0
1099075600,926,208,11,677,7,4,0,0,718
1099075700,1428,482,16,897,8,1,0,5,946
1099075800,1085,329,6,716,5,3,0,0,756
1099075901,3170,1456,25,1532,46,34,0,12,1714
1099075902,2669,1177,28,1362,10,13,0,9,1492
1099076000,3093,1253,43,1721,16,13,0,2,1840
1099076101,1589,1106,20,320,46,4,0,9,483
1099076102,4114,3016,57,825,49,13,0,6,1098
1099076200,1698,1307,1,203,94,3,0,1,391
1101000100,982,368,34,522,0,25,2,0,614
1101000200,1440,306,52,1056,2,3,0,0,1134
1101000300,1261,154,43,1041,4,2,0,0,1107
1101000400,4267,1141,487,2482,18,16,0,6,3126
1101000500,2902,1089,719,944,15,14,1,12,1813
1101000600,1763,149,24,1555,3,2,0,0,1614
1101000700,997,201,24,725,4,5,0,2,796
1101000900,2133,1145,254,574,6,71,3,5,988
1101001000,1200,99,18,1048,0,7,0,6,1101
1101001100,2684,39,26,2575,7,0,0,1,2645
1101001200,1455,13,17,1382,1,2,0,2,1442
1101001300,2094,660,76,1258,5,21,1,5,1434
1101001400,3555,2600,118,600,6,49,9,7,955
1101001500,4112,1667,154,2086,2,96,5,8,2445
1101001600,3830,1009,464,2157,10,40,2,22,2821
1101001700,5469,2829,195,2168,15,27,7,14,2640
1101001800,3375,1758,146,1285,9,35,0,22,1617
1101001900,3110,2050,80,758,7,39,4,8,1060
1101002000,4750,2769,213,1593,5,46,0,10,1981
1101002100,3886,620,101,3064,9,15,0,21,3266
1101002201,3754,75,111,3498,4,0,0,11,3679
1101002202,884,6,6,858,0,0,0,0,878
1101002300,2501,7,25,2409,4,1,0,9,2494
1101002400,1758,32,34,1634,0,23,0,3,1726
1101002500,2315,375,261,1489,9,80,4,4,1940
1101002600,5458,3650,192,1294,10,79,0,13,1808
1101002700,4349,2711,105,1342,3,50,0,25,1638
1101002800,4948,721,190,3835,15,40,1,25,4227
1101002901,3313,135,72,3036,0,15,2,6,3178
1101002902,3875,66,90,3647,0,0,0,22,3809
1101003000,1904,288,101,1438,3,4,0,13,1616
1101003100,3436,155,30,3192,0,3,0,2,3281
1101003200,5741,349,98,5118,4,30,0,21,5392
1101003301,3470,1810,91,1395,4,59,0,18,1660
1101003303,2652,611,58,1857,1,48,0,10,2041
1101003304,3723,820,91,2411,6,293,16,4,2903
1101005101,3604,803,107,2580,6,33,0,5,2801
1101005102,4239,364,124,3635,2,12,0,8,3875
1101005301,1154,638,146,177,2,61,9,13,516
1101005302,2198,569,529,974,5,45,0,10,1629
1101005402,5486,1008,159,4083,13,81,7,22,4478
1101005403,3905,669,70,2974,13,91,4,12,3236
1101005407,4335,1833,114,1854,5,366,4,24,2502
1101005409,2325,726,92,1347,6,65,1,7,1599
1101005410,5070,1059,175,3472,9,198,10,26,4011
1101005411,3092,2301,70,410,0,260,0,0,791
1101005412,6381,3345,164,2066,6,578,0,19,3036
1101005413,3973,2275,83,1323,8,152,1,11,1698
1101005414,3945,876,116,2690,7,149,0,10,3069
1101005501,3426,1338,107,1854,2,67,1,0,2088
1101005502,3195,1073,96,1655,2,231,1,15,2122
1101005503,6176,3715,171,1667,12,453,0,9,2461
1101005504,1829,1548,51,178,0,19,0,5,281
1101005604,3541,2068,79,1195,4,90,1,6,1473
1101005605,3712,768,88,2659,0,79,4,5,2944
1101005606,4770,421,129,4059,5,53,0,14,4349
1101005607,5640,2283,184,1126,7,1811,1,26,3357
1101005608,1633,1071,37,327,5,151,2,12,562
1101005609,5034,925,115,3121,4,736,0,24,4109
1101005610,1400,283,316,746,0,11,3,6,1117
1101005611,3644,1936,124,933,18,514,2,15,1708
1101005612,2131,759,79,878,0,304,0,14,1372
1101005613,4832,229,926,3520,3,27,6,20,4603
1101005614,2808,58,532,2163,2,14,0,8,2750
1101005700,1417,884,30,445,2,6,2,0,533
1101005800,1918,1281,23,553,3,1,0,6,637
1101005902,3212,35,158,2949,7,5,0,2,3177
1101005903,1943,1202,39,640,1,9,1,9,741
1101005904,2369,1011,145,1130,6,25,1,8,1358
1101006000,3209,1489,487,1121,7,10,1,12,1720
1101006100,2062,34,19,1971,1,5,0,2,2028
1103000100,4185,2038,934,978,20,12,2,19,2147
1103000200,3696,3272,111,108,12,35,0,2,424
1103000300,2910,2048,352,296,18,20,10,13,862
1103000400,4027,2373,566,792,16,71,2,28,1654
1103000600,3266,578,840,1767,0,6,0,13,2688
1103000700,3992,864,1231,1729,13,9,15,21,3128
1103000800,3282,1289,1090,735,9,5,5,9,1993
1103000900,5853,2384,1845,1337,24,24,9,8,3469
1103001000,3409,1407,771,965,16,14,3,25,2002
1103005101,5146,3621,476,727,39,24,3,26,1525
1103005103,854,631,92,71,0,6,1,0,223
1103005105,2195,1740,134,156,14,41,0,7,455
1103005106,6587,4310,323,1490,21,119,1,9,2277
1103005107,4495,3494,430,289,17,36,0,8,1001
1103005108,3847,2504,350,748,11,54,2,15,1343
1103005109,4989,2226,773,1631,21,54,2,25,2763
1103005201,2142,1877,63,80,16,3,0,5,265
1103005202,4471,3974,193,46,29,17,2,9,497
1103005302,4149,3635,120,150,20,7,3,12,514
1103005303,3893,3438,125,126,17,20,1,13,455
1103005304,6079,5363,150,214,28,35,3,12,716
1103005305,4632,3912,127,243,23,69,2,16,720
1103005306,3788,3293,127,138,14,36,1,9,495
1103005404,6162,5366,219,155,46,42,7,5,796
1103005405,5170,4629,99,114,44,12,0,26,541
1103005500,5745,5274,120,70,44,10,1,10,471
1103005601,3289,2970,116,4,20,8,0,3,319
1103005602,2426,2272,18,8,13,5,0,3,154
1103005701,2809,2387,201,13,26,16,0,9,422
1103005703,2821,2312,301,37,21,4,4,2,509
1103005704,3112,2757,80,90,19,15,0,14,355
1105686800,736,422,8,284,3,0,0,0,314
1105687001,1123,603,11,491,1,0,0,0,520
1105687002,3563,951,56,2473,6,10,1,0,2612
1105687100,3089,369,14,2666,5,0,0,0,2720
1107050000,4428,3384,82,783,4,26,0,5,1044
1107050100,3172,1933,44,1090,0,3,0,4,1239
1107050200,1847,1251,18,535,0,12,0,0,596
1107050300,4886,1762,823,2177,19,27,0,1,3124
1107050401,2007,410,32,1518,0,2,0,1,1597
1107050402,2783,1326,54,1345,0,8,0,1,1457
1109188600,2183,1592,31,453,15,20,0,8,591
1109188700,1718,853,26,745,11,0,0,5,865
1109188800,2404,1701,64,520,18,4,0,5,703
1109188900,4266,1167,55,2831,5,63,0,13,3099
1109189001,3055,1785,72,1037,12,29,1,17,1270
1109189002,864,528,46,231,2,30,2,2,336
1109189003,3946,2136,80,1528,15,60,0,7,1810
1109189101,4248,2273,160,1403,18,234,1,28,1975
1109189102,3352,2074,178,843,23,104,2,10,1278
1109189200,2785,1942,73,605,27,20,0,3,843
1109189300,4188,1985,120,1872,23,13,3,19,2203
1111000100,3772,3146,268,188,10,2,0,6,626
1111000200,3439,3076,56,163,11,4,0,6,363
1111000300,4090,3258,82,595,6,14,1,7,832
1111000400,4286,3183,84,837,6,17,0,14,1103
1111000500,4467,2587,46,1656,7,37,0,18,1880
1111000600,1913,1379,69,375,10,12,0,0,534
1113030200,1766,506,48,1115,13,2,3,12,1260
1113030300,3198,1793,105,1138,7,10,0,9,1405
1113030402,3252,2230,151,693,5,34,5,9,1022
1113030403,3601,1865,188,1356,4,34,1,19,1736
1113030404,2810,1654,132,860,13,37,2,8,1156
1113030500,2367,1234,173,799,11,13,5,25,1133
1113030601,3717,784,489,2296,7,25,5,5,2933
1113030602,4525,999,207,3060,10,39,1,28,3526
1113030700,3619,839,187,2465,4,13,3,7,2780
1113030800,2981,190,66,2632,5,5,1,3,2791
1113030903,4598,1307,275,2723,16,31,23,22,3291
1113030904,2991,1091,265,1412,6,34,12,9,1900
1113030905,3795,1726,440,1227,11,63,50,33,2069
1113030906,3566,2608,106,648,35,9,4,17,958
1113030907,3135,2304,104,543,6,13,4,10,831
1113031000,3857,2785,98,755,10,26,4,3,1072
1113031100,1539,423,30,1042,2,0,1,3,1116
1113031200,3866,2341,131,1166,15,20,4,12,1525
1115040104,5400,4412,223,459,10,67,3,13,988
1115040105,4465,3972,171,99,10,8,3,11,493
1115040107,5901,4577,217,750,17,65,1,22,1324
1115040108,5225,4012,172,736,16,60,0,17,1213
1115040109,2819,2497,67,51,19,18,0,19,322
1115040110,4967,3757,207,623,8,106,2,17,1210
1115040206,2772,2360,40,223,3,22,1,8,412
1115040207,3381,2984,115,156,3,0,0,3,397
1115040208,2589,1754,61,595,7,41,0,7,835
1115040209,3312,2399,93,616,6,32,0,2,913
1115040210,3585,3107,85,270,5,16,0,2,478
1115040211,3072,2236,116,509,4,55,0,3,836
1115040212,2529,2282,33,124,5,12,1,10,247
1115040213,3249,2837,48,208,14,16,0,9,412
1115040301,2876,2560,73,85,23,5,0,0,316
1115040302,2771,2400,29,187,3,2,1,11,371
1115040401,5078,4168,164,486,29,24,5,14,910
1115040402,3923,3507,174,52,17,7,0,16,416
1115040503,4780,4332,68,197,10,23,0,4,448
1115040504,5436,4621,107,382,16,29,0,18,815
1115040505,2154,1999,41,32,0,3,0,0,155
1115040506,5659,4429,174,694,13,34,0,12,1230
1115040507,3303,2130,50,1002,9,7,0,10,1173
1115040508,1857,1630,47,81,2,3,3,6,227
1117030102,3983,2860,152,808,14,2,0,23,1123
1117030103,1066,897,33,83,6,2,0,8,169
1117030211,3097,2696,73,162,11,42,0,7,401
1117030212,3607,1864,301,968,8,271,4,22,1743
1117030215,5095,3871,255,571,18,131,2,26,1224
1117030216,8070,6428,169,860,13,290,2,33,1642
1117030218,4808,3961,206,334,20,78,0,10,847
1117030219,5059,4177,218,347,13,81,0,23,882
1117030220,5827,4912,134,348,1,270,0,2,915
1117030221,5378,3698,360,836,9,259,0,27,1680
1117030304,6311,5332,156,347,12,195,0,18,979
1117030305,3935,3556,101,66,12,71,0,3,379
1117030306,3866,2444,534,642,11,23,2,14,1422
1117030314,3266,2047,152,720,2,184,3,21,1219
1117030315,5610,2925,1759,597,6,104,0,37,2685
1117030316,5096,3328,620,772,3,126,3,20,1768
1117030317,4111,3223,296,357,8,38,0,22,888
1117030319,2480,1190,323,830,6,31,0,11,1290
1117030320,5500,4100,499,543,7,61,8,15,1400
1117030330,5557,4640,106,351,10,220,0,24,917
1117030331,4509,3662,444,111,7,73,0,18,847
1117030336,9126,6898,399,1137,24,216,12,22,2228
1117030337,2053,1226,431,281,5,27,2,2,827
1117030340,5681,3876,703,732,6,78,0,21,1805
1117030341,2484,1149,763,411,1,75,0,18,1335
1117030345,3616,2585,386,430,13,60,9,16,1031
1117030346,3847,3280,97,162,11,163,0,4,567
1117030347,4736,3285,251,769,10,250,7,18,1451
1117030348,4763,3884,125,293,7,270,0,14,879
1117030349,1226,997,57,70,0,64,0,13,229
1117030350,3004,2371,85,366,10,32,0,5,633
1117030351,3043,2334,109,277,4,225,0,6,709
1117030352,6077,4723,195,386,13,517,0,26,1354
1117030405,1265,741,124,332,2,8,1,8,524
1117030406,3735,2402,616,490,22,14,0,24,1333
1117030407,2126,1403,130,461,7,8,12,8,723
1117030408,3165,1893,464,658,9,2,0,6,1272
1117030502,3249,2231,140,701,5,39,0,6,1018
1117030503,4186,2582,327,1077,8,21,1,11,1604
1117030504,3748,1934,447,1190,7,10,0,1,1814
1117030607,6175,4286,486,1027,9,80,7,23,1889
1117030610,4143,2531,953,455,12,19,0,21,1612
1117030611,3206,2210,256,585,4,47,0,16,996
1117030612,2210,1568,206,281,4,23,0,5,642
1117030613,6935,4561,397,1532,13,84,3,20,2374
1117030614,4203,2290,356,1280,8,35,0,34,1913
1117030615,6484,4987,306,821,17,96,7,17,1497
1117030616,2810,2237,112,304,3,59,6,10,573
1117030701,5077,4015,172,728,15,8,0,9,1062
1117030703,3735,2782,200,541,6,8,0,13,953
1117030704,3875,3532,92,73,8,7,0,1,343
1117030800,4235,3760,117,165,8,14,0,12,475
1117030900,2557,2338,64,43,10,3,0,3,219
1117980000,14,10,1,0,0,0,0,1,4
1117980100,4,0,2,0,0,0,0,0,4
1119011301,3331,1161,66,1959,16,85,0,3,2170
1119011302,2478,600,25,1786,6,12,2,4,1878
1119011400,1478,306,22,1126,0,1,0,0,1172
1119011500,4054,469,10,3504,2,3,1,2,3585
1119011600,1004,401,8,580,2,1,0,0,603
1121010101,5481,3903,158,1053,19,143,0,8,1578
1121010102,5221,3833,131,1034,8,20,3,6,1388
1121010201,3996,2681,68,1082,6,11,3,6,1315
1121010202,4311,3295,80,695,15,35,4,15,1016
1121010301,3133,1693,49,1273,2,2,1,15,1440
1121010302,4779,3274,81,1251,15,3,0,10,1505
1121010400,2775,2322,49,313,4,2,0,3,453
1121010500,2713,786,133,1702,8,10,0,13,1927
1121010600,3115,438,45,2549,0,4,0,3,2677
1121010700,2966,875,154,1894,9,14,3,4,2091
1121010900,3225,1832,62,1200,10,32,0,2,1393
1121011000,2909,2194,41,529,3,14,1,6,715
1121011100,4532,2672,62,1633,15,12,2,16,1860
1121011200,2590,982,24,1518,2,1,1,10,1608
1121011301,2875,1767,50,958,6,4,0,5,1108
1121011302,3052,1827,59,1057,5,17,2,8,1225
1121011400,2668,1557,60,954,2,0,3,11,1111
1121011501,2660,2451,28,105,4,3,0,6,209
1121011502,3036,2516,59,355,12,2,0,0,520
1121011600,4903,3195,70,1433,8,27,0,23,1708
1121011700,4106,2811,125,1009,5,15,1,13,1295
1121011800,2107,1105,65,826,4,15,3,12,1002
1121011900,2711,1649,78,843,19,3,0,9,1062
1121012000,2285,1074,48,1074,3,6,0,2,1211
1123961900,2342,2031,23,218,10,0,0,2,311
1123962000,3988,2327,64,1464,8,10,0,14,1661
1123962100,3936,1740,153,1908,6,28,0,3,2196
1123962200,4628,3126,219,1115,8,22,0,3,1502
1123962301,2613,2004,114,389,4,5,0,11,609
1123962302,3677,2451,244,774,7,95,0,6,1226
1123962400,4620,2799,72,1615,14,12,0,13,1821
1123962501,4285,3769,64,296,6,17,0,5,516
1123962502,3574,3280,38,158,6,11,0,6,294
1123962600,1661,339,24,1261,2,5,0,5,1322
1123962701,1950,1697,33,120,4,2,0,6,253
1123962702,4037,2689,96,1048,9,15,0,17,1348
1125010101,3905,3235,114,169,3,233,1,2,670
1125010102,3865,3559,91,80,8,14,2,0,306
1125010104,3716,3354,54,163,16,3,0,7,362
1125010105,3736,3305,182,113,5,11,1,11,431
1125010201,5227,4394,255,369,4,20,4,18,833
1125010203,3033,2629,237,51,2,19,1,11,404
1125010204,5136,3815,200,775,7,145,4,7,1321
1125010205,6938,5795,311,560,13,80,0,13,1143
1125010206,5129,3532,290,1062,8,64,0,21,1597
1125010302,4386,3112,504,634,7,7,0,3,1274
1125010303,3776,2450,40,1190,5,0,2,5,1326
1125010304,4469,2685,517,1030,27,32,11,52,1784
1125010305,4079,3195,149,573,10,12,0,8,884
1125010403,4326,2205,331,1614,6,47,0,6,2121
1125010404,2657,900,308,1358,3,10,0,11,1757
1125010405,4677,3372,502,397,10,232,2,23,1305
1125010406,4571,3904,99,268,5,121,2,8,667
1125010407,3504,2344,101,887,3,91,2,3,1160
1125010500,2198,636,262,1235,2,0,1,3,1562
1125010601,5706,4794,238,408,15,10,2,14,912
1125010603,6089,4923,144,771,20,16,1,13,1166
1125010604,6817,5898,162,430,26,13,8,34,919
1125010703,3602,2798,207,426,5,16,0,6,804
1125010704,4966,3202,191,1414,6,6,0,17,1764
1125010705,4318,2297,75,1806,22,21,0,10,2021
1125010706,4326,3363,322,442,6,15,0,12,963
1125010707,4295,3527,180,393,2,8,0,16,768
1125010802,4626,2682,352,1337,0,73,0,19,1944
1125010803,2790,893,243,1539,0,19,0,10,1897
1125010804,2581,1461,310,686,8,11,2,1,1120
1125011200,9076,5402,1992,1244,18,159,11,141,3674
1125011401,3773,3037,145,222,6,209,0,38,736
1125011402,3200,2557,138,205,4,212,3,1,643
1125011600,3341,1449,145,1626,1,29,1,10,1892
1125011701,2597,198,77,2265,6,9,1,5,2399
1125011703,4526,92,51,4305,4,13,0,10,4434
1125011800,2575,88,85,2338,6,3,0,4,2487
1125011901,2833,1408,135,1151,5,75,1,3,1425
1125011902,2953,1133,109,1601,3,29,0,14,1820
1125012001,1712,1134,93,346,0,53,1,4,578
1125012002,2736,2096,130,307,7,91,1,11,640
1125012101,3564,1943,199,1174,2,106,1,9,1621
1125012102,2535,1502,151,665,5,85,3,6,1033
1125012304,3379,547,110,2597,7,34,0,2,2832
1125012305,4616,1466,107,2838,15,61,10,18,3150
1125012306,5432,2480,161,2481,16,104,3,26,2952
1125012307,1382,411,42,846,2,25,3,10,971
1125012403,4692,1560,97,2820,5,61,0,12,3132
1125012404,3908,1055,192,2519,3,53,0,12,2853
1125012406,2580,595,109,1790,2,22,0,22,1985
1125012407,1306,224,63,960,0,14,0,6,1082
1125012408,2388,331,116,1825,2,17,1,15,2057
1125012501,1535,250,20,1234,9,1,0,0,1285
1125012503,4719,2753,116,1554,7,131,1,6,1966
1125012504,3558,1322,57,2009,4,66,1,5,2236
1125012505,3951,2203,67,1473,8,59,3,10,1748
1125012600,2427,1323,108,758,2,113,3,8,1104
1125012700,4227,1807,447,1762,9,52,0,16,2420
1125012800,2071,255,65,1684,8,6,0,4,1816
1127020100,3624,2403,206,848,8,9,0,8,1221
1127020200,4372,3566,336,254,5,33,0,12,806
1127020301,3982,3292,158,293,11,73,0,9,690
1127020302,3259,2852,119,138,5,42,0,12,407
1127020400,2231,1326,384,424,8,10,1,8,905
1127020600,2460,2240,90,29,5,7,0,4,220
1127020700,3139,2786,203,36,6,14,0,13,353
1127020801,2478,2150,53,180,16,2,0,0,328
1127020802,3178,2961,56,22,16,6,0,4,217
1127020900,4989,4725,89,35,13,11,0,1,264
1127021000,3447,3246,59,19,17,2,0,3,201
1127021100,3186,2862,58,124,1,11,0,4,324
1127021200,3100,2890,50,33,9,6,0,4,210
1127021300,3531,3195,26,177,8,4,0,5,336
1127021400,3599,3077,62,305,7,2,0,19,522
1127021500,2919,2569,46,174,3,3,0,4,350
1127021600,1668,1377,17,181,22,1,0,10,291
1127021700,4490,3824,36,410,8,31,0,4,666
1127021800,3444,3037,54,146,12,12,0,10,407
1127021900,2246,2016,50,61,7,4,1,2,230
1129043900,2548,2009,23,447,7,4,0,0,539
1129044000,3744,2877,29,699,17,1,1,8,867
1129044100,3036,2153,19,738,24,4,1,3,883
1129044200,3610,1295,40,1119,990,2,0,6,2315
1129044300,2450,1933,27,315,64,3,0,6,517
1131034700,1283,103,36,1137,2,0,0,1,1180
1131034801,2155,386,16,1726,1,0,2,4,1769
1131034802,2591,1165,33,1323,0,7,0,6,1426
1131035100,3083,815,15,2201,5,0,0,0,2268
1131035200,1488,397,12,1038,3,0,3,5,1091
1133965501,2219,2088,22,5,12,2,3,1,131
1133965502,2728,2589,23,17,8,7,2,3,139
1133965503,2633,2478,45,6,12,7,0,5,155
1133965601,2077,1947,32,10,10,2,2,4,130
1133965602,3128,2950,32,19,9,3,0,6,178
1133965700,4693,4088,335,35,16,18,2,10,605
1133965800,4057,3552,286,33,14,17,0,6,505
1133965900,2005,1906,40,6,2,2,0,4,99
2013000100,3420,658,674,297,797,771,32,11,2762
2016000100,978,259,74,36,527,19,17,2,719
2016000200,4254,1326,594,221,182,1483,221,8,2928
2020000101,5650,4355,310,35,245,82,2,57,1295
2020000102,5215,3781,325,37,222,171,19,46,1434
2020000201,4318,2860,414,129,178,139,34,46,1458
2020000202,6384,4715,479,145,288,142,15,53,1669
2020000204,3582,2738,190,44,188,74,23,27,844
2020000205,7421,5434,670,176,162,187,31,42,1987
2020000206,3413,2584,217,43,91,70,14,36,829
2020000500,2124,982,224,137,174,180,123,26,1142
2020000601,4328,1058,599,486,674,391,556,15,3270
2020000602,2716,540,337,383,300,302,469,15,2176
2020000701,6986,2535,835,685,675,851,577,42,4451
2020000702,5435,1979,528,632,527,679,372,25,3456
2020000703,5555,1798,600,435,693,1090,210,34,3757
2020000801,6814,2082,825,477,814,1082,703,53,4732
2020000802,4759,1687,607,344,528,761,222,21,3072
2020000901,5090,1192,705,493,960,633,521,36,3898
2020000902,3158,1169,431,384,238,336,309,17,1989
2020001000,3942,1856,347,299,555,268,231,35,2086
2020001100,1657,807,132,127,330,76,34,13,850
2020001200,3749,2934,166,57,142,129,31,39,815
2020001300,3227,2496,175,33,78,110,51,21,731
2020001401,2928,1408,288,152,327,278,161,25,1520
2020001402,2168,851,222,221,198,248,188,16,1317
2020001500,5165,3312,292,184,335,353,120,41,1853
2020001601,3824,2035,283,233,276,393,190,17,1789
2020001602,4191,2179,327,226,588,250,126,23,2012
2020001701,6824,3562,547,508,561,560,234,48,3262
2020001702,4940,2826,347,291,351,349,128,33,2114
2020001731,6119,2539,508,464,744,743,281,49,3580
2020001732,6111,3139,528,432,419,501,307,39,2972
2020001801,4372,2158,435,185,427,500,162,20,2214
2020001802,5379,2075,621,264,562,957,253,26,3304
2020001900,3873,1357,451,274,458,696,227,18,2516
2020002000,3315,1209,427,171,446,493,202,14,2106
2020002100,3686,1937,255,153,356,352,173,16,1749
2020002201,4742,2584,312,119,333,778,120,31,2158
2020002202,2931,1546,297,72,292,282,96,12,1385
2020002301,7653,4847,452,168,405,864,52,58,2806
2020002302,4641,2472,360,105,452,363,191,38,2169
2020002304,6312,3214,468,178,620,729,259,41,3098
2020002305,2647,1122,286,122,205,444,114,15,1525
2020002400,3039,1646,212,98,272,380,83,22,1393
2020002501,4928,2567,558,173,386,453,196,27,2361
2020002502,4947,2489,446,236,388,508,236,38,2458
2020002601,5035,1996,495,252,462,942,241,24,3039
2020002602,5746,2889,572,179,455,804,71,32,2857
2020002603,6434,3503,522,169,579,733,138,54,2931
2020002711,6817,4359,418,144,289,672,106,57,2458
2020002712,9027,3870,1358,292,775,1561,209,28,5157
2020002713,4903,3352,373,90,261,227,85,16,1551
2020002714,4593,2855,311,122,292,383,74,57,1738
2020002811,6519,2931,795,267,671,949,98,13,3588
2020002812,8359,5705,470,245,318,651,69,92,2654
2020002813,4796,3892,204,36,137,106,6,28,904
2020002821,5080,3621,347,81,232,218,19,25,1459
2020002822,4135,3393,152,43,122,56,0,26,742
2020002823,5720,4468,305,48,155,255,6,45,1252
2020002900,2503,2131,116,10,46,54,0,9,372
2020980000,5,1,0,0,1,1,0,0,4
2020980100,4592,2747,774,451,42,210,39,20,1845
2020980200,6725,3863,1188,738,180,232,37,30,2862
2050000100,10885,281,32,8,10316,7,0,0,10604
2050000200,6325,1177,144,73,4129,187,2,18,5148
2050000300,1456,170,31,3,1135,7,0,1,1286
2060000100,844,357,45,6,296,5,3,2,487
2063000200,2632,1635,115,7,238,371,8,10,997
2063000300,4470,3133,282,39,419,156,53,16,1337
2066000100,2617,1591,84,6,645,17,10,15,1026
2068000100,1619,1378,32,9,59,13,3,4,241
2070000100,2505,146,42,2,2155,5,0,0,2359
2070000200,2352,624,104,17,1257,40,9,7,1728
2090000100,1563,862,103,89,259,72,21,5,701
2090000200,3244,1791,229,187,479,125,35,21,1453
2090000300,4709,1888,391,456,993,240,92,58,2821
2090000400,4582,2635,337,231,503,239,58,24,1947
2090000500,2467,1343,227,115,260,150,13,27,1124
2090000600,3753,2090,303,174,507,143,10,20,1663
2090000700,4094,2186,366,239,511,247,28,37,1908
2090000800,5010,3074,334,204,520,222,32,18,1936
2090000900,6002,4601,222,77,442,113,2,41,1401
2090001000,1348,892,96,34,135,25,0,7,456
2090001200,6743,5081,314,68,436,119,29,56,1662
2090001300,5630,4293,208,53,332,174,4,50,1337
2090001401,2776,1977,139,30,220,64,10,45,799
2090001402,4658,3229,281,116,334,113,16,64,1429
2090001501,4442,3238,291,110,194,83,20,64,1204
2090001502,5097,3827,268,93,273,86,7,37,1270
2090001600,4716,3268,329,160,220,157,30,43,1448
2090001700,1345,1109,68,12,39,20,1,1,236
2090001901,5700,4532,207,53,313,68,11,48,1168
2090001902,5255,4157,262,30,172,99,9,64,1098
2090980000,9798,5396,1901,1075,134,374,141,60,4402
2090980100,2723,1709,444,198,23,98,15,22,1014
2100000100,2080,1577,67,2,205,14,2,9,503
2105000400,2365,1123,120,6,841,15,4,16,1242
2110000100,5212,4059,238,22,193,107,23,39,1153
2110000200,7064,4074,526,68,654,562,142,44,2990
2110000300,5983,3214,386,58,757,492,175,41,2769
2110000400,5148,2290,409,79,971,607,38,17,2858
2110000500,3283,2281,197,29,303,164,10,15,1002
2110000600,5565,3755,321,72,519,154,81,27,1810
2122000100,214,40,20,1,124,4,4,0,174
2122000200,5692,4246,172,44,538,57,20,66,1446
2122000300,975,847,22,1,32,15,0,0,128
2122000400,7022,5862,225,26,254,89,18,39,1160
2122000500,6560,5091,348,50,348,116,26,39,1469
2122000600,7424,5151,420,41,708,133,34,33,2273
2122000701,5876,4751,183,19,359,56,11,53,1125
2122000702,4814,3719,210,14,319,73,7,29,1095
2122000800,4003,3269,122,13,215,45,5,31,734
2122000900,2494,2114,55,8,68,28,1,16,380
2122001000,4370,3522,199,27,199,43,13,17,848
2122001100,3459,3029,81,1,58,29,7,27,430
2122001200,957,398,27,1,376,6,0,6,559
2122001300,4939,3507,244,115,509,99,27,16,1432
2130000101,2894,2153,106,9,265,52,6,41,741
2130000102,484,412,9,0,15,9,0,2,72
2130000200,4414,2275,169,36,710,726,10,16,2139
2130000300,3782,1887,243,45,846,290,9,27,1895
2130000400,2374,1494,123,10,428,41,1,7,880
2150000100,1611,828,60,1,609,11,6,4,783
2150000200,6833,3296,545,25,893,1304,90,30,3537
2150000300,2032,487,171,10,139,1098,5,3,1545
2150000400,952,438,67,5,89,301,1,0,514
2150000500,1673,1242,181,44,29,67,5,37,431
2158000100,8368,173,14,16,7946,23,0,14,8195
2164000100,1476,297,34,1,993,7,0,0,1179
2170000101,700,579,21,1,39,3,0,1,121
2170000102,2607,2211,83,4,74,24,0,27,396
2170000200,1741,1352,52,5,115,15,1,19,389
2170000300,7636,6113,320,43,291,83,20,61,1523
2170000401,1975,1603,41,5,114,20,6,7,372
2170000402,2193,1869,23,16,93,21,1,16,324
2170000501,2007,1529,66,11,162,23,46,8,478
2170000502,2276,1844,68,19,123,15,10,6,432
2170000601,5880,4380,326,55,321,93,37,30,1500
2170000603,7887,5755,405,58,579,136,27,56,2132
2170000604,7470,4951,416,177,928,131,75,50,2519
2170000701,3830,2896,187,44,211,36,15,32,934
2170000703,4671,3457,259,49,291,89,17,30,1214
2170000705,4279,3241,248,32,213,47,13,23,1038
2170000706,5702,4430,290,31,284,71,18,31,1272
2170000800,5621,3916,383,92,399,107,56,48,1705
2170000900,3020,2333,118,25,185,68,6,24,687
2170001001,4391,3400,214,32,268,54,5,55,991
2170001003,4128,2985,269,29,231,86,14,30,1143
2170001004,5182,4042,233,58,230,66,11,28,1140
2170001100,7354,5584,412,114,348,120,21,51,1770
2170001201,5621,4089,389,81,421,101,10,40,1532
2170001202,5025,3618,264,60,346,58,64,44,1407
2170001300,5885,4873,157,18,265,48,3,68,1012
2180000100,6140,337,52,19,5569,26,2,5,5803
2180000200,3906,1056,134,33,1939,83,3,20,2850
2185000100,4934,671,173,70,2593,591,286,6,4263
2185000200,3367,300,25,13,2926,2,0,4,3067
2185000300,2730,1993,350,76,161,43,35,20,737
2188000100,4691,193,25,8,4347,5,0,0,4498
2188000200,3102,491,77,63,2106,48,11,0,2611
2195000200,3398,2444,164,46,231,117,12,21,954
2198000100,2069,1059,45,9,793,4,26,8,1010
2198000200,2051,1095,67,7,575,21,0,5,956
2198000300,71,63,2,1,0,0,0,3,8
2198940100,1562,151,46,4,1161,0,4,0,1411
2220000100,3230,2070,179,4,400,121,5,25,1160
2220000200,5228,2980,322,33,806,452,9,28,2248
2230000100,1240,1056,41,6,23,39,0,6,184
2240000100,2113,1159,50,5,661,15,0,6,954
2240000400,4695,3834,326,63,134,72,13,17,861
2275000300,2127,1341,76,0,368,25,2,11,786
2282000100,662,248,29,2,250,32,1,0,414
2290000100,1086,116,8,0,915,0,1,0,970
2290000200,1478,632,21,2,768,3,0,4,846
2290000300,1708,192,15,0,1373,5,0,10,1516
2290000400,1071,181,28,4,762,0,2,2,890
4001942600,1549,8,10,1,1522,0,0,2,1541
4001942700,4491,56,61,7,4288,29,7,0,4435
4001944000,5348,133,98,18,4945,56,0,5,5215
4001944100,5495,300,126,7,4946,16,0,5,5195
4001944201,4021,190,76,22,3611,63,0,0,3831
4001944202,3608,51,26,13,3456,31,0,0,3557
4001944301,3789,45,53,0,3658,1,0,5,3744
4001944302,2685,1,16,0,2636,0,0,0,2684
4001944901,3369,22,50,7,3219,32,2,0,3347
4001944902,4201,28,57,8,4035,3,0,0,4173
4001945001,4133,83,63,2,3907,1,1,1,4050
4001945002,3589,26,78,4,3426,3,2,2,3563
4001945100,2132,127,53,17,1857,11,1,5,2005
4001970201,2569,2073,340,9,46,18,0,17,496
4001970202,2610,2125,250,8,43,4,3,34,485
4001970300,3216,1916,966,42,171,12,1,4,1300
4001970501,4449,3077,1043,10,168,21,0,24,1372
4001970502,4767,3530,495,9,575,6,1,11,1237
4003000101,1071,502,503,1,9,5,0,0,569
4003000102,745,587,104,7,3,3,0,1,158
4003000201,3098,1618,1317,8,17,15,2,7,1480
4003000202,3382,1294,1908,26,29,28,3,14,2088
4003000203,2540,1976,432,13,15,12,0,13,564
4003000301,4029,2814,826,48,29,31,20,20,1215
4003000303,3400,2632,439,19,18,19,15,35,768
4003000304,2328,1801,329,15,22,11,2,10,527
4003000305,2681,2284,232,9,16,19,0,22,397
4003000400,2084,1609,318,4,13,8,0,7,475
4003000501,1924,1353,461,10,22,9,0,5,571
4003000502,921,681,177,10,11,6,0,9,240
4003000503,2063,834,826,296,92,4,2,2,1229
4003000600,2600,565,1948,22,16,11,0,10,2035
4003000700,4833,320,4434,18,6,15,2,9,4513
4003000800,5130,361,4628,21,15,71,0,5,4769
4003000901,3305,144,3121,8,2,11,0,3,3161
4003000902,2684,138,2493,16,5,10,1,11,2546
4003001000,1464,1096,263,23,5,10,2,16,368
4003001100,3103,1649,1293,12,16,12,1,22,1454
4003001200,2753,1288,1275,6,17,10,4,11,1465
4003001301,2333,1723,414,33,17,24,5,20,610
4003001302,2788,1951,526,73,22,39,8,22,837
4003001401,3437,1491,935,510,39,222,38,33,1946
4003001402,1802,944,375,214,8,114,4,18,858
4003001501,3329,1741,948,269,25,105,28,38,1588
4003001502,3633,1721,1251,240,40,76,33,52,1912
4003001601,5280,2837,1295,395,31,203,36,38,2443
4003001602,3038,1653,805,178,20,131,29,14,1385
4003001701,4355,2515,1044,319,13,131,17,20,1840
4003001702,3658,1967,990,255,26,131,17,16,1691
4003001703,5039,3094,1121,275,23,189,21,29,1945
4003001801,5649,3823,909,261,13,286,31,44,1826
4003001802,3372,2196,648,176,12,139,36,17,1176
4003001900,7114,4896,1084,321,20,319,27,47,2218
4003002001,5453,3595,1278,155,28,79,18,23,1858
4003002002,4295,3067,862,42,17,24,5,27,1228
4003002100,4734,3496,803,63,30,55,14,35,1238
4005000100,3873,3006,409,24,144,38,15,10,867
4005000200,4097,2890,458,50,342,108,1,36,1207
4005000301,3957,1612,1350,41,747,29,6,18,2345
4005000302,2819,1001,959,35,645,27,1,13,1818
4005000400,5343,2946,1283,62,728,55,8,30,2397
4005000500,5007,2116,1673,61,867,70,6,15,2891
4005000601,2010,1611,163,17,29,48,4,24,399
4005000602,3395,2266,414,37,368,97,15,15,1129
4005000700,4143,2576,660,57,508,126,8,10,1567
4005000800,6313,3320,1321,277,845,136,31,32,2993
4005000901,5033,3439,662,42,428,164,8,36,1594
4005000902,3539,1900,615,82,698,59,2,12,1639
4005001000,10422,6285,2345,397,378,477,54,24,4137
4005001101,5229,3823,642,46,212,173,2,38,1406
4005001103,5208,2679,1492,89,629,84,17,12,2529
4005001104,4937,3123,761,85,428,217,16,38,1814
4005001201,2738,2174,270,33,87,32,1,15,564
4005001301,5375,3703,754,22,593,29,13,33,1672
4005001302,5547,3876,732,21,552,35,2,37,1671
4005001500,3528,2872,325,4,180,14,2,25,656
4005001601,1787,1527,146,10,7,31,0,16,260
4005001602,1223,1021,101,6,7,27,0,0,202
4005001700,3347,1913,1100,48,58,51,2,23,1434
4005002000,1918,1562,79,6,195,16,0,5,356
4005002101,3870,1937,431,25,1147,66,1,18,1933
4005002102,3562,1281,218,21,1810,55,11,7,2281
4005002201,4081,3062,575,24,167,68,3,17,1019
4005002202,2928,2226,356,22,154,27,0,23,702
4005002301,3947,2240,730,70,692,86,1,13,1707
4005002302,3234,2594,360,33,62,12,14,14,640
4005942201,3678,21,44,3,3495,2,0,6,3657
4005942202,3696,17,39,4,3600,2,1,0,3679
4005944900,3888,145,104,16,3416,110,5,1,3743
4005945000,4006,36,60,2,3850,3,0,0,3970
4005945100,3342,29,42,0,3201,1,3,0,3313
4005945200,4056,60,44,5,3873,7,1,0,3996
4005980000,25,15,2,0,1,0,0,0,10
4005980100,0,0,0,0,0,0,0,0,0
4005980200,0,0,0,0,0,0,0,0,0
4007000100,2908,2553,164,5,41,5,7,27,355
4007000200,2132,1827,188,4,9,8,1,13,305
4007000301,5775,4584,702,30,111,73,5,21,1191
4007000302,3042,2534,320,12,21,15,5,13,508
4007000400,5307,4484,518,18,52,31,7,18,823
4007000500,5706,4598,617,13,228,37,2,10,1108
4007000600,1569,1392,84,20,24,4,0,4,177
4007000700,1695,1537,83,12,12,4,0,0,158
4007000800,1099,686,344,3,19,6,0,3,413
4007000900,2502,1129,1152,29,83,13,3,20,1373
4007001000,4605,2687,1491,37,160,17,0,24,1918
4007001100,3660,1861,1352,30,197,87,2,16,1799
4007001200,4872,2528,1384,19,670,87,3,28,2344
4007001300,1044,285,730,4,7,3,2,0,759
4007940200,1825,21,27,3,1719,37,2,3,1804
4007940400,5531,51,127,0,5302,0,6,3,5480
4009940500,4720,22,101,4,4558,0,0,2,4698
4009961100,4849,3575,1055,15,60,3,3,12,1274
4009961201,3918,2890,798,19,95,19,0,0,1028
4009961202,4102,2801,1135,15,35,21,4,11,1301
4009961300,3083,1552,1316,34,57,20,3,7,1531
4009961400,5293,2669,2340,46,69,35,5,12,2624
4009961500,4702,2947,1566,21,31,8,1,27,1755
4009961600,2563,1247,883,190,136,41,0,18,1316
4009961700,5303,2695,2234,109,102,22,0,13,2608
4011960100,2951,1072,1698,16,79,10,0,15,1879
4011960200,4084,1765,1911,57,175,55,1,13,2319
4011960300,2528,1609,767,7,21,3,0,6,919
4012020101,935,475,394,0,9,15,2,1,460
4012020102,1028,822,134,2,11,10,14,8,206
4012020201,1773,1385,231,11,41,17,0,12,388
4012020202,581,510,45,0,4,8,0,0,71
4012020501,1419,1157,172,6,2,7,15,6,262
4012020503,1043,849,118,5,9,2,0,5,194
4012020504,820,726,50,1,0,0,2,1,94
4012020505,939,816,74,6,10,1,0,2,123
4012020602,983,602,310,8,6,4,1,2,381
4012940200,3414,1101,1433,58,614,34,3,1,2313
4012940300,3622,618,1236,5,1648,13,4,5,3004
4012980000,0,0,0,0,0,0,0,0,0
4013010102,5592,5138,192,30,20,76,1,22,454
4013010103,3779,3277,244,41,17,68,5,12,502
4013010104,2989,2851,46,11,8,18,1,7,138
4013030401,4882,4447,207,43,16,56,2,10,435
4013030402,3913,3402,290,10,6,51,4,12,511
4013040502,4820,3701,791,51,46,30,1,4,1119
4013040506,5809,5443,135,82,20,35,1,15,366
4013040507,6362,5983,142,68,13,46,0,15,379
4013040512,1732,1657,23,10,2,23,0,5,75
4013040513,3071,2931,66,4,8,23,0,0,140
4013040514,3315,3114,77,13,0,29,1,13,201
4013040515,4189,3089,875,14,34,27,1,22,1100
4013040516,7427,6267,614,156,36,105,2,26,1160
4013040522,4230,3994,81,33,16,42,0,12,236
4013040523,3333,3075,67,64,3,39,1,9,258
4013040524,1662,1552,31,29,0,21,1,0,110
4013040525,3037,2837,64,40,2,40,0,3,200
4013040526,2431,2286,68,23,3,18,0,5,145
4013040527,4434,3560,417,156,27,66,0,12,874
4013040528,6026,5701,127,46,9,55,0,6,325
4013040529,3603,3441,50,36,3,30,0,5,162
4013040530,3729,2500,699,200,26,98,12,12,1229
4013040531,3757,2967,372,177,21,94,9,5,790
4013040532,6632,4923,1001,150,35,145,0,14,1709
4013040533,2500,1695,480,59,10,104,11,8,805
4013040534,3431,3184,96,54,7,28,0,8,247
4013040535,5823,4632,619,103,27,152,0,34,1191
4013040536,6248,4626,850,181,9,208,12,17,1622
4013040537,2223,1770,217,60,0,85,0,5,453
4013040538,4385,3040,788,206,21,79,8,15,1345
4013040539,6356,4738,1053,116,59,75,22,38,1618
4013040540,5684,3197,1789,262,20,99,17,29,2487
4013040541,4309,2977,1003,47,38,28,4,29,1332
4013050603,4592,2597,1687,36,59,14,0,58,1995
4013050604,3871,1834,1737,31,44,25,0,13,2037
4013050609,6343,3210,2273,463,39,95,15,42,3133
4013050611,7114,2658,3437,502,51,87,37,34,4456
4013050612,9560,3647,4638,605,85,161,29,54,5913
4013050613,5523,2368,2564,257,53,54,0,38,3155
4013050614,5040,2017,2241,406,67,71,27,17,3023
4013050615,5624,2161,2698,421,47,83,13,21,3463
4013050616,3676,1550,1599,248,16,39,8,25,2126
4013050617,5312,2122,2384,396,26,101,31,33,3190
4013050618,6427,4143,1424,220,45,195,19,35,2284
4013050619,7507,4799,2063,166,45,121,11,23,2708
4013050620,7835,4467,2208,473,52,161,8,32,3368
4013050621,8644,4298,3187,597,59,96,14,27,4346
4013050701,7711,2746,3843,570,85,101,11,73,4965
4013050702,6555,2212,3500,407,89,65,15,42,4343
4013060801,5282,1384,3356,333,27,29,12,17,3898
4013060802,3306,1438,1381,250,27,76,14,4,1868
4013060901,5053,2070,2158,378,49,89,21,22,2983
4013060902,3514,530,2631,209,25,13,6,11,2984
4013060903,5505,1548,3234,395,43,65,13,20,3957
4013060904,3915,1081,2272,251,38,58,9,20,2834
4013061010,6267,4379,1129,188,26,244,4,28,1888
4013061011,7598,3005,2850,768,64,487,16,35,4593
4013061013,6049,2523,2168,502,46,505,6,29,3526
4013061014,6517,2306,2728,645,68,334,30,120,4211
4013061015,6037,2586,2465,449,64,157,39,27,3451
4013061017,3288,1808,902,262,259,25,10,1,1480
4013061018,5301,4904,129,107,7,73,4,11,397
4013061020,3865,2011,1104,252,37,217,9,12,1854
4013061021,2024,887,634,117,3,280,10,10,1137
4013061024,2391,861,1160,148,14,58,16,30,1530
4013061026,5922,3880,1207,305,39,143,15,29,2042
4013061027,5496,3531,1114,332,49,107,4,17,1965
4013061028,3182,2005,693,209,12,75,6,26,1177
4013061029,5174,3360,1128,286,32,97,10,12,1814
4013061031,6566,4155,1385,363,50,217,17,19,2411
4013061032,6108,3794,1390,307,35,162,16,25,2314
4013061033,6360,4005,1399,362,46,165,30,34,2355
4013061034,7464,4394,1678,508,46,281,33,46,3070
4013061035,7099,4303,1690,437,41,241,19,31,2796
4013061036,5176,3114,1067,413,23,257,11,34,2062
4013061037,6238,3945,1337,273,34,225,11,23,2293
4013061038,4992,2826,1281,373,41,115,10,35,2166
4013061039,6004,3656,1328,332,30,314,7,15,2348
4013061040,4567,1994,1787,316,57,133,14,40,2573
4013061041,4734,1837,2095,359,67,127,41,20,2897
4013061042,2384,1405,712,111,30,29,3,12,979
4013061043,2827,1075,1396,137,30,62,12,7,1752
4013061044,9294,5875,2165,472,66,172,21,45,3419
4013061045,7940,5095,1870,314,42,212,7,34,2845
4013061046,5844,2243,2366,538,61,239,32,41,3601
4013061047,3885,1718,1215,364,24,325,8,22,2167
4013061048,4079,2166,1142,282,45,231,22,18,1913
4013061049,5826,2451,2392,479,29,211,21,28,3375
4013061050,6465,2740,2505,539,48,261,14,47,3725
4013061051,4010,1645,1602,331,32,193,25,29,2365
4013061052,7060,2555,3173,691,58,171,15,36,4505
4013061053,7287,2742,3007,821,87,231,14,25,4545
4013061054,8264,5006,1822,498,51,524,11,41,3258
4013061055,6157,3060,1664,464,29,509,17,26,3097
4013061056,3074,1797,857,175,16,82,11,16,1277
4013061057,4309,1882,1760,266,21,168,17,20,2427
4013061058,3567,1423,1507,314,19,112,19,4,2144
4013061059,4843,3198,855,275,39,119,15,21,1645
4013061060,3575,2041,893,275,28,53,12,27,1534
4013061061,3568,2260,708,238,11,110,1,30,1308
4013061062,6953,4433,1289,369,33,303,20,30,2520
4013061063,1743,447,1021,167,21,12,6,5,1296
4013061064,2964,1562,741,205,9,280,6,9,1402
4013061100,2659,1445,465,353,21,107,26,12,1214
4013061200,6746,1243,4562,519,92,100,19,29,5503
4013061300,2050,580,1291,71,15,20,3,12,1470
4013061401,2167,276,1616,202,26,5,10,3,1891
4013061402,6154,692,4596,574,59,87,26,27,5462
4013071503,4959,4571,182,66,5,44,4,19,388
4013071504,3721,3462,105,59,10,34,3,5,259
4013071505,6537,5670,386,185,26,81,1,17,867
4013071506,4183,3852,135,59,13,35,0,13,331
4013071509,5603,3746,1012,204,31,310,5,20,1857
4013071510,4402,2992,779,134,31,228,8,27,1410
4013071511,3890,2454,850,142,36,223,3,16,1436
4013071512,6246,4156,1327,186,43,260,10,15,2090
4013071513,1758,1220,313,38,6,91,2,25,538
4013071514,3896,2788,625,163,27,153,7,20,1108
4013071515,3704,2765,508,131,23,121,0,23,939
4013071516,4561,3143,746,315,36,118,1,18,1418
4013071517,3961,2571,855,134,5,159,16,4,1390
4013071600,4192,2019,1789,170,42,37,2,20,2173
4013071701,3009,1509,1017,130,45,136,3,18,1500
4013071702,3555,3098,241,78,17,40,4,3,457
4013071801,5090,4299,422,143,23,54,4,13,791
4013071802,3575,3098,233,96,13,45,3,13,477
4013071903,6435,3806,1978,192,55,157,0,18,2629
4013071906,6331,2596,2798,335,68,230,5,25,3735
4013071909,4178,2312,1222,269,45,148,3,19,1866
4013071910,7132,3379,2726,462,89,169,9,29,3753
4013071911,3246,1614,992,231,53,129,5,18,1632
4013071912,2695,1233,1146,94,62,46,4,19,1462
4013071913,5423,2455,1696,621,80,230,23,21,2968
4013071914,3245,1156,1763,106,37,47,3,30,2089
4013071915,3617,1827,1372,181,24,72,1,12,1790
4013082002,6542,1781,3684,548,73,155,13,15,4761
4013082007,4398,730,3281,183,35,67,0,11,3668
4013082008,5378,607,4283,231,40,101,11,14,4771
4013082009,5183,570,4229,201,51,34,19,16,4613
4013082010,4342,561,3355,193,80,45,14,13,3781
4013082012,7092,1648,4206,641,31,295,30,25,5444
4013082016,3275,680,1756,402,30,275,11,16,2595
4013082017,5160,756,2967,922,57,275,12,22,4404
4013082018,5151,567,3922,383,41,124,18,16,4584
4013082019,2485,1057,935,189,28,149,0,7,1428
4013082020,4027,1612,1704,273,24,248,1,31,2415
4013082021,2365,643,1326,182,20,93,4,7,1722
4013082022,4739,1400,2419,410,100,169,30,13,3339
4013082023,5888,1947,2798,486,47,348,27,31,3941
4013082024,5154,1390,2607,598,73,268,20,24,3764
4013082025,3006,853,1477,344,32,142,14,19,2153
4013082026,6384,1738,3193,786,81,306,30,26,4646
4013082027,5051,1061,2765,724,67,228,26,34,3990
4013082028,4641,550,3459,317,69,110,12,34,4091
4013082204,7339,835,5161,881,80,121,30,40,6504
4013082205,5947,813,4216,582,46,97,37,25,5134
4013082206,4900,514,3530,517,75,130,19,24,4386
4013082207,3436,581,2484,159,33,47,4,16,2855
4013082208,3890,521,2940,248,48,22,8,40,3369
4013082209,2864,191,2567,56,11,6,0,15,2673
4013082210,5348,967,3503,549,45,61,7,36,4381
4013082211,7701,1599,4643,750,89,280,36,51,6102
4013082212,5836,804,3803,775,46,182,17,53,5032
4013082213,6642,843,4677,696,53,173,1,50,5799
4013083000,7216,712,5712,500,63,97,0,34,6504
4013092305,4286,2130,1608,158,48,120,8,24,2156
4013092306,6363,3391,1892,291,75,347,37,28,2972
4013092307,6486,2777,2388,426,116,484,22,27,3709
4013092308,7108,3406,2696,365,88,262,26,25,3702
4013092309,5566,2822,1944,281,61,184,14,21,2744
4013092311,3313,1053,1402,538,94,60,5,21,2260
4013092312,6380,2837,1886,655,136,498,31,24,3543
4013092401,4635,1613,2182,470,104,89,1,16,3022
4013092402,3679,1304,1730,337,36,113,19,21,2375
4013092500,5616,1840,2813,379,56,336,10,32,3776
4013092600,3209,749,2044,230,34,37,0,10,2460
4013092705,4609,1026,2454,562,65,338,9,23,3583
4013092708,2000,974,645,200,33,46,2,7,1026
4013092709,5044,2232,1965,252,52,261,5,30,2812
4013092710,5199,1667,2675,294,111,249,0,22,3532
4013092711,3537,1117,1814,228,66,217,6,10,2420
4013092712,5499,1301,3094,478,46,336,12,35,4198
4013092713,5080,1152,3146,290,57,264,21,26,3928
4013092715,4674,788,3178,394,25,138,8,31,3886
4013092716,4206,722,3045,232,38,84,3,21,3484
4013092717,5393,877,2992,883,97,319,7,28,4516
4013092718,4016,765,2338,472,56,230,8,15,3251
4013092719,4950,1547,2246,631,99,171,20,37,3403
4013092720,5829,2163,2473,514,127,249,13,33,3666
4013092721,3593,1358,1274,232,20,521,4,17,2235
4013092723,4397,2277,1405,286,66,110,7,11,2120
4013092724,4473,2481,1448,144,33,114,4,19,1992
4013092801,5374,904,3486,569,68,186,0,32,4470
4013092802,5636,771,3910,579,74,162,5,13,4865
4013092900,3027,406,2283,206,49,38,3,4,2621
4013093001,6328,1425,3303,946,122,267,11,39,4903
4013093002,4510,897,2852,444,67,110,0,18,3613
4013093101,4984,1030,3225,388,53,115,15,33,3954
4013093104,5537,813,3533,860,95,85,11,19,4724
4013093105,5816,1112,3692,713,72,51,5,12,4704
4013093106,4459,655,3302,268,43,54,6,14,3804
4013093200,4211,1301,1851,585,107,144,10,21,2910
4013103205,2799,2293,269,10,3,72,3,3,506
4013103206,2433,2006,235,12,4,50,0,14,427
4013103207,2389,1993,183,32,14,46,2,8,396
4013103208,3995,3306,284,68,14,169,6,18,689
4013103209,5312,4420,353,63,11,204,8,25,892
4013103210,6470,4245,995,251,107,519,12,43,2225
4013103211,4342,3474,478,65,20,109,1,8,868
4013103212,4030,3380,329,22,12,123,5,16,650
4013103214,3759,3131,295,19,4,127,4,27,628
4013103215,3027,2355,228,59,19,200,9,14,672
4013103216,4992,3703,449,100,14,487,3,21,1289
4013103217,6244,4273,516,106,36,1054,2,27,1971
4013103219,3361,2714,271,42,7,183,1,12,647
4013103220,2951,2187,251,52,14,309,3,21,764
4013103302,6376,3652,2052,112,90,152,19,55,2724
4013103303,3646,2591,670,77,41,108,10,14,1055
4013103304,5174,1065,3502,243,68,146,5,19,4109
4013103305,3536,752,2602,39,33,27,1,12,2784
4013103306,4537,1285,2537,373,59,124,5,14,3252
4013103400,4617,3141,1074,47,38,76,25,16,1476
4013103501,3128,2010,733,115,26,129,1,17,1118
4013103502,6138,4398,1066,117,71,160,8,30,1740
4013103604,4544,2404,1342,163,53,383,0,31,2140
4013103605,6128,4925,613,69,19,176,6,43,1203
4013103606,4396,2834,990,107,37,232,6,12,1562
4013103607,4427,3193,658,81,58,184,6,40,1234
4013103608,4435,2035,822,286,75,952,9,22,2400
4013103609,5820,3092,1462,607,170,123,17,33,2728
4013103611,5240,3976,531,197,43,303,9,20,1264
4013103612,4995,3527,752,284,56,125,5,23,1468
4013103614,3077,2163,624,74,34,55,0,2,914
4013103615,5170,1496,2713,554,108,106,8,25,3674
4013103701,4895,2987,1126,259,79,207,8,36,1908
4013103702,3151,2034,717,125,47,78,4,26,1117
4013103900,6350,3059,2359,339,187,119,4,19,3291
4013104000,7434,3360,2524,627,190,301,28,72,4074
4013104100,7141,3768,2264,462,98,197,6,39,3373
4013104202,5361,3474,1239,190,47,142,12,17,1887
4013104203,6615,3367,2227,377,97,220,25,31,3248
4013104204,3535,2005,1066,155,28,138,7,9,1530
4013104205,5715,2471,1956,568,222,174,16,32,3244
4013104206,4240,1803,1790,231,78,138,7,33,2437
4013104207,4380,2845,898,208,43,189,3,12,1535
4013104212,6357,3675,1729,244,60,301,11,44,2682
4013104214,2167,1595,389,26,13,16,3,43,572
4013104215,4371,3106,812,112,45,88,2,13,1265
4013104216,4976,3339,952,210,55,161,17,11,1637
4013104217,5604,3696,1224,230,51,99,5,47,1908
4013104218,4293,2498,1069,248,92,168,1,19,1795
4013104219,3738,2315,900,194,51,88,23,31,1423
4013104221,6125,3532,1650,291,86,248,19,27,2593
4013104222,6058,3491,1613,409,66,140,7,41,2567
4013104223,1798,1270,282,40,9,96,1,17,528
4013104224,6118,3618,1355,420,75,343,5,37,2500
4013104225,3760,2693,663,99,52,53,12,8,1067
4013104226,4873,2981,1096,276,70,212,4,15,1892
4013104227,2350,1308,684,140,32,57,6,11,1042
4013104301,3805,1926,1482,107,19,102,0,2,1879
4013104302,3963,1912,1025,556,127,87,1,21,2051
4013104401,5144,2210,2002,494,137,97,17,10,2934
4013104402,2637,896,539,370,154,521,5,13,1741
4013104501,3972,1138,2152,404,98,34,2,28,2834
4013104502,5491,1137,3608,406,139,63,9,16,4354
4013104600,4065,1860,1647,248,79,60,0,31,2205
4013104701,2741,1619,757,174,48,28,0,14,1122
4013104702,4520,2028,1913,266,109,43,5,21,2492
4013104801,3747,2853,506,105,37,97,11,15,894
4013104802,5921,4598,693,163,45,126,3,25,1323
4013104900,4284,3321,512,63,19,113,2,11,963
4013105002,2608,2187,144,22,2,144,6,8,421
4013105003,4544,3630,266,20,3,413,2,18,914
4013105004,3026,2504,128,12,3,227,0,19,522
4013105101,4557,3797,329,44,10,132,1,28,760
4013105102,4851,3780,508,90,25,212,1,27,1071
4013105103,2905,2363,173,21,9,221,3,23,542
4013105200,5939,3344,1819,209,85,160,12,40,2595
4013105300,5224,3223,1415,234,35,89,6,22,2001
4013105400,3887,2706,691,174,66,72,1,35,1181
4013105501,2587,769,1133,319,130,106,1,14,1818
4013105502,1915,564,555,486,150,41,4,8,1351
4013105503,3835,1297,1273,743,195,63,6,30,2538
4013105601,4262,1187,2643,101,91,139,0,11,3075
4013105602,6810,2006,2472,1436,166,393,2,32,4804
4013105701,3605,1450,1522,209,64,199,16,10,2155
4013105702,4290,1401,2194,207,101,182,10,22,2889
4013105800,7245,2298,3706,374,97,511,18,37,4947
4013105900,5991,2222,2487,546,90,407,12,31,3769
4013106001,1843,549,926,214,68,16,1,7,1294
4013106002,3039,1121,1125,418,157,37,6,29,1918
4013106003,3628,1242,1614,390,121,105,1,14,2386
4013106100,5788,3748,1095,438,139,105,4,22,2040
4013106200,3498,2801,381,28,19,94,0,13,697
4013106300,5393,3756,851,261,118,124,5,26,1637
4013106400,2996,2079,499,91,69,82,7,21,917
4013106501,3346,2303,617,106,48,68,3,44,1043
4013106502,3652,2496,678,101,59,82,5,42,1156
4013106600,3916,2914,503,148,67,92,3,15,1002
4013106701,4556,1366,1169,1137,196,387,5,32,3190
4013106702,1277,738,290,79,55,43,0,14,539
4013106703,2234,1399,534,78,42,74,6,12,835
4013106801,4785,1085,2024,1016,174,273,10,37,3700
4013106802,3569,1419,1588,210,123,99,11,13,2150
4013106900,7793,1697,4711,393,123,684,10,27,6096
4013107001,4391,928,2723,274,69,276,4,7,3463
4013107002,4151,1020,2376,212,66,348,21,9,3131
4013107101,4505,764,3105,228,48,239,8,40,3741
4013107102,5963,719,4005,643,131,305,9,42,5244
4013107201,8139,3169,2757,740,493,467,31,63,4970
4013107202,5180,707,3747,254,85,264,11,20,4473
4013107300,6769,1584,3815,618,161,281,5,109,5185
4013107401,2726,1541,655,234,40,77,6,26,1185
4013107402,1496,402,799,162,40,39,0,4,1094
4013107403,2007,597,757,404,90,47,1,14,1410
4013107404,883,182,209,285,48,95,4,6,701
4013107500,3653,2779,490,99,25,81,0,17,874
4013107601,3332,2059,741,201,95,105,0,19,1273
4013107602,2650,1722,517,126,64,77,7,15,928
4013107700,4498,2961,765,231,132,168,1,20,1537
4013107800,2598,2261,155,37,3,72,5,14,337
4013107900,3682,2924,340,90,9,170,0,8,758
4013108000,3477,2926,235,19,13,137,1,8,551
4013108100,2329,1933,214,34,5,51,0,11,396
4013108200,3307,2562,434,74,16,76,3,18,745
4013108301,3661,2930,363,67,19,106,0,10,731
4013108302,3196,2374,492,85,31,71,1,14,822
4013108400,6054,3870,1258,310,106,217,6,33,2184
4013108501,2575,1395,738,151,50,110,0,14,1180
4013108502,3612,2291,696,172,43,230,8,11,1321
4013108601,2443,827,1127,180,127,49,4,17,1616
4013108602,6215,2805,2000,524,313,239,5,26,3410
4013108802,2073,1267,489,115,34,70,0,14,806
4013108901,2524,1245,821,195,75,56,10,17,1279
4013108902,5098,1919,1794,591,189,355,7,32,3179
4013109001,4379,562,2453,816,162,205,0,77,3817
4013109002,4165,826,2014,620,96,463,3,27,3339
4013109003,5677,859,3781,633,138,91,4,28,4818
4013109101,3425,390,2723,75,28,150,2,9,3035
4013109102,5645,616,4291,444,77,94,16,15,5029
4013109200,4338,715,2626,606,85,196,9,31,3623
4013109300,4767,426,3997,158,33,82,2,9,4341
4013109401,4422,407,3501,300,91,52,3,9,4015
4013109402,4049,636,3078,170,32,36,4,14,3413
4013109500,5432,769,4234,229,48,40,5,29,4663
4013109601,5240,609,4203,242,35,22,3,14,4631
4013109602,6567,622,5282,412,60,69,1,17,5945
4013109603,4780,536,3924,160,52,29,0,12,4244
4013109604,4188,438,3428,150,48,37,11,7,3750
4013109702,5288,592,4394,170,42,24,6,8,4696
4013109703,2973,258,2469,126,35,20,12,6,2715
4013109704,2401,235,2059,49,12,16,2,12,2166
4013109705,1889,161,1621,63,12,3,1,2,1728
4013109706,2486,157,2136,96,19,27,1,6,2329
4013109707,5280,395,3999,610,99,71,5,16,4885
4013109801,4344,339,3542,297,68,36,3,6,4005
4013109802,4913,500,4122,161,35,23,2,8,4413
4013109900,7653,574,6418,373,100,65,6,14,7079
4013110001,4620,363,4065,95,29,14,3,13,4257
4013110002,4467,435,3724,179,56,32,0,11,4032
4013110100,6730,425,5781,285,76,71,1,29,6305
4013110400,5239,2445,1906,306,139,169,1,48,2794
4013110501,4685,2447,1010,526,184,254,21,19,2238
4013110502,3203,1702,764,237,115,214,0,16,1501
4013110600,5003,2440,1736,271,159,131,0,34,2563
4013110701,2447,885,1171,146,80,73,0,9,1562
4013110702,4052,1554,1940,188,92,99,11,15,2498
4013110801,4699,1941,1833,417,176,99,26,31,2758
4013110802,2257,1248,747,75,33,45,4,9,1009
4013110901,3281,1916,878,229,29,77,8,15,1365
4013110902,4203,2136,1452,228,122,89,1,7,2067
4013111000,4749,3342,816,126,65,136,3,27,1407
4013111100,4660,3391,677,142,61,128,5,31,1269
4013111201,5701,2509,2114,509,160,132,6,33,3192
4013111202,2150,510,1125,256,118,44,10,15,1640
4013111203,1614,510,307,516,99,86,8,2,1104
4013111204,2454,947,710,373,143,115,14,22,1507
4013111300,5590,2523,2019,416,156,169,58,38,3067
4013111401,4405,794,3222,148,106,31,3,19,3611
4013111402,3956,1187,2044,374,113,92,27,18,2769
4013111501,2077,221,1692,64,31,10,0,16,1856
4013111502,6317,1320,4301,296,115,108,1,23,4997
4013111601,2956,771,1938,71,54,29,1,17,2185
4013111602,4569,800,3389,192,66,22,10,6,3769
4013111700,5203,2746,1790,179,62,143,4,26,2457
4013111800,4964,3380,822,214,117,195,3,29,1584
4013111900,2370,1625,504,39,16,54,3,18,745
4013112100,3729,229,3349,35,26,34,3,14,3500
4013112201,4363,306,3849,95,40,21,4,8,4057
4013112202,4375,546,3409,208,62,53,4,14,3829
4013112301,5197,337,4357,285,62,78,6,30,4860
4013112302,7063,690,5208,806,78,138,17,25,6373
4013112401,5581,434,4751,229,40,53,3,14,5147
4013112402,5167,329,4580,111,81,25,0,7,4838
4013112502,5294,380,4642,147,51,20,1,9,4914
4013112504,3909,290,3163,353,16,19,0,20,3619
4013112507,2554,183,1953,277,49,29,6,8,2371
4013112508,2862,265,2477,65,19,7,0,8,2597
4013112510,4681,540,3543,308,64,72,14,20,4141
4013112512,566,109,358,71,0,4,6,3,457
4013112514,5044,851,2733,994,74,241,6,21,4193
4013112515,4680,557,3330,560,58,53,9,23,4123
4013112516,4305,461,3267,361,43,57,0,24,3844
4013112517,5477,648,3859,558,75,157,19,15,4829
4013112518,4287,742,2784,431,26,150,35,28,3545
4013112519,4773,341,4174,106,48,17,6,5,4432
4013112520,4265,348,3503,213,38,67,13,11,3917
4013112521,3373,314,2258,492,104,78,19,26,3059
4013112522,4485,391,3838,177,17,27,0,10,4094
4013112523,4666,694,2435,1029,120,161,28,25,3972
4013112524,4925,756,2617,1101,156,78,47,22,4169
4013112601,3084,291,2349,275,63,53,1,10,2793
4013112602,7359,304,6812,133,41,10,4,28,7055
4013112700,6933,496,6036,213,57,39,0,47,6437
4013112900,4660,1783,2208,353,73,58,6,38,2877
4013113000,3531,2169,699,201,48,196,14,27,1362
4013113100,4996,2827,999,505,159,233,3,15,2169
4013113201,2314,435,1669,72,51,14,2,35,1879
4013113202,1706,425,1074,81,33,21,3,11,1281
4013113204,2695,755,1616,115,72,35,0,19,1940
4013113301,3915,649,2569,450,116,28,5,20,3266
4013113502,2881,164,2082,531,23,5,0,12,2717
4013113503,4543,519,3398,380,106,30,10,16,4024
4013113601,3912,814,2260,392,137,107,58,22,3098
4013113602,3988,387,2625,781,82,33,9,13,3601
4013113701,6353,1406,3069,1092,335,134,44,35,4947
4013113702,2082,575,859,489,24,80,0,8,1507
4013113800,3059,1037,1326,350,87,122,14,8,2022
4013113900,1527,247,865,281,60,21,4,15,1280
4013114000,2306,927,785,332,26,129,3,14,1379
4013114100,3294,1523,788,665,152,73,0,15,1771
4013114200,1075,178,781,76,8,7,0,0,897
4013114301,1189,472,348,263,56,12,3,4,717
4013114302,2965,247,1630,867,59,62,15,19,2718
4013114401,1778,108,1485,134,11,7,0,5,1670
4013114402,2095,358,1496,150,41,7,0,1,1737
4013114500,4071,263,3609,98,13,21,0,6,3808
4013114600,1988,155,1717,67,15,7,4,5,1833
4013114704,1761,268,1325,86,73,5,0,0,1493
4013114705,4360,2776,510,810,217,1,1,2,1584
4013114800,3459,227,2745,346,36,28,0,5,3232
4013114900,2771,241,1906,368,53,138,2,6,2530
4013115200,3227,403,1778,574,127,42,202,29,2824
4013115300,2821,289,1800,604,19,9,9,8,2532
4013115400,1995,161,1689,84,23,7,2,8,1834
4013115500,3894,440,3259,76,45,24,5,12,3454
4013115600,4481,325,2956,917,49,102,2,32,4156
4013115700,6779,448,5617,417,83,68,5,22,6331
4013115801,4054,301,3019,480,134,27,1,8,3753
4013115802,3674,294,2902,366,33,14,11,4,3380
4013115900,5860,622,4110,822,76,95,16,22,5238
4013116000,6765,1048,3326,1796,112,284,3,22,5717
4013116100,4902,485,2908,1089,88,135,29,14,4417
4013116202,5126,905,3411,443,97,100,39,11,4221
4013116203,6261,2162,2067,1106,158,410,78,43,4099
4013116204,3728,751,2377,271,104,71,20,20,2977
4013116205,4394,1214,2092,638,120,113,27,25,3180
4013116300,6155,632,3820,1358,96,75,10,28,5523
4013116400,5666,650,4123,647,42,58,6,17,5016
4013116500,4953,370,4094,345,51,19,10,6,4583
4013116605,7187,1233,3447,1510,135,420,21,63,5954
4013116606,6682,938,3815,1250,93,290,34,42,5744
4013116607,4338,557,2383,934,74,203,7,32,3781
4013116610,6912,1406,3132,1498,146,428,35,42,5506
4013116611,3929,1296,1790,449,60,154,12,21,2633
4013116612,7130,1584,3353,1342,147,371,13,49,5546
4013116614,3766,465,2516,515,46,118,5,31,3301
4013116615,4546,319,3122,812,66,87,14,18,4227
4013116616,4942,1055,2522,784,139,237,13,17,3887
4013116617,3391,980,1677,401,12,144,8,40,2411
4013116618,5073,1017,2548,999,93,190,20,22,4056
4013116619,4567,1158,2111,821,68,224,14,29,3409
4013116620,8015,1660,3954,1598,140,319,28,50,6355
4013116621,5456,1047,2467,1257,95,310,12,46,4409
4013116703,5194,1314,2701,741,57,165,4,30,3880
4013116707,2730,2011,428,47,26,68,4,25,719
4013116708,5370,3860,699,320,100,172,9,19,1510
4013116709,2543,1207,604,275,113,174,16,17,1336
4013116710,4728,3591,517,82,27,241,8,24,1137
4013116711,2052,1030,424,244,136,80,6,20,1022
4013116712,7907,4261,1585,641,194,703,13,52,3646
4013116713,5996,3935,902,306,113,419,14,26,2061
4013116714,3382,2153,549,141,29,321,1,15,1229
4013116715,1984,1355,379,76,22,62,10,3,629
4013116717,3404,1475,722,540,302,163,6,10,1929
4013116718,2795,1469,561,340,150,139,10,14,1326
4013116719,6689,3755,1204,458,97,796,2,50,2934
4013116720,3892,2301,706,305,143,168,37,21,1591
4013116721,3588,2548,469,100,31,216,2,20,1040
4013116725,5035,3354,737,295,56,338,9,12,1681
4013116727,4095,2868,508,173,7,280,0,19,1227
4013116728,4792,3360,526,190,25,375,2,30,1432
4013116729,4008,3016,444,79,19,250,8,9,992
4013116730,1974,1222,315,106,6,208,2,18,752
4013116731,3629,2428,583,158,25,216,5,13,1201
4013116732,4376,1226,2480,314,92,98,12,29,3150
4013116733,11,6,2,0,0,0,0,0,5
4013116734,1748,362,1086,187,32,22,3,14,1386
4013116735,3923,471,2863,416,68,35,9,7,3452
4013116736,3154,445,2105,417,77,29,9,6,2709
4013116737,3428,1312,1117,628,44,166,21,24,2116
4013116738,6273,2750,1774,770,77,558,7,39,3523
4013116800,2559,859,1486,87,37,26,4,6,1700
4013116900,2493,328,2011,71,42,15,0,10,2165
4013117000,6234,1567,3003,944,138,388,1,23,4667
4013117100,2986,1560,812,224,123,100,3,31,1426
4013117200,949,89,773,32,21,4,2,5,860
4013117300,1924,146,1393,310,15,4,1,14,1778
4013216806,3106,2611,230,16,13,98,7,15,495
4013216807,5140,4340,355,38,7,195,7,8,800
4013216809,4890,3903,301,79,15,370,0,22,987
4013216810,1567,1285,114,14,1,81,0,8,282
4013216813,4443,3830,270,57,4,139,3,19,613
4013216816,6861,5602,429,115,16,360,3,38,1259
4013216819,6020,5349,298,39,15,129,2,23,671
4013216820,4356,3756,267,48,25,96,1,21,600
4013216821,5952,5287,265,67,7,148,2,17,665
4013216822,4448,4011,170,39,1,95,4,18,437
4013216826,4727,3883,318,66,14,252,1,23,844
4013216829,5320,4798,191,68,4,146,2,15,522
4013216830,3238,2363,343,124,21,199,2,24,875
4013216831,2896,2412,178,23,5,137,1,13,484
4013216832,2447,2179,110,25,1,74,0,0,268
4013216833,4808,3771,349,73,18,410,0,16,1037
4013216834,2345,2035,157,11,1,73,0,7,310
4013216835,2782,2314,202,33,18,104,9,10,468
4013216836,3690,3018,266,49,15,162,5,7,672
4013216837,5344,3745,551,177,39,529,12,15,1599
4013216838,4907,3728,389,54,24,473,2,20,1179
4013216839,4176,3481,248,44,7,276,1,12,695
4013216840,4775,4046,274,57,3,225,6,9,729
4013216841,4355,3641,279,67,4,221,0,14,714
4013216842,3461,2900,207,33,3,161,0,23,561
4013216843,3592,3254,124,43,4,74,0,10,338
4013216844,4228,3558,237,94,16,209,5,4,670
4013216845,3449,2367,234,123,3,437,9,141,1082
4013216849,6263,5207,314,33,1,424,0,31,1056
4013216850,4190,3057,345,147,29,429,9,22,1133
4013216851,4593,4048,212,28,7,141,0,30,545
4013216852,3001,2247,272,104,12,221,3,11,754
4013216853,4870,3587,371,93,6,577,2,19,1283
4013216854,4356,3456,320,63,3,327,0,15,900
4013216855,3890,3287,231,20,8,198,1,21,603
4013216856,2819,2470,122,30,18,80,0,4,349
4013216857,4673,4014,290,81,35,97,4,23,659
4013216858,0,0,0,0,0,0,0,0,0
4013216859,6531,5166,364,72,9,665,0,22,1365
4013216860,2246,1654,209,30,0,254,0,5,592
4013216861,4279,3541,224,45,11,253,0,13,738
4013216901,3544,2960,278,43,11,127,4,11,584
4013216902,3843,3033,413,80,22,103,0,11,810
4013217001,4305,3697,317,51,22,102,5,15,608
4013217002,5307,4226,608,53,26,118,11,24,1081
4013217101,2627,2030,355,21,29,68,3,12,597
4013217102,2746,2153,276,52,23,77,9,11,593
4013217201,2451,1885,215,105,18,109,0,14,566
4013217203,3376,2773,275,78,12,117,4,13,603
4013217204,2987,1918,636,133,69,99,4,13,1069
4013217300,4781,3950,295,82,5,203,5,27,831
4013217400,3301,2607,343,64,13,87,0,14,694
4013217501,3093,1423,1246,124,101,82,10,17,1670
4013217502,3629,2545,580,141,37,137,3,21,1084
4013217600,5036,3304,1049,171,109,158,12,22,1732
4013217700,4750,3605,621,70,30,157,7,32,1145
4013217800,6047,4265,1109,176,104,139,9,15,1782
4013217900,3682,2630,590,112,40,141,8,17,1052
4013218000,5613,3603,1223,238,120,171,6,38,2010
4013218100,1973,1191,533,50,45,72,1,5,782
4013218200,6897,3842,1981,272,191,264,12,34,3055
4013218300,4616,3193,738,210,83,198,0,27,1423
4013318400,5840,2806,1797,270,155,453,12,25,3034
4013318501,3317,1946,859,99,71,126,26,16,1371
4013318700,5937,3381,1059,384,69,680,10,39,2556
4013318800,7468,3780,1768,612,272,593,28,56,3688
4013318900,6427,3785,1456,383,143,280,29,18,2642
4013319001,2731,1646,510,125,23,303,3,4,1085
4013319002,4058,2448,795,177,50,363,8,25,1610
4013319101,4634,2256,705,238,65,1145,2,25,2378
4013319103,5390,2214,770,321,83,1748,18,38,3176
4013319104,7240,2874,1325,420,148,2111,21,25,4366
4013319201,7038,2642,2472,663,188,615,64,25,4396
4013319202,3680,1770,741,413,130,324,9,30,1910
4013319300,2425,932,881,169,77,230,13,20,1493
4013319401,6404,3830,1289,356,130,387,34,33,2574
4013319402,4085,2710,772,141,61,173,2,27,1375
4013319403,4709,2639,1053,388,180,182,16,41,2070
4013319404,3750,2879,470,99,47,126,5,10,871
4013319500,6177,3736,1165,318,136,446,14,32,2441
4013319600,5632,3524,980,177,99,464,48,33,2108
4013319705,3297,1645,1015,200,146,109,18,15,1652
4013319706,5644,1538,2764,431,221,461,18,22,4106
4013319707,2,0,2,0,0,0,0,0,2
4013319708,4025,1967,1168,301,120,294,6,18,2058
4013319709,0,0,0,0,0,0,0,0,0
4013319710,2670,1367,645,209,67,203,21,18,1303
4013319801,3513,1557,922,528,114,150,32,28,1956
4013319802,3321,1726,816,324,87,118,38,15,1595
4013319902,2762,1568,679,178,66,119,6,24,1194
4013319903,5675,3726,935,264,124,289,4,28,1949
4013319904,4928,3303,975,149,56,179,15,18,1625
4013319905,4827,3178,969,162,62,194,17,15,1649
4013319906,3349,2293,477,148,46,234,10,19,1056
4013319907,2155,1630,260,43,12,123,0,16,525
4013319908,2258,1248,561,130,93,87,15,6,1010
4013319909,2312,1687,291,58,22,146,3,8,625
4013319910,4587,2875,577,155,38,682,3,20,1712
4013320001,7287,2762,1776,1052,471,767,43,46,4525
4013320002,5322,198,3124,123,1760,42,6,25,5124
4013320007,6643,2572,1948,739,332,642,52,32,4071
4013320100,3591,2210,681,155,69,264,6,11,1381
4013420104,5447,4315,739,87,35,73,5,28,1132
4013420105,6299,4944,784,87,57,124,19,28,1355
4013420107,6775,5544,579,121,16,221,9,0,1231
4013420108,1596,1329,121,19,4,42,1,14,267
4013420109,5598,4469,577,98,42,128,5,24,1129
4013420110,5799,4727,682,48,45,94,4,7,1072
4013420111,4082,2626,1198,32,33,37,7,25,1456
4013420112,3342,2447,622,62,18,47,9,23,895
4013420113,3758,2324,745,357,49,54,22,18,1434
4013420114,4009,2219,1415,59,49,96,10,25,1790
4013420115,3169,1861,1050,59,30,37,8,13,1308
4013420116,3004,2368,447,33,26,30,2,11,636
4013420202,5307,3804,945,153,58,100,6,33,1503
4013420206,3726,3215,270,68,33,14,0,29,511
4013420207,2768,2316,241,28,20,65,0,1,452
4013420208,5614,3601,1416,122,61,117,26,25,2013
4013420209,4220,3243,631,86,23,70,11,24,977
4013420210,5328,3958,866,127,34,58,3,23,1370
4013420211,4380,3340,642,54,49,79,3,25,1040
4013420212,2957,2353,336,39,25,71,1,9,604
4013420213,1382,1300,29,6,8,4,0,0,82
4013420214,4363,3046,777,231,32,104,0,18,1317
4013420215,3114,2036,691,71,38,97,22,23,1078
4013420216,4264,3306,527,87,50,92,7,16,958
4013420301,2250,1706,302,31,30,87,2,17,544
4013420302,4778,3760,543,80,52,107,17,20,1018
4013420303,4314,2948,945,75,34,106,9,30,1366
4013420304,1149,926,105,8,6,62,0,12,223
4013420401,4574,1842,2138,133,272,49,0,7,2732
4013420402,4862,3775,559,70,59,223,6,4,1087
4013420503,3428,1725,1073,257,156,65,10,24,1703
4013420504,3438,2043,954,120,63,87,7,17,1395
4013420505,3235,1179,1521,117,173,77,18,28,2056
4013420506,3636,1445,1432,265,233,62,22,15,2191
4013420602,4937,3416,1107,70,73,67,43,19,1521
4013420603,3972,2988,590,77,69,38,30,24,984
4013420604,4658,3526,755,46,52,59,9,37,1132
4013420704,5060,3499,967,202,62,77,22,23,1561
4013420705,3693,2912,367,51,22,203,6,11,781
4013420706,5096,3656,805,82,59,195,25,34,1440
4013420707,2397,1795,292,139,41,28,3,13,602
4013420708,3688,2533,726,221,56,18,11,6,1155
4013420709,2925,2289,329,103,44,41,0,4,636
4013420710,3354,1914,984,173,36,98,7,13,1440
4013420800,5275,2932,1755,164,74,68,39,25,2343
4013420901,3676,1495,1552,230,210,25,17,12,2181
4013420902,3492,1982,1154,117,48,30,13,15,1510
4013421001,4125,2155,1347,262,166,32,27,13,1970
4013421002,3208,1517,1016,360,112,38,10,8,1691
4013421101,4713,2117,1859,202,225,102,11,34,2596
4013421102,5988,3041,1953,388,269,62,21,53,2947
4013421201,4837,2568,1179,259,172,360,20,15,2269
4013421202,3990,1942,1479,171,123,89,5,21,2048
4013421302,6346,1881,3442,443,187,136,38,17,4465
4013421303,5610,1966,2606,305,200,197,26,28,3644
4013421304,3343,1268,1079,383,267,178,7,7,2075
4013421400,2793,1551,846,165,52,42,8,14,1242
4013421501,3980,1159,2454,145,63,27,9,20,2821
4013421502,3506,1206,1984,125,49,36,4,23,2300
4013421601,3460,1325,1826,110,50,23,21,23,2135
4013421602,4398,1036,3021,122,69,27,30,6,3362
4013421701,4947,2267,1727,398,168,84,34,35,2680
4013421702,3822,1704,1764,133,61,40,13,13,2118
4013421801,2719,905,1575,69,22,25,6,19,1814
4013421802,4942,1374,3114,161,57,35,54,17,3568
4013421901,4023,967,2742,93,66,47,13,17,3056
4013421902,6188,995,4816,126,85,60,24,14,5193
4013422001,3994,567,3110,83,83,37,10,12,3427
4013422002,3970,950,2660,131,78,19,14,24,3020
4013422102,4408,1475,2308,173,141,131,11,12,2933
4013422103,5294,2008,1478,687,550,179,87,44,3286
4013422104,6024,2480,2026,474,296,356,77,42,3544
4013422105,3165,1096,1589,146,87,117,10,25,2069
4013422106,5947,2018,2508,659,318,108,39,41,3929
4013422107,4292,1643,1388,559,326,117,15,37,2649
4013422203,5759,2720,1621,527,312,209,36,48,3039
4013422209,7386,3597,1986,738,253,355,8,44,3789
4013422210,5417,3355,1338,154,67,214,16,22,2062
4013422211,2672,1880,434,59,13,154,0,19,792
4013422212,4265,3143,559,112,22,193,8,23,1122
4013422213,2527,1615,577,55,61,72,10,9,912
4013422215,2158,1166,597,126,49,100,8,31,992
4013422216,6000,3755,1200,278,137,316,25,28,2245
4013422217,3607,2152,882,196,76,126,1,8,1455
4013422218,3016,1773,755,127,53,121,9,14,1243
4013422219,3059,1763,697,190,80,131,8,21,1296
4013422220,2054,1405,323,67,21,107,2,6,649
4013422221,4292,2557,1006,214,107,166,21,18,1735
4013422222,2185,1460,425,89,29,78,14,5,725
4013422223,3210,1841,674,275,129,91,21,13,1369
4013422224,0,0,0,0,0,0,0,0,0
4013422225,0,0,0,0,0,0,0,0,0
4013422226,0,0,0,0,0,0,0,0,0
4013422227,1436,934,313,34,23,30,8,9,502
4013422301,6454,1948,3579,292,162,162,54,20,4506
4013422302,5041,2795,1593,141,102,120,9,29,2246
4013422304,2935,1469,737,303,77,173,8,3,1466
4013422305,5935,3910,834,233,55,551,15,19,2025
4013422307,4400,2529,1010,260,71,293,22,8,1871
4013422308,5513,3410,1226,152,50,410,21,26,2103
4013422309,5662,3243,1140,220,53,651,31,42,2419
4013422401,3850,2322,943,145,50,142,4,14,1528
4013422402,4735,3009,1149,126,71,119,11,15,1726
4013422403,5245,3368,1138,173,36,267,5,27,1877
4013422404,4737,3287,855,141,26,145,15,18,1450
4013422501,6078,3580,1897,164,71,79,4,36,2498
4013422502,5925,3454,1727,219,98,131,63,29,2471
4013422503,6792,3445,2434,236,144,129,49,25,3347
4013422504,4927,3201,1037,191,98,179,7,19,1726
4013422506,5094,3551,876,141,46,168,20,28,1543
4013422507,4406,3310,537,65,47,208,10,24,1096
4013422508,3680,2573,740,86,43,72,5,23,1107
4013422509,5399,3565,993,166,77,251,10,21,1834
4013422510,3474,2499,564,62,15,163,4,12,975
4013422511,3181,2201,584,74,39,132,4,8,980
4013422512,4984,3398,942,115,31,239,4,29,1586
4013422513,4441,3314,763,115,26,58,11,15,1127
4013422514,4933,3074,1139,244,46,192,10,9,1859
4013422607,4499,3866,329,129,29,54,0,14,633
4013422609,4276,2905,1006,89,46,76,5,11,1371
4013422610,3139,2841,176,32,7,15,3,9,298
4013422615,6986,4752,1271,264,102,227,32,26,2234
4013422617,6141,4177,1236,148,71,156,48,33,1964
4013422618,2984,2870,61,10,3,16,0,0,114
4013422620,3261,2339,503,90,23,153,8,10,922
4013422621,4933,3361,857,125,35,308,11,8,1572
4013422622,4229,2983,717,124,39,181,9,29,1246
4013422623,8259,5649,1258,310,60,597,7,28,2610
4013422624,2404,2152,125,43,15,14,2,2,252
4013422625,4405,3039,1002,125,41,47,6,16,1366
4013422626,2719,2235,351,32,17,19,0,3,484
4013422627,3576,2079,1243,40,34,27,16,23,1497
4013422628,4065,2266,1243,201,77,44,5,19,1799
4013422629,3577,2319,835,113,70,40,17,27,1258
4013422630,4783,3055,1399,47,51,35,14,5,1728
4013422632,4098,2949,833,79,47,55,7,12,1149
4013422633,3075,1795,674,181,52,197,4,7,1280
4013422634,5457,2991,2022,88,41,89,7,19,2466
4013422636,3267,2019,654,168,55,193,24,17,1248
4013422637,3597,2496,694,107,45,70,4,12,1101
4013422638,4260,2460,978,245,56,229,34,34,1800
4013422639,3687,3335,135,55,8,77,4,5,352
4013422640,5077,3568,839,157,49,166,31,18,1509
4013422642,5886,4185,976,221,28,206,7,33,1701
4013422643,5862,4065,1150,127,47,138,14,22,1797
4013422647,9208,6271,1478,369,26,483,18,25,2937
4013422648,5827,3971,937,185,32,326,32,39,1856
4013422649,6397,4367,1261,207,51,190,20,12,2030
4013422650,2900,2318,382,44,4,43,14,4,582
4013422651,5260,3612,889,217,30,245,3,12,1648
4013422652,2781,2662,64,7,3,11,0,5,119
4013422653,4602,3040,1060,127,71,124,8,18,1562
4013422654,5858,3897,1139,142,43,226,41,26,1961
4013422655,3529,2240,817,129,26,88,16,16,1289
4013422656,5166,4064,466,60,8,330,14,21,1102
4013422657,4482,3333,622,52,23,226,13,27,1149
4013422658,3652,2509,441,85,8,392,0,11,1143
4013422659,1890,1379,294,96,17,26,7,11,511
4013422660,4871,3213,1016,195,30,149,22,6,1658
4013522801,5,0,3,0,1,0,0,0,5
4013522802,1289,518,291,227,49,105,3,2,771
4013522901,5029,2574,1303,438,104,350,23,30,2455
4013522903,5123,858,3707,287,51,109,6,11,4265
4013522904,5070,1195,3002,281,95,342,5,11,3875
4013523002,5970,1639,3661,234,85,134,9,27,4331
4013523005,5041,2955,1091,202,73,419,10,25,2086
4013523006,5689,2770,1850,298,93,393,9,25,2919
4013523007,3379,1359,1402,207,70,174,2,15,2020
4013523008,3520,1625,1242,188,49,214,9,6,1895
4013523102,5752,1590,2834,583,120,309,32,16,4162
4013523103,6567,3199,1402,642,180,728,18,26,3368
4013523104,6782,2474,2796,572,137,487,24,30,4308
4013610001,2404,2027,196,22,22,34,2,8,377
4013610002,6672,4602,1075,308,188,203,19,13,2070
4013610100,696,539,103,4,7,19,0,4,157
4013610201,4325,3670,322,65,27,62,2,12,655
4013610202,3795,3291,222,43,8,104,1,24,504
4013610301,3956,3024,465,108,20,125,1,16,932
4013610302,5438,4212,562,118,30,121,12,36,1226
4013610400,5676,4433,657,97,5,147,15,21,1243
4013610500,7316,6247,600,45,32,85,8,28,1069
4013610600,6367,4862,712,202,17,175,25,55,1505
4013610700,7705,6629,660,54,25,44,8,31,1076
4013610800,6842,4980,767,195,31,533,5,29,1862
4013610901,5541,4109,676,90,23,364,4,28,1432
4013610902,5035,3422,662,132,21,514,11,15,1613
4013610903,3818,2942,413,72,12,198,3,20,876
4013611000,3187,2394,369,58,12,202,3,25,793
4013611100,3943,2941,462,80,20,236,5,18,1002
4013611200,6566,4854,821,125,23,399,14,11,1712
4013611300,7346,5142,833,309,79,518,14,43,2204
4013611400,6675,5054,684,132,20,467,8,21,1621
4013611500,7896,5161,722,205,27,1331,7,39,2735
4013611600,3099,2364,386,35,16,182,4,12,735
4013611700,6545,5090,656,145,33,356,3,27,1455
4013611800,6761,5229,930,93,47,109,4,47,1532
4013611900,3238,2285,479,89,23,200,3,7,953
4013612000,4400,3407,427,126,11,222,5,17,993
4013612200,6533,4518,612,124,38,886,7,33,2015
4013612301,4031,2583,403,195,53,589,1,53,1448
4013612302,4950,3303,508,153,17,764,4,4,1647
4013612401,4496,3418,461,78,2,284,4,26,1078
4013612402,4190,3001,406,59,0,494,1,31,1189
4013612500,4440,3878,286,27,11,91,3,7,562
4013612600,2397,2064,187,15,3,62,0,4,333
4013612700,2239,1913,147,20,8,54,5,7,326
4013612800,2444,1998,181,33,3,105,0,11,446
4013612900,2618,2183,229,18,6,68,1,11,435
4013613000,6109,5173,336,54,12,224,4,28,936
4013613100,2893,2664,96,23,5,38,3,12,229
4013613200,3762,3256,229,30,28,67,4,21,506
4013613300,6892,5596,536,103,15,295,7,41,1296
4013613400,3870,3156,398,81,20,49,4,12,714
4013613500,4321,3167,569,170,18,185,20,16,1154
4013613601,4128,2959,606,77,22,300,2,5,1169
4013613602,5831,3829,704,105,13,914,7,10,2002
4013613700,5646,4253,751,122,16,240,6,16,1393
4013613800,4199,3273,516,73,10,140,1,23,926
4013613900,6253,4733,736,132,21,326,5,43,1520
4013614000,4270,3274,546,53,28,163,11,13,996
4013614100,6700,4712,835,173,30,673,12,20,1988
4013614200,4732,3565,490,113,21,339,2,17,1167
4013614300,3023,2265,273,32,10,324,6,15,758
4013614400,4016,2594,874,112,37,196,12,22,1422
4013614500,4696,2958,1155,91,47,216,3,38,1738
4013614601,3521,2317,591,154,52,180,11,22,1204
4013614602,3102,1897,614,157,35,209,14,19,1205
4013614700,3094,1842,570,261,62,113,6,10,1252
4013614800,4194,2760,770,96,66,306,13,15,1434
4013614900,4213,3035,486,146,29,326,0,27,1178
4013615001,5840,4287,350,105,7,803,6,17,1553
4013615002,5033,3727,423,101,9,513,2,22,1306
4013615100,4714,3496,365,107,8,494,0,17,1218
4013615201,5839,3940,599,208,33,706,6,158,1899
4013615202,3854,3077,287,83,3,252,0,18,777
4013615300,2085,1765,211,14,16,23,4,4,320
4013615400,2756,2559,85,21,5,26,0,3,197
4013615500,2988,2785,84,37,4,33,0,4,203
4013615600,3891,3302,288,87,15,99,5,3,589
4013615700,3073,2292,382,115,7,148,2,15,781
4013615800,5088,3770,619,186,30,251,0,35,1318
4013615900,4328,3060,565,121,14,323,0,14,1268
4013616000,2408,1593,315,58,27,287,7,12,815
4013616100,3905,2721,672,120,34,128,4,18,1184
4013616200,3353,2334,610,116,15,120,2,11,1019
4013616300,2125,1542,367,39,7,80,3,7,583
4013616400,6300,3519,675,140,61,1622,4,63,2781
4013616500,3838,2358,887,164,69,126,20,30,1480
4013616600,5698,3712,1377,179,63,129,6,22,1986
4013616700,5315,3628,987,169,50,195,16,40,1687
4013616800,5865,3911,1414,133,39,92,27,18,1954
4013616900,4396,2981,622,220,73,307,3,17,1415
4013617001,8,5,2,1,0,0,0,0,3
4013617002,6177,4037,1388,155,38,297,8,17,2140
4013617100,2275,1732,268,56,3,95,2,17,543
4013617200,2521,1899,264,48,7,158,1,14,622
4013617300,3018,2068,332,77,10,379,2,11,950
4013617400,7573,6280,639,197,40,145,3,29,1293
4013617500,3977,3423,263,84,10,75,0,16,554
4013617600,6285,4551,968,216,52,205,8,32,1734
4013617700,3473,2049,698,322,38,182,18,17,1424
4013617800,2661,2122,328,28,9,66,2,7,539
4013617900,2742,2088,314,51,28,141,2,4,654
4013618000,4476,3172,724,106,22,194,16,18,1304
4013618100,4415,3300,632,92,38,96,2,21,1115
4013618200,3928,2652,782,149,38,88,6,11,1276
4013618300,3119,2240,569,61,33,41,2,9,879
4013618400,4022,2501,1059,127,51,89,0,25,1521
4013618500,4026,2295,1018,321,83,68,7,23,1731
4013618600,4938,2806,1360,250,49,204,11,37,2132
4013618700,3005,1581,1097,64,38,90,0,19,1424
4013618800,5349,2280,2000,598,128,55,40,32,3069
4013618900,6858,4292,1491,381,116,239,6,35,2566
4013619000,3068,2291,381,119,21,107,9,17,777
4013619100,3893,1862,993,611,65,116,16,39,2031
4013619200,6078,3064,1542,607,139,395,16,30,3014
4013619300,4666,2648,1413,184,58,177,5,15,2018
4013619400,4884,2463,1551,308,76,252,3,19,2421
4013619500,5561,3172,1669,187,68,202,3,30,2389
4013619601,0,0,0,0,0,0,0,0,0
4013619602,1906,1343,376,25,13,46,0,11,563
4013619700,3404,2333,599,93,21,150,4,8,1071
4013619800,4774,2894,534,108,24,1023,6,20,1880
4013619900,6066,4107,417,67,36,1223,3,26,1959
4013723304,6439,3555,2498,88,61,37,3,44,2884
4013723305,2486,410,1587,8,412,14,0,1,2076
4013723306,4662,1669,2212,517,229,18,4,4,2993
4013723307,2146,1527,329,106,3,58,7,11,619
4013723309,3035,2079,625,120,28,59,3,23,956
4013723310,2909,2060,419,153,24,92,0,22,849
4013723311,5781,3883,1187,307,12,104,8,33,1898
4013810000,3251,1701,501,254,41,555,6,24,1550
4013810100,6352,4555,698,113,34,637,6,33,1797
4013810200,3546,1890,573,198,71,607,19,9,1656
4013810300,5954,3482,1069,267,74,762,20,30,2472
4013810400,5413,2974,917,404,118,692,16,34,2439
4013810500,5118,2845,808,228,62,875,0,20,2273
4013810600,6794,3953,1049,284,132,974,14,26,2841
4013810700,7543,3946,1471,646,210,812,32,42,3597
4013810800,4365,2299,757,178,100,819,6,19,2066
4013810900,5752,3531,1069,258,91,561,11,18,2221
4013811000,2793,1852,534,78,26,145,3,6,941
4013811100,3673,1897,885,296,88,326,5,9,1776
4013811200,3511,1597,852,357,114,392,21,13,1914
4013811300,3026,1700,651,150,30,327,4,13,1326
4013811400,5325,3219,1029,259,55,470,10,46,2106
4013811500,2892,1639,456,161,28,477,9,11,1253
4013811600,4450,2615,1038,169,33,415,1,17,1835
4013811700,4646,2569,1300,204,54,255,21,21,2077
4013811800,1910,1023,159,82,1,548,2,19,887
4013811900,5838,3469,926,307,71,734,15,18,2369
4013812000,4939,2036,1751,326,77,507,10,14,2903
4013812100,7106,3662,1453,643,110,786,8,50,3444
4013812200,7700,3948,1280,375,97,1557,16,54,3752
4013812300,4961,2781,714,301,82,845,11,18,2180
4013812400,7909,4189,1274,594,79,1342,6,17,3720
4013812500,2232,1279,303,105,7,407,17,13,953
4013812600,6396,4022,898,336,74,725,13,60,2374
4013812700,6773,3766,871,347,59,1358,14,43,3007
4013812801,3303,1821,413,98,13,741,13,22,1482
4013812802,6012,3123,761,296,15,1470,6,28,2889
4013812900,3363,1898,339,101,25,846,0,21,1465
4013813000,6077,3856,512,122,17,1315,5,10,2221
4013813100,3708,1984,428,97,18,1012,5,15,1724
4013813200,4852,2774,626,181,7,1015,9,23,2078
4013813300,6713,4207,780,236,19,1163,6,19,2506
4013813400,4825,2863,774,291,31,567,0,29,1962
4013813500,3905,2422,523,142,15,605,11,19,1483
4013813600,4786,3210,596,151,7,570,4,8,1576
4013813700,2510,2346,64,32,5,13,1,8,164
4013813800,2913,2700,72,40,7,39,3,6,213
4013813900,6104,3883,1131,289,80,348,10,28,2221
4013814000,2736,2334,178,59,22,61,1,10,402
4013814100,6160,3890,1141,383,41,317,5,28,2270
4013814200,2703,1798,342,109,17,273,2,10,905
4013814300,4595,2954,882,141,48,347,4,18,1641
4013814400,5533,3632,1035,187,36,349,14,17,1901
4013814500,5232,3527,974,172,52,217,11,8,1705
4013814600,5755,3607,1249,252,68,228,8,37,2148
4013814700,4576,3269,721,119,25,209,3,15,1307
4013814801,3629,2287,602,207,40,249,14,14,1342
4013814802,6047,3508,1186,537,34,368,14,24,2539
4013814900,3143,2190,538,84,19,154,10,16,953
4013815000,4236,3111,614,69,16,241,0,13,1125
4013815100,5506,3475,1080,183,40,378,16,30,2031
4013815201,5551,3378,1081,312,62,346,23,37,2173
4013815202,3341,1980,616,197,16,306,7,8,1361
4013815203,3778,2464,529,232,23,342,2,17,1314
4013815300,4031,2877,438,115,16,344,7,17,1154
4013815401,3849,2929,402,99,13,250,6,12,920
4013815402,6512,3854,1109,311,51,763,36,41,2658
4013815501,4502,2898,705,198,46,379,6,17,1604
4013815502,2640,1639,481,180,27,144,3,21,1001
4013815601,1246,848,171,36,9,100,1,3,398
4013815602,5736,3717,1029,265,32,362,17,27,2019
4013815700,5644,3640,1111,235,58,271,9,30,2004
4013815800,6465,4373,1096,283,47,275,7,31,2092
4013815901,6438,3723,893,234,53,1205,5,27,2715
4013815902,5394,3643,716,149,33,627,1,13,1751
4013816001,4030,2821,605,92,1,318,0,10,1209
4013816002,3964,2824,562,97,7,266,3,17,1140
4013816003,2643,1669,302,85,7,457,0,17,974
4013816004,6839,4371,1156,263,26,596,20,31,2468
4013816005,4670,3135,705,217,17,333,12,30,1535
4013816100,7437,5142,1377,216,50,269,12,50,2295
4013816200,4059,2642,716,208,38,175,24,22,1417
4013816301,3085,2899,78,28,4,36,0,6,186
4013816302,4315,2902,624,117,15,411,6,12,1413
4013816401,3912,2607,632,160,27,231,11,25,1305
4013816402,4878,3448,685,198,20,207,13,50,1430
4013816501,2220,1741,243,48,5,64,5,18,479
4013816502,2318,1687,427,53,3,40,1,12,631
4013816600,5354,3867,831,165,21,207,7,25,1487
4013816700,2634,1874,445,60,15,102,5,6,760
4013816800,7767,5605,1275,203,68,184,21,26,2162
4013816901,5903,4093,1053,233,33,145,16,14,1810
4013816902,2514,1944,322,55,16,49,3,4,570
4013816903,3039,2106,553,108,22,66,12,16,933
4013816904,3310,2386,545,81,32,82,0,8,924
4013817000,3955,3060,516,104,23,108,8,4,895
4013817101,3591,2606,605,106,21,71,3,22,985
4013817102,3286,1942,808,231,45,85,0,7,1344
4013817103,5401,3718,1139,168,24,103,3,51,1683
4013817200,7797,5650,1577,140,32,80,5,33,2147
4013817300,5561,5265,90,63,5,64,7,7,296
4013817400,3070,2809,127,33,13,32,3,5,261
4013817500,2847,2650,74,45,4,25,1,5,197
4013817600,6885,4846,1119,225,31,343,8,25,2039
4013940700,88,0,2,0,85,0,0,0,88
4013941000,3540,37,469,9,2968,0,0,5,3503
4013941100,43,6,10,0,21,0,0,0,37
4013941200,1152,70,156,2,875,0,0,0,1082
4013941300,6334,812,1048,32,4228,12,2,6,5522
4013980100,1,1,0,0,0,0,0,0,0
4013980400,14,6,4,0,0,3,0,0,8
4013980500,0,0,0,0,0,0,0,0,0
4013980700,0,0,0,0,0,0,0,0,0
4013980900,26,15,7,0,0,0,0,0,11
4013981000,803,445,201,114,26,3,1,1,358
4015940400,1250,11,67,4,1151,4,0,3,1239
4015940501,2736,2042,402,19,118,11,20,17,694
4015950101,3187,2238,801,18,45,13,0,6,949
4015950102,2463,2405,22,0,1,1,0,1,58
4015950103,2367,2103,30,6,182,3,0,1,264
4015950401,1781,1272,366,14,13,13,6,10,509
4015950403,1831,1609,121,10,16,12,2,1,222
4015950404,2308,1976,124,22,85,14,0,3,332
4015950500,1363,1088,200,13,6,8,2,6,275
4015950601,3487,2814,371,29,29,40,1,13,673
4015950602,2818,2211,376,22,26,35,2,9,607
4015950603,3122,2442,369,15,32,20,14,20,680
4015950703,4055,3114,609,28,62,18,5,11,941
4015950705,4117,3107,663,13,38,40,16,8,1010
4015950706,3776,2942,471,48,71,24,7,11,834
4015950707,2690,2066,359,27,31,58,12,8,624
4015950708,4345,3547,431,36,48,42,5,6,798
4015951401,4132,3149,638,92,32,59,7,13,983
4015951403,2275,1731,334,36,13,51,9,0,544
4015951404,2181,1630,353,38,28,15,0,5,551
4015951501,4157,3031,761,47,41,54,2,6,1126
4015951503,2052,1725,189,25,9,23,1,9,327
4015951504,3819,2848,553,74,31,118,3,15,971
4015951601,3768,2392,1077,33,34,55,6,14,1376
4015951602,4153,2523,1324,43,24,36,2,20,1630
4015951701,3013,1558,1211,35,28,22,16,21,1455
4015951702,2350,1396,792,13,21,16,1,16,954
4015951800,3431,1927,1238,38,28,25,18,13,1504
4015951900,4204,2839,1019,49,44,60,12,9,1365
4015952001,1871,1321,377,19,12,51,2,0,550
4015952003,4617,3277,977,54,36,68,6,10,1340
4015952004,4172,3034,754,57,37,86,3,24,1138
4015952005,1225,1032,111,5,17,4,2,3,193
4015952006,3215,2323,591,35,38,54,6,8,892
4015952007,3970,3054,580,49,27,56,5,7,916
4015952400,3176,2593,379,12,28,31,5,5,583
4015952501,3161,2615,319,13,21,51,8,9,546
4015952502,2533,2127,271,10,5,14,5,8,406
4015952600,3427,2504,710,12,26,46,0,6,923
4015952701,2526,1778,596,20,11,15,11,2,748
4015952702,2816,2121,493,30,17,21,0,10,695
4015952801,3459,2886,357,11,23,13,10,11,573
4015952802,3650,2989,433,13,25,46,2,12,661
4015952901,2166,1558,378,15,18,50,0,15,608
4015952902,3493,2795,492,9,18,25,2,8,698
4015953001,2304,1828,345,13,20,28,0,2,476
4015953002,3466,2754,484,25,21,27,1,12,712
4015953100,3315,2600,502,30,22,38,8,0,715
4015953200,2998,2534,261,11,12,47,6,9,464
4015953301,3215,2628,360,6,17,27,2,22,587
4015953302,3320,2644,430,19,36,34,5,10,676
4015953403,2590,2112,323,26,20,24,1,6,478
4015953404,3175,2471,469,17,25,31,4,14,704
4015953405,3280,2745,388,13,10,30,2,4,535
4015953406,2631,2120,330,18,24,50,2,6,511
4015953602,2718,2079,366,73,33,28,7,13,639
4015953603,4292,3174,634,52,82,52,7,16,1118
4015953604,6675,5282,783,40,72,152,6,30,1393
4015953800,6659,4898,1087,104,112,92,17,27,1761
4015953901,4203,2979,705,50,64,166,24,19,1224
4015953902,4203,3062,694,31,65,88,13,23,1141
4015954801,2630,2204,210,24,46,27,0,13,426
4015954802,5653,3650,1334,220,154,37,4,26,2003
4015954900,4048,3205,473,49,38,73,7,16,843
4015955001,2280,1641,436,7,66,16,7,4,639
4015955002,2904,1812,423,24,468,12,6,5,1092
4017940008,1258,5,11,0,1242,0,0,0,1253
4017940010,2642,31,12,4,2513,3,0,0,2611
4017940011,3040,25,20,5,2936,14,0,2,3015
4017940012,2643,23,19,4,2568,9,0,0,2620
4017940013,3790,67,49,11,3622,17,0,3,3723
4017940014,2382,15,44,0,2286,2,0,1,2367
4017940015,4071,23,74,4,3887,3,2,1,4048
4017940100,4282,105,53,8,4033,22,0,4,4177
4017940301,4597,17,32,3,4506,6,0,0,4580
4017940302,3116,22,27,0,3042,3,0,0,3094
4017942300,2231,12,14,3,2155,1,0,0,2219
4017942400,2682,19,24,0,2624,1,0,0,2663
4017942500,4808,118,49,5,4547,0,0,0,4690
4017960100,1813,643,423,17,602,16,4,5,1170
4017960200,3498,1428,840,76,974,18,4,18,2070
4017960400,3580,1433,911,75,945,26,1,16,2147
4017960500,3618,1626,1162,179,533,5,5,14,1992
4017960600,4453,1183,1156,105,1780,40,3,9,3270
4017961300,3454,2465,639,16,197,30,0,9,989
4017961701,3414,2442,572,13,184,38,0,9,972
4017961702,3664,2845,472,19,112,53,3,21,819
4017962501,1567,1092,265,6,84,26,1,4,475
4017962502,1286,1033,141,2,46,12,2,6,253
4017963300,5090,3963,593,11,276,23,18,14,1127
4017963400,3478,2924,285,13,74,6,7,27,554
4017963700,1855,1599,164,4,23,15,0,5,256
4017963800,4508,3658,537,18,173,20,0,7,850
4017964201,1864,1587,191,5,28,5,1,3,277
4017964202,1559,1372,96,4,21,0,8,12,187
4017964801,2724,2340,181,11,25,27,0,18,384
4017964802,1872,1512,225,6,34,14,4,5,360
4017964901,1047,660,208,7,108,8,2,1,387
4017964902,947,831,55,4,11,13,1,2,116
4017965201,2446,1978,250,5,101,18,0,6,468
4017965202,2763,1926,558,3,142,27,0,3,837
4017965301,1525,1200,164,11,79,14,1,0,325
4017965302,3150,2564,371,17,59,13,1,7,586
4019000100,930,560,217,48,5,46,0,6,370
4019000200,4035,1167,2308,116,83,211,0,33,2868
4019000300,1449,672,536,64,48,56,0,8,777
4019000401,2486,1610,501,56,32,104,1,15,876
4019000402,1267,779,273,56,15,76,0,3,488
4019000501,5138,3424,729,250,49,438,0,4,1714
4019000502,5876,4250,867,235,77,291,1,14,1626
4019000600,4522,3195,734,97,17,234,6,21,1327
4019000700,4981,2328,2043,160,96,135,9,17,2653
4019000800,2053,963,830,58,41,70,0,17,1090
4019001100,2591,364,2074,35,59,16,1,0,2227
4019001200,3575,565,2201,262,411,35,4,12,3010
4019001302,2089,792,881,160,89,72,8,22,1297
4019001303,2925,874,1638,135,108,85,2,11,2051
4019001304,5244,1868,2376,368,218,182,22,21,3376
4019001400,5146,2614,1414,300,79,445,6,35,2532
4019001500,5292,3316,1017,175,68,481,9,28,1976
4019001600,3608,2532,669,99,31,93,3,23,1076
4019001700,2909,1898,676,62,38,84,6,13,1011
4019001801,5540,2719,1505,608,124,148,117,35,2821
4019001802,2278,1378,547,94,46,82,0,17,900
4019001900,3850,2569,791,72,18,209,14,16,1281
4019002000,6640,1766,4296,203,112,95,4,53,4874
4019002100,6205,596,4802,461,126,75,10,15,5609
4019002201,3151,396,2528,88,53,37,1,5,2755
4019002202,3500,384,2516,331,128,46,5,24,3116
4019002300,4613,514,3527,97,356,32,3,9,4099
4019002400,5397,468,4558,80,191,23,1,17,4929
4019002503,4097,829,3022,54,98,20,6,25,3268
4019002504,5518,1303,3996,44,58,32,10,16,4215
4019002505,6876,789,5424,161,257,122,7,11,6087
4019002507,3079,521,2236,74,120,34,9,6,2558
4019002508,4896,614,3810,127,206,51,12,10,4282
4019002509,4276,587,3423,70,95,20,2,20,3689
4019002602,5199,2491,1813,302,104,227,8,28,2708
4019002603,3210,950,1494,344,166,115,8,21,2260
4019002604,3707,1330,1572,302,112,224,25,9,2377
4019002702,4992,3090,1122,196,56,279,11,34,1902
4019002703,3484,1866,980,172,90,144,15,23,1618
4019002704,2307,1168,867,79,19,45,6,19,1139
4019002801,2206,993,862,143,81,21,0,12,1213
4019002802,3885,1925,1251,293,131,81,3,28,1960
4019002803,2311,1240,675,142,32,56,22,15,1071
4019002901,5829,3239,1583,467,95,140,4,32,2590
4019002904,3448,2523,613,87,31,72,3,13,925
4019002905,4554,2615,1122,264,56,202,15,59,1939
4019002906,2266,1627,376,47,9,115,1,12,639
4019003002,4686,2913,1126,242,56,109,8,27,1773
4019003003,4523,2665,1067,350,83,87,18,30,1858
4019003004,2053,1308,420,120,21,65,12,8,745
4019003102,3900,2083,1184,297,32,89,15,33,1817
4019003103,2855,1426,895,200,68,65,46,11,1429
4019003104,2741,1396,802,257,57,101,18,13,1345
4019003201,3044,1898,809,82,22,82,15,22,1146
4019003202,2832,1463,760,273,53,88,11,14,1369
4019003302,4130,2398,1175,190,46,90,12,13,1732
4019003303,4088,2435,1036,191,35,141,27,34,1653
4019003304,3411,1758,970,244,43,208,4,18,1653
4019003400,5537,2962,1910,190,58,174,3,30,2575
4019003502,4327,1881,1559,434,59,153,8,32,2446
4019003503,4342,1573,1913,440,73,65,23,24,2769
4019003504,2884,1178,1183,210,16,130,17,11,1706
4019003505,4475,1512,2113,440,76,112,13,32,2963
4019003506,3941,1088,1954,484,133,91,16,50,2853
4019003601,4566,2431,1099,431,20,173,54,37,2135
4019003702,6997,548,6098,103,145,14,3,12,6449
4019003704,4375,286,3763,99,160,13,5,6,4089
4019003705,5315,409,4581,111,116,31,6,5,4906
4019003706,5426,548,4548,154,86,22,4,21,4878
4019003707,3679,320,3052,124,106,29,0,7,3359
4019003801,3610,234,3185,36,95,11,2,4,3376
4019003802,4839,260,4312,42,139,29,2,11,4579
4019003901,1993,92,1792,12,73,1,0,2,1901
4019003902,2676,200,2371,12,36,3,6,12,2476
4019003903,3144,235,2760,21,77,6,6,9,2909
4019004008,4799,2480,1611,303,38,101,26,40,2319
4019004010,4021,2046,1340,235,39,154,7,18,1975
4019004026,5600,3806,1100,167,31,205,1,26,1794
4019004029,4355,2221,1517,216,28,139,2,11,2134
4019004030,1820,1431,241,16,8,30,0,6,389
4019004031,4069,2887,745,121,42,106,0,17,1182
4019004032,3704,2433,752,142,32,129,7,15,1271
4019004033,4152,1842,1442,379,57,171,29,21,2310
4019004034,3667,1656,1293,347,53,102,3,12,2011
4019004035,3582,2095,906,195,29,130,15,19,1487
4019004036,3071,1619,972,194,22,88,6,13,1452
4019004037,2826,1417,980,180,11,96,4,5,1409
4019004038,3040,1544,923,266,23,117,9,18,1496
4019004039,2438,1722,438,107,26,56,2,17,716
4019004042,4966,3376,958,171,28,162,11,25,1590
4019004043,3989,2625,787,141,9,257,6,20,1364
4019004044,3958,3003,531,80,26,115,3,35,955
4019004046,4574,2926,922,274,23,183,3,30,1648
4019004047,2901,2202,428,51,12,66,7,24,699
4019004048,4577,3061,944,179,20,96,22,29,1516
4019004049,3144,2027,665,121,23,97,7,21,1117
4019004050,1901,1495,248,15,4,40,0,14,406
4019004051,5103,4182,554,32,20,83,4,22,921
4019004052,2026,1672,219,16,7,31,0,13,354
4019004053,3084,2349,485,63,21,39,1,26,735
4019004054,1496,1181,189,11,10,27,2,7,315
4019004055,3404,2461,533,92,14,113,10,15,943
4019004056,2274,1234,642,133,20,72,9,16,1040
4019004057,4768,2931,1252,220,25,132,8,14,1837
4019004058,4393,2661,1131,237,21,110,9,16,1732
4019004061,5242,3873,845,92,19,77,7,31,1369
4019004062,8543,4682,2548,451,38,283,33,37,3861
4019004063,7483,4617,1752,296,39,315,17,35,2866
4019004065,3729,2152,1056,135,34,136,9,25,1577
4019004066,2972,1737,775,162,16,93,3,14,1235
4019004067,2898,1738,713,173,18,95,0,11,1160
4019004068,4869,3190,1094,164,52,135,6,35,1679
4019004069,4060,2237,1137,328,30,89,20,16,1823
4019004070,3273,1782,876,291,35,77,14,16,1491
4019004071,4885,2981,1106,332,38,157,6,18,1904
4019004072,2461,1550,568,107,24,61,11,13,911
4019004073,6077,3389,1699,313,43,280,33,39,2688
4019004074,1885,1156,495,64,8,46,11,14,729
4019004075,2703,1504,615,257,15,98,14,13,1199
4019004076,5177,2512,1670,432,39,178,25,24,2665
4019004077,3162,2006,733,124,16,104,2,9,1156
4019004078,3263,2040,769,144,24,110,10,14,1223
4019004079,3058,2197,460,69,16,142,6,22,861
4019004080,3805,3014,457,36,8,122,1,16,791
4019004081,5402,3961,941,107,23,98,6,25,1441
4019004082,4270,2955,798,146,15,127,7,15,1315
4019004109,5908,4137,1332,48,14,53,18,36,1771
4019004110,3348,297,2851,52,31,70,1,0,3051
4019004112,2715,512,1995,88,28,28,1,0,2203
4019004114,4834,724,3979,15,33,17,4,12,4110
4019004115,6672,1080,5137,195,87,64,2,15,5592
4019004116,2593,481,1833,138,35,46,6,4,2112
4019004117,6164,917,4664,285,99,96,0,4,5247
4019004118,5274,1562,2836,406,81,162,6,27,3712
4019004122,4056,434,3143,244,120,27,0,26,3622
4019004126,7335,4548,1829,283,42,125,12,60,2787
4019004127,5516,3589,1493,88,27,78,1,18,1927
4019004128,3689,2256,1164,53,11,38,0,13,1433
4019004129,4107,3086,818,25,12,49,1,15,1021
4019004130,2411,2238,89,21,0,17,0,5,173
4019004131,6779,1681,4042,403,40,324,23,25,5098
4019004132,4643,1924,1807,385,36,189,19,19,2719
4019004133,2500,2363,74,3,6,11,0,3,137
4019004307,3389,2984,290,11,17,25,1,0,405
4019004310,2405,556,1706,24,41,25,4,10,1849
4019004311,4216,987,2909,59,117,25,2,17,3229
4019004312,5659,1149,4064,85,204,48,3,16,4510
4019004313,4529,2540,1630,34,110,25,2,22,1989
4019004316,3106,1706,1201,24,56,14,3,25,1400
4019004317,3160,2742,293,18,9,24,0,12,418
4019004320,2527,517,1858,5,92,5,0,18,2010
4019004321,4569,695,3548,78,137,41,2,4,3874
4019004322,6341,1127,4705,149,215,33,0,27,5214
4019004323,4056,1693,1860,138,25,118,23,34,2363
4019004324,3020,2804,134,9,4,18,0,2,216
4019004325,1914,1727,120,6,2,20,3,3,187
4019004326,4054,1587,2077,99,16,84,24,17,2467
4019004327,5257,2983,1808,110,56,78,14,18,2274
4019004328,3425,3246,92,10,4,18,0,4,179
4019004330,1806,1641,94,7,0,13,2,8,165
4019004332,1818,1690,74,4,8,12,0,0,128
4019004333,3894,774,2822,65,82,37,0,9,3120
4019004335,8429,3866,3611,319,66,151,9,54,4563
4019004336,4208,1972,1784,119,16,90,7,22,2236
4019004337,2360,1901,316,22,9,35,1,6,459
4019004338,1411,1309,61,1,1,11,0,3,102
4019004339,6219,1234,4313,177,229,106,14,36,4985
4019004340,6585,1276,4656,213,219,50,17,23,5309
4019004404,3500,2880,425,34,32,32,0,2,620
4019004407,5925,826,4280,339,282,44,6,14,5099
4019004412,3292,1523,1436,79,16,125,9,14,1769
4019004413,3159,1293,1517,108,28,108,2,13,1866
4019004414,3110,992,1693,99,83,115,19,11,2118
4019004415,1602,663,810,40,11,29,2,5,939
4019004418,3429,2352,765,54,16,103,1,20,1077
4019004419,5798,4144,1220,76,52,22,0,27,1654
4019004422,5711,2533,2694,167,58,98,3,11,3178
4019004423,4108,3197,640,16,44,17,9,20,911
4019004424,3857,1775,1707,31,130,13,1,29,2082
4019004425,6305,4649,1176,31,68,49,2,29,1656
4019004426,2673,1450,836,76,17,134,6,37,1223
4019004428,3187,2339,626,33,10,49,0,28,848
4019004430,3274,1644,1259,120,101,44,3,14,1630
4019004431,6579,3947,1876,186,39,149,8,47,2632
4019004432,3363,1147,1620,199,111,165,6,33,2216
4019004433,3713,1923,1408,87,22,120,1,18,1790
4019004434,3208,1520,1485,35,43,22,4,20,1688
4019004435,3618,1773,1572,75,45,42,0,17,1845
4019004436,4883,3513,923,108,23,135,2,9,1370
4019004437,3086,1712,922,92,17,184,2,16,1374
4019004438,3542,2144,948,70,14,164,1,27,1398
4019004439,3208,1904,810,91,17,252,6,7,1304
4019004440,4758,2893,1320,65,32,219,10,17,1865
4019004505,3961,1705,1886,73,46,133,5,6,2256
4019004506,5076,2216,2545,51,32,79,0,25,2860
4019004508,4331,2229,1755,99,65,63,6,14,2102
4019004510,4195,1761,1585,214,67,385,18,15,2434
4019004511,4607,1997,1921,198,95,165,16,24,2610
4019004512,4198,2061,1841,50,50,49,9,10,2137
4019004513,3151,1483,1437,49,41,54,0,5,1668
4019004514,3669,1444,1932,79,25,38,11,17,2225
4019004515,3866,1137,2248,115,47,183,2,13,2729
4019004610,6655,3556,2171,160,64,395,14,42,3099
4019004613,4017,2238,1323,136,31,92,15,12,1779
4019004614,3436,2549,621,42,20,78,4,8,887
4019004615,3377,2376,619,53,20,154,6,12,1001
4019004616,4496,2881,976,108,28,357,12,11,1615
4019004617,3249,2069,786,117,19,113,5,14,1180
4019004618,3404,2007,911,67,22,265,0,4,1397
4019004619,3413,2621,478,56,6,79,12,23,792
4019004620,1852,1281,413,25,11,34,0,14,571
4019004621,2452,1967,318,17,8,60,3,8,485
4019004622,2996,2047,669,68,13,83,3,12,949
4019004623,6316,4252,1357,154,40,267,8,22,2064
4019004624,6024,3581,1778,129,31,227,4,21,2443
4019004625,2030,1152,590,54,13,137,4,5,878
4019004626,3574,1979,1052,160,36,154,10,15,1595
4019004627,2735,1590,865,39,8,94,8,16,1145
4019004628,1245,848,262,19,8,40,10,3,397
4019004630,2162,1414,530,42,26,45,12,10,748
4019004631,3623,2320,955,80,14,87,4,10,1303
4019004632,2642,1779,596,47,14,104,0,13,863
4019004633,2989,2119,580,37,3,102,3,11,870
4019004634,1892,1325,329,27,11,84,2,22,567
4019004635,5188,4032,594,79,6,278,0,17,1156
4019004636,7100,5221,1132,93,18,286,15,18,1879
4019004639,5243,3347,1192,141,26,253,1,24,1896
4019004640,6933,5054,1005,113,20,414,1,22,1879
4019004641,3847,2912,544,71,17,145,8,14,935
4019004642,4918,3963,447,58,13,273,1,24,955
4019004643,4158,3732,226,30,7,64,1,14,426
4019004644,2579,1652,651,61,28,58,0,24,927
4019004645,5591,3358,1629,111,44,145,0,38,2233
4019004646,4688,2849,1295,108,51,152,13,17,1839
4019004647,3835,2250,1293,58,13,47,1,32,1585
4019004648,6691,4440,1606,144,28,140,21,11,2251
4019004649,1630,1333,172,14,8,39,0,4,297
4019004650,5778,4576,716,112,19,169,4,26,1202
4019004710,4323,2708,929,108,44,328,3,19,1615
4019004711,4789,3444,585,64,14,463,3,35,1345
4019004712,3393,2355,510,72,10,267,12,16,1038
4019004713,4005,3204,441,13,29,163,6,29,801
4019004714,5573,4125,752,69,5,376,2,20,1448
4019004715,4647,2966,1394,40,27,28,4,15,1681
4019004717,2231,1761,201,38,1,133,3,7,470
4019004718,2273,1570,357,40,6,139,6,17,703
4019004720,1387,1106,132,19,9,64,0,9,281
4019004721,3893,2770,610,83,26,219,3,16,1123
4019004722,2531,2077,264,5,4,85,1,7,454
4019004723,4808,3324,635,76,14,439,9,29,1484
4019004724,2507,1897,326,40,3,152,2,14,610
4019004725,2957,1894,643,93,23,143,12,14,1063
4019004726,4047,3019,543,35,6,246,1,33,1028
4019004727,2886,2166,465,34,9,50,8,7,720
4019004728,3604,2752,420,92,15,178,12,13,852
4019004729,2827,2313,230,49,8,130,6,7,514
4019004730,2935,2245,285,27,5,264,0,15,690
4019005200,3207,1677,1145,25,194,63,3,9,1530
4019005300,3871,2780,638,121,95,69,12,10,1091
4019005400,3585,1367,1798,140,95,47,4,13,2218
4019940800,3997,36,169,4,3747,0,0,0,3961
4019940900,2210,264,578,8,1315,0,2,0,1946
4019941000,3759,143,1019,8,2519,0,6,2,3616
4019941100,2421,27,94,4,2272,0,1,0,2394
4019980001,3,0,3,0,0,0,0,0,3
4019980002,1,0,0,0,0,0,0,0,1
4019980100,1918,961,473,334,133,16,1,0,957
4019980200,4855,1750,1909,942,200,23,7,0,3105
4019980300,5,0,3,0,0,0,0,0,5
4019980400,1646,574,739,230,92,9,0,0,1072
4021000201,5996,5087,530,42,35,67,2,21,909
4021000204,13220,9507,2372,345,109,219,60,68,3713
4021000206,8458,5931,1634,307,50,158,16,55,2527
4021000208,4709,2827,1278,240,58,52,22,23,1882
4021000211,5432,3043,1508,381,72,102,33,18,2389
4021000212,7918,4554,2185,520,77,148,17,36,3364
4021000215,3246,2324,704,26,37,36,5,12,922
4021000216,4786,3302,1028,136,26,46,8,11,1484
4021000217,6653,3872,2300,109,46,40,4,31,2781
4021000218,5585,3321,1561,242,39,143,10,25,2264
4021000219,3353,2105,905,138,25,41,11,21,1248
4021000220,3914,2517,918,184,39,52,12,15,1397
4021000221,5751,3603,1340,351,76,119,15,15,2148
4021000222,6462,3812,1757,368,61,160,16,15,2650
4021000223,5045,3057,1300,240,18,126,19,20,1988
4021000224,7934,4690,2123,417,96,180,11,44,3244
4021000225,2886,1786,726,102,30,89,15,4,1100
4021000226,6855,4030,1849,380,50,111,26,46,2825
4021000227,4377,2654,1083,258,48,69,14,22,1723
4021000228,2130,1323,449,169,14,28,7,15,807
4021000229,5567,3874,1027,247,32,94,32,19,1693
4021000307,2568,2160,206,14,9,36,2,16,408
4021000309,3118,2543,370,20,23,23,5,5,575
4021000310,3183,2618,380,17,55,21,3,3,565
4021000311,2877,2414,275,17,9,26,2,9,463
4021000312,3850,2483,1056,36,34,59,6,24,1367
4021000313,4733,3682,788,30,49,41,13,6,1051
4021000315,5072,3792,866,80,43,36,10,13,1280
4021000316,7422,6645,431,45,23,59,4,26,777
4021000317,2394,2056,242,11,14,12,0,5,338
4021000319,1677,1608,21,11,3,2,0,1,69
4021000320,2130,1699,320,10,21,7,0,11,431
4021000321,3444,2565,668,37,25,14,5,2,879
4021000322,3238,2146,819,49,31,44,2,21,1092
4021000323,2035,1654,281,10,14,22,0,5,381
4021000324,4905,3854,733,79,28,51,1,14,1051
4021000325,2187,1679,338,24,18,40,2,8,508
4021000400,2418,670,1646,23,17,12,2,2,1748
4021000603,6079,5081,665,49,25,96,6,20,998
4021000604,4731,4486,99,20,6,30,0,0,245
4021000700,3114,1442,1510,12,27,10,5,22,1672
4021000802,5548,4447,756,65,55,44,7,20,1101
4021000804,1963,1412,449,10,11,38,3,5,551
4021000805,5715,4196,917,206,47,82,4,30,1519
4021000806,6583,4091,1577,423,79,107,14,19,2492
4021000807,3069,1336,1100,389,116,29,6,1,1733
4021000808,6168,2434,2409,880,364,22,11,4,3734
4021000902,2240,1041,883,113,69,16,0,8,1199
4021000903,6544,3027,1982,342,541,5,5,0,3517
4021000904,875,397,380,30,22,10,0,2,478
4021001000,4802,1660,2299,454,179,38,4,21,3142
4021001100,8146,3545,3309,615,235,57,5,44,4601
4021001200,4173,2410,1296,182,80,21,5,18,1763
4021001303,1490,982,387,7,38,17,0,7,508
4021001305,6307,3246,2366,234,162,84,15,13,3061
4021001306,5819,2332,2570,304,199,129,48,29,3487
4021001307,5238,2969,1610,248,120,90,10,7,2269
4021001308,2465,774,1458,58,65,28,3,7,1691
4021001309,5565,2458,2311,263,77,209,7,24,3107
4021001310,5082,2651,1733,235,121,121,7,26,2431
4021001403,4681,1788,2141,223,280,60,21,18,2893
4021001404,4009,1769,1782,158,70,97,0,14,2240
4021001405,3890,2562,913,151,59,72,17,10,1328
4021001406,4874,1388,2747,293,203,36,18,15,3486
4021001407,1795,919,700,37,42,33,1,2,876
4021001408,2872,2180,482,75,19,40,8,2,692
4021001500,3270,738,2114,155,149,17,9,7,2532
4021001600,5373,2394,2597,98,118,20,1,15,2979
4021001701,886,498,299,23,27,9,0,5,388
4021001704,7461,3294,2266,1095,85,223,34,46,4167
4021001705,7885,4091,1953,874,139,265,38,58,3794
4021001706,5494,2846,1393,598,90,195,38,35,2648
4021001707,4289,1831,1286,632,80,151,31,15,2458
4021001709,7624,3737,2200,885,148,191,55,48,3887
4021001712,5168,2365,1585,589,153,94,15,52,2803
4021001713,3087,1389,1033,374,68,53,9,19,1698
4021001714,4621,1926,1576,663,98,87,11,17,2695
4021001715,4773,2440,1380,475,73,139,20,21,2333
4021001716,5408,2762,1404,648,102,165,35,27,2646
4021001717,2343,2068,100,68,7,46,1,13,275
4021001900,2415,798,1237,194,51,32,11,19,1617
4021002001,4394,2544,1561,89,66,23,4,3,1850
4021002004,3918,483,2971,225,168,5,2,6,3435
4021002005,6407,1175,3520,616,113,180,104,24,5232
4021002104,4218,2443,1324,175,89,27,6,12,1775
4021002105,5365,2709,2020,252,96,36,0,24,2656
4021002106,1042,525,415,17,41,9,0,6,517
4021002107,3180,1943,957,60,29,38,4,15,1237
4021002200,4068,2105,1719,8,43,21,9,22,1963
4021002300,2109,1181,815,12,13,8,0,8,928
4021002400,1420,452,906,3,15,4,2,5,968
4021941200,7117,74,833,9,6094,3,0,1,7043
4021941300,3381,21,404,5,2908,2,0,0,3360
4021941401,4806,2174,1616,46,735,21,0,35,2632
4021941402,2377,490,1201,33,593,20,0,5,1887
4023966000,2965,2202,635,7,7,10,3,9,763
4023966101,3068,1894,1058,15,24,17,2,12,1174
4023966103,1209,53,1140,4,0,4,0,4,1156
4023966106,2091,246,1799,6,7,15,2,6,1845
4023966107,1647,230,1366,9,0,24,0,6,1417
4023966108,6249,283,5857,16,6,52,3,15,5966
4023966109,3261,866,2315,13,8,17,0,14,2395
4023966110,1547,114,1429,0,1,0,0,0,1433
4023966111,6011,573,5360,4,6,19,2,21,5438
4023966200,4751,162,4474,16,3,74,0,9,4589
4023966301,4243,211,3975,9,13,15,0,10,4032
4023966302,3379,85,3264,1,0,4,0,22,3294
4023966401,3230,85,3108,7,0,1,1,11,3145
4023966402,4018,115,3852,7,3,19,0,11,3903
4025000205,1423,1186,142,5,12,16,2,2,237
4025000206,5103,4280,478,21,22,32,12,40,823
4025000207,1709,1392,198,1,21,6,1,3,317
4025000208,1796,1146,527,11,22,5,5,4,650
4025000209,6439,4953,1022,30,45,62,8,26,1486
4025000210,1527,1184,216,8,20,15,2,13,343
4025000211,6231,4480,1310,15,50,29,0,21,1751
4025000301,5195,4198,470,53,30,193,6,28,997
4025000302,1350,1158,87,1,11,13,3,6,192
4025000403,1413,1088,193,12,24,16,6,9,325
4025000404,2223,1843,203,6,14,75,0,6,380
4025000405,3658,3175,245,22,17,67,2,21,483
4025000406,1946,1633,172,2,12,37,2,2,313
4025000407,3770,3215,236,16,20,89,6,22,555
4025000501,1537,1189,193,15,15,27,2,8,348
4025000502,3947,3189,380,8,127,64,2,24,758
4025000604,5016,3648,950,41,57,71,7,18,1368
4025000608,3543,2462,845,23,26,31,2,10,1081
4025000609,4869,2882,1682,26,65,39,3,9,1987
4025000611,1516,875,498,4,26,8,3,1,641
4025000612,1766,916,704,4,18,24,0,15,850
4025000613,8626,6628,1242,100,54,200,17,38,1998
4025000614,1537,806,607,22,8,23,3,2,731
4025000615,5699,3774,1382,54,66,106,19,23,1925
4025000616,2015,1547,349,18,13,20,4,1,468
4025000617,3168,2530,447,20,32,18,4,12,638
4025000618,1719,1455,119,14,12,55,3,8,264
4025000619,4451,3735,439,26,25,46,5,28,716
4025000701,2236,1922,161,8,26,13,9,8,314
4025000702,2197,1686,329,6,80,12,2,11,511
4025000802,3754,3149,302,39,40,41,1,23,605
4025000803,1228,968,153,11,13,25,0,10,260
4025000804,2587,2256,171,14,13,24,4,10,331
4025000901,1228,912,209,15,26,16,3,10,316
4025000902,3240,2392,588,46,67,27,6,10,848
4025001002,3765,3231,306,19,22,36,2,13,534
4025001003,1343,1104,137,8,11,22,0,3,239
4025001004,3659,3178,266,19,17,21,4,9,481
4025001103,1354,1199,90,6,0,17,0,7,155
4025001104,2990,2563,221,15,16,30,1,18,427
4025001105,1821,1623,117,2,6,10,0,0,198
4025001106,2281,1903,234,16,21,9,0,17,378
4025001201,3239,2881,185,10,11,24,0,25,358
4025001202,4127,3617,288,12,20,21,1,38,510
4025001300,2191,1409,575,4,52,37,2,14,782
4025001401,2410,1973,204,15,29,15,2,15,437
4025001402,3980,3485,244,15,27,29,2,26,495
4025001403,3427,2819,369,24,26,19,0,11,608
4025001501,2309,1969,184,6,19,28,0,3,340
4025001502,4416,3615,462,17,27,21,9,29,801
4025001601,6837,4282,1241,51,860,49,3,13,2555
4025001602,4156,3212,643,12,67,17,8,21,944
4025001604,1689,1136,373,6,27,20,0,9,553
4025001605,4712,3578,635,14,217,29,6,18,1134
4025001701,6013,4805,788,40,53,57,8,32,1208
4025001703,2595,2099,279,22,34,53,5,14,496
4025001704,1106,932,114,1,5,13,0,0,174
4025001705,3533,3042,240,22,22,78,5,17,491
4025001801,3259,2687,305,19,27,72,0,24,572
4025001803,1843,1363,348,10,7,51,2,9,480
4025001804,2819,2200,417,16,11,67,1,16,619
4025001901,2383,1798,282,12,155,15,4,12,585
4025001902,3678,2926,419,34,66,40,6,20,752
4025001903,6362,5338,599,38,38,105,9,20,1024
4025001904,6574,5453,699,41,28,53,1,22,1121
4025002001,5190,3325,1526,36,67,34,2,27,1865
4025002002,5195,3174,1629,40,65,30,10,34,2021
4025002003,4070,2833,911,36,37,38,4,29,1237
4025002005,1964,1709,164,4,10,12,0,2,255
4025002006,1593,1226,272,4,8,15,6,2,367
4025002007,5333,4057,967,31,32,56,12,12,1276
4025002100,2331,1700,408,21,50,14,0,8,631
4027000100,2093,478,1442,55,63,13,2,2,1615
4027000200,3082,529,2337,73,54,13,0,15,2553
4027000301,2922,379,2383,80,18,8,0,13,2543
4027000302,3557,369,3012,87,40,9,1,4,3188
4027000402,3704,306,3322,6,21,6,7,4,3398
4027000403,1324,312,921,39,13,8,3,2,1012
4027000404,4024,681,3183,45,51,10,0,11,3343
4027000501,2619,1046,1309,73,19,63,5,11,1573
4027000502,2507,1113,1236,37,16,23,5,24,1394
4027000600,5096,1369,3368,118,64,42,1,7,3727
4027000700,3859,487,3181,75,30,15,2,19,3372
4027000800,4935,1483,3026,128,50,116,2,6,3452
4027000901,3431,1162,2060,53,23,48,1,12,2269
4027000902,2859,855,1728,76,22,67,4,12,2004
4027000903,3485,1110,2136,59,37,74,7,6,2375
4027000907,6615,1291,4770,160,35,172,19,38,5324
4027000908,4648,1461,2670,90,22,231,18,16,3187
4027000909,5456,709,4467,69,30,107,0,22,4747
4027000910,2786,637,1892,62,17,121,7,7,2149
4027001001,2649,1422,1065,38,9,57,0,14,1227
4027001003,1341,463,772,45,4,17,3,3,878
4027001004,2167,596,1359,60,49,37,0,8,1571
4027001100,4871,1605,2867,103,76,73,1,19,3266
4027001200,4081,1535,2252,38,34,51,6,29,2546
4027010907,5428,3280,1702,97,41,99,17,25,2148
4027010910,1769,1507,198,0,10,2,0,4,262
4027010911,6700,2677,3472,122,41,124,9,47,4023
4027010913,1173,333,785,7,19,7,0,2,840
4027010914,533,303,194,5,8,7,3,0,230
4027010915,2081,1216,760,9,1,16,2,8,865
4027010916,833,455,358,7,0,1,0,0,378
4027011000,1612,622,869,7,64,19,0,3,990
4027011107,3061,1579,1184,38,32,61,4,37,1482
4027011108,3700,1912,1476,90,18,77,6,29,1788
4027011112,2610,2158,352,2,19,15,1,2,452
4027011114,1828,1446,293,10,11,10,0,0,382
4027011116,1635,877,657,15,15,19,0,4,758
4027011117,3651,1255,2203,43,26,40,0,3,2396
4027011118,1238,1050,136,1,7,11,0,0,188
4027011119,2155,1588,411,9,30,27,7,10,567
4027011120,1692,1140,475,26,2,15,2,3,552
4027011121,6467,2707,3243,103,45,118,23,25,3760
4027011122,1440,950,364,7,14,13,5,10,490
4027011123,1454,914,471,6,7,5,0,2,540
4027011124,1682,1408,198,6,6,13,0,4,274
4027011125,1672,1425,160,15,11,12,2,0,247
4027011202,1106,564,502,9,2,4,3,0,542
4027011203,1423,683,686,7,7,4,1,5,740
4027011204,1753,1190,472,18,8,11,0,9,563
4027011403,3940,42,3871,8,1,5,1,8,3898
4027011405,4535,53,4472,0,1,1,1,3,4482
4027011407,6872,49,6790,2,2,2,2,13,6823
4027011408,3810,42,3743,2,5,0,1,6,3768
4027011501,2007,227,1348,9,381,9,0,2,1780
4027011503,5386,137,5197,7,20,14,0,0,5249
4027011505,4480,75,4366,7,6,4,1,2,4405
4027011506,3958,68,3866,6,0,10,0,3,3890
4027011601,4797,25,4747,1,1,0,0,14,4772
4027011602,3571,29,3525,0,4,0,0,10,3542
4027011700,1313,857,389,13,4,15,0,1,456
4027011801,9640,2447,5630,887,201,33,8,9,7193
4027011802,3083,322,2700,12,7,6,8,4,2761
4027012100,725,312,305,23,7,25,0,7,413
4027980003,0,0,0,0,0,0,0,0,0
4027980004,5,1,1,0,0,0,0,0,4
4027980005,503,352,146,2,0,2,0,0,151
4027980006,2449,1448,528,177,7,84,14,4,1001
5001480100,1224,1063,13,102,5,1,0,3,161
5001480200,1527,1334,14,130,8,0,0,0,193
5001480300,2698,1518,126,897,3,46,2,5,1180
5001480400,2216,635,52,1444,4,6,4,5,1581
5001480500,3821,2487,252,861,10,18,2,15,1334
5001480600,1700,1459,46,128,0,10,0,0,241
5001480700,2727,1979,100,507,4,13,1,7,748
5001480800,1236,1100,33,69,0,0,0,0,136
5003960100,1488,860,134,447,2,1,0,1,628
5003960200,2449,2101,122,154,7,4,0,8,348
5003960300,4303,2775,597,797,1,5,3,2,1528
5003960400,1507,989,30,442,2,1,1,0,518
5003960500,2447,1953,59,361,0,3,0,3,494
5003960600,5089,2865,138,1899,10,24,2,6,2224
5003960700,1779,1142,34,544,3,3,0,12,637
5005950100,4528,4124,158,9,24,18,0,12,404
5005950200,4761,4320,137,19,28,41,1,19,441
5005950300,5087,4559,176,16,17,90,0,17,528
5005950400,3384,3135,67,10,13,11,0,3,249
5005950500,5110,4721,98,12,28,17,2,14,389
5005950600,3811,3485,97,3,22,13,3,13,326
5005950700,3356,3079,82,6,19,6,2,3,277
5005950801,4236,3946,91,1,19,17,0,5,290
5005950802,1847,1722,25,4,14,4,1,3,125
5005950900,5507,4958,127,8,34,17,0,5,549
5007020102,7651,5985,865,55,62,140,5,29,1666
5007020103,5061,4196,419,34,53,28,4,10,865
5007020104,1710,1434,102,6,15,0,1,8,276
5007020201,4999,2702,1819,56,36,42,108,12,2297
5007020203,3031,2205,574,10,31,17,33,15,826
5007020205,6353,2266,3526,58,45,44,193,20,4087
5007020206,7335,2220,4498,68,52,100,182,30,5115
5007020301,4305,1799,2064,72,48,23,117,14,2506
5007020302,4298,1871,1819,91,48,118,130,15,2427
5007020304,4380,2813,901,74,38,259,37,13,1567
5007020305,4068,2154,1516,37,26,138,22,8,1914
5007020401,7286,4635,1953,111,64,127,51,30,2651
5007020402,4687,2505,1737,47,47,57,35,23,2182
5007020404,4953,2249,2138,54,45,114,114,14,2704
5007020405,5479,3985,659,136,27,374,10,16,1494
5007020501,5336,3906,452,69,45,541,7,20,1430
5007020503,4727,2287,593,126,31,1396,54,22,2440
5007020504,2819,1830,478,50,32,230,8,4,989
5007020604,4571,3231,613,112,60,232,20,9,1340
5007020605,4485,3526,368,105,43,129,1,17,959
5007020606,4299,3511,261,71,45,103,0,16,788
5007020607,9451,4830,632,313,76,3114,19,54,4621
5007020608,3259,1938,364,179,43,499,19,6,1321
5007020701,5783,4934,370,34,72,36,16,7,849
5007020703,5103,4427,243,45,52,46,3,11,676
5007020704,4670,3997,238,52,44,32,6,4,673
5007020801,4604,4182,138,12,41,22,0,15,422
5007020803,4653,4040,221,42,35,35,0,20,613
5007020805,4873,4245,208,42,46,38,2,11,628
5007020806,6750,5675,371,85,72,121,3,21,1075
5007020903,5310,3296,763,349,42,466,28,28,2014
5007020904,6043,4278,832,189,89,252,12,19,1765
5007020905,3071,2553,154,9,94,19,5,7,518
5007020906,5514,4059,724,121,82,130,0,14,1455
5007021001,5265,4146,358,19,167,122,7,25,1119
5007021003,3291,2032,644,17,114,188,41,7,1259
5007021004,4006,2891,485,19,148,101,0,7,1115
5007021101,5151,2769,1571,35,261,113,5,14,2382
5007021102,3498,1985,942,31,128,78,7,4,1513
5007021201,4894,3341,817,56,137,113,15,14,1553
5007021202,3521,2016,905,30,163,50,1,11,1505
5007021304,12149,7459,1267,420,89,2065,59,64,4690
5007021305,7458,5404,921,163,103,225,34,21,2054
5007021306,4625,3689,380,70,27,224,1,13,936
5007021308,6511,5180,487,150,20,242,6,11,1331
5007021312,4051,3088,440,13,169,102,0,5,963
5007021313,3304,2263,467,42,167,78,11,8,1041
5007021314,3751,2676,576,78,24,121,46,7,1075
5007021315,6275,4183,1292,76,66,219,67,15,2092
5007021316,7193,5671,715,124,55,124,16,15,1522
5007021317,3681,2857,424,46,35,58,56,8,824
5007021404,3813,2817,633,21,50,30,0,9,996
5007021405,2020,1717,109,4,22,6,2,9,303
5007021406,5918,2670,1989,107,37,191,638,6,3248
5007021407,4587,3974,238,9,37,30,13,17,613
5007021408,5920,2941,2184,76,63,83,328,9,2979
5007021409,2534,2228,83,3,36,17,0,0,306
5009790100,6858,6266,136,9,44,40,4,7,592
5009790200,6047,5535,117,12,58,19,2,20,512
5009790300,5538,5084,89,11,42,19,2,8,454
5009790400,6158,5637,150,9,38,16,5,10,521
5009790501,4030,3547,158,13,19,74,3,5,483
5009790502,3938,3453,147,6,28,26,9,10,485
5009790600,4804,4231,176,36,36,39,2,22,573
5011950100,2615,1442,345,728,8,7,0,7,1173
5011950200,1914,1011,241,602,10,0,0,1,903
5011950300,1975,897,319,729,0,6,0,0,1078
5011950400,1586,703,345,473,5,13,0,4,883
5011950500,2455,1655,325,389,6,1,0,1,800
5013480100,2242,1620,65,474,0,2,1,2,622
5013480200,2497,1879,62,439,3,3,8,2,618
5015950100,2978,2547,159,13,39,29,0,19,431
5015950201,3496,3149,102,15,40,23,1,10,347
5015950202,2921,2561,162,14,33,13,0,14,360
5015950301,3517,2221,873,11,25,78,114,28,1296
5015950302,3661,2384,849,8,28,57,187,2,1277
5015950400,4260,3587,386,9,34,18,8,3,673
5015950501,2181,1920,70,8,14,5,1,4,261
5015950502,5246,2806,1705,10,40,341,121,14,2440
5017080100,3331,2331,329,537,11,6,5,11,1000
5017080200,2144,389,31,1644,8,10,0,7,1755
5017080300,2634,918,146,1480,4,22,0,1,1716
5017080400,2099,249,75,1726,3,0,4,6,1850
5019953601,4915,2899,198,1491,19,59,9,57,2016
5019953602,4129,3074,205,633,17,43,5,12,1055
5019953700,4115,3475,149,291,17,8,0,6,640
5019953800,3544,1739,146,1435,9,37,1,10,1805
5019953901,1831,1301,44,388,3,2,0,2,530
5019953902,2912,1605,350,830,11,1,1,0,1307
5021950100,1874,1778,24,3,4,1,0,2,96
5021950200,2047,1936,23,6,11,4,0,0,111
5021950300,1699,1579,27,1,0,1,2,1,120
5021950400,3182,2950,78,5,10,5,0,1,232
5021950500,2028,1851,63,12,12,1,3,1,177
5021950600,3722,3480,112,13,7,2,0,15,242
5023480100,3913,3590,110,6,15,8,2,7,323
5023480201,1452,1334,24,11,8,4,1,7,118
5023480203,2423,2296,27,0,13,12,0,3,127
5023480204,934,871,14,1,2,1,5,0,63
5023480301,2060,1838,73,10,6,16,0,0,222
5023480302,2994,2757,75,12,12,18,0,3,237
5023480400,4319,3954,135,7,27,22,0,4,365
5023480501,2944,2682,113,5,10,9,3,9,262
5023480502,3672,3426,61,4,19,6,0,17,246
5025970100,4135,3427,97,454,12,4,1,7,708
5025970200,3415,3002,85,221,9,3,0,5,413
5027950100,3907,2755,131,881,24,12,0,6,1152
5027950200,4110,2247,64,1645,1,8,0,12,1863
5027950301,1298,1131,17,112,0,0,0,0,167
5027950302,3460,2467,102,761,17,5,0,1,993
5027950401,4604,3184,179,976,16,85,0,47,1420
5027950402,2189,829,113,1130,7,32,0,3,1360
5027950500,3233,623,167,2329,6,21,0,2,2610
5029950100,4975,4294,154,257,26,12,1,1,681
5029950200,3341,2920,59,98,20,7,4,0,421
5029950300,5453,3753,358,880,32,27,1,10,1700
5029950400,2429,1797,118,317,23,14,2,10,632
5029950500,2613,1681,138,632,17,22,0,1,932
5029950600,1904,1703,59,6,18,7,0,0,201
5031000101,3700,2167,285,1012,15,16,4,6,1533
5031000102,3718,2427,306,740,6,40,0,18,1291
5031000200,4115,2131,389,1300,8,26,2,19,1984
5031000300,7044,5010,422,1196,11,40,5,27,2034
5031000401,6540,4122,456,1515,16,93,0,23,2418
5031000403,4797,2252,504,1757,8,76,6,24,2545
5031000404,4832,2772,244,1460,14,129,17,18,2060
5031000501,8250,6736,274,708,8,98,4,35,1514
5031000502,6517,4101,608,1405,9,66,3,11,2416
5031000601,7054,3607,519,2409,17,182,2,17,3447
5031000602,6117,2700,755,2050,20,325,1,8,3417
5031000701,4002,3404,251,139,8,2,0,8,598
5031000702,3763,2381,351,825,15,7,0,12,1382
5031000803,6004,4886,233,308,13,303,1,9,1118
5031000804,2870,2532,90,69,6,90,1,0,338
5031000805,3566,2378,113,808,12,118,1,5,1188
5031000806,3984,3489,140,153,10,45,3,8,495
5031000900,5713,5207,112,133,23,9,4,5,506
5031001000,4008,3671,218,16,7,1,0,4,337
5031001101,4785,4432,78,53,17,5,0,8,353
5031001102,5014,4450,189,161,13,11,0,2,564
5031001200,4838,4282,190,114,14,2,0,11,556
5033020101,2678,2377,77,6,56,4,1,6,301
5033020102,2703,2343,54,1,72,7,2,8,360
5033020204,5343,4318,350,54,132,130,2,10,1025
5033020205,3215,2710,74,12,81,14,2,4,505
5033020206,2068,1722,62,3,50,9,1,6,346
5033020207,4032,3174,277,50,97,54,8,4,858
5033020208,3838,2742,469,84,72,169,0,7,1096
5033020301,4484,3377,445,75,141,99,0,13,1107
5033020302,3925,3100,305,68,103,41,2,16,825
5033020401,4817,3819,358,50,131,50,1,13,998
5033020402,4474,3967,121,43,63,12,2,4,507
5033020501,4101,2202,1126,126,88,253,5,5,1899
5033020502,4588,3410,504,148,106,29,0,15,1178
5033020601,2574,2260,55,13,49,20,1,5,314
5033020602,7293,6106,290,124,125,48,0,10,1187
5035030101,1991,105,47,1775,2,12,0,5,1886
5035030102,2805,161,40,2562,5,7,0,4,2644
5035030201,5355,3153,275,1678,12,15,3,14,2202
5035030202,3400,2278,51,884,9,42,0,6,1122
5035030301,3034,682,55,2228,3,5,3,5,2352
5035030302,2741,324,51,2296,10,2,0,4,2417
5035030503,1400,26,12,1314,4,0,1,0,1374
5035030601,759,302,15,416,4,0,0,0,457
5035030602,3696,1222,73,2262,9,21,2,0,2474
5035030701,886,585,43,223,3,2,0,0,301
5035030702,879,200,26,616,2,1,0,6,679
5035030703,906,607,95,136,5,4,1,3,299
5035030803,1975,1127,61,681,2,39,0,4,848
5035030804,4335,1761,188,2160,16,73,0,10,2574
5035030805,3396,1981,103,1108,7,54,1,13,1415
5035030806,4209,2599,130,1264,6,33,4,9,1610
5035030807,1682,786,47,776,0,4,1,4,896
5035031000,1211,642,70,451,11,1,0,0,569
5035031100,2080,367,33,1636,1,5,1,0,1713
5035031200,1423,40,13,1338,4,2,0,2,1383
5037950100,1058,417,24,573,3,0,0,1,641
5037950200,3150,2799,46,168,13,2,4,9,351
5037950300,1355,1282,29,0,0,0,0,1,73
5037950400,2451,2151,39,176,0,3,0,7,300
5037950500,4408,2011,111,2076,7,22,0,21,2397
5037950600,4411,3407,103,658,15,75,1,4,1004
5039970100,1185,774,20,339,4,2,0,5,411
5039970200,1573,1190,56,278,5,0,0,8,383
5039970300,3724,1461,125,1965,5,5,0,12,2263
5041950100,1342,947,71,273,4,0,0,3,395
5041950200,4119,1601,458,1870,7,27,0,9,2518
5041950300,1247,81,44,1085,1,3,0,0,1166
5041950400,2792,1049,96,1498,20,24,0,4,1743
5041950500,1895,1054,104,659,4,7,0,0,841
5043490100,2230,1728,84,344,7,3,0,6,502
5043490200,2195,916,63,1122,7,3,3,9,1279
5043490300,5952,3693,236,1699,45,79,5,13,2259
5043490400,3076,1820,142,968,5,11,0,13,1256
5043490500,3897,2991,131,682,4,4,1,14,906
5045030101,3310,2790,77,186,23,14,0,3,520
5045030102,5990,5312,212,71,22,21,2,4,678
5045030103,3741,3388,96,31,13,12,3,13,353
5045030104,5576,5024,134,70,36,22,3,4,552
5045030201,3235,2894,81,14,39,5,0,4,341
5045030202,2847,2579,56,17,26,7,0,11,268
5045030301,5944,4809,346,447,27,31,0,7,1135
5045030302,6189,5411,228,65,42,30,2,23,778
5045030303,4810,4217,252,46,28,14,4,21,593
5045030401,2580,1991,76,276,14,37,3,16,589
5045030402,4136,3458,210,162,24,21,2,10,678
5045030403,3954,2335,193,1084,22,96,5,27,1619
5045030404,2631,1621,179,622,7,38,4,14,1010
5045030502,4989,3001,395,1198,14,78,3,25,1988
5045030503,4825,3416,204,838,15,133,0,8,1409
5045030504,7257,5525,266,899,17,212,1,13,1732
5045030600,5336,4056,201,636,11,39,0,22,1280
5045030701,3541,2109,336,844,12,44,5,8,1432
5045030702,3660,2063,340,982,19,34,3,17,1597
5045030800,6249,3997,323,768,20,129,6,62,2252
5045030900,3908,1904,624,968,22,60,4,20,2004
5045031001,4033,2751,449,536,6,47,1,19,1282
5045031003,2441,1531,303,428,10,16,1,5,910
5045031006,4066,2710,182,856,20,59,6,12,1356
5045031007,3797,2610,218,633,14,111,0,14,1187
5045031008,4773,3505,210,707,23,126,0,6,1268
5045031101,4780,3817,447,226,16,11,3,16,963
5045031102,4900,3749,152,664,20,14,0,14,1151
5047950100,3520,3180,61,21,36,26,0,5,340
5047950201,3112,2796,90,9,28,11,3,2,316
5047950202,3570,3094,173,15,44,27,1,9,476
5047950301,3867,3469,90,8,45,83,6,10,398
5047950302,3028,2662,77,25,46,15,0,4,366
5049550101,3338,3133,33,4,22,13,0,7,205
5049550102,2406,2214,43,7,11,5,0,1,192
5049550201,3379,3073,52,9,16,7,0,8,306
5049550202,2952,2781,26,7,17,10,0,0,171
5051010301,4163,3178,393,218,29,12,8,8,985
5051010302,1875,1560,115,17,18,6,7,1,315
5051010401,3903,3554,134,52,17,20,0,9,349
5051010402,3762,3262,149,44,23,21,1,13,500
5051010501,4299,3697,187,133,12,30,2,5,602
5051010502,2196,1885,126,25,19,4,0,7,311
5051010601,1537,1284,107,30,6,5,2,4,253
5051010602,2253,758,224,1049,11,6,3,7,1495
5051010700,1552,1017,137,250,20,8,0,5,535
5051010800,2248,1496,110,420,16,45,0,4,752
5051010900,3356,2110,325,546,29,25,7,9,1246
5051011001,3728,2954,300,215,19,48,1,13,774
5051011002,1887,1316,283,101,21,6,1,5,571
5051011101,4832,4221,228,43,43,18,0,8,611
5051011102,4131,3643,128,69,39,18,6,7,488
5051011201,5244,4366,299,204,25,51,0,23,878
5051011202,3891,3146,259,175,19,43,4,7,745
5051011300,4726,2867,656,846,25,41,5,22,1859
5051011400,3373,1620,568,757,34,17,2,23,1753
5051011500,2135,946,209,771,21,18,0,7,1189
5051011601,6242,4825,455,506,31,98,7,28,1417
5051011602,5178,4236,308,222,25,90,0,6,942
5051011701,3316,2406,222,410,17,96,2,11,910
5051011702,1206,608,276,218,3,1,2,3,598
5051011801,2014,1466,149,218,10,64,0,3,548
5051011802,2265,1883,128,124,10,28,2,6,382
5051011901,3538,2850,191,200,28,67,3,5,688
5051011902,2564,2247,100,41,8,19,3,19,317
5051012001,4952,4428,150,53,32,35,0,18,524
5051012002,3814,3410,131,77,13,20,3,11,404
5053470100,5035,4558,71,160,16,11,0,2,477
5053470200,3230,2983,58,12,18,12,0,1,247
5053470300,3774,3340,169,113,8,5,0,3,434
5053470401,3585,3190,89,106,19,33,1,7,395
5053470402,2334,2095,53,56,9,15,0,2,239
5055480100,2929,2745,57,7,4,2,0,7,184
5055480200,4615,4310,78,16,10,7,0,5,305
5055480300,3177,2973,49,11,13,2,2,5,204
5055480401,4506,4037,132,134,11,24,11,6,469
5055480402,3083,2551,182,118,7,3,60,8,532
5055480501,3680,3040,176,187,9,11,77,6,640
5055480502,3542,2858,247,156,33,8,26,13,684
5055480601,3231,2998,40,7,9,7,2,8,233
5055480602,4528,4173,129,31,8,12,3,13,355
5055480700,2092,1641,202,52,17,2,18,7,451
5055480801,5213,4713,141,95,8,31,26,11,500
5055480802,5140,4470,163,112,9,72,62,15,670
5057480101,2052,1453,222,244,11,31,0,0,599
5057480102,2785,2068,258,312,8,8,1,12,717
5057480200,2156,1218,119,718,24,10,0,4,938
5057480301,2121,293,404,1339,8,1,0,5,1828
5057480302,3064,1307,622,995,9,12,0,16,1757
5057480400,3730,3024,176,361,13,15,0,7,706
5057480500,4157,1195,1152,1675,8,11,4,0,2962
5059020101,4071,3738,76,19,19,1,2,3,333
5059020102,3411,3027,66,96,6,5,0,7,384
5059020200,2903,1469,135,1128,8,10,0,8,1434
5059020300,1914,1305,156,348,12,0,2,4,609
5059020400,5350,3431,313,1125,27,34,2,26,1919
5059020500,5701,4638,152,678,23,18,4,8,1063
5059020600,3577,3308,57,18,16,8,0,6,269
5059020701,2386,2022,132,26,30,14,0,4,364
5059020702,3727,3283,178,12,24,24,1,9,444
5061950100,3722,3258,183,68,54,0,0,2,464
5061950200,4739,2721,522,1296,20,18,1,11,2018
5061950300,4324,2003,812,1262,8,44,3,8,2321
5063490101,2687,2463,80,14,11,7,0,1,224
5063490102,3578,3248,127,43,13,12,0,6,330
5063490200,2619,1907,384,126,9,38,4,12,712
5063490300,6338,4710,931,268,21,102,15,18,1628
5063490400,4545,4092,160,28,25,12,4,9,453
5063490500,3074,2644,188,41,7,70,1,11,430
5063490600,2909,1603,875,202,9,57,1,11,1306
5063490701,3631,3242,139,42,14,12,3,9,389
5063490702,3629,3068,256,46,6,23,0,5,561
5063490800,4928,4534,118,20,18,7,2,11,394
5065960100,3301,2957,105,11,23,10,6,7,344
5065960200,4783,4341,96,26,15,12,0,25,442
5065960300,3080,2674,71,209,20,5,0,0,406
5065960400,2413,2203,54,10,15,0,3,1,210
5067480100,3175,2895,51,107,7,1,0,6,280
5067480200,3429,2078,122,1032,20,12,1,8,1351
5067480300,4059,2830,164,830,11,37,0,17,1229
5067480401,1475,1248,41,109,4,2,3,2,227
5067480402,2941,2157,56,678,0,8,0,5,784
5067480500,1676,1546,27,8,1,3,0,12,130
5069000102,1645,843,46,725,1,4,0,0,802
5069000301,3139,2583,37,382,15,6,6,4,556
5069000302,5927,4360,145,891,27,266,20,32,1567
5069000303,3484,1805,152,1302,12,56,20,4,1679
5069000502,2906,95,22,2725,0,16,3,7,2811
5069000900,2774,189,25,2518,3,0,0,6,2585
5069001000,1289,215,33,992,5,0,0,5,1074
5069001200,1668,113,14,1503,3,0,0,3,1555
5069001300,1333,22,13,1262,1,1,0,0,1311
5069001401,1416,214,25,1066,12,15,35,7,1202
5069001402,2117,152,14,1890,4,16,0,2,1965
5069001501,3394,302,37,2966,7,17,0,11,3092
5069001502,3289,320,45,2775,4,45,1,15,2969
5069001600,2604,148,51,2316,17,4,0,10,2456
5069001700,2116,62,25,1988,1,1,0,1,2054
5069001800,3096,692,60,2198,14,54,1,4,2404
5069001901,1354,478,33,791,7,8,0,3,876
5069001903,2086,132,25,1894,5,0,0,1,1954
5069002000,5573,2528,62,2748,21,59,0,19,3045
5069002103,5144,2944,165,1854,17,41,4,7,2200
5069002104,3782,2580,102,902,6,25,0,15,1202
5069002300,2227,794,143,1243,4,6,0,1,1433
5069002400,3963,3279,163,299,24,23,3,6,684
5069002500,934,380,51,482,2,1,0,1,554
5071951700,4699,4033,242,16,47,66,0,4,666
5071951800,4356,3778,242,8,36,65,1,4,578
5071951900,3343,2149,681,194,24,139,5,12,1194
5071952000,4287,2497,955,116,22,467,16,18,1790
5071952100,3575,2202,981,84,19,147,2,10,1373
5071952200,5489,4741,338,36,54,34,3,8,748
5073470101,1681,813,31,761,9,6,0,4,868
5073470102,1973,1155,32,731,6,6,2,2,818
5073470200,2654,1902,82,551,14,20,3,0,752
5075470100,1584,1419,37,61,0,0,4,9,165
5075470200,4139,3860,77,15,21,8,2,8,279
5075470300,1883,1800,24,7,3,0,2,1,83
5075470400,1360,1270,35,2,0,2,1,2,90
5075470501,2671,2467,30,17,10,3,1,3,204
5075470502,4579,4109,154,36,7,25,0,10,470
5077470100,2396,1190,87,1058,3,6,0,2,1206
5077470200,1382,852,50,446,6,0,0,0,530
5077470300,3698,729,52,2760,9,6,1,12,2969
5077470400,1124,653,27,393,0,1,0,1,471
5079960300,2582,2023,140,304,7,3,3,4,559
5079960400,3211,2684,164,213,10,5,4,2,527
5079960500,2240,1649,87,367,4,8,1,5,591
5079960600,4908,1832,228,2766,6,7,1,6,3076
5081030101,1981,1200,98,580,13,1,0,5,781
5081030103,2081,1589,40,338,17,3,1,0,492
5081030104,2763,1798,82,698,18,4,5,5,965
5081030200,2478,1770,107,399,50,5,0,4,708
5081030301,1077,926,34,2,29,0,1,2,151
5081030302,1646,1310,48,147,34,6,2,4,336
5083950100,3942,3515,110,5,29,84,2,3,427
5083950200,3631,3198,70,75,18,94,4,9,433
5083950300,3581,3065,150,78,38,38,0,3,516
5083950400,3181,2852,63,17,26,62,0,6,329
5083950500,3951,3470,140,22,63,24,1,11,481
5083950600,2845,2486,107,28,54,26,1,3,359
5085020102,6579,5689,221,92,42,30,1,20,890
5085020103,7514,6516,320,105,22,82,10,22,998
5085020105,6221,5390,294,81,24,82,20,32,831
5085020106,2226,2005,47,23,11,8,0,2,221
5085020107,2638,2349,84,28,10,11,0,6,289
5085020108,5101,4587,128,31,31,18,3,7,514
5085020201,3829,3389,129,44,18,44,0,13,440
5085020202,3703,3041,209,132,23,59,3,12,662
5085020204,6127,4766,448,274,30,174,3,9,1361
5085020205,4840,4033,301,115,18,48,0,8,807
5085020206,4919,4014,316,153,17,63,0,14,905
5085020301,3725,2917,142,349,23,35,5,4,808
5085020302,3833,3223,336,67,12,18,0,3,610
5085020400,2853,2300,124,286,8,7,3,3,553
5085020500,4566,2919,277,1155,8,30,1,7,1647
5085020600,1666,1086,81,409,14,4,0,4,580
5085020700,2633,1610,85,837,3,3,0,2,1023
5085020800,1042,762,68,168,0,0,0,5,280
5087960100,4080,3540,204,8,54,40,0,12,540
5087960200,4152,3162,441,15,53,13,234,24,990
5087960300,4974,4466,154,9,44,25,0,11,508
5087960400,3315,2907,91,4,54,24,4,12,408
5089960100,4366,4023,80,3,34,13,0,7,343
5089960201,3299,2942,109,4,35,9,0,2,357
5089960202,4014,3696,97,6,33,9,0,2,318
5089960301,2028,1881,28,0,14,12,0,0,147
5089960302,3119,2872,65,7,11,13,0,3,247
5091020100,3864,1935,151,1524,13,26,0,3,1929
5091020200,2740,1409,154,972,14,29,0,11,1331
5091020400,2771,1424,180,1037,12,14,0,8,1347
5091020500,2550,1067,174,1146,24,2,1,5,1483
5091020600,2100,399,49,1565,6,0,0,1,1701
5091020701,3534,2026,112,1210,16,18,0,21,1508
5091020702,3642,1640,137,1710,22,17,0,8,2002
5091020801,2976,1785,95,891,17,42,0,23,1191
5091020802,2346,1971,84,144,20,10,1,12,375
5091020901,2551,1935,76,424,6,10,0,17,616
5091020902,5569,4911,168,121,42,20,2,12,658
5091021001,3238,2802,84,164,26,4,0,6,436
5091021002,4687,4263,118,9,28,13,0,12,424
5091980000,32,26,1,5,0,0,0,0,6
5093010100,1262,255,61,881,1,2,0,0,1007
5093010200,5214,1419,223,3311,11,56,1,28,3795
5093010300,2451,382,72,1902,3,7,0,10,2069
5093010601,4296,2074,165,1851,3,44,0,8,2222
5093010602,1710,1140,76,367,5,0,0,14,570
5093010700,3652,3135,141,191,11,32,2,8,517
5093010801,3256,2792,312,20,3,2,0,3,464
5093010802,3703,3408,137,21,6,18,0,6,295
5093010900,2229,1378,104,677,1,1,0,0,851
5093011000,3818,852,97,2723,7,23,0,7,2966
5093011100,3250,1785,129,1181,0,26,0,4,1465
5093011200,1913,1550,44,254,6,0,0,7,363
5093011300,1728,1168,107,404,4,4,0,1,560
5093011400,2203,1523,103,468,6,27,0,2,680
5095950100,3110,1335,50,1546,5,23,1,16,1775
5095950200,1933,1195,79,568,19,4,4,7,738
5095950300,1756,1008,57,637,6,1,2,9,748
5097953000,3008,2729,92,9,36,3,3,7,279
5097953100,1923,1750,37,0,21,22,0,0,173
5097953200,3553,3020,286,4,35,22,2,7,533
5099090100,2153,1452,60,523,12,24,0,3,701
5099090200,4759,2652,261,1646,19,17,0,9,2107
5099090300,1398,1041,33,264,6,0,0,4,357
5101180100,3420,3141,44,2,35,10,1,6,279
5101180200,3805,3517,38,4,31,14,0,13,288
5103950101,1957,1480,77,321,6,4,0,5,477
5103950102,2979,1851,89,857,8,6,1,1,1128
5103950200,2273,1397,35,706,6,25,0,11,876
5103950301,1991,1645,27,214,5,3,0,4,346
5103950302,2830,1775,40,884,6,5,0,5,1055
5103950400,3083,1121,90,1696,8,31,2,6,1962
5103950500,3417,1595,79,1554,6,26,0,7,1822
5103950600,4120,1228,79,2624,4,23,0,8,2892
5105952700,5203,4681,157,98,23,10,0,8,522
5105952800,3165,2891,82,7,12,2,0,17,274
5105952900,1651,1497,47,2,8,0,0,0,154
5107480100,2531,952,32,1478,8,13,0,7,1579
5107480201,2306,1317,27,883,6,1,0,2,989
5107480202,2069,1185,33,784,10,10,0,2,884
5107480300,5069,1139,81,3706,5,30,0,7,3930
5107480400,1206,268,21,872,6,8,3,0,938
5107480500,2057,266,30,1734,0,1,1,0,1791
5107480600,1330,414,40,848,3,1,0,1,916
5109953300,3778,2964,587,26,33,12,0,15,814
5109953400,2236,1978,100,2,20,0,0,5,258
5109953500,4157,3583,144,210,30,4,0,6,574
5111490100,3946,3316,145,305,7,1,0,6,630
5111490200,1412,1227,81,23,1,0,0,6,185
5111490300,3317,2548,182,372,28,13,0,0,769
5111490400,4479,3733,166,291,12,31,0,22,746
5111490501,2699,2413,43,76,20,5,1,8,286
5111490502,3537,3307,88,25,22,3,0,6,230
5111490600,1413,1293,59,17,1,3,0,1,120
5111490700,2162,1326,65,664,0,0,0,1,836
5113950100,3994,3575,112,7,47,9,0,12,419
5113950201,2516,2075,146,10,50,28,0,12,441
5113950202,3172,2696,110,9,54,11,0,11,476
5113950300,2433,2134,86,5,50,6,0,2,299
5113950400,3051,2679,114,3,38,39,6,8,372
5113950500,1948,1659,69,2,56,3,3,2,289
5113950600,2107,1274,641,3,40,4,0,7,833
5115950700,3630,3261,80,8,51,8,0,4,369
5115950800,4296,3714,194,38,38,22,1,5,582
5115950901,3138,2778,147,19,18,14,0,3,360
5115950902,3800,3384,112,11,34,8,0,10,416
5115951000,4581,4057,114,12,43,27,4,5,524
5115951100,3833,3422,109,45,26,7,2,13,411
5115951201,3403,2925,156,50,23,36,0,4,478
5115951202,6002,4894,678,52,36,34,0,17,1108
5115951301,1314,945,163,100,18,15,0,6,369
5115951302,3786,2567,669,244,20,30,3,16,1219
5115951303,2832,2038,375,141,17,76,0,16,794
5115951400,4515,3339,304,533,44,117,2,20,1176
5115951501,3703,3105,230,67,10,63,2,15,598
5115951503,2656,2200,149,91,15,52,1,4,456
5115951504,4051,2743,760,275,24,43,0,10,1308
5115951601,6511,3629,1989,367,23,100,8,26,2882
5115951602,1330,1036,186,7,16,12,0,3,294
5117460100,3787,3279,70,316,6,6,1,2,508
5117460200,2568,2133,41,294,11,12,2,4,435
5117460300,1927,1512,34,312,2,2,0,5,415
5119000500,2234,82,52,2016,4,6,0,7,2152
5119001100,1984,116,42,1747,21,7,0,3,1868
5119001200,2359,180,981,1152,4,2,0,6,2179
5119001300,1969,219,77,1570,14,5,0,18,1750
5119001501,3956,3299,128,274,5,86,1,10,657
5119001502,4096,3134,182,377,7,186,1,19,962
5119001600,6011,5011,184,488,9,114,2,8,1000
5119001800,3943,526,151,3077,1,27,0,10,3417
5119001900,3934,686,252,2788,25,38,4,16,3248
5119002001,5475,811,1097,3369,6,37,0,15,4664
5119002002,4811,387,1473,2800,15,4,2,12,4424
5119002102,4799,1241,520,2564,12,257,9,42,3558
5119002103,3636,1495,161,1610,14,196,0,19,2141
5119002104,4559,3605,175,488,10,97,3,16,954
5119002203,5207,3273,192,1414,23,76,2,13,1934
5119002206,3776,1450,184,1701,4,274,0,20,2326
5119002208,2152,1104,133,701,11,63,0,10,1048
5119002209,3468,1189,233,1731,14,113,0,13,2279
5119002210,1598,1372,42,96,6,29,1,4,226
5119002211,5441,3118,318,1618,6,124,5,33,2323
5119002403,3988,695,540,2589,2,42,0,9,3293
5119002405,4920,746,837,3080,7,88,4,25,4174
5119002406,3004,659,586,1613,8,14,0,14,2345
5119002407,2544,1567,189,501,7,169,0,6,977
5119002409,3134,445,224,2266,0,79,0,18,2689
5119002410,3780,660,295,2664,5,19,0,18,3120
5119002500,1732,832,104,677,8,27,2,2,900
5119002600,902,177,56,607,4,1,0,5,725
5119002700,5811,1081,344,4107,11,18,2,29,4730
5119002800,1771,57,23,1628,6,1,0,4,1714
5119002900,1141,163,77,826,0,16,1,4,978
5119003001,2988,787,202,1814,3,26,3,8,2201
5119003002,2637,701,150,1630,8,11,4,6,1936
5119003100,963,155,16,741,1,0,0,5,808
5119003202,6997,2508,1078,3068,20,27,0,31,4489
5119003207,1911,1018,172,560,19,5,2,8,893
5119003208,4497,1454,698,2020,19,11,0,32,3043
5119003303,4651,3592,142,577,15,108,1,15,1059
5119003305,3899,2213,490,952,17,28,3,13,1686
5119003306,3597,1593,188,1520,33,110,0,4,2004
5119003307,1740,1144,72,391,14,40,1,9,596
5119003308,4304,3422,173,417,20,39,2,5,882
5119003403,2681,2211,107,120,14,8,2,4,470
5119003404,4561,3861,151,167,14,37,2,5,700
5119003405,1454,1090,59,154,6,9,0,5,364
5119003406,4780,3260,322,794,33,34,4,26,1520
5119003604,6397,3200,386,2182,16,125,21,35,3197
5119003605,5703,2414,397,2458,16,82,5,30,3289
5119003606,2655,935,246,1203,22,15,0,12,1720
5119003607,5013,1650,297,2652,11,53,2,18,3363
5119003608,4883,2075,263,2064,11,126,2,16,2808
5119003609,4478,2259,361,1457,23,72,6,10,2219
5119003703,6580,5010,214,852,24,126,2,24,1570
5119003704,3879,2056,306,1213,5,56,2,13,1823
5119003707,4226,2529,144,1239,13,101,3,16,1697
5119003711,5953,3495,247,1739,10,145,3,19,2458
5119003712,4041,3075,111,579,9,65,0,7,966
5119003713,4922,3283,231,981,14,96,0,23,1639
5119003714,4449,2939,210,953,7,95,1,24,1510
5119003800,4765,1080,463,2959,13,57,3,28,3685
5119003900,4503,1997,137,2186,12,16,4,0,2506
5119004001,2547,425,186,1871,3,9,0,4,2122
5119004004,3480,2279,416,578,4,30,2,3,1201
5119004005,3268,1403,180,1543,12,61,7,7,1865
5119004006,3630,2215,570,669,9,32,0,5,1415
5119004007,2454,558,110,1699,2,4,0,13,1896
5119004103,3832,484,1013,2173,7,39,0,19,3348
5119004104,2140,1031,275,700,10,14,0,6,1109
5119004105,6096,776,1651,3451,12,16,1,22,5320
5119004106,6081,378,1023,4521,15,6,2,26,5703
5119004107,3177,346,1295,1441,3,10,9,6,2831
5119004108,5668,358,2295,2877,8,15,0,17,5310
5119004201,2510,2155,72,110,10,8,2,12,355
5119004202,4167,3648,118,115,13,97,4,7,519
5119004205,4933,3150,167,1082,21,295,1,8,1783
5119004213,5658,4329,139,423,13,499,0,15,1329
5119004214,2875,2043,112,456,2,146,0,4,832
5119004215,5314,3649,170,1036,23,187,2,26,1665
5119004218,3288,1982,186,688,7,250,0,15,1306
5119004219,5629,4273,141,480,8,487,0,16,1356
5119004220,6712,1580,1098,3711,6,110,0,32,5132
5119004222,2692,1340,143,738,10,360,0,11,1352
5119004223,3531,2165,102,604,4,494,4,8,1366
5119004224,6230,4062,331,846,12,747,3,16,2168
5119004225,3978,2623,248,521,19,378,3,19,1355
5119004226,3264,969,227,1907,3,42,1,11,2295
5119004227,1605,1274,143,61,9,11,0,5,331
5119004228,2399,1721,94,273,1,210,1,10,678
5119004229,4461,3355,154,393,12,379,1,11,1106
5119004302,5370,3760,351,824,30,41,0,23,1610
5119004306,5671,3662,245,1306,30,96,1,34,2009
5119004307,5148,1885,270,2596,10,98,6,17,3263
5119004308,3359,2302,122,703,10,60,0,12,1057
5119004309,4496,2852,209,981,5,232,3,11,1644
5119004310,4278,2901,247,811,21,45,2,24,1377
5119004311,3823,2920,106,474,4,133,1,7,903
5119004400,1942,1224,79,463,11,55,0,8,718
5119004500,2441,293,66,1976,9,7,1,9,2148
5119004600,2446,841,97,1366,7,21,1,18,1605
5119004700,3357,1228,89,1854,21,17,3,11,2129
5119004801,2415,1598,101,539,6,20,0,10,817
5119004901,2477,1915,73,371,4,23,0,7,562
5119004902,3804,3399,70,110,2,68,1,12,405
5119980100,4,0,2,0,0,0,0,0,4
5119980200,565,296,14,202,2,40,0,9,269
5119980300,3136,1842,438,460,25,102,27,13,1294
5119980400,532,118,30,355,3,1,2,0,414
5121960100,4009,3757,34,10,16,6,2,2,252
5121960201,1948,1839,19,6,15,2,0,7,109
5121960202,4315,4054,61,16,11,15,23,0,261
5121960301,4320,3644,125,46,23,23,290,12,676
5121960302,3979,3259,145,62,19,27,280,5,720
5123960100,2202,813,51,1238,5,20,0,6,1389
5123960201,2081,1424,66,512,12,6,0,4,657
5123960202,3083,2003,67,925,6,12,0,7,1080
5123960300,2126,1436,39,576,0,4,0,0,690
5123960400,3965,350,81,3433,4,16,0,5,3615
5123960500,2954,1165,59,1607,2,39,0,9,1789
5123960600,6679,2015,323,4210,36,25,0,4,4664
5125010101,3800,2795,390,343,27,28,3,12,1005
5125010104,3821,3144,128,292,21,57,0,6,677
5125010105,5359,4307,341,391,22,45,0,15,1052
5125010106,3276,2476,109,452,15,45,7,21,800
5125010107,6454,4195,362,1387,17,134,3,25,2259
5125010301,4772,3828,204,442,25,48,1,7,944
5125010302,3758,3265,106,168,12,34,0,2,493
5125010303,4178,3663,163,108,12,40,0,9,515
5125010405,4681,3931,161,253,21,99,0,11,750
5125010406,5702,4755,424,114,27,71,1,12,947
5125010407,4943,4296,326,63,28,10,2,18,647
5125010408,6977,4068,704,1698,27,66,11,30,2909
5125010409,3115,1896,677,347,12,52,1,7,1219
5125010410,2546,1191,495,711,3,25,0,7,1355
5125010411,5700,4167,323,746,29,126,0,16,1533
5125010507,3707,3311,104,49,20,13,1,4,396
5125010508,5138,4644,152,78,15,27,16,10,494
5125010509,5570,4417,491,327,22,73,2,18,1153
5125010511,6677,5532,322,389,23,75,4,14,1145
5125010512,3238,2888,164,28,19,11,0,8,350
5125010513,3134,2797,112,68,16,7,5,3,337
5125010514,3640,3044,295,142,24,12,0,3,596
5125010515,2374,2227,47,27,4,7,4,0,147
5125010516,2075,1942,34,12,6,9,1,6,133
5125010517,3040,2846,41,29,5,12,2,7,194
5125010518,3250,2345,338,262,7,161,0,11,905
5125010519,4282,3129,321,501,21,132,4,14,1153
5125010520,1763,682,733,258,7,26,0,2,1081
5125010601,3349,2366,276,487,17,4,0,17,983
5125010602,3097,2598,164,179,18,4,2,16,499
5127950100,4104,3464,127,11,101,136,3,20,640
5127950200,3850,2982,556,10,39,91,1,7,868
5127950300,1882,1585,65,10,43,48,1,4,297
5129970100,2212,1992,38,0,17,4,2,5,220
5129970200,3383,3071,54,2,31,7,3,7,312
5129970300,2233,2029,48,3,17,9,0,3,204
5131000100,6116,1667,2422,925,51,718,2,9,4449
5131000200,5561,1590,2273,770,89,442,13,5,3971
5131000300,2334,1078,679,367,29,41,1,5,1256
5131000400,3411,916,1630,520,48,141,0,8,2495
5131000501,5248,1587,2390,633,60,299,10,11,3661
5131000502,3208,1066,1280,316,35,350,2,0,2142
5131000600,4801,3505,429,313,86,152,2,3,1296
5131000700,5263,2693,1406,526,68,141,14,21,2570
5131000800,3893,2193,838,330,74,111,5,5,1700
5131001001,4828,3360,540,313,102,86,0,26,1468
5131001002,2071,1590,146,65,47,33,0,6,481
5131001101,4123,2913,332,289,105,163,0,9,1210
5131001102,3275,2057,387,252,73,206,0,15,1218
5131001201,3479,2418,360,222,98,82,0,8,1061
5131001202,3242,2126,308,346,90,87,0,6,1116
5131001301,2579,1888,126,99,34,229,1,6,691
5131001305,4549,3401,322,171,52,274,7,19,1148
5131001306,3964,2834,251,158,63,439,3,4,1130
5131001307,3313,2258,222,154,47,388,1,26,1055
5131001308,4126,2934,484,81,72,196,3,12,1192
5131001309,1855,1257,151,101,54,74,0,11,598
5131001310,5273,3257,538,469,126,350,1,13,2016
5131001311,3775,3080,169,68,67,124,3,2,695
5131001312,3964,2833,301,218,79,160,1,9,1131
5131010101,5921,5033,257,16,111,38,5,13,888
5131010102,6312,5304,225,26,158,85,3,10,1008
5131010201,4969,4204,232,43,95,81,0,4,765
5131010202,3839,3200,202,19,95,29,3,7,639
5131010301,6441,5359,237,39,143,101,5,18,1082
5131010303,2422,2051,97,30,39,44,6,2,371
5131010304,3644,3133,94,12,89,36,0,6,511
5133080100,3579,2411,865,25,75,11,0,14,1168
5133080200,4013,2542,1073,52,94,6,2,5,1471
5133080300,5947,1693,3422,270,80,39,239,2,4254
5133080400,2300,1754,148,203,56,4,0,0,546
5135470100,1760,1598,19,3,6,4,0,6,162
5135470201,2489,2281,49,5,25,5,0,0,208
5135470202,3038,2770,66,14,8,24,2,4,268
5135470300,3960,3612,88,10,40,10,8,14,348
5135470401,2946,2693,48,51,17,11,1,0,253
5135470402,3078,2775,92,31,25,3,9,0,303
5137950100,3748,3472,88,4,31,6,1,13,276
5137950201,1660,1522,32,3,12,1,1,0,138
5137950203,2481,2261,60,3,27,0,0,7,220
5137950204,4470,4132,91,11,17,18,0,10,338
5139950100,2786,1478,70,1120,10,1,5,6,1308
5139950200,3983,3104,112,567,8,11,0,5,879
5139950300,2190,1525,55,480,13,3,4,11,665
5139950401,2312,1696,189,338,6,5,1,6,616
5139950402,3423,2702,75,511,17,18,1,5,721
5139950501,3386,3010,103,132,16,5,0,17,376
5139950502,2677,2147,92,375,3,18,1,2,530
5139950600,3294,1390,222,1515,9,18,0,18,1904
5139950700,5167,2517,306,2018,15,121,1,13,2650
5139950800,3266,2072,212,835,5,46,3,13,1194
5139950900,2500,629,141,1647,1,14,0,10,1871
5139951000,4070,634,177,3132,5,13,0,10,3436
5141460100,3287,3016,63,11,28,9,0,6,271
5141460200,3418,2993,204,19,33,15,0,2,425
5141460301,1525,1436,7,8,5,4,0,3,89
5141460303,1613,1475,43,8,13,12,0,0,138
5141460304,2118,1869,109,14,15,12,0,0,249
5141460400,3835,3530,75,11,16,4,0,4,305
5143010101,4900,3199,1150,32,51,58,146,10,1701
5143010107,6040,4968,313,152,41,118,35,20,1072
5143010108,6090,4937,358,109,42,259,41,26,1153
5143010109,3726,2910,425,29,32,71,34,7,816
5143010110,4675,3576,340,251,40,122,28,17,1099
5143010111,1794,1611,55,10,10,24,2,0,183
5143010112,2897,2490,120,9,35,18,3,18,407
5143010113,6955,5632,426,182,70,178,16,17,1323
5143010114,3153,2221,323,295,15,57,33,13,932
5143010115,3044,2562,115,44,40,74,9,14,482
5143010201,4163,995,1871,84,24,89,974,7,3168
5143010202,4133,679,2625,43,6,31,652,16,3454
5143010303,5931,2233,2744,116,26,204,365,8,3698
5143010304,4491,1524,1934,89,30,54,674,10,2967
5143010305,6038,1931,3094,166,30,254,391,18,4107
5143010306,5007,950,2631,76,26,121,1048,12,4057
5143010307,4830,692,2835,85,22,27,1038,17,4138
5143010401,7381,2809,3201,242,48,127,673,22,4572
5143010402,5119,2167,2056,70,38,26,546,4,2952
5143010404,2577,512,1737,32,7,23,165,5,2065
5143010405,5119,3107,1232,169,55,107,202,13,2012
5143010501,6666,5350,599,74,63,88,21,10,1316
5143010508,7663,5621,792,411,90,167,20,13,2042
5143010510,4812,2398,1902,52,43,103,101,7,2414
5143010511,5176,3956,456,200,41,216,20,19,1220
5143010512,4474,2876,914,72,34,122,146,10,1598
5143010513,3890,2760,372,7,88,216,5,3,1130
5143010514,4060,3266,230,35,80,44,1,6,794
5143010515,6290,5132,372,135,80,88,11,35,1158
5143010516,4185,2899,360,377,41,99,64,32,1286
5143010517,5483,4263,305,255,38,230,5,13,1220
5143010518,4338,3211,419,127,38,164,114,10,1127
5143010519,4984,2941,985,88,30,102,520,2,2043
5143010520,4165,2980,382,263,40,158,10,24,1185
5143010521,3473,2310,462,298,51,89,13,9,1163
5143010601,2927,2162,279,188,25,85,0,4,765
5143010602,4052,2626,466,474,55,101,11,27,1426
5143010703,3397,2052,436,420,29,163,40,8,1345
5143010704,4333,2903,350,331,40,363,22,21,1430
5143010705,3502,2359,450,263,44,93,33,9,1143
5143010706,2128,1813,93,44,11,28,2,6,315
5143011002,4933,4034,273,13,145,67,2,13,899
5143011003,4942,4174,221,33,88,27,3,9,768
5143011004,3661,3149,94,7,74,22,0,7,512
5143011005,4463,3704,240,27,73,38,1,14,759
5143011006,6522,5143,542,194,71,64,15,22,1379
5143011103,4074,3486,143,11,63,19,13,14,588
5143011104,3753,2628,309,366,26,100,33,32,1125
5143011105,5116,3725,505,383,68,75,57,21,1391
5143011106,3734,2995,318,41,44,17,12,8,739
5143011107,4952,3750,409,287,55,93,32,19,1202
5143011200,2033,724,767,81,17,20,324,0,1309
5143011301,6520,4939,525,346,44,277,5,23,1581
5143011302,3107,2532,200,142,26,51,3,5,575
5145070100,4275,3939,94,12,15,9,0,17,336
5145070200,4787,4363,104,7,16,1,0,6,424
5145070300,5133,4654,172,33,25,7,1,15,479
5145070401,5850,4830,317,309,16,40,0,25,1020
5145070402,4231,3337,203,360,13,32,9,14,894
5145070501,3494,3034,239,33,16,8,0,5,460
5145070502,2580,2263,118,40,9,6,0,4,317
5145070600,3714,3231,150,102,11,10,0,6,483
5145070700,4083,3211,276,264,12,101,0,13,872
5145070801,2747,1821,126,545,13,104,1,14,926
5145070802,2493,1820,129,314,15,52,3,10,673
5145070901,4508,3345,263,551,14,34,2,15,1163
5145070902,4948,4383,150,150,16,79,0,3,565
5145071001,3365,3021,98,35,15,12,0,8,344
5145071002,3856,3488,64,17,37,15,2,7,368
5145071101,3117,2247,340,315,15,22,0,9,870
5145071102,3025,2525,241,50,13,6,3,9,500
5145071201,5263,4507,191,193,25,53,4,10,756
5145071202,5353,4344,224,347,23,25,0,24,1009
5147490100,3874,2939,36,686,4,17,0,9,935
5147490200,2395,1296,60,915,4,5,0,16,1099
5149952301,2989,1736,1024,92,21,10,1,5,1253
5149952302,2950,1783,926,71,9,23,1,10,1167
5149952401,2584,1896,451,18,15,70,1,3,688
5149952402,5561,4779,498,12,37,43,2,5,782
5149952500,4060,2623,1210,30,19,35,2,4,1437
5149952600,2119,1893,95,3,10,21,4,2,226
6001400100,3038,1840,205,140,0,538,10,49,1198
6001400200,2001,1383,207,39,0,190,2,14,618
6001400300,5504,3293,547,544,11,540,23,37,2211
6001400400,4112,2676,374,283,6,386,8,29,1436
6001400500,3644,1898,437,617,8,304,5,38,1746
6001400600,1788,809,188,428,5,125,1,42,979
6001400700,4508,1842,633,1198,10,406,9,52,2666
6001400800,3917,1531,500,970,8,574,17,40,2386
6001400900,2514,1023,374,619,4,243,3,24,1491
6001401000,6097,2188,977,1829,13,566,32,49,3909
6001401100,4966,2257,701,921,35,634,20,43,2709
6001401200,2989,1654,388,288,5,357,16,16,1335
6001401300,5887,1945,1121,1215,55,1029,113,44,3942
6001401400,5355,1426,1283,1578,42,575,46,47,3929
6001401500,2661,819,474,946,2,188,4,27,1842
6001401600,2971,801,791,793,22,283,38,43,2170
6001401700,6121,1861,1585,1265,40,776,117,47,4260
6001401800,1981,496,403,822,8,96,8,26,1485
6001402200,3250,879,924,841,15,341,42,26,2371
6001402400,2459,553,359,971,6,397,5,20,1906
6001402500,2010,402,169,1014,2,204,10,37,1608
6001402600,1226,214,113,324,4,505,4,3,1012
6001402700,1827,414,364,732,2,180,7,26,1413
6001402801,2941,725,267,1005,2,754,2,13,2216
6001402802,1453,311,165,565,14,281,20,7,1142
6001402900,1917,559,207,326,0,730,0,0,1358
6001403000,3007,238,95,122,4,2472,7,4,2769
6001403100,1690,458,153,236,0,732,5,10,1232
6001403301,1999,186,107,221,0,1413,4,5,1813
6001403302,3220,1261,413,403,7,843,20,23,1959
6001403401,3031,1178,391,443,0,817,17,19,1853
6001403402,1524,463,202,319,10,401,4,24,1061
6001403501,5880,2105,608,1320,26,1368,25,40,3775
6001403502,2148,996,303,367,3,300,4,12,1152
6001403600,4717,1830,569,1259,3,637,13,37,2887
6001403701,2786,1392,340,406,5,432,5,24,1394
6001403702,2149,1068,218,389,3,293,5,22,1081
6001403800,3710,2158,403,319,2,481,9,22,1552
6001403900,3943,2110,468,488,6,550,7,38,1833
6001404000,3049,1592,372,366,9,436,3,21,1457
6001404101,3139,1945,352,186,4,384,0,33,1194
6001404102,2516,1549,259,181,8,345,0,15,967
6001404200,3641,2307,301,191,5,504,0,18,1334
6001404300,3416,2261,229,115,5,489,0,17,1155
6001404400,5621,3345,456,269,9,940,6,51,2276
6001404501,1771,1173,123,65,1,228,3,23,598
6001404502,6194,3911,551,367,7,774,4,35,2283
6001404600,4551,2940,382,218,4,556,3,33,1611
6001404700,1982,1239,185,151,3,197,7,18,743
6001404800,2757,1246,476,360,8,418,15,13,1511
6001404900,4458,2281,527,483,8,757,14,24,2177
6001405000,3313,2036,317,224,1,412,0,21,1277
6001405100,4363,2752,349,368,4,483,3,42,1611
6001405200,4839,1900,625,569,20,1238,9,35,2939
6001405301,2991,1246,525,484,10,461,7,24,1745
6001405302,2797,821,391,428,2,970,2,16,1976
6001405401,3875,698,753,655,13,1541,10,30,3177
6001405402,3171,439,727,596,14,1228,5,6,2732
6001405500,3844,849,663,641,17,1464,8,19,2995
6001405600,3224,901,522,536,14,1026,7,19,2323
6001405700,3423,579,659,835,15,1108,5,24,2844
6001405800,4320,476,896,695,2,2017,22,38,3844
6001405901,4279,289,1805,541,23,1467,16,16,3990
6001405902,3181,280,827,442,10,1513,9,13,2901
6001406000,5223,1128,1216,786,42,1726,69,34,4095
6001406100,5887,1173,2872,804,41,701,47,30,4714
6001406201,5019,286,2447,637,20,1454,11,13,4733
6001406202,4769,313,3114,514,39,644,14,28,4456
6001406300,3989,461,1424,652,8,1273,32,22,3528
6001406400,2211,553,489,506,2,507,6,8,1658
6001406500,6196,592,2966,995,22,1328,24,31,5604
6001406601,4834,802,1306,1081,15,1299,21,30,4032
6001406602,2554,410,798,577,7,594,34,9,2144
6001406700,5567,2650,695,726,18,957,30,43,2917
6001406800,3569,1393,535,483,10,841,19,17,2176
6001406900,3839,1395,662,712,17,707,17,23,2444
6001407000,6079,883,2076,1165,30,1606,35,49,5196
6001407101,3558,311,1954,484,6,671,10,16,3247
6001407102,4382,531,2057,653,18,904,20,16,3851
6001407200,6823,525,4974,414,41,733,3,24,6298
6001407300,3943,655,2173,582,24,268,66,21,3288
6001407400,4412,142,2971,757,16,395,10,13,4270
6001407500,4383,230,2545,1101,16,269,66,22,4153
6001407600,6390,1052,2401,1794,28,664,72,37,5338
6001407700,4465,1284,798,1621,11,365,12,36,3181
6001407800,2373,755,538,640,3,223,9,20,1618
6001407900,3081,1154,544,565,5,479,19,29,1927
6001408000,2630,1380,237,292,0,501,5,12,1250
6001408100,6712,2275,709,1630,3,1492,24,33,4437
6001408200,4471,857,1221,1749,22,275,10,41,3614
6001408300,4791,1169,1219,1592,8,371,36,38,3622
6001408400,3927,170,1985,1444,16,113,42,34,3757
6001408500,5752,205,3096,1980,24,174,76,23,5547
6001408600,6167,312,3228,2031,11,264,57,31,5855
6001408700,7774,530,3762,2742,11,365,45,39,7244
6001408800,7257,450,3518,2305,31,592,82,34,6807
6001408900,3857,143,2514,923,11,155,19,13,3714
6001409000,4879,365,2555,1425,27,292,73,41,4514
6001409100,2472,50,1527,629,18,122,53,10,2422
6001409200,3755,101,2310,927,21,213,59,28,3654
6001409300,5701,235,3781,1287,10,196,27,47,5466
6001409400,5379,181,3784,858,18,388,54,23,5198
6001409500,4390,246,2804,994,15,176,42,31,4144
6001409600,5777,142,3925,1309,10,167,59,18,5635
6001409700,5523,159,2779,1980,14,219,135,27,5364
6001409800,3220,492,594,1640,8,222,20,29,2728
6001409900,3546,997,375,1514,11,367,9,26,2549
6001410000,3031,953,418,1167,1,267,1,26,2078
6001410100,2925,310,794,1384,5,201,48,26,2615
6001410200,3679,212,1597,1410,6,234,65,24,3467
6001410300,4036,73,2816,832,4,131,80,8,3963
6001410400,4142,247,1955,1291,7,453,18,27,3895
6001410500,2553,426,336,1306,9,268,25,15,2127
6001420100,2436,1343,246,40,1,585,2,33,1093
6001420200,3234,1185,381,96,3,1273,2,8,2049
6001420301,2593,826,191,107,0,1294,0,7,1767
6001420302,2426,1023,349,74,0,755,0,23,1403
6001420401,1597,642,391,87,4,351,1,17,955
6001420402,2155,701,552,164,2,550,1,25,1454
6001420500,2431,1098,289,72,1,709,1,25,1333
6001420600,3399,2127,266,51,6,626,2,30,1272
6001421100,2031,1408,135,45,0,279,3,20,623
6001421200,3657,2650,235,58,5,376,5,25,1007
6001421300,3945,2782,279,71,0,463,0,27,1163
6001421400,1679,1255,114,18,0,168,1,16,424
6001421500,3745,2715,232,45,0,406,4,25,1030
6001421600,3836,2720,263,102,0,431,4,46,1116
6001421700,3386,2057,271,95,0,659,4,15,1329
6001421800,2110,1450,134,57,2,252,3,17,660
6001421900,3901,2281,394,258,3,601,6,31,1620
6001422000,4160,1731,670,779,36,527,66,58,2429
6001422100,2843,1180,728,313,11,343,9,37,1663
6001422200,3322,1745,381,256,2,560,6,51,1577
6001422300,3811,2107,385,214,2,794,2,31,1704
6001422400,4134,1697,370,222,3,1530,7,41,2437
6001422500,5065,2404,695,217,7,1398,22,48,2661
6001422700,4868,2364,628,117,0,1297,2,40,2504
6001422800,11245,3050,3147,340,7,4175,1,23,8195
6001422901,2322,713,271,135,5,1054,3,12,1609
6001422902,3033,918,381,404,21,1083,15,39,2115
6001423000,4676,2629,518,285,14,794,8,57,2047
6001423100,4335,2081,623,560,15,657,12,46,2254
6001423200,2886,1022,818,489,10,329,8,23,1864
6001423300,3738,1674,551,810,2,357,7,35,2064
6001423400,5057,2239,838,880,8,609,6,53,2818
6001423500,3474,1701,412,459,13,571,3,43,1773
6001423601,2824,1747,288,79,6,421,6,40,1077
6001423602,5615,2141,714,148,12,2141,10,52,3474
6001423700,4234,2541,533,143,2,692,4,21,1693
6001423800,3216,2368,230,60,3,318,6,16,848
6001423901,2031,1088,301,260,4,202,1,18,943
6001423902,1464,989,128,54,3,169,0,10,475
6001424001,4146,1668,763,823,23,447,11,47,2478
6001424002,2488,899,425,632,7,290,8,35,1589
6001425101,1853,946,97,82,1,585,4,27,907
6001425102,3752,1053,325,499,10,1626,10,22,2699
6001425103,2926,1111,330,438,0,787,16,23,1815
6001425104,4374,1454,683,949,12,920,9,54,2920
6001426100,6364,4076,355,71,5,1274,7,54,2288
6001426200,4915,2992,375,51,0,974,3,45,1923
6001427100,4063,2388,427,146,0,738,4,25,1675
6001427200,4363,1645,689,177,10,1462,24,15,2718
6001427300,5719,2094,675,529,27,1897,26,50,3625
6001427600,4730,1168,657,642,17,1839,40,44,3562
6001427700,5016,2362,674,294,12,1271,18,32,2654
6001427800,4827,2390,632,192,7,1192,11,42,2437
6001427900,4744,2367,642,204,12,1078,10,31,2377
6001428000,2997,986,481,186,8,1080,17,15,2011
6001428100,4880,2559,631,142,10,1039,16,49,2321
6001428200,6644,3316,733,196,6,1732,38,51,3328
6001428301,7044,2154,691,199,4,3370,17,41,4890
6001428302,7120,2695,471,181,1,3220,10,29,4425
6001428400,4645,1934,688,330,18,1277,35,29,2711
6001428500,3339,1363,374,193,8,1083,14,12,1976
6001428600,3398,1285,432,232,9,1135,18,47,2113
6001428700,4751,1446,538,556,24,1694,58,44,3305
6001430101,6747,1977,610,268,3,3518,16,34,4770
6001430102,2553,1355,335,57,3,584,3,26,1198
6001430200,7477,3587,1108,191,11,2009,14,51,3890
6001430300,3940,1929,654,91,12,975,5,14,2011
6001430400,2207,1107,317,51,0,534,9,29,1100
6001430500,6289,1715,1644,1025,22,1424,44,31,4574
6001430600,6385,2500,955,289,18,2141,39,33,3885
6001430700,4209,1775,749,113,4,1231,9,39,2434
6001430800,6165,2263,1217,185,15,2009,24,44,3902
6001430900,5137,1454,1496,498,24,1274,49,51,3683
6001431000,3091,914,856,221,6,875,7,17,2177
6001431100,3537,1035,1063,436,8,683,38,33,2502
6001431200,6091,2259,1558,635,16,1206,47,32,3832
6001432100,4121,1537,1043,513,31,616,35,13,2584
6001432200,4231,1377,1187,701,4,658,20,23,2854
6001432300,4885,902,1752,499,21,1476,20,32,3983
6001432400,6279,936,2519,505,16,2007,49,24,5343
6001432501,5161,756,1941,224,10,2033,33,12,4405
6001432502,4641,535,1396,550,13,1928,46,16,4106
6001432601,4358,828,1326,764,5,1206,16,40,3530
6001432602,3214,684,996,668,9,651,33,16,2530
6001432700,2660,1070,700,206,5,507,7,14,1590
6001432800,4121,1307,873,450,9,1226,18,19,2814
6001433000,4178,1056,1272,290,4,1355,34,13,3122
6001433102,4124,572,1255,335,9,1762,59,19,3552
6001433103,3682,445,1477,776,12,772,25,41,3237
6001433104,4125,816,1499,782,11,756,40,32,3309
6001433200,7652,1070,1909,1190,16,2997,81,54,6582
6001433300,7448,1228,1830,255,14,3784,72,26,6220
6001433400,6644,1015,876,537,17,3891,43,16,5629
6001433500,4557,926,1096,144,5,2223,34,9,3631
6001433600,6307,1172,1511,447,13,2870,50,29,5135
6001433700,3515,488,1824,336,10,664,48,9,3027
6001433801,3637,410,1704,590,24,766,25,17,3227
6001433802,4365,481,1262,485,14,1891,24,28,3884
6001433900,6833,577,3230,1476,13,1136,137,26,6256
6001434000,5564,682,2557,968,15,1081,46,43,4882
6001435102,5870,1423,1508,949,11,1550,53,29,4447
6001435103,7726,2066,838,560,10,3668,43,40,5660
6001435104,7230,906,2519,888,12,2340,155,45,6324
6001435200,4504,1027,1215,845,6,962,81,28,3477
6001435300,5077,1097,1849,849,17,888,56,63,3980
6001435400,4940,944,1840,872,12,921,61,42,3996
6001435500,4104,835,2055,379,14,554,105,28,3269
6001435601,5454,636,3364,477,20,666,97,33,4818
6001435602,5709,922,3269,482,12,748,75,20,4787
6001435700,4904,840,2443,244,7,1087,74,16,4064
6001435800,5735,1166,2112,229,12,1930,55,17,4569
6001435900,5431,1406,1630,179,10,1898,48,27,4025
6001436000,5049,1184,1976,128,19,1500,53,16,3865
6001436100,5745,1042,2392,256,10,1703,82,31,4703
6001436200,4176,399,2687,484,6,413,51,22,3777
6001436301,5785,502,2456,550,11,1976,75,42,5283
6001436302,3903,468,1960,437,8,788,86,17,3435
6001436402,3007,1250,595,313,0,586,20,21,1757
6001436403,4282,1043,1643,552,14,663,101,27,3239
6001436404,3609,1236,973,406,6,645,50,18,2373
6001436500,5372,771,2306,714,8,1168,171,28,4601
6001436601,6761,588,4047,582,13,1082,236,44,6173
6001436602,5402,406,2551,529,20,1469,158,39,4996
6001436700,3689,431,1924,247,6,865,73,20,3258
6001436800,4341,484,1878,437,15,1170,150,33,3857
6001436900,7099,613,4480,345,10,1288,174,35,6486
6001437000,3726,601,1256,252,8,1194,194,15,3125
6001437101,7532,727,1669,348,23,4128,293,43,6805
6001437102,4557,403,1399,318,2,2054,158,47,4154
6001437200,8696,1447,2201,688,25,3645,270,40,7249
6001437300,3359,367,1270,302,4,1101,153,15,2992
6001437400,3508,423,1919,141,12,754,99,44,3085
6001437500,4797,327,3022,265,0,706,249,19,4470
6001437600,3398,344,1503,218,12,975,160,26,3054
6001437701,3991,216,2342,427,15,644,196,20,3775
6001437702,4404,121,3333,202,9,538,126,24,4283
6001437800,4785,563,1804,297,2,1716,201,21,4222
6001437900,2426,243,1330,154,10,468,116,6,2183
6001438000,3409,809,1148,188,9,1007,37,13,2600
6001438100,7807,1058,3450,416,12,2393,136,21,6749
6001438201,4752,471,2499,184,11,1227,179,14,4281
6001438203,4200,481,1164,283,15,1982,126,21,3719
6001438204,5940,794,1769,334,7,2529,235,29,5146
6001438300,3865,248,1603,225,15,1383,225,20,3617
6001438400,2460,366,830,97,0,936,112,16,2094
6001440100,2656,858,423,122,0,1080,31,5,1798
6001440200,5786,273,3885,211,10,1259,43,16,5513
6001440301,7129,914,2288,304,13,3185,72,34,6215
6001440304,4726,322,620,214,6,3290,50,21,4404
6001440305,3682,400,574,197,1,2288,72,26,3282
6001440306,4020,262,456,203,14,2855,46,19,3758
6001440307,4459,718,903,212,8,2326,50,16,3741
6001440308,5946,734,1718,216,18,2875,136,22,5212
6001440331,3323,283,639,158,4,2031,58,12,3040
6001440332,3034,227,162,99,0,2396,7,14,2807
6001440333,2787,186,213,126,1,2105,23,0,2601
6001440334,4083,390,684,173,2,2572,42,10,3693
6001440336,4583,639,1040,236,9,2425,62,12,3944
6001440337,2708,209,227,81,2,2070,11,10,2499
6001440338,4305,470,460,199,7,2863,30,35,3835
6001441100,4504,1627,684,107,22,1718,11,42,2877
6001441200,7277,2293,1201,139,19,3112,16,52,4984
6001441301,3248,617,290,96,6,2066,9,16,2631
6001441302,5661,1204,706,135,16,3323,16,33,4457
6001441401,7319,1046,855,214,4,4805,49,30,6273
6001441402,5293,871,465,153,10,3511,19,24,4422
6001441501,5913,593,408,213,16,4355,34,22,5320
6001441503,7763,475,249,101,10,6708,8,34,7288
6001441521,5779,719,385,118,4,4289,64,14,5060
6001441522,4868,543,574,145,2,3397,25,30,4325
6001441523,4169,368,215,120,7,3301,26,19,3801
6001441524,4040,327,165,81,4,3323,10,9,3713
6001441525,1632,117,105,56,2,1327,0,9,1515
6001441601,4641,1075,890,137,5,2249,42,23,3566
6001441602,7220,1177,1704,250,8,3608,78,17,6043
6001441701,3846,553,1014,98,8,1969,50,28,3293
6001441702,5728,1077,943,402,44,2937,26,62,4651
6001441800,7195,1537,1081,193,14,4046,28,54,5658
6001441921,3718,694,954,105,6,1782,27,16,3024
6001441923,6333,828,778,206,28,4177,28,116,5505
6001441924,7619,1211,896,183,13,4935,27,19,6408
6001441926,3836,381,835,127,8,2318,22,20,3455
6001441927,4310,668,466,113,11,2847,20,43,3642
6001441928,3392,481,337,140,10,2238,23,18,2911
6001441929,3466,483,182,64,2,2602,1,16,2983
6001442000,3236,456,125,24,2,2467,3,16,2780
6001442100,5265,657,127,25,1,4333,4,7,4608
6001442200,7454,1010,394,90,10,5744,13,36,6444
6001442301,5046,824,719,118,16,3173,17,26,4222
6001442302,6417,822,1075,331,14,3808,41,50,5595
6001442400,6347,1286,1583,139,15,2893,49,96,5061
6001442501,3543,732,737,84,10,1759,20,59,2811
6001442502,3976,759,915,94,32,2006,23,10,3217
6001442601,3854,1064,600,50,14,1856,19,27,2790
6001442602,5314,1244,1179,143,9,2376,29,22,4070
6001442700,3141,1082,518,49,6,1290,17,10,2059
6001442800,2959,687,546,42,13,1489,13,16,2272
6001442900,7661,1493,1162,113,8,4530,36,50,6168
6001443001,2888,464,768,44,0,1461,1,24,2424
6001443002,6650,983,1239,57,13,4132,8,17,5667
6001443102,4942,623,191,27,10,3905,22,19,4319
6001443103,3972,421,100,10,0,3360,0,15,3551
6001443104,5901,670,250,34,10,4739,4,27,5231
6001443105,4687,494,106,18,3,3940,3,6,4193
6001443200,3553,523,94,23,2,2769,2,6,3030
6001443301,4134,709,257,48,1,2957,10,16,3425
6001443321,3511,282,179,30,12,2929,7,14,3229
6001443322,3191,503,176,32,6,2370,1,2,2688
6001444100,7703,2186,1908,193,12,2801,143,27,5517
6001444200,6451,1343,2150,135,10,2339,85,31,5108
6001444301,3617,946,1142,94,17,1146,59,27,2671
6001444303,5,0,2,0,0,1,0,0,5
6001444304,7202,799,2361,258,12,3370,116,14,6403
6001444400,5282,839,2472,185,14,1507,59,35,4443
6001444500,6414,914,2549,247,10,2286,104,48,5500
6001444601,6083,1244,1207,158,10,3009,84,37,4839
6001444602,4777,674,571,196,5,3144,7,29,4103
6001450101,6825,1545,687,378,18,3831,15,26,5280
6001450102,8660,2004,2082,470,263,3496,41,28,6656
6001450200,6456,2189,842,494,14,2419,26,50,4267
6001450300,5548,2302,871,193,9,1804,11,38,3246
6001450400,7675,2707,1513,237,15,2660,35,27,4968
6001450501,3278,1566,421,50,6,987,17,15,1712
6001450502,5754,2099,500,145,12,2605,11,25,3655
6001450601,3480,1699,315,42,4,1209,9,15,1781
6001450603,4905,2163,541,67,7,1801,9,32,2742
6001450604,4898,2601,484,25,5,1438,4,34,2297
6001450605,3937,2075,356,36,5,1249,5,11,1862
6001450606,6026,2937,367,52,10,2317,9,17,3089
6001450607,6054,2611,1029,245,26,1775,7,37,3443
6001450608,4141,1731,363,56,8,1719,10,23,2410
6001450609,4849,2296,427,86,5,1739,13,12,2553
6001450701,8271,3912,573,121,8,3141,6,32,4359
6001450741,5482,2826,1004,75,17,1151,17,90,2656
6001450742,5439,2802,539,96,6,1627,2,47,2637
6001450743,8901,1563,992,320,25,5616,16,54,7338
6001450744,5987,2877,461,50,3,2307,9,32,3110
6001450745,6374,1913,401,50,2,3718,1,39,4461
6001450746,3238,1654,301,20,9,1062,2,10,1584
6001450750,6790,1209,568,322,17,4290,16,55,5581
6001450751,12411,1448,467,263,6,9692,17,25,10963
6001450752,9846,1411,509,198,20,7224,13,60,8435
6001451102,3955,2717,452,33,2,485,6,24,1238
6001451103,1480,960,227,22,2,173,0,9,520
6001451104,7028,3444,1279,174,22,1625,20,39,3584
6001451201,7271,3729,1431,139,25,1370,20,53,3542
6001451202,5781,2745,1060,102,8,1479,9,26,3036
6001451300,6435,3790,1439,80,13,633,15,38,2645
6001451401,6053,3261,1427,147,11,812,25,28,2792
6001451403,2175,1186,554,22,5,237,15,15,989
6001451404,6613,2217,3243,120,15,669,18,37,4396
6001451501,4920,2896,893,120,3,677,6,28,2024
6001451503,6520,3540,1494,152,17,856,15,41,2980
6001451504,1657,888,330,68,6,216,5,30,769
6001451505,3177,2225,439,22,8,262,0,7,952
6001451506,3123,1366,1115,103,25,305,6,19,1757
6001451601,5003,3387,763,88,5,427,5,24,1616
6001451602,6631,4363,1148,96,13,586,13,28,2268
6001451701,3270,1908,650,35,6,391,17,21,1362
6001451703,3952,2319,631,46,6,697,8,12,1633
6001451704,4572,2819,742,42,11,633,12,28,1753
6001981900,49,29,14,0,0,1,1,0,20
6001982000,206,78,57,28,4,15,10,3,128
6001982100,1044,436,163,67,0,308,0,11,608
6001983200,834,419,79,112,3,166,2,3,415
6001990000,0,0,0,0,0,0,0,0,0
6003010000,1204,801,84,10,214,12,0,7,403
6005000101,4009,3322,336,16,42,39,8,20,687
6005000102,1892,1499,201,6,36,24,2,12,393
6005000201,3156,2551,343,5,43,36,2,24,605
6005000202,1768,1397,208,7,16,18,2,15,371
6005000301,5726,2752,1643,989,84,77,18,40,2974
6005000303,6321,4698,974,48,99,110,0,26,1623
6005000304,4297,3177,660,30,68,60,18,23,1120
6005000401,5146,3925,681,22,86,94,5,44,1221
6005000402,4928,3858,557,63,55,61,15,33,1070
6005000500,3231,2546,411,29,48,35,3,12,685
6007000102,4202,3060,578,29,34,167,17,32,1142
6007000103,6087,4266,1020,56,27,354,8,30,1821
6007000104,6153,3981,1188,98,50,351,47,29,2172
6007000201,4470,3088,851,47,48,128,9,18,1382
6007000202,4029,2608,822,104,84,106,13,16,1421
6007000300,4740,2934,1144,68,63,194,7,28,1806
6007000401,5099,3202,1088,81,34,334,16,35,1897
6007000403,3429,2279,688,63,31,126,9,11,1150
6007000404,4070,3196,505,28,14,79,8,21,874
6007000501,4939,3129,1233,82,15,142,13,24,1810
6007000502,4900,2583,1386,186,34,359,63,27,2317
6007000601,3386,2436,518,39,22,103,4,33,950
6007000603,3450,2191,794,68,22,120,9,9,1259
6007000604,4571,2249,1517,180,20,292,15,19,2322
6007000700,5081,3695,722,87,51,151,11,29,1386
6007000800,5626,4300,720,35,43,119,15,47,1326
6007000901,2799,2042,406,24,12,113,6,17,757
6007000903,7042,4257,1571,195,96,362,8,49,2785
6007000904,6331,4811,807,53,37,241,7,34,1520
6007001000,4979,3208,1121,101,31,116,9,53,1771
6007001100,4568,2776,1140,144,48,179,11,26,1792
6007001200,3488,2312,708,38,46,94,9,32,1176
6007001300,4079,2046,1220,68,129,258,26,40,2033
6007001400,6143,4678,873,60,33,140,0,28,1465
6007001500,5504,4271,807,33,48,58,5,40,1233
6007001601,1712,1392,136,12,13,19,2,20,320
6007001602,3740,2946,349,50,29,161,3,25,794
6007001702,3574,2944,278,11,51,35,7,18,630
6007001703,1741,1440,154,7,9,20,2,1,301
6007001704,3261,2569,329,21,35,41,0,31,692
6007001800,840,703,65,3,13,16,3,0,137
6007001900,675,560,64,0,0,7,0,4,115
6007002000,886,728,75,4,11,9,0,0,158
6007002100,926,746,97,4,1,12,0,2,180
6007002200,1799,1498,133,4,16,32,1,0,301
6007002300,1851,1482,241,6,9,13,3,5,369
6007002401,1418,1053,120,30,31,50,1,32,365
6007002402,3555,2639,332,54,123,137,8,21,916
6007002500,5008,2623,1013,136,118,705,13,21,2385
6007002601,2474,1942,225,25,48,87,3,9,532
6007002602,3980,3050,419,37,72,118,9,25,930
6007002700,5833,3993,762,114,144,147,22,26,1840
6007002800,4718,2898,750,203,122,232,14,25,1820
6007002900,3315,1726,324,20,70,966,10,4,1589
6007003001,3141,1510,615,219,84,422,6,10,1631
6007003002,3508,1990,646,56,125,409,11,10,1518
6007003100,4575,3182,554,43,172,259,6,31,1393
6007003200,4352,2441,1206,41,156,207,3,16,1911
6007003300,5071,3235,935,69,189,243,15,26,1836
6007003400,2921,1522,1146,26,29,81,1,22,1399
6007003501,3716,1972,1284,27,53,178,2,13,1744
6007003502,5060,1974,2697,29,42,125,9,14,3086
6007003600,3568,2122,1102,31,42,101,0,14,1446
6007003700,5249,3173,634,71,171,815,9,32,2076
6009000121,4354,3418,531,27,61,49,12,9,936
6009000122,3839,3074,453,27,27,25,4,31,765
6009000123,2690,2111,323,21,10,56,3,6,579
6009000124,2314,1739,345,20,16,30,4,15,575
6009000220,5849,4240,958,48,57,78,7,21,1609
6009000221,5691,4084,952,53,43,163,8,37,1607
6009000222,4397,3136,755,67,39,86,7,30,1261
6009000301,4186,3192,525,27,52,55,10,39,994
6009000302,2172,1714,188,20,28,38,10,23,458
6009000400,3862,3028,331,14,126,43,5,26,834
6009000501,3214,2673,260,4,28,40,1,22,541
6009000504,758,620,75,3,5,16,0,2,138
6009000505,1208,1001,121,1,5,9,2,4,207
6009000506,758,638,48,2,0,18,2,3,120
6011000100,5389,1606,3528,34,20,47,7,25,3783
6011000200,5151,1938,2753,30,148,62,34,15,3213
6011000301,4141,748,3136,44,11,82,15,20,3393
6011000302,2204,450,1684,5,10,17,4,9,1754
6011000400,2270,1227,871,34,49,10,5,20,1043
6011000500,2684,972,1504,35,42,34,5,3,1712
6013301000,5514,2935,1360,451,14,331,29,41,2579
6013302005,7134,2761,2897,564,24,417,51,25,4373
6013302006,4032,1736,1437,280,20,231,21,32,2296
6013302007,7412,2667,3154,492,17,559,50,42,4745
6013302009,7817,1386,2108,1963,29,1745,79,39,6431
6013302011,5401,1496,1723,750,14,962,44,22,3905
6013302012,5348,1972,2172,411,20,401,33,34,3376
6013302013,3359,1581,1053,227,3,246,17,16,1778
6013302014,7906,3455,2683,368,11,836,15,64,4451
6013303104,7206,2809,2082,578,12,1194,52,27,4397
6013303105,3356,1061,1371,320,5,368,14,22,2295
6013303106,7021,2719,2617,391,26,754,31,60,4302
6013303107,6966,2832,2516,428,14,608,34,51,4134
6013303202,9125,4325,2371,646,28,1039,28,61,4800
6013303204,4860,2347,1520,190,19,426,16,18,2513
6013303206,4700,2181,910,351,13,847,20,20,2519
6013303207,6600,1239,1964,1606,6,1275,62,55,5361
6013303208,3955,2362,851,107,11,334,8,16,1593
6013303209,5403,1857,1207,586,15,1295,39,27,3546
6013303210,3815,2756,518,103,7,242,10,28,1059
6013303211,4958,2403,1387,217,13,531,23,41,2555
6013304001,5748,3168,846,391,6,893,20,35,2580
6013304002,1293,585,645,24,8,7,3,2,708
6013304003,3550,2619,473,99,9,126,8,23,931
6013304004,3621,2637,508,78,9,146,24,16,984
6013304006,3987,2103,977,304,9,311,21,6,1884
6013304007,4706,2614,1127,242,12,309,18,23,2092
6013305000,7064,1587,3447,1260,35,258,46,69,5477
6013306002,3678,1160,1607,382,19,273,47,20,2518
6013306003,5615,1457,2762,739,34,251,61,36,4158
6013306004,3667,1080,1355,818,18,143,35,25,2587
6013307101,4554,1567,1684,590,33,327,32,29,2987
6013307102,5824,1252,3220,743,33,221,79,30,4572
6013307201,3794,726,1819,623,9,389,52,8,3068
6013307202,4355,410,1648,1702,14,221,111,28,3945
6013307204,4526,1221,2121,558,8,349,52,28,3305
6013307205,7484,1677,2782,1761,29,647,136,62,5807
6013308001,7770,2578,2990,1034,17,610,88,50,5192
6013308002,5289,1248,1574,1026,26,990,40,27,4041
6013309000,3699,708,1135,1030,12,539,20,29,2991
6013310000,6106,647,3299,1181,12,597,64,33,5459
6013311000,5668,457,3190,955,17,806,18,24,5211
6013312000,2974,287,1290,798,15,421,41,16,2687
6013313102,4581,935,1548,1203,16,531,50,43,3646
6013313104,2685,566,1182,377,11,450,6,9,2119
6013313105,6559,1003,2332,1780,25,952,94,52,5556
6013313106,5879,1139,1877,1058,21,1311,58,53,4740
6013313107,3071,842,1307,343,14,334,56,28,2229
6013313203,3354,839,1358,240,8,664,42,25,2515
6013313204,5704,1257,2728,655,13,696,55,33,4447
6013313205,1822,300,899,134,7,377,17,13,1522
6013313206,6342,637,3802,790,9,678,121,64,5705
6013314102,6812,888,4069,636,13,901,29,29,5924
6013314103,5513,608,3371,746,6,580,36,7,4905
6013314105,4540,521,2641,763,9,416,10,47,4019
6013314106,3744,510,2474,218,3,357,32,10,3234
6013314200,7168,878,5368,208,30,443,31,31,6290
6013315000,3434,1061,1067,251,13,767,16,41,2373
6013316000,1605,676,479,286,6,54,21,5,929
6013317000,2078,1388,358,85,8,82,8,9,690
6013318000,3442,2191,665,121,12,183,0,10,1251
6013319001,4093,2298,876,138,18,397,14,27,1795
6013319002,4179,2597,924,131,21,184,15,31,1582
6013320001,3626,1721,1271,81,16,224,25,37,1905
6013320003,2801,1671,389,58,5,446,5,13,1130
6013320004,7038,3706,1308,268,30,1140,28,43,3332
6013321101,6498,4003,1062,219,10,703,12,33,2495
6013321102,6826,4275,960,119,7,970,14,45,2551
6013321103,4779,3281,631,76,13,406,7,22,1498
6013321200,5589,2560,1040,183,14,1288,29,49,3029
6013322000,6528,3949,856,102,13,1084,23,42,2579
6013323000,4622,3061,633,52,14,492,8,27,1561
6013324002,5519,2818,970,268,18,1027,18,32,2701
6013324003,3123,1396,391,210,1,842,8,33,1727
6013324004,2811,1508,464,129,10,498,4,19,1303
6013325000,5733,3897,786,86,20,507,17,41,1836
6013326000,3508,2515,377,55,0,285,10,19,993
6013327001,3448,1361,1591,80,8,219,11,23,2087
6013327002,4276,1567,1630,221,8,542,45,22,2709
6013328000,2411,1033,519,169,9,480,30,30,1378
6013329000,6579,2706,2349,236,16,749,74,39,3873
6013330000,5587,2606,1766,113,12,644,46,32,2981
6013331000,7337,3423,1939,251,19,1113,29,48,3914
6013332000,7719,4082,1867,228,7,931,28,59,3637
6013333101,4212,2229,929,106,18,635,6,30,1983
6013333102,4090,2146,839,134,14,664,10,26,1944
6013333200,5961,3239,1324,165,13,797,23,38,2722
6013334001,3991,2000,943,151,24,544,21,14,1991
6013334006,4880,2562,701,114,10,1075,13,20,2318
6013334007,3867,1864,807,191,10,718,8,38,2003
6013334008,4114,1793,940,229,5,825,17,22,2321
6013334200,7194,5124,665,100,8,836,10,51,2070
6013335000,3463,1785,903,114,6,391,5,32,1678
6013336101,4808,666,2839,336,1,671,70,52,4142
6013336103,4131,688,2267,241,9,696,14,32,3443
6013336104,3321,502,1872,201,2,569,13,43,2819
6013336201,4062,1069,2168,105,9,503,26,22,2993
6013336202,5720,834,3797,207,9,654,11,24,4886
6013337100,3238,1712,634,94,12,525,5,21,1526
6013337201,2602,1108,704,135,6,439,25,26,1494
6013337202,4999,2521,1324,141,20,648,25,37,2478
6013337300,6147,3845,712,127,16,983,6,42,2302
6013338101,5161,1481,2345,202,15,778,26,42,3680
6013338102,3498,2082,625,59,5,458,6,23,1416
6013338201,3814,2354,479,54,8,653,1,23,1460
6013338203,5379,2768,653,164,14,1336,9,56,2611
6013338204,6234,3721,669,122,11,1225,20,71,2513
6013338301,3063,1993,233,26,3,557,3,14,1070
6013338302,5981,3921,484,70,0,1017,8,44,2060
6013339001,3663,1820,629,229,6,721,16,12,1843
6013339003,4065,2368,601,149,3,644,5,21,1697
6013339004,3598,1967,503,142,4,736,5,27,1631
6013340001,6419,3662,1017,195,15,1051,13,50,2757
6013340003,3644,2486,408,46,1,429,3,34,1158
6013340004,4067,2729,395,47,1,615,0,26,1338
6013341000,5374,3678,560,75,4,613,3,33,1696
6013343001,5059,3335,712,85,5,577,14,18,1724
6013343002,4640,3204,388,72,8,666,7,43,1436
6013343003,4045,2965,360,46,2,387,7,37,1080
6013345101,6264,2758,846,99,8,2146,13,42,3506
6013345102,4226,2120,550,66,1,1200,11,16,2106
6013345103,5270,2653,498,62,10,1630,10,39,2617
6013345105,6484,4327,759,51,5,875,11,38,2157
6013345111,5990,1867,447,105,14,3244,11,37,4123
6013345112,8830,2405,682,356,9,4861,24,45,6425
6013345113,4627,2543,341,54,10,1360,7,27,2084
6013345114,6591,4876,502,36,7,790,5,25,1715
6013345115,6309,2581,469,103,3,2784,9,45,3728
6013345116,2982,1488,372,53,4,859,13,13,1494
6013345117,4182,1671,288,64,5,1920,7,9,2511
6013345118,4141,2046,393,81,2,1341,3,29,2095
6013345203,6966,5274,597,68,21,574,11,48,1692
6013345204,3669,2974,248,15,5,239,0,24,695
6013345205,5775,2320,614,192,7,2167,14,45,3455
6013345206,3496,1884,471,72,0,832,3,12,1612
6013346101,3555,2516,223,27,12,533,2,41,1039
6013346102,5748,4065,413,44,2,845,12,28,1683
6013346203,3966,3040,322,26,3,351,0,13,926
6013346204,7334,4968,654,62,4,1184,4,30,2366
6013346205,4077,3213,270,22,9,344,3,9,864
6013346206,3596,2537,272,29,2,479,1,21,1059
6013347000,6230,4328,570,82,10,768,9,33,1902
6013348000,4835,3506,310,12,3,593,0,42,1329
6013349000,5151,3508,436,69,0,685,11,42,1643
6013350000,6224,4055,601,57,12,1007,3,34,2169
6013351101,2898,2362,79,29,0,352,3,12,536
6013351103,2113,1658,50,18,0,335,2,4,455
6013351104,1964,1554,90,13,1,255,1,13,410
6013351105,1723,1374,58,10,1,237,3,3,349
6013351200,5953,4324,469,25,6,657,6,20,1629
6013352101,3344,1978,454,62,2,550,19,22,1366
6013352102,5724,3632,564,56,6,1005,10,21,2092
6013352201,6266,3741,571,98,4,1284,9,44,2525
6013352202,2559,1803,184,5,2,382,1,14,756
6013353001,4256,2648,285,52,4,919,5,30,1608
6013353002,4310,2932,289,28,5,753,1,15,1378
6013354001,1958,1336,123,14,4,310,0,9,622
6013354002,7200,5199,434,65,1,981,8,36,2001
6013355107,5793,1923,1872,793,31,773,74,32,3870
6013355109,7167,1844,2017,1601,13,1167,105,69,5323
6013355110,4434,768,1457,1071,25,738,77,56,3666
6013355111,6685,1335,2153,1508,9,1154,80,64,5350
6013355112,5636,3611,526,117,9,1082,5,51,2025
6013355113,5000,2645,322,69,4,1612,2,19,2355
6013355115,10242,1775,786,585,16,6432,22,58,8467
6013355118,4302,839,1246,937,9,871,50,39,3463
6013355119,4788,865,1183,1226,9,1122,84,33,3923
6013355120,4248,850,1208,1093,19,729,43,29,3398
6013355121,7053,1822,488,106,12,4261,15,10,5231
6013355122,5006,2021,402,89,6,2167,0,31,2985
6013355123,2957,214,88,42,1,2497,18,12,2743
6013355124,4604,427,129,80,5,3774,2,9,4177
6013355125,4261,507,290,142,6,3101,6,23,3754
6013355126,5496,986,216,97,3,3937,4,29,4510
6013355201,9199,1274,2019,964,16,4295,140,67,7925
6013355202,3689,479,722,582,9,1653,32,10,3210
6013355302,3464,2213,256,39,3,697,1,13,1251
6013355306,5000,3688,593,56,8,274,5,22,1312
6013355307,4445,2731,621,135,2,586,6,25,1714
6013355308,3550,2487,369,43,6,369,8,13,1063
6013355309,4735,2659,660,78,7,899,15,19,2076
6013355310,3197,1820,633,74,12,356,33,35,1377
6013356001,3908,789,986,487,13,1343,31,49,3119
6013356002,5481,1732,855,665,16,1804,31,44,3749
6013357000,3202,1948,616,184,15,163,6,26,1254
6013358000,6237,1759,1951,1013,17,1004,44,46,4478
6013359102,5496,1135,1566,798,18,1564,26,48,4361
6013359103,5269,1451,1363,654,17,1423,9,47,3818
6013359104,2116,381,375,437,2,754,13,14,1735
6013359105,5276,836,810,757,8,2386,32,54,4440
6013359202,6130,2384,1566,364,19,1302,26,55,3746
6013359203,7013,1128,1442,1143,7,2864,21,59,5885
6013359204,4711,634,810,588,4,2355,37,51,4077
6013360101,4855,1710,1121,455,27,1107,20,74,3145
6013360102,4381,1434,839,491,10,1240,22,55,2947
6013360200,5094,1461,1396,652,17,1042,44,90,3633
6013361000,4763,1370,1254,689,23,1041,23,53,3393
6013362000,2961,1521,463,251,6,409,14,31,1440
6013363000,7612,1920,2223,1326,28,1533,37,89,5692
6013364002,5868,1238,2411,680,18,1206,15,47,4630
6013365002,6085,254,4131,1016,8,438,53,59,5831
6013365003,5215,664,1284,1530,13,1099,28,186,4551
6013366001,4594,312,2783,477,9,845,12,40,4282
6013366002,6525,414,4337,662,9,898,27,57,6111
6013367100,5941,463,2093,2108,14,924,53,44,5478
6013367200,5754,414,2837,795,3,1432,47,51,5340
6013368001,5467,244,4401,379,2,325,19,25,5223
6013368002,4148,202,3131,296,6,382,10,29,3946
6013369001,6771,753,3262,1141,17,1269,39,72,6018
6013369002,2839,763,942,422,4,492,10,34,2076
6013370000,2953,1132,733,317,8,552,1,32,1821
6013371000,5995,1226,2709,577,13,1037,54,106,4769
6013372000,8009,1015,4808,561,21,1218,53,92,6994
6013373000,4711,215,3729,330,15,270,42,31,4496
6013374000,4994,908,2718,660,11,455,10,44,4086
6013375000,4869,185,3952,388,17,177,15,23,4684
6013376000,6941,257,4577,1437,9,388,22,44,6684
6013377000,7725,639,5315,1188,11,338,9,52,7086
6013378000,3892,2287,745,295,10,256,14,29,1605
6013379000,7255,245,4826,1732,9,249,32,28,7010
6013380001,3773,1818,450,341,5,844,15,32,1955
6013380002,3649,439,1333,1110,8,484,51,30,3210
6013381000,7261,563,3724,2057,17,525,46,58,6698
6013382000,8334,1019,2622,3052,19,1059,55,85,7315
6013383000,4969,1948,904,416,15,1267,4,62,3021
6013384000,4180,2148,401,301,8,885,10,31,2032
6013385100,2886,1562,229,120,6,742,8,19,1324
6013385200,1453,641,111,62,0,507,0,23,812
6013386000,3500,943,596,330,9,1296,2,90,2557
6013387000,2993,1150,429,204,0,947,11,34,1843
6013388000,2819,1258,336,127,3,839,3,34,1561
6013389100,2434,960,308,88,0,866,10,10,1474
6013389200,1907,497,342,104,1,830,1,31,1410
6013390100,2376,1415,185,81,0,491,6,23,961
6013390200,1860,1146,183,16,1,348,1,25,714
6013391000,2737,1878,213,61,2,329,0,24,859
6013392000,2609,1759,173,33,0,382,1,22,850
6013392201,5945,488,1889,1168,9,1961,14,108,5457
6013392202,4889,940,2554,356,14,805,29,19,3949
6013392300,3742,268,379,598,0,2275,10,19,3474
6013980000,491,149,172,107,3,19,22,0,342
6013990000,0,0,0,0,0,0,0,0,0
6015000101,3687,2265,601,40,232,273,1,10,1422
6015000102,3765,2448,528,23,398,77,3,14,1317
6015000104,2081,1236,443,26,91,86,1,7,845
6015000106,3687,2345,550,17,196,139,10,16,1342
6015000107,3461,2224,529,13,184,126,1,13,1237
6015000201,6138,2864,1892,689,272,75,7,43,3274
6015000202,3719,2412,668,15,313,45,2,17,1307
6015000203,1205,468,110,18,450,5,3,2,737
6015990000,0,0,0,0,0,0,0,0,0
6017030201,2253,1172,806,24,17,139,4,6,1081
6017030202,2141,931,1051,7,11,71,3,17,1210
6017030301,2703,1624,778,32,21,83,3,19,1079
6017030302,2903,1841,793,9,27,99,5,16,1062
6017030402,3847,2601,861,11,33,93,0,21,1246
6017030403,1391,1101,159,8,2,58,0,6,290
6017030404,2117,1431,446,12,10,73,0,24,686
6017030502,2768,2257,281,9,7,54,1,12,511
6017030504,2579,2037,301,8,6,58,2,30,542
6017030506,1009,843,99,2,2,18,0,5,166
6017030507,1717,1374,167,21,2,36,0,13,343
6017030601,5087,4168,448,17,52,87,7,25,919
6017030603,3401,2747,297,15,38,35,0,27,654
6017030604,814,658,83,2,8,9,0,2,156
6017030605,1696,1358,171,2,10,16,2,4,338
6017030606,4141,3329,374,55,27,50,11,46,812
6017030701,6177,4687,645,46,12,367,4,33,1490
6017030706,6563,4558,735,67,18,653,10,68,2005
6017030709,5065,3748,533,54,8,349,12,32,1317
6017030710,5947,4272,554,70,8,659,17,23,1675
6017030711,6518,4320,728,141,17,880,19,38,2198
6017030712,5114,3256,547,101,18,796,19,20,1858
6017030801,4347,3442,449,15,25,140,7,21,905
6017030804,6695,5246,816,35,35,124,7,44,1449
6017030807,4044,3045,604,32,21,127,0,15,999
6017030808,6726,5052,905,57,25,193,3,37,1674
6017030809,2557,1833,455,15,30,32,5,9,724
6017030810,3644,2519,740,25,26,102,3,21,1125
6017030811,1689,1298,241,11,7,32,1,3,391
6017030812,5814,4664,604,24,29,110,18,36,1150
6017030901,3158,2605,298,9,6,39,5,28,553
6017030902,4829,3821,447,37,127,65,11,31,1008
6017031000,6314,4655,1115,35,40,71,8,22,1659
6017031100,5634,4260,815,36,57,64,10,32,1374
6017031200,5157,3936,751,33,54,65,2,26,1221
6017031301,3403,2724,299,6,33,36,4,60,679
6017031302,4815,3599,700,21,41,56,0,31,1216
6017031404,2508,2073,209,6,23,19,6,8,435
6017031405,2484,1968,256,14,31,29,1,7,516
6017031406,5526,4486,502,23,37,88,11,41,1040
6017031407,1259,1004,96,5,19,35,5,10,255
6017031408,2137,1740,220,4,15,20,10,20,397
6017031409,2395,1903,226,11,32,29,2,19,492
6017031503,2818,2269,303,12,32,39,3,22,549
6017031504,5556,4320,757,10,66,43,3,38,1236
6017031505,3366,2556,537,17,38,20,4,22,810
6017031506,2703,2013,422,20,32,43,2,20,690
6017031601,2077,842,955,27,10,162,0,5,1235
6017031602,1928,714,715,15,4,417,6,6,1214
6017031700,3660,2277,342,56,7,684,10,26,1383
6017031800,6896,4034,763,108,14,1444,10,64,2862
6017031900,155,124,11,2,1,11,0,0,31
6017032001,672,570,35,2,1,1,0,4,102
6017032002,268,236,14,0,1,1,0,0,32
6017990000,0,0,0,0,0,0,0,0,0
6019000100,3840,948,2068,571,41,55,10,1,2892
6019000200,3251,130,2355,521,17,175,2,1,3121
6019000300,3755,179,2528,779,29,146,5,5,3576
6019000400,5384,340,4399,230,65,263,1,32,5044
6019000501,2580,179,1933,240,15,152,2,14,2401
6019000502,3357,421,2363,245,26,191,8,25,2936
6019000601,4673,699,3040,492,51,202,0,22,3974
6019000602,1612,270,974,185,33,87,0,4,1342
6019000701,2645,130,1609,731,10,103,0,15,2515
6019000702,1439,91,1011,216,5,83,0,8,1348
6019000901,2852,73,1910,468,19,307,0,6,2779
6019000902,5263,119,3240,1032,52,747,4,22,5144
6019001000,4731,333,2756,816,34,663,4,47,4398
6019001100,3185,117,2413,484,7,110,13,4,3068
6019001201,5944,201,4702,211,43,737,2,11,5743
6019001202,4753,112,3565,334,12,656,12,10,4641
6019001301,5471,249,4701,120,34,316,9,13,5222
6019001303,2537,66,1929,92,16,417,0,5,2471
6019001304,5496,230,3616,440,11,1068,4,30,5266
6019001407,4908,352,2915,852,52,588,1,17,4556
6019001408,2266,654,1148,171,15,215,3,7,1612
6019001409,2357,656,975,193,14,434,0,12,1701
6019001411,6946,1081,3036,418,24,2128,1,37,5865
6019001412,3215,788,1368,80,21,857,7,23,2427
6019001413,8006,1577,3264,251,29,2570,7,59,6429
6019001415,5368,417,3503,272,17,1054,9,25,4951
6019001416,7149,544,3081,303,26,3007,12,31,6605
6019001417,6790,834,2775,273,22,2683,0,47,5956
6019001418,2220,773,965,89,5,320,1,0,1447
6019001500,2129,343,1579,18,3,126,2,14,1786
6019001600,5340,1081,3570,67,13,507,0,23,4259
6019001700,6092,1215,3760,58,42,850,0,59,4877
6019001800,4363,1130,2845,47,28,218,3,24,3233
6019002000,6452,920,4292,405,70,584,2,28,5532
6019002100,5566,1451,3292,348,45,186,6,45,4115
6019002200,3702,1213,1981,151,57,113,0,45,2489
6019002300,3577,940,2112,191,50,142,1,32,2637
6019002400,4862,313,3450,280,46,653,3,22,4549
6019002501,5169,373,3549,264,26,862,4,20,4796
6019002502,4657,247,3262,186,28,857,0,7,4410
6019002601,5736,217,4947,174,40,291,8,13,5519
6019002602,3359,514,2537,94,13,139,0,23,2845
6019002701,4541,339,3699,88,17,310,13,7,4202
6019002702,5594,240,4593,158,12,539,3,4,5354
6019002800,5444,348,3740,248,30,978,11,18,5096
6019002903,4081,313,2678,281,6,748,2,15,3768
6019002904,3042,395,1863,84,13,644,0,13,2647
6019002905,3109,486,1688,260,35,545,0,16,2623
6019002906,5491,596,3016,298,49,1384,9,30,4895
6019003001,3142,355,1556,186,36,924,0,15,2787
6019003003,4216,634,2126,325,30,939,2,29,3582
6019003004,2509,492,1426,56,11,441,12,10,2017
6019003102,7528,2316,3692,346,66,748,20,27,5212
6019003103,6064,1943,2757,237,92,750,19,37,4121
6019003104,4184,1501,1729,161,20,606,10,12,2683
6019003201,4764,671,2894,221,30,802,6,19,4093
6019003202,5594,688,3164,394,47,1130,3,35,4906
6019003301,3673,602,2430,199,18,315,13,11,3071
6019003302,4918,660,3457,237,18,383,1,30,4258
6019003401,3533,353,1998,346,38,720,0,4,3180
6019003402,2332,485,1442,141,22,150,1,32,1847
6019003500,5734,1589,3345,353,46,212,7,9,4145
6019003600,4062,1815,1749,117,20,108,8,63,2247
6019003701,3583,576,2492,220,39,154,9,15,3007
6019003702,5085,817,3120,379,36,563,4,19,4268
6019003804,6173,994,3260,496,15,1181,23,32,5179
6019003805,7318,857,4282,578,61,1304,7,69,6461
6019003807,3670,662,2347,201,27,321,0,17,3008
6019003808,5241,676,3028,347,42,1003,2,25,4565
6019003809,5300,939,2753,504,21,868,13,46,4361
6019003810,5632,961,3020,403,41,995,10,29,4671
6019003811,8690,1429,3955,566,56,2396,21,63,7261
6019003812,2411,690,1028,44,17,492,8,38,1721
6019003900,5024,1313,3479,5,29,85,5,28,3711
6019004003,4761,830,3487,30,3,333,0,16,3931
6019004004,4399,617,3377,22,20,266,0,35,3782
6019004005,4643,359,3722,7,10,465,1,40,4284
6019004006,2989,370,2381,11,7,179,0,5,2619
6019004100,3225,777,2203,17,2,180,2,9,2448
6019004205,6433,1344,3630,680,34,520,23,20,5089
6019004208,6933,3099,1995,395,32,1103,23,40,3834
6019004210,3770,1158,1488,402,20,504,4,38,2612
6019004211,6899,2073,3083,647,48,737,14,43,4826
6019004212,12943,3529,5263,1203,65,2228,28,97,9414
6019004213,3335,1268,1451,233,18,200,8,17,2067
6019004214,4879,2656,1475,193,16,321,5,11,2223
6019004215,4726,1333,2001,357,15,817,2,14,3393
6019004216,4338,1178,1746,228,12,1007,8,38,3160
6019004217,3983,508,2371,431,82,475,11,9,3475
6019004218,7709,1643,2850,440,15,2450,0,72,6066
6019004301,4181,2916,558,117,17,372,7,30,1265
6019004302,4918,3231,1068,99,17,281,6,15,1687
6019004303,4312,2839,986,114,11,188,0,16,1473
6019004404,3554,633,2264,219,46,280,5,10,2921
6019004405,3935,2242,951,80,19,414,6,29,1693
6019004406,5405,2570,1854,259,16,429,4,12,2835
6019004409,3467,1596,1268,182,26,227,2,28,1871
6019004410,2342,931,876,122,7,282,6,12,1411
6019004411,1488,820,343,61,3,204,2,3,668
6019004503,4987,2537,1725,148,21,320,4,24,2450
6019004504,5215,1979,2304,291,27,404,11,23,3236
6019004505,5164,1738,2281,495,38,350,19,31,3426
6019004506,3387,2006,967,91,15,151,6,23,1381
6019004601,2931,1271,1277,106,16,128,5,13,1660
6019004602,2552,1600,626,72,8,127,2,10,952
6019004703,4155,676,2756,324,30,262,0,16,3479
6019004704,5355,830,3470,592,44,197,8,26,4525
6019004705,2210,690,1126,152,6,164,5,14,1520
6019004706,4676,891,2482,713,57,351,8,23,3785
6019004801,4595,874,2857,459,62,156,11,20,3721
6019004802,5047,890,3028,712,24,194,10,20,4157
6019004901,4347,1122,2447,293,46,236,10,24,3225
6019004902,1905,724,933,51,17,102,5,11,1181
6019005000,4200,1392,2038,183,35,396,0,9,2808
6019005100,6032,1158,3493,559,52,523,13,23,4874
6019005202,3536,557,2074,215,32,572,0,23,2979
6019005203,4628,915,2662,348,53,482,7,14,3713
6019005204,4242,942,2329,200,46,576,2,12,3300
6019005301,6011,1409,3196,382,35,782,9,13,4602
6019005302,5463,1322,2651,455,55,699,13,49,4141
6019005304,5344,1318,2520,444,40,707,6,43,4026
6019005305,3766,1058,1774,172,40,560,5,23,2708
6019005403,4268,982,1978,677,49,353,5,28,3286
6019005405,4407,1958,1610,190,32,369,6,32,2449
6019005406,3976,1733,1464,129,35,408,5,14,2243
6019005407,3122,1638,1007,68,16,237,5,18,1484
6019005408,1908,783,745,150,1,135,0,29,1125
6019005409,3738,1124,1702,300,28,396,17,17,2614
6019005410,3417,1091,1526,141,26,473,12,13,2326
6019005503,6643,3827,1041,85,42,1312,6,39,2816
6019005504,3496,1651,736,83,4,822,5,24,1845
6019005505,6685,3266,1511,223,30,1298,5,31,3419
6019005507,6097,3086,1542,216,34,913,3,43,3011
6019005508,5974,2892,1282,180,17,1263,15,46,3082
6019005509,5622,2633,1463,232,18,990,6,42,2989
6019005512,5444,2854,1533,103,25,607,23,22,2590
6019005513,3008,1721,582,83,15,377,4,12,1287
6019005514,3855,2385,768,68,21,401,0,20,1470
6019005515,1637,989,302,21,20,223,0,1,648
6019005516,5722,3055,1355,221,9,742,5,34,2667
6019005518,7318,3919,1592,221,15,1142,8,56,3399
6019005520,3419,1905,653,40,16,628,0,32,1514
6019005522,4792,2928,834,97,19,655,3,11,1864
6019005524,4727,2780,972,78,7,661,3,17,1947
6019005525,1392,824,319,10,3,155,0,11,568
6019005526,1595,806,435,46,17,201,0,7,789
6019005527,3381,2019,809,102,18,272,0,22,1362
6019005528,1583,935,306,73,5,184,0,4,648
6019005529,6014,3380,1093,94,14,1043,4,48,2634
6019005602,5649,2627,2112,139,68,365,42,32,3022
6019005605,1465,821,405,38,5,112,10,13,644
6019005606,4175,2110,1204,97,19,454,16,49,2065
6019005607,4438,1958,1714,149,35,327,27,13,2480
6019005608,3193,1605,1193,75,29,114,7,19,1588
6019005701,3758,1781,1360,79,55,266,15,21,1977
6019005702,5412,3185,1431,97,42,388,0,30,2227
6019005703,5066,2952,1313,46,22,423,10,25,2114
6019005704,5392,2389,2234,80,26,377,11,26,3003
6019005801,5395,2579,1951,88,33,485,15,30,2816
6019005802,4805,2461,1253,84,18,719,5,28,2344
6019005804,6620,2302,2904,144,72,863,21,28,4318
6019005805,8910,2776,2819,240,25,2585,14,55,6134
6019005904,6935,2386,2158,91,31,1922,10,53,4549
6019005906,2135,1287,621,6,3,137,0,15,848
6019005907,3637,1807,939,126,5,520,4,28,1830
6019005911,7259,3166,2009,196,39,1441,4,66,4093
6019005912,10640,5267,2665,301,48,1727,18,61,5373
6019005913,3149,1320,891,70,13,660,8,19,1829
6019005914,4726,2047,1230,83,16,1108,8,11,2679
6019005915,4613,2935,856,69,31,454,4,48,1678
6019005916,3030,1465,985,14,24,414,0,22,1565
6019006001,6090,1270,4329,66,26,242,7,18,4820
6019006002,4406,653,3564,16,19,85,1,19,3753
6019006101,3293,363,2461,30,12,363,9,7,2930
6019006102,4729,495,4074,33,7,39,4,9,4234
6019006201,2680,158,2435,24,2,23,10,12,2522
6019006202,7057,506,6340,26,13,105,1,21,6551
6019006301,5081,1107,3521,27,12,269,0,19,3974
6019006302,2227,1082,1007,2,15,44,0,19,1145
6019006405,5185,3684,746,55,165,165,6,19,1501
6019006406,2119,1669,244,15,18,23,1,12,450
6019006407,2703,1909,440,19,112,52,0,15,794
6019006408,1160,818,146,8,70,9,6,17,342
6019006409,1570,1154,184,0,161,11,0,11,416
6019006410,2441,1591,521,38,75,65,0,16,850
6019006411,3969,2727,836,30,40,97,5,22,1242
6019006501,6295,338,5819,17,14,50,1,9,5957
6019006502,4489,222,4185,11,5,33,4,0,4267
6019006602,5912,478,5218,18,16,99,0,44,5434
6019006603,2179,545,1493,19,10,46,0,18,1634
6019006605,1723,291,1345,7,2,40,2,6,1432
6019006606,5579,126,5295,2,0,100,1,23,5453
6019006700,7141,1948,4709,13,12,224,1,71,5193
6019006802,3666,373,3184,4,2,49,6,4,3293
6019006900,2789,353,2228,14,2,159,1,2,2436
6019007002,4831,607,4019,25,18,34,3,29,4224
6019007003,8006,846,6510,60,29,431,5,34,7160
6019007004,6042,1211,4143,37,21,431,1,51,4831
6019007101,6262,260,5612,38,13,255,0,10,6002
6019007102,1670,201,1387,15,16,21,1,8,1469
6019007202,5292,1705,3206,24,12,134,7,26,3587
6019007203,1871,1181,499,6,5,78,3,17,690
6019007204,6433,2914,2977,19,30,236,3,44,3519
6019007300,4422,1131,2690,16,20,393,0,57,3291
6019007400,3213,845,2265,22,14,16,2,6,2368
6019007500,5393,1102,3810,27,32,309,0,24,4291
6019007600,4594,842,3430,30,9,203,0,27,3752
6019007700,5691,1130,4321,56,19,24,1,21,4561
6019007801,2474,71,2361,0,4,12,1,8,2403
6019007802,4902,133,4675,29,9,43,0,0,4769
6019007903,7077,1879,4521,382,63,112,12,13,5198
6019008000,4918,1611,2910,141,25,78,6,22,3307
6019008100,6518,1465,4497,146,29,190,10,35,5053
6019008200,6506,366,6012,39,9,13,3,33,6140
6019008301,5828,202,5576,5,9,7,1,21,5626
6019008303,4052,54,3939,0,7,3,0,13,3998
6019008304,4387,223,3874,195,39,35,0,12,4164
6019008402,1047,282,731,12,0,2,0,7,765
6019008403,1805,245,1534,1,0,7,3,7,1560
6019008404,3638,145,3441,20,0,8,0,10,3493
6019008405,3121,165,2917,12,3,1,0,14,2956
6019008501,3880,116,3658,19,5,61,0,11,3764
6019008503,4999,54,4890,10,6,17,2,6,4945
6019008504,3670,64,3571,8,1,15,0,0,3606
6019008600,3993,915,2205,287,16,482,0,14,3078
6021010101,4841,1816,2619,22,52,133,8,20,3025
6021010102,4384,1989,2064,14,48,55,4,37,2395
6021010200,4967,2623,2018,16,52,62,3,28,2344
6021010300,2202,1443,478,17,186,3,6,9,759
6021010401,1564,901,500,4,29,45,5,5,663
6021010402,6313,3242,2336,46,134,268,7,20,3071
6021010501,3189,802,2239,18,13,54,3,8,2387
6021010502,1457,1081,287,3,17,6,3,17,376
6023000100,4752,2740,993,133,189,232,65,30,2012
6023000200,6020,3651,1045,110,222,334,83,52,2369
6023000300,5520,3597,703,90,156,414,34,69,1923
6023000400,4100,2693,637,53,123,268,17,21,1407
6023000500,3626,2257,571,110,144,174,23,19,1369
6023000600,4977,3616,545,55,144,231,11,29,1361
6023000700,5496,4024,586,49,175,236,31,41,1472
6023000800,4868,3442,553,81,129,189,18,45,1426
6023000900,5149,4049,484,39,54,108,10,57,1100
6023001001,2865,1867,569,89,50,48,3,34,998
6023001002,3285,1902,862,154,47,65,17,20,1383
6023001102,5124,3472,850,88,142,138,16,53,1652
6023001103,1889,1367,251,39,37,32,1,15,522
6023001200,5141,3229,1092,97,138,129,4,43,1912
6023001300,1433,1054,148,23,42,12,10,17,379
6023010102,2914,1642,202,13,704,23,6,34,1272
6023010200,2921,2235,231,9,154,38,5,22,686
6023010300,3496,2744,223,22,160,18,8,27,752
6023010400,3814,2792,345,27,198,50,4,23,1022
6023010502,5577,4142,525,46,225,85,10,47,1435
6023010503,3858,2660,501,52,156,76,4,41,1198
6023010504,3438,2549,346,16,162,50,3,13,889
6023010600,1849,1536,112,7,27,17,1,22,313
6023010701,4341,3069,554,67,183,118,19,27,1272
6023010702,2570,1892,281,14,69,75,0,14,678
6023010800,4910,3281,870,46,314,38,7,52,1629
6023010901,4725,2944,1246,30,112,68,3,32,1781
6023010902,4074,3198,323,12,139,29,0,34,876
6023011000,4625,3349,792,9,114,51,10,17,1276
6023011100,4724,3424,692,59,142,34,6,25,1300
6023011200,3275,2625,342,13,45,25,0,21,650
6023011501,2474,1846,339,36,29,19,1,28,628
6023011502,1638,1294,131,7,25,23,0,19,344
6023011600,3822,2873,460,33,101,45,6,41,949
6023940000,3173,261,131,1,2603,3,0,7,2912
6023990100,0,0,0,0,0,0,0,0,0
6025010101,3499,478,1925,964,50,31,4,11,3021
6025010102,4738,451,4062,98,11,29,10,4,4287
6025010200,2293,283,1965,11,1,12,0,0,2010
6025010300,802,302,494,0,0,1,1,0,500
6025010401,2748,104,2558,57,1,6,1,6,2644
6025010402,4367,128,4169,36,1,9,2,12,4239
6025010500,6714,763,5666,93,9,86,0,23,5951
6025010600,7985,1621,6001,70,16,132,6,19,6364
6025010700,4713,166,4460,49,3,3,1,9,4547
6025010800,1297,478,741,2,6,13,3,10,819
6025010900,6403,876,5391,23,6,19,1,13,5527
6025011001,6362,811,5254,103,16,92,8,11,5551
6025011002,9436,1436,7486,135,17,224,5,29,8000
6025011100,3293,658,2417,97,10,31,1,15,2635
6025011201,8254,1050,6743,103,13,210,3,31,7204
6025011202,5508,267,5103,49,9,36,3,24,5241
6025011301,3549,68,3465,0,4,1,1,4,3481
6025011302,1672,101,1538,8,4,5,0,3,1571
6025011303,4551,244,4215,24,11,21,1,16,4307
6025011400,4476,135,4069,218,0,18,1,12,4341
6025011500,6059,290,5543,104,13,60,0,18,5769
6025011600,6615,445,5982,73,4,17,0,28,6170
6025011700,5046,443,4451,53,13,34,4,13,4603
6025011801,3982,855,2935,22,10,93,0,13,3127
6025011802,5245,604,4423,113,11,44,4,2,4641
6025011803,6175,726,5018,76,7,262,3,33,5449
6025011901,2289,50,2207,8,0,13,0,3,2239
6025011902,3927,43,3869,0,0,5,4,2,3884
6025011903,5400,143,4798,37,0,394,0,19,5257
6025012001,3801,35,3737,1,0,9,0,12,3766
6025012003,3882,73,3652,6,0,125,0,13,3809
6025012004,5935,72,5770,8,2,52,0,16,5863
6025012101,3563,89,3412,9,3,30,0,10,3474
6025012102,3455,46,3373,0,1,14,0,15,3409
6025012201,4139,51,4045,7,0,23,0,9,4088
6025012202,3294,19,3257,0,0,5,0,3,3275
6025012301,4493,650,2583,1082,37,43,7,17,3843
6025012302,6288,894,5137,72,34,31,4,13,5394
6025012400,756,503,170,27,14,2,2,2,253
6025940000,2698,362,943,8,1247,9,2,26,2336
6027000100,2943,1876,848,4,40,44,0,4,1067
6027000200,1698,1244,261,36,43,16,0,8,454
6027000300,2642,2098,294,6,41,52,0,16,544
6027000400,5792,2531,1548,9,1298,95,3,30,3261
6027000500,2606,1487,423,3,493,28,4,15,1119
6027000800,3335,1799,1025,27,274,38,6,14,1536
6029000102,3422,2240,857,50,43,6,2,14,1182
6029000103,3816,2425,1012,61,63,14,0,22,1391
6029000104,1654,1041,434,45,5,22,2,12,613
6029000105,5340,3302,1442,102,37,116,4,39,2038
6029000106,2665,1489,857,76,33,53,11,20,1176
6029000201,4449,2411,1561,134,58,31,7,12,2038
6029000202,3797,2211,1263,60,28,31,1,3,1586
6029000300,4630,2681,1547,130,38,36,4,12,1949
6029000400,4757,2367,1821,210,87,26,0,15,2390
6029000504,4615,2808,1321,158,38,65,8,29,1807
6029000505,3738,2486,856,44,23,70,0,46,1252
6029000506,2323,1175,686,78,16,263,6,25,1148
6029000507,3757,2101,1276,65,34,73,4,53,1656
6029000508,1920,1387,372,29,6,19,0,0,533
6029000509,2659,1674,581,31,12,210,0,11,985
6029000510,4223,2295,1293,53,24,313,0,21,1928
6029000601,2453,874,1072,305,22,72,0,4,1579
6029000602,2939,467,1648,604,28,38,7,22,2472
6029000603,2316,400,1390,429,12,14,3,15,1916
6029000701,2927,864,1786,93,28,48,3,10,2063
6029000702,2504,1085,1233,44,4,54,1,7,1419
6029000800,5600,1278,3836,220,42,58,6,20,4322
6029000902,3891,1029,2442,180,39,82,1,12,2862
6029000903,4347,1281,2571,132,33,155,5,43,3066
6029000904,4239,1014,2762,165,26,112,21,21,3225
6029000905,2631,492,1953,87,12,14,0,17,2139
6029000906,4504,718,3495,106,29,23,0,22,3786
6029000907,2600,456,1948,95,25,21,0,11,2144
6029000908,5429,1583,3269,209,39,120,19,40,3846
6029000909,2618,1245,1074,53,18,99,1,11,1373
6029000911,2756,727,1595,231,20,65,5,29,2029
6029000912,3349,1029,2041,82,12,84,7,19,2320
6029000913,3743,1541,1489,145,24,351,3,29,2202
6029000914,4129,1568,2016,210,32,125,8,24,2561
6029001001,3743,1138,2330,40,17,113,6,20,2605
6029001002,3441,464,2790,57,24,21,2,24,2977
6029001003,3692,487,2991,73,29,36,0,13,3205
6029001101,5368,650,4413,168,35,24,2,10,4718
6029001104,2876,246,2459,72,32,7,1,8,2630
6029001105,3652,269,3244,60,19,17,0,16,3383
6029001106,2279,137,2023,65,20,8,2,9,2142
6029001107,2647,163,2357,88,12,6,0,5,2484
6029001201,2892,203,2495,130,23,3,0,10,2689
6029001202,6099,418,5104,413,20,22,0,5,5681
6029001301,5276,338,4448,361,22,14,0,18,4938
6029001302,2451,292,1720,323,31,5,1,17,2159
6029001401,4750,577,3733,270,17,32,5,23,4173
6029001402,3088,333,2456,188,21,15,2,16,2755
6029001500,2944,291,2341,226,20,10,0,4,2653
6029001600,2510,583,1331,318,28,129,8,22,1927
6029001700,4299,2298,1432,179,24,89,5,27,2001
6029001801,5514,1553,2999,501,41,172,9,29,3961
6029001803,2754,1382,919,163,25,107,6,28,1372
6029001804,3144,1277,1286,233,24,179,11,11,1867
6029001901,3883,1225,2104,198,17,156,2,18,2658
6029001902,4802,1255,2903,362,42,56,2,30,3547
6029002001,3344,241,2141,773,28,53,15,10,3103
6029002002,4392,420,2983,720,36,93,1,28,3972
6029002100,3504,190,3004,228,11,4,0,20,3314
6029002201,2753,45,2320,321,11,0,0,15,2708
6029002202,3761,193,2982,515,9,5,1,10,3568
6029002302,3173,102,2884,124,23,6,4,8,3071
6029002303,3660,312,3067,147,19,22,2,20,3348
6029002304,3244,175,2901,110,8,9,2,9,3069
6029002305,2660,139,2444,41,15,2,3,5,2521
6029002401,2291,418,1758,26,7,37,3,4,1873
6029002402,3797,365,3050,122,28,123,0,28,3432
6029002403,3116,310,2359,320,9,44,0,26,2806
6029002501,4576,301,3639,503,15,22,0,5,4275
6029002502,2256,40,2033,156,4,2,0,6,2216
6029002503,2636,44,2265,262,18,7,1,16,2592
6029002600,3439,295,2780,253,21,40,0,3,3144
6029002701,2906,484,2114,194,14,29,0,8,2422
6029002702,3020,507,2107,267,8,53,0,15,2513
6029002804,2763,1777,692,89,27,69,1,17,986
6029002806,2285,1210,540,99,12,322,4,3,1075
6029002807,4026,2414,1054,133,16,182,8,27,1612
6029002811,3905,2232,562,92,8,809,1,41,1673
6029002813,4611,1003,2542,629,21,257,1,10,3608
6029002814,4532,987,2584,583,31,156,11,46,3545
6029002815,4392,963,2462,628,17,151,0,31,3429
6029002816,5700,1216,3632,472,39,168,13,32,4484
6029002817,5145,1288,2694,683,26,227,15,30,3857
6029002818,4022,1892,1516,304,24,117,13,25,2130
6029002819,4873,1725,2280,370,16,199,16,30,3148
6029002820,6690,2385,2718,397,39,776,12,44,4305
6029002821,4751,1884,2188,275,17,168,3,19,2867
6029002822,3407,1891,949,100,22,295,1,13,1516
6029002823,4256,1630,1733,273,38,362,4,26,2626
6029002824,2883,523,1725,430,18,66,1,11,2360
6029002825,2565,748,1431,218,30,45,3,20,1817
6029002901,3074,444,2261,213,11,72,2,12,2630
6029002902,4427,725,2790,588,25,130,1,46,3702
6029003001,4141,410,3263,323,9,31,12,20,3731
6029003002,3294,312,2693,164,6,48,0,5,2982
6029003103,4822,507,4077,100,13,54,1,10,4315
6029003112,5365,1119,3145,533,36,332,2,36,4246
6029003113,4904,652,3376,454,11,277,4,49,4252
6029003124,5802,1359,3316,297,32,609,0,33,4443
6029003125,3194,416,2302,251,17,126,0,29,2778
6029003126,5437,615,3883,577,20,202,8,29,4822
6029003127,4813,381,4010,263,17,80,1,17,4432
6029003128,4746,381,3868,280,12,119,6,6,4365
6029003129,3787,983,1778,247,12,580,10,12,2804
6029003130,4246,1050,2243,325,11,473,5,22,3196
6029003131,3715,1012,1826,315,16,372,8,23,2703
6029003132,4586,876,2961,341,19,272,16,18,3710
6029003133,3176,1032,1810,176,17,55,4,11,2144
6029003134,3698,880,1211,319,22,1110,7,36,2818
6029003135,4082,914,2068,244,14,689,3,19,3168
6029003136,2041,302,1540,76,13,52,3,11,1739
6029003137,3453,344,2676,254,9,69,2,12,3109
6029003203,2294,1382,699,38,36,34,0,6,912
6029003207,4934,315,3969,223,11,339,4,33,4619
6029003208,7852,533,6305,345,15,516,10,53,7319
6029003209,3686,574,2187,239,12,540,1,23,3112
6029003210,5917,976,3237,373,22,1110,5,28,4941
6029003211,4533,530,2844,208,13,825,7,35,4003
6029003212,6669,2836,1454,237,32,1794,12,55,3833
6029003213,2065,946,616,60,8,340,5,10,1119
6029003214,2516,327,1945,74,1,117,1,12,2189
6029003215,3726,842,2584,110,19,72,2,21,2884
6029003216,3167,423,2178,191,20,298,2,6,2744
6029003217,3152,526,1746,201,8,574,1,25,2626
6029003218,6298,797,2758,282,30,2172,16,84,5501
6029003219,6685,963,3738,416,13,1342,22,40,5722
6029003220,4804,1316,2411,206,15,661,3,51,3488
6029003221,4636,1595,1539,236,15,1040,5,24,3041
6029003222,1693,877,675,24,9,48,4,6,816
6029003303,1257,782,355,14,35,7,2,0,475
6029003304,3732,1615,1758,113,37,66,0,29,2117
6029003305,3367,2277,842,22,23,44,4,12,1090
6029003307,2605,1837,473,30,23,62,4,37,768
6029003308,2099,1356,570,15,10,44,0,7,743
6029003400,4380,1458,2743,21,12,13,2,25,2922
6029003500,6686,3657,2582,29,47,78,30,17,3029
6029003600,4553,2038,2209,25,47,15,20,12,2515
6029003806,5285,2861,1354,140,27,609,4,31,2424
6029003807,3589,2280,923,46,56,72,5,20,1309
6029003808,4504,2272,1463,190,30,290,17,30,2232
6029003810,2531,1647,517,74,25,123,2,2,884
6029003811,2729,1617,755,68,13,107,1,7,1112
6029003812,4948,2478,1545,168,17,502,9,28,2470
6029003814,6293,3265,2068,161,32,443,16,31,3028
6029003815,6087,2995,2064,172,42,505,2,43,3092
6029003816,3522,1931,1181,83,21,150,1,24,1591
6029003817,4158,2433,1215,95,25,179,1,14,1725
6029003818,5162,2777,1515,92,22,491,3,22,2385
6029003819,3851,2217,925,92,27,352,5,18,1634
6029003820,3740,2296,762,78,18,406,1,18,1444
6029003821,4606,2403,1315,169,19,482,6,26,2203
6029003822,3206,1946,849,65,5,153,3,38,1260
6029003823,4184,2837,892,69,43,108,3,14,1347
6029003824,2279,1414,585,53,21,88,1,26,865
6029003825,2982,1590,889,34,17,264,5,27,1392
6029003826,3325,2003,875,69,18,178,1,46,1322
6029003827,2445,1430,639,66,16,170,0,6,1015
6029003900,3702,1357,1759,319,9,179,10,16,2345
6029004001,4014,428,3297,172,15,18,5,5,3586
6029004002,4321,290,3916,29,2,15,1,18,4031
6029004101,5727,1368,4105,20,13,40,0,68,4359
6029004102,5234,341,4808,30,2,1,0,21,4893
6029004302,4356,769,2454,1022,18,27,2,8,3587
6029004303,5691,294,5228,103,8,17,1,5,5397
6029004304,3218,125,2991,32,10,42,0,3,3093
6029004305,1665,189,1418,36,0,5,0,0,1476
6029004402,4027,145,3697,125,13,16,8,5,3882
6029004403,3395,307,2997,45,11,5,2,5,3088
6029004404,4823,518,4138,70,12,23,1,17,4305
6029004500,3625,168,3428,6,0,8,0,7,3457
6029004601,4971,775,2683,1392,36,25,3,4,4196
6029004603,2483,304,1263,836,25,18,4,14,2179
6029004605,3326,282,2239,16,11,727,1,7,3044
6029004606,2605,66,1914,8,4,577,3,11,2539
6029004607,5765,66,5050,27,15,549,8,20,5699
6029004702,3763,51,3687,1,2,0,1,14,3712
6029004703,4664,198,4293,66,12,64,0,4,4466
6029004704,5912,186,5626,11,4,51,2,21,5726
6029004801,4007,39,3471,18,4,431,6,7,3968
6029004802,6193,156,5366,92,13,508,3,22,6037
6029004901,5413,131,4208,34,11,976,0,11,5282
6029004903,4823,111,3447,18,4,1169,1,4,4712
6029004904,3009,89,1941,12,5,899,0,6,2920
6029005003,3512,149,2833,61,8,414,6,3,3363
6029005005,4204,200,3552,164,23,226,3,2,4004
6029005006,3434,276,2444,26,4,615,3,14,3158
6029005103,2726,1992,535,25,36,32,2,4,734
6029005104,4167,2707,993,73,22,200,3,17,1460
6029005203,4041,3218,409,15,102,39,4,11,823
6029005205,3577,2626,529,21,74,36,3,17,951
6029005206,2582,2071,275,27,37,22,5,11,511
6029005207,2327,1811,269,11,64,27,3,13,516
6029005208,3212,2584,303,4,63,22,5,29,628
6029005300,2104,936,644,227,16,85,27,17,1168
6029005402,5000,3171,923,185,19,297,24,24,1829
6029005405,2458,1272,804,121,13,94,8,18,1186
6029005406,3514,2387,511,122,28,239,12,15,1127
6029005407,4152,2513,1008,123,22,154,24,12,1639
6029005408,4669,2789,1018,190,42,225,35,37,1880
6029005409,4725,2891,1014,178,19,210,21,22,1834
6029005410,1816,1208,346,59,3,54,9,4,608
6029005508,4731,1652,1624,1038,26,112,11,24,3079
6029005509,4150,2947,620,85,39,167,5,24,1203
6029005510,2216,1562,320,17,30,37,4,14,654
6029005511,5071,1598,1704,1159,33,146,20,43,3473
6029005512,3009,1105,859,661,15,92,12,24,1904
6029005513,2549,972,1204,186,22,57,0,14,1577
6029005514,3428,1807,1299,78,21,30,8,14,1621
6029005600,2086,1145,542,167,28,44,5,11,941
6029005700,2332,1319,457,214,4,95,24,16,1013
6029005803,3344,1040,1620,397,47,60,7,9,2304
6029005804,5271,1492,2553,738,37,127,2,31,3779
6029005805,2645,1150,968,184,9,109,2,22,1495
6029005806,4722,1852,1716,504,12,255,25,14,2870
6029005900,4163,1178,1776,908,42,58,5,39,2985
6029006002,3660,868,1790,867,44,32,3,12,2792
6029006003,5804,3517,1669,97,53,82,6,52,2287
6029006004,1587,1142,331,14,27,23,2,4,445
6029006006,3774,2775,642,35,31,52,2,25,999
6029006009,2781,2198,345,36,15,28,0,19,583
6029006010,3689,2916,471,52,20,60,1,12,773
6029006011,3508,2504,688,39,25,57,2,18,1004
6029006012,2557,1771,512,21,22,65,4,19,786
6029006101,3804,2191,1202,77,28,62,9,32,1613
6029006102,5185,2958,1666,75,15,157,9,38,2227
6029006201,2587,443,2010,11,17,26,0,25,2144
6029006202,7006,308,6549,15,0,54,2,9,6698
6029006301,3732,186,3477,20,11,11,0,4,3546
6029006303,6062,207,5676,108,5,22,2,19,5855
6029006304,4022,209,3751,16,8,12,2,6,3813
6029006403,5468,177,5234,3,5,10,0,19,5291
6029006404,3036,125,2870,4,5,10,0,4,2911
6029006405,2997,92,2858,0,9,23,0,0,2905
6029006406,4413,73,4309,6,0,5,0,9,4340
6029006500,4350,1488,1958,617,36,79,9,19,2862
6029006600,4831,1223,3399,38,35,18,0,28,3608
6031000100,2916,1600,1154,19,12,43,1,20,1316
6031000200,2150,1174,813,41,16,28,2,6,976
6031000402,6299,2476,2774,292,50,371,10,37,3823
6031000403,5297,1748,2432,327,59,425,14,21,3549
6031000405,7274,1983,3811,432,77,584,35,20,5291
6031000406,3329,948,1742,161,13,281,18,3,2381
6031000407,6893,2335,3200,338,49,571,23,63,4558
6031000500,5572,1467,3679,124,14,109,3,29,4105
6031000602,5847,3035,1995,277,50,184,12,50,2812
6031000603,2960,1232,1051,110,19,405,5,12,1728
6031000604,7930,3488,3282,298,43,405,13,39,4442
6031000701,5522,2828,2100,101,31,156,6,47,2694
6031000702,4585,1919,2204,143,14,113,2,25,2666
6031000800,4819,1343,3080,132,33,84,3,10,3476
6031000901,4404,1479,2504,135,35,70,6,23,2925
6031000902,3198,774,2110,156,14,52,1,5,2424
6031001001,5753,2225,2385,328,66,412,15,36,3528
6031001002,4453,664,3260,247,24,125,3,15,3789
6031001003,7096,1210,5076,274,22,274,9,22,5886
6031001100,6179,701,4676,459,32,107,19,44,5478
6031001200,2397,1119,1161,12,27,21,3,14,1278
6031001300,4379,458,3555,230,20,24,5,7,3921
6031001401,2846,179,2554,50,12,12,0,16,2667
6031001402,2160,247,1816,45,10,18,1,6,1913
6031001500,4743,633,3838,120,13,45,0,26,4110
6031001601,4283,509,2984,32,665,6,3,22,3774
6031001702,4898,233,4579,9,6,18,0,9,4665
6031001703,4549,203,4277,7,14,6,1,11,4346
6031980000,6656,3095,1572,880,52,417,80,34,3561
6031980100,8811,1763,4225,2435,142,86,26,24,7048
6031981800,4288,1293,2718,86,56,59,12,17,2995
6033000100,3284,2117,621,22,283,32,0,30,1167
6033000300,4045,2875,780,42,78,65,4,21,1170
6033000401,3115,2155,612,34,63,68,2,8,960
6033000402,2775,1883,577,25,65,67,3,14,892
6033000501,3416,2297,654,33,93,55,8,25,1119
6033000502,2901,1890,500,49,111,63,10,25,1011
6033000601,2342,1700,303,73,32,45,2,21,642
6033000602,2078,1440,244,51,72,60,0,9,638
6033000702,4757,2403,1826,147,59,23,12,24,2354
6033000703,2416,1457,627,67,61,13,0,13,959
6033000704,2158,1253,582,105,26,14,0,22,905
6033000801,2956,1776,769,92,66,31,6,7,1180
6033000802,4671,2451,1628,150,83,77,5,27,2220
6033000901,2598,1828,469,59,35,30,1,14,770
6033000902,4118,2947,695,69,52,101,4,26,1171
6033001000,6102,3277,2096,21,392,35,6,25,2825
6033001101,1763,1446,132,8,22,9,4,3,317
6033001102,1536,1223,142,7,26,11,0,13,313
6033001200,3414,2398,634,40,45,25,7,19,1016
6033001301,3605,2515,677,40,27,77,10,17,1090
6033001302,4113,2871,874,24,46,39,5,23,1242
6035040100,1627,1219,242,36,30,18,5,8,408
6035040200,2459,1988,234,13,54,7,4,2,471
6035040302,4343,3256,610,22,90,84,18,34,1087
6035040303,3204,2091,635,49,53,73,114,12,1113
6035040304,1804,1163,367,18,43,28,58,19,641
6035040305,4169,2657,705,73,315,97,39,19,1512
6035040400,8786,2645,3814,1781,198,92,39,16,6141
6035040500,3045,2478,287,4,46,18,4,12,567
6035040600,3293,2037,637,248,110,55,2,20,1256
6037101110,4926,2840,1381,65,7,434,8,14,2086
6037101122,3728,2614,542,31,7,392,0,23,1114
6037101220,3344,1751,1081,34,4,352,0,21,1593
6037101221,3444,1840,1178,73,3,246,3,10,1604
6037101222,2808,1455,1040,76,3,148,0,8,1353
6037101300,4269,3251,483,24,1,352,2,20,1018
6037101400,3898,2597,731,40,10,320,3,24,1301
6037102103,2107,1407,419,46,1,140,6,22,700
6037102104,3906,2719,556,83,1,399,1,16,1187
6037102105,1855,568,1028,20,1,177,0,10,1287
6037102107,3984,2328,1149,87,5,242,1,41,1656
6037103101,2712,1879,514,26,6,183,5,4,833
6037103102,4752,3026,1073,22,5,430,4,14,1726
6037103201,4676,2397,1691,110,11,279,5,23,2279
6037103202,2026,972,695,128,6,126,4,19,1054
6037103300,3953,2650,860,53,5,233,3,31,1303
6037103401,2516,1586,530,33,9,242,0,16,930
6037103402,4075,2378,1183,56,8,270,2,12,1697
6037104103,3811,416,2651,389,1,254,11,24,3395
6037104105,5999,376,4813,280,6,407,0,37,5623
6037104108,5829,274,4799,456,7,205,1,24,5555
6037104124,4333,1319,2210,387,0,257,14,39,3014
6037104201,4377,93,3876,297,0,63,1,16,4284
6037104203,4874,132,4381,209,1,102,0,14,4742
6037104204,3304,309,2526,189,0,219,0,24,2995
6037104310,4396,69,4153,107,10,26,0,13,4327
6037104321,3009,55,2763,84,13,79,0,5,2954
6037104322,2233,55,2012,99,7,31,1,10,2178
6037104401,3022,83,2872,19,3,13,1,21,2939
6037104403,2947,67,2772,11,4,79,0,7,2880
6037104404,3082,85,2911,21,7,30,0,7,2997
6037104500,3151,102,2954,20,5,44,1,10,3049
6037104610,3645,174,3348,54,3,32,0,13,3471
6037104620,3200,55,3088,12,11,18,0,7,3145
6037104701,4601,63,4336,131,1,31,0,3,4538
6037104703,2572,153,2171,93,4,109,0,1,2419
6037104704,4760,281,3758,407,2,239,3,30,4479
6037104821,3498,130,3160,47,4,123,5,19,3368
6037104822,2345,87,2045,22,0,156,2,13,2258
6037104823,3024,178,2387,34,3,383,12,6,2846
6037104824,2207,81,2040,21,4,40,1,4,2126
6037106010,3390,594,2375,118,14,190,4,34,2796
6037106020,5557,790,4368,88,17,194,2,32,4767
6037106111,4331,1029,2692,142,18,334,0,33,3302
6037106112,6201,917,4441,141,10,532,3,27,5284
6037106113,3939,509,3001,86,9,274,0,11,3430
6037106114,6643,505,5365,234,7,441,9,22,6138
6037106403,3704,260,3282,18,9,86,0,10,3444
6037106405,3968,411,3146,164,16,157,0,19,3557
6037106406,6173,1012,4477,162,14,387,1,28,5161
6037106407,2909,272,2303,200,7,90,0,21,2637
6037106408,3440,189,3008,66,22,112,0,14,3251
6037106510,5791,974,3919,295,8,442,3,31,4817
6037106520,5670,470,4975,72,14,87,0,23,5200
6037106603,2998,1708,494,91,5,570,4,17,1290
6037106604,5378,424,4419,190,18,220,5,36,4954
6037106641,2330,1520,296,40,3,378,1,13,810
6037106642,3316,1775,847,91,3,429,2,24,1541
6037106643,4084,2551,530,136,3,692,0,17,1533
6037106645,3501,2152,630,100,1,456,1,25,1349
6037106646,3367,1345,1107,99,4,692,4,17,2022
6037106648,4815,308,4162,124,15,141,5,17,4507
6037106649,2754,276,1867,66,0,488,1,17,2478
6037107010,3205,162,2934,21,3,57,0,11,3043
6037107020,5488,326,4629,79,1,353,0,27,5162
6037108101,2324,1282,262,78,0,578,3,23,1042
6037108102,3795,1869,501,75,0,1221,0,24,1926
6037108103,3190,1818,393,44,0,810,0,17,1372
6037108104,1692,944,199,42,0,413,0,10,748
6037108202,8701,2855,972,379,21,3973,4,60,5846
6037108203,3577,1409,339,136,4,1538,5,23,2168
6037108204,1857,644,142,55,2,944,0,5,1213
6037109100,2958,862,1683,81,13,282,1,5,2096
6037109200,3153,946,1310,146,5,612,8,12,2207
6037109300,3120,847,1575,103,8,462,9,11,2273
6037109400,3752,412,2878,67,13,306,8,16,3340
6037109500,4524,164,4092,55,10,128,4,16,4360
6037109601,4958,662,3600,138,7,472,3,2,4296
6037109603,4203,681,2750,135,22,513,4,28,3522
6037109604,2938,528,1968,86,14,268,1,21,2410
6037109700,4389,1503,1868,107,13,736,9,25,2886
6037109800,4679,1339,2285,108,4,756,0,41,3340
6037111100,3047,1096,1312,56,1,472,18,8,1951
6037111201,3609,1677,1169,73,4,526,3,25,1932
6037111202,5489,2461,1780,158,20,788,5,44,3028
6037111204,5865,2927,1074,198,9,1361,6,42,2938
6037111205,3864,1338,853,178,0,1333,14,29,2526
6037111206,4716,2225,1284,114,10,873,7,20,2491
6037111302,4633,1845,1373,233,9,934,8,42,2788
6037111303,4429,1667,1504,135,9,917,8,34,2762
6037111304,3359,805,1404,199,5,764,12,16,2554
6037111401,2406,840,890,92,5,472,1,19,1566
6037111402,5333,1947,2045,198,6,871,8,45,3386
6037113101,3461,1690,856,125,4,587,0,10,1771
6037113102,2971,1693,545,87,1,519,2,20,1278
6037113211,4275,2359,889,180,1,625,10,19,1916
6037113212,3211,1353,928,171,5,628,2,18,1858
6037113213,4589,1783,1347,274,8,963,0,29,2806
6037113231,2254,1356,350,84,3,287,6,7,898
6037113232,4297,2227,923,210,6,687,11,19,2070
6037113234,4542,1027,2367,176,1,834,7,16,3515
6037113235,1815,1022,498,64,7,102,2,20,793
6037113237,3921,1747,1042,279,7,647,14,25,2174
6037113238,5182,784,3105,361,12,693,15,34,4398
6037113239,2259,561,1259,107,4,253,3,12,1698
6037113301,3655,1720,734,300,4,688,3,36,1935
6037113303,4160,1644,1540,111,8,656,4,28,2516
6037113322,4251,1942,1027,191,9,887,20,20,2309
6037113323,3927,1072,1530,211,10,880,4,62,2855
6037113324,2072,510,875,153,0,428,3,18,1562
6037113423,2639,697,1223,60,1,568,4,9,1942
6037113424,3613,1273,1319,184,6,681,0,28,2340
6037113425,4020,584,2559,350,3,400,9,27,3436
6037113426,2479,571,1326,94,0,367,9,18,1908
6037113427,3024,588,1658,187,2,456,3,13,2436
6037113428,3397,1061,1391,138,8,668,4,13,2336
6037115101,5112,2902,1034,162,7,735,12,35,2210
6037115103,2345,465,1056,510,4,286,8,0,1880
6037115104,4409,1508,1360,308,5,947,1,106,2901
6037115202,5189,1567,2121,316,9,917,2,48,3622
6037115203,2793,856,941,265,4,564,5,31,1937
6037115204,4228,1461,1365,282,13,868,2,31,2767
6037115301,4236,1764,1136,222,2,880,13,28,2472
6037115302,4044,418,3048,95,3,416,4,4,3626
6037115401,5980,1740,2980,282,7,768,5,30,4240
6037115403,3245,657,1799,218,5,491,10,15,2588
6037115404,2956,579,1561,199,9,514,0,22,2377
6037117101,5195,682,2235,276,2,1836,9,16,4513
6037117102,2733,559,1603,80,5,413,0,21,2174
6037117201,4514,556,2966,252,2,626,22,33,3958
6037117202,2711,727,1006,183,5,664,6,21,1984
6037117301,3917,1507,1465,152,7,599,8,23,2410
6037117302,5414,2200,1860,249,3,876,7,42,3214
6037117303,3647,1222,1624,115,6,538,0,25,2425
6037117404,4548,1407,1821,189,1,949,17,26,3141
6037117405,3364,147,2919,164,4,80,3,18,3217
6037117407,3482,70,3173,86,5,97,0,30,3412
6037117408,2843,193,2188,150,7,229,3,36,2650
6037117510,4181,254,3451,91,3,320,1,32,3927
6037117520,3961,157,3338,171,6,228,0,21,3804
6037117530,5888,379,4284,224,4,923,7,25,5509
6037119001,4024,328,2928,20,20,652,2,21,3696
6037119003,3893,171,3470,36,3,182,2,7,3722
6037119004,2830,187,2290,21,0,282,2,23,2643
6037119201,3866,287,3277,15,0,232,1,11,3579
6037119202,4394,208,3823,55,8,268,5,13,4186
6037119310,3983,474,2666,143,6,617,0,26,3509
6037119320,4793,410,3303,159,0,834,10,27,4383
6037119340,3600,108,3260,87,4,103,3,9,3492
6037119341,2867,320,1627,106,3,755,3,3,2547
6037119342,3076,191,2388,70,6,363,2,23,2885
6037119400,4881,363,4047,57,13,336,0,22,4518
6037119700,4893,1365,2334,39,4,1041,9,21,3528
6037119801,2933,290,2270,17,2,302,5,6,2643
6037119802,3016,312,2239,29,3,395,0,5,2704
6037119900,4774,579,2969,71,6,1079,5,19,4195
6037120010,2892,263,2188,70,9,303,13,15,2629
6037120020,4037,193,2958,58,5,764,0,18,3844
6037120030,2591,170,2246,27,6,104,2,19,2421
6037120103,3123,117,2849,37,0,89,0,8,3006
6037120104,2327,223,1468,167,12,419,2,18,2104
6037120105,2855,270,2010,74,8,445,1,19,2585
6037120106,4377,196,3344,101,4,682,0,22,4181
6037120107,3760,212,3185,115,2,191,4,27,3548
6037120108,5263,412,3978,227,8,565,2,32,4851
6037120300,5550,1106,3124,108,12,1079,0,32,4444
6037120400,6614,1167,3687,176,6,1437,5,38,5447
6037121010,4693,1402,2676,62,6,456,6,19,3291
6037121020,3781,1236,1974,92,8,366,5,20,2545
6037121101,2936,675,1867,79,8,242,1,17,2261
6037121102,2846,1116,1441,51,5,152,0,21,1730
6037121210,3182,361,2201,45,6,507,3,11,2821
6037121221,2147,233,1711,34,5,139,0,8,1914
6037121222,5376,348,4689,66,6,216,0,33,5028
6037121600,2996,1256,975,66,3,629,7,5,1740
6037121801,3854,579,2679,207,0,295,1,31,3275
6037121802,3192,741,2033,99,6,239,3,18,2451
6037121900,3921,581,2916,68,7,281,1,15,3340
6037122000,5289,2462,1858,80,13,771,6,15,2827
6037122120,4559,524,3704,59,3,210,6,15,4035
6037122121,2629,338,1978,45,6,218,5,2,2291
6037122122,2750,325,2161,74,3,60,1,97,2425
6037122200,4064,629,3169,29,7,146,3,25,3435
6037122410,3824,383,2897,230,3,239,1,19,3441
6037122420,4623,563,3512,151,3,301,10,23,4060
6037123010,4253,394,3610,86,8,99,6,22,3859
6037123020,3177,396,2565,27,1,150,3,11,2781
6037123103,4285,1139,2396,212,6,397,9,20,3146
6037123104,4309,1143,2608,170,7,255,8,21,3166
6037123203,3508,488,2648,178,1,130,0,10,3020
6037123204,3125,594,2228,125,5,118,0,14,2531
6037123205,2503,376,1920,78,1,88,4,7,2127
6037123206,2857,259,2411,54,11,90,0,4,2598
6037123301,4424,1348,1682,335,3,893,7,24,3076
6037123303,3091,968,1761,77,3,224,0,10,2123
6037123304,4518,1856,2215,148,4,185,5,12,2662
6037123410,3967,1397,2171,105,4,221,4,21,2570
6037123420,4481,1563,2407,102,0,299,0,24,2918
6037123510,4938,2028,2229,201,3,318,2,36,2910
6037123520,2669,1137,1227,78,6,143,15,11,1532
6037123601,4985,2717,1665,175,13,220,1,32,2268
6037123602,3433,1713,1261,147,3,197,3,18,1720
6037123700,4142,2441,1143,120,4,310,0,18,1701
6037123800,5757,3433,1486,287,17,281,17,39,2324
6037123901,4621,1585,2338,255,4,310,3,14,3036
6037123902,2596,1267,751,159,3,258,10,16,1329
6037124000,4786,3380,670,185,3,240,4,43,1406
6037124102,3627,1251,1805,194,2,231,4,30,2376
6037124103,1857,442,1237,48,8,83,0,14,1415
6037124104,2519,637,1534,153,1,110,0,21,1882
6037124105,2425,725,1410,81,3,130,1,9,1700
6037124201,3391,1059,1829,90,3,288,1,21,2332
6037124203,2450,557,1677,64,8,89,0,14,1893
6037124204,2753,744,1616,137,6,119,14,18,2009
6037124300,3830,1016,2373,107,3,198,2,18,2814
6037124400,4308,2825,905,152,6,171,3,89,1483
6037124500,2880,1757,626,132,6,205,0,22,1123
6037124600,3223,2065,564,174,6,249,0,20,1158
6037124700,5343,3625,790,328,14,326,3,39,1718
6037124902,2893,1572,731,201,7,239,6,16,1321
6037124903,3630,2044,827,260,9,247,4,28,1586
6037125101,3979,2202,877,305,8,340,4,29,1777
6037125102,2280,1489,365,115,8,141,1,5,791
6037125200,4014,2089,1145,268,4,274,5,25,1925
6037125310,4941,1913,1818,556,10,331,7,52,3028
6037125321,3049,1179,1045,295,12,323,0,18,1870
6037125322,2222,1090,490,324,0,173,6,10,1132
6037125402,4076,2245,876,328,12,310,6,31,1831
6037125403,2181,1073,562,223,4,171,3,15,1108
6037125404,3133,1512,656,474,7,250,4,22,1621
6037125501,3249,1773,843,238,2,221,6,19,1476
6037125502,3572,2152,629,247,10,304,0,25,1420
6037125600,2599,1828,398,99,4,143,5,15,771
6037127102,5450,1205,3153,331,7,566,12,33,4245
6037127103,3203,892,1808,164,5,198,4,32,2311
6037127104,4140,1408,2153,165,0,261,8,43,2732
6037127210,5453,1225,3060,339,6,630,4,50,4228
6037127220,4993,1096,2959,229,11,538,5,46,3897
6037127300,3735,1040,1881,198,19,429,13,27,2695
6037127400,5529,901,3955,235,10,259,1,40,4628
6037127520,4226,364,3189,251,10,320,2,23,3862
6037127603,2949,448,2141,93,1,172,5,28,2501
6037127604,3194,845,1756,195,1,289,1,17,2349
6037127605,3314,468,2468,143,8,137,2,33,2846
6037127606,3253,809,1891,169,4,272,5,24,2444
6037127711,3434,970,1948,143,1,207,0,36,2464
6037127712,3894,934,2263,270,3,261,5,28,2960
6037127803,5076,1252,2940,289,2,400,4,56,3824
6037127804,4422,1218,2243,342,9,459,1,31,3204
6037127805,3514,856,2141,195,2,224,6,25,2658
6037127806,3505,862,2040,193,6,269,3,30,2643
6037127910,5209,1105,3529,156,3,304,0,22,4104
6037127920,4212,1502,2225,121,5,230,6,28,2710
6037128101,3635,1613,1616,85,6,170,18,26,2022
6037128102,4874,997,3235,253,2,273,7,36,3877
6037128210,4809,704,3483,295,10,185,1,31,4105
6037128220,3087,1372,1299,136,4,148,12,18,1715
6037128302,4654,682,3471,186,5,200,0,17,3972
6037128303,3876,472,2985,111,3,203,0,23,3404
6037128400,4516,2157,1485,238,4,364,0,31,2359
6037128500,4294,2569,874,225,8,369,4,36,1725
6037128601,4379,1746,2020,226,3,210,2,22,2633
6037128602,3422,2150,709,137,5,218,4,30,1272
6037128703,3317,2078,513,242,3,256,4,33,1239
6037128704,2594,1641,453,119,8,199,2,27,953
6037128801,3805,2067,704,364,8,404,1,37,1738
6037128802,4673,2614,993,295,2,471,1,32,2059
6037128910,4384,2670,715,250,5,429,7,39,1714
6037131021,2972,618,1736,93,1,428,0,30,2354
6037131022,3491,619,2104,190,6,458,1,30,2872
6037131023,2628,504,1587,87,4,376,0,16,2124
6037131024,3422,769,2057,122,7,366,1,14,2653
6037131100,3264,1313,1374,97,2,335,3,26,1951
6037131200,3549,1380,1506,129,1,381,0,28,2169
6037131300,4854,946,2918,152,4,679,8,22,3908
6037131400,6149,1559,2829,337,6,1141,9,52,4590
6037131600,5366,1327,3022,141,10,711,7,21,4039
6037131701,4794,1216,2062,295,9,1001,2,31,3578
6037131702,3602,865,1974,183,6,455,0,18,2737
6037131801,3104,625,1864,102,5,408,1,18,2479
6037131802,2552,723,1350,80,6,326,0,17,1829
6037131900,4382,1537,2059,120,0,495,0,27,2845
6037132001,3335,1575,1144,146,1,279,0,22,1760
6037132002,3193,1370,1327,76,5,263,4,16,1823
6037132101,4330,1295,2150,229,2,452,2,47,3035
6037132102,5618,1714,2737,335,10,595,4,43,3904
6037132301,3577,893,1867,139,2,520,1,24,2684
6037132302,3005,723,1896,73,4,212,4,10,2282
6037132501,4357,1382,2173,164,16,476,2,20,2975
6037132502,4252,1527,1811,143,8,553,0,44,2725
6037132700,5038,1444,2929,147,8,356,2,14,3594
6037132900,3538,2078,857,106,3,282,1,10,1460
6037133000,4424,1098,2439,186,4,506,8,54,3326
6037133101,2091,1071,633,84,2,178,1,11,1020
6037133102,3376,1491,1197,167,19,349,3,24,1885
6037134001,3708,327,2827,90,1,410,0,22,3381
6037134002,3483,637,1996,177,6,555,4,22,2846
6037134101,4991,1159,2171,201,8,1296,3,12,3832
6037134103,4294,1209,1965,142,5,827,6,19,3085
6037134104,4429,820,1917,247,8,1244,12,43,3609
6037134201,4271,1028,2296,127,5,646,2,44,3243
6037134302,3746,1638,1000,128,10,714,3,47,2108
6037134303,5166,1938,1895,168,8,884,8,17,3228
6037134304,3001,1069,973,130,5,674,2,16,1932
6037134305,3769,272,3024,132,4,264,5,25,3497
6037134306,3553,754,1785,224,6,624,3,28,2799
6037134421,3851,2604,433,82,2,491,0,23,1247
6037134422,4959,2613,894,210,9,970,3,27,2346
6037134423,3338,1954,565,97,8,515,1,12,1384
6037134424,2862,1890,243,74,0,540,0,13,972
6037134520,5601,750,3958,189,4,497,2,62,4851
6037134521,2972,115,2627,56,5,132,3,11,2857
6037134522,4015,529,2869,140,12,364,2,16,3486
6037134710,5183,668,3593,190,13,559,8,49,4515
6037134720,5011,1053,2553,250,8,950,11,37,3958
6037134801,3177,891,1434,142,6,568,2,33,2286
6037134802,3196,869,1669,111,8,427,0,12,2327
6037134901,3266,1723,912,134,7,294,5,28,1543
6037134904,4368,1197,2347,209,11,406,4,19,3171
6037134905,5219,2695,757,701,9,706,3,47,2524
6037134906,3115,653,1653,207,5,441,2,41,2462
6037134907,2953,1293,554,423,1,456,10,21,1660
6037135102,3612,1993,738,154,4,461,10,40,1619
6037135111,3118,1591,800,139,4,396,3,26,1527
6037135113,3240,1535,537,319,8,608,0,47,1705
6037135115,4698,1710,523,214,3,1958,8,45,2988
6037135116,1718,886,327,152,6,244,1,7,832
6037135201,2592,1526,393,75,5,410,1,25,1066
6037135202,4399,2514,784,104,8,708,5,39,1885
6037135204,4791,2873,850,142,4,677,0,24,1918
6037135205,2342,1625,177,39,0,338,0,16,717
6037137000,4754,3395,536,131,2,370,5,30,1359
6037137103,4951,2827,794,311,14,698,0,30,2124
6037137104,2725,2018,254,89,5,195,0,18,707
6037137202,3588,2009,540,230,7,544,4,26,1579
6037137203,2416,1508,458,63,1,197,4,7,908
6037137301,2238,1578,294,53,5,180,1,15,660
6037137302,4341,3092,423,104,4,463,4,33,1249
6037137401,4708,3169,621,180,15,378,4,43,1539
6037137402,5663,3913,666,283,7,431,0,46,1750
6037137501,4662,3002,587,368,1,387,1,33,1660
6037137502,4441,3109,555,148,4,316,4,42,1332
6037137504,1920,1531,118,51,0,105,0,11,389
6037138000,4575,3451,424,119,7,307,0,53,1124
6037139001,5125,3086,1089,239,4,374,9,28,2039
6037139200,5519,3381,1122,250,9,422,6,36,2138
6037139301,4692,3253,595,163,7,377,0,48,1439
6037139302,4734,2091,1538,372,7,426,5,40,2643
6037139303,4481,2308,1336,278,2,328,5,29,2173
6037139401,2894,1712,606,156,9,217,6,22,1182
6037139402,2782,2264,188,51,0,132,0,18,518
6037139502,3118,2433,287,50,1,138,2,20,685
6037139504,3742,2595,463,196,1,221,1,21,1147
6037139505,2565,1668,423,126,0,192,0,20,897
6037139506,2767,1835,408,124,1,212,3,25,932
6037139600,5185,3709,556,222,6,389,7,38,1476
6037139701,5438,4116,453,136,7,406,3,54,1322
6037139703,2693,2162,142,35,3,179,0,17,531
6037139704,2624,2035,152,52,8,185,1,10,589
6037139705,3643,2914,203,47,0,253,0,19,729
6037139801,3523,2915,193,76,1,156,5,9,608
6037139802,3858,3127,260,73,2,227,0,20,731
6037141101,4903,3186,747,267,13,337,5,57,1717
6037141102,3023,2057,425,158,5,187,2,19,966
6037141201,4289,2634,805,275,3,312,7,21,1655
6037141202,2922,2130,317,99,2,176,1,41,792
6037141303,3191,2017,502,181,3,276,8,16,1174
6037141304,3015,2146,371,135,1,179,1,28,869
6037141305,2986,1918,447,185,0,218,7,30,1068
6037141306,2974,2004,395,142,2,275,7,15,970
6037141400,4705,3318,588,154,1,390,3,38,1387
6037141500,3089,2444,210,47,2,226,2,8,645
6037141600,4088,3211,283,50,0,304,2,18,877
6037141700,3096,2386,210,69,2,226,2,16,710
6037143101,2142,1485,327,82,0,114,0,15,657
6037143102,2294,1447,385,144,3,172,2,16,847
6037143200,4377,2490,910,283,17,386,5,35,1887
6037143301,3236,1831,767,171,9,234,6,29,1405
6037143302,3367,2322,434,123,0,285,1,16,1045
6037143401,4632,3248,542,224,5,319,4,24,1384
6037143402,1791,1237,227,58,2,136,4,7,554
6037143500,5197,3713,585,157,0,350,0,36,1484
6037143602,4740,3366,501,203,4,369,4,50,1374
6037143603,2482,1602,334,130,6,248,5,25,880
6037143605,1945,1027,300,164,6,275,5,29,918
6037143606,1581,914,213,119,5,209,0,28,667
6037143700,3800,2719,370,127,2,307,5,35,1081
6037143801,2926,2104,297,88,4,233,1,23,822
6037143802,2298,1674,226,82,2,165,0,13,624
6037143901,4319,3292,339,100,5,301,0,36,1027
6037143902,2979,2234,273,78,11,205,0,33,745
6037181000,6132,2552,1641,91,15,1465,5,46,3580
6037181300,3613,1252,1107,65,7,982,4,13,2361
6037181400,4134,1291,1373,79,13,1172,3,24,2843
6037181500,3653,1324,1373,52,5,701,3,21,2329
6037181600,4247,1645,1310,124,11,865,15,23,2602
6037183101,3659,1030,2022,64,13,361,2,37,2629
6037183103,3839,658,2519,95,22,400,3,32,3181
6037183104,2095,590,997,36,2,364,1,18,1505
6037183220,3682,574,2489,49,9,470,0,14,3108
6037183221,2901,834,1599,62,15,258,4,24,2067
6037183222,3303,1039,1450,64,12,576,7,18,2264
6037183300,3083,550,1898,10,10,532,0,14,2533
6037183401,2226,540,1156,29,4,423,1,6,1686
6037183402,2997,671,1289,50,7,839,3,12,2326
6037183510,2368,502,1615,16,3,160,0,12,1866
6037183520,3450,616,2483,54,3,193,0,20,2834
6037183610,2813,554,1860,37,22,247,0,16,2259
6037183620,2912,619,1880,31,8,280,3,17,2293
6037183701,3838,707,2687,82,9,252,0,16,3131
6037183702,2669,650,1308,120,0,455,4,21,2019
6037183810,4260,805,3055,78,6,194,1,20,3455
6037183820,3626,410,2903,54,9,203,1,13,3216
6037185101,2830,739,1687,35,6,239,2,4,2091
6037185102,2990,1506,815,88,2,354,2,26,1484
6037185202,3682,1139,1989,108,5,245,0,21,2543
6037185203,2651,381,1964,21,10,209,2,4,2270
6037185204,1977,675,690,43,2,474,3,13,1302
6037185310,2724,207,2292,9,4,175,1,4,2517
6037185320,2763,254,2217,36,4,198,2,13,2509
6037186100,4678,1613,1557,58,13,1177,7,37,3065
6037186201,3085,647,1079,81,3,1110,2,15,2438
6037186202,1985,485,766,49,9,591,2,12,1500
6037186203,2751,1126,1007,57,9,384,0,16,1625
6037186301,2679,449,1782,57,4,303,1,16,2230
6037186302,5190,1410,2497,96,1,953,5,32,3780
6037186401,2991,259,2199,52,5,431,2,4,2732
6037186403,2521,324,1669,35,6,429,4,7,2197
6037186404,2266,385,1552,28,0,246,0,17,1881
6037187101,3011,1013,1165,31,11,652,2,17,1998
6037187102,4083,913,2136,65,7,829,7,17,3170
6037187200,2801,521,1781,43,6,386,0,10,2280
6037187300,3456,1833,662,80,6,675,4,25,1623
6037188100,4070,1415,1980,98,6,422,3,14,2655
6037188201,3378,2067,579,141,8,326,2,24,1311
6037188202,2460,1615,269,77,1,343,4,16,845
6037188300,3271,1386,870,37,4,801,2,13,1885
6037189101,2589,1707,383,60,5,267,2,16,882
6037189102,3316,2293,457,82,4,289,2,26,1023
6037189201,3256,2133,525,140,6,313,4,11,1123
6037189202,2775,1955,311,37,4,290,5,18,820
6037189300,3216,2263,275,77,3,399,2,17,953
6037189400,3575,2695,336,97,6,189,5,20,880
6037189501,2183,1591,252,76,2,128,0,15,592
6037189502,2251,1428,399,126,3,152,0,18,823
6037189600,3738,2435,596,211,6,257,0,37,1303
6037189702,2389,1649,278,105,5,183,0,27,740
6037189703,2259,1418,326,154,0,182,4,18,841
6037189704,2786,1780,356,163,5,271,6,40,1006
6037189801,2302,1637,311,95,1,115,2,15,665
6037189802,2005,1397,238,121,0,113,0,13,608
6037189903,2228,1539,249,135,2,174,4,18,689
6037189904,2502,1582,365,130,1,205,0,33,920
6037189905,2462,1680,368,128,9,134,6,27,782
6037189906,2746,1791,344,185,7,228,1,30,955
6037189907,2434,1667,300,145,6,161,4,23,767
6037190101,1832,1002,368,168,0,150,0,27,830
6037190102,2737,1442,645,185,6,223,9,52,1295
6037190201,2872,1235,877,341,15,128,13,124,1637
6037190202,3568,1854,697,369,17,354,3,54,1714
6037190302,2283,1313,447,172,8,190,6,36,970
6037190303,2470,1308,647,142,3,250,1,14,1162
6037190401,2857,1690,610,119,7,286,2,12,1167
6037190402,2388,1343,508,89,4,339,6,15,1045
6037190510,4362,1531,1467,358,3,771,0,38,2831
6037190520,3489,1471,1186,154,7,520,5,22,2018
6037190701,1867,831,544,169,10,198,7,11,1036
6037190702,1420,640,529,63,2,118,1,17,780
6037190801,2500,910,1103,152,4,229,0,16,1590
6037190802,2794,986,1212,200,2,241,9,52,1808
6037190901,4016,604,3024,168,8,120,0,19,3412
6037190902,3608,1088,1954,172,5,239,0,30,2520
6037191000,5893,2555,1652,646,14,612,7,67,3338
6037191110,3141,1515,1056,102,2,379,3,17,1626
6037191120,3801,1210,1905,158,8,386,0,30,2591
6037191201,4072,2162,1130,116,9,468,9,14,1910
6037191203,2531,773,1127,122,9,412,2,5,1758
6037191204,1862,685,771,53,3,297,1,13,1177
6037191301,2076,486,1028,95,0,416,1,4,1590
6037191302,2192,587,894,95,0,524,0,19,1605
6037191410,3924,587,2582,120,7,511,3,22,3337
6037191420,2837,552,1751,85,9,340,6,16,2285
6037191500,4980,1007,2732,135,4,975,6,29,3973
6037191610,4271,823,2723,138,3,442,7,18,3448
6037191620,2628,544,1583,77,0,338,6,15,2084
6037191710,2576,565,1550,134,5,241,4,20,2011
6037191720,3534,539,2484,100,4,328,0,25,2995
6037191810,3028,748,1824,165,7,177,4,20,2280
6037191820,3279,1270,1281,201,0,310,1,35,2009
6037191901,3563,1773,909,304,9,333,5,38,1790
6037191902,2961,1905,413,114,6,306,1,29,1056
6037192001,2574,1774,324,134,2,200,0,39,800
6037192002,2550,1874,306,58,0,153,3,18,676
6037192300,2863,1816,288,132,2,460,1,10,1047
6037192410,3573,1695,707,150,1,809,2,31,1878
6037192420,3645,633,1454,143,6,1248,1,49,3012
6037192510,3508,241,1859,66,18,1237,4,21,3267
6037192520,4326,335,3051,93,4,737,2,34,3991
6037192610,4149,527,2782,163,10,567,2,35,3622
6037192620,3260,280,1978,95,3,800,3,34,2980
6037192700,3550,545,1938,185,19,730,8,24,3005
6037194101,3236,2289,423,119,5,182,4,13,947
6037194102,3462,2644,225,117,9,228,3,28,818
6037194200,3596,2864,292,63,3,160,0,26,732
6037194300,2972,2312,238,86,4,143,0,14,660
6037194401,2559,1708,325,142,3,193,0,41,851
6037194402,3146,2376,280,74,2,245,7,24,770
6037194500,2347,1703,214,66,4,244,1,25,644
6037195100,4974,3115,667,121,5,722,3,38,1859
6037195201,3080,1954,530,54,1,302,7,38,1126
6037195202,3194,2113,439,76,3,330,0,10,1081
6037195300,3070,1692,767,56,2,359,5,17,1378
6037195400,4244,2438,879,135,2,507,3,33,1806
6037195500,4991,2417,1316,120,3,852,4,34,2574
6037195600,3056,973,1498,112,5,331,0,19,2083
6037195710,3939,880,2280,127,7,536,3,22,3059
6037195720,1896,619,939,45,2,203,1,19,1277
6037195802,2744,485,1349,112,9,711,1,18,2259
6037195803,2457,1063,830,97,12,313,0,16,1394
6037195804,2459,806,1099,54,4,388,1,12,1653
6037195901,2248,1023,672,61,6,358,10,9,1225
6037195902,1848,1055,402,52,2,214,1,10,793
6037195903,1988,647,854,53,3,328,2,11,1341
6037197200,3287,317,1738,10,9,1121,0,6,2970
6037197300,3650,1553,1376,78,8,457,1,27,2097
6037197410,3707,1867,1199,66,5,324,4,30,1840
6037197420,3376,1089,1698,83,12,351,4,20,2287
6037197500,3973,1317,1953,107,13,409,0,28,2656
6037197600,2431,800,1127,58,5,344,3,9,1631
6037197700,4565,920,1399,166,10,1859,1,31,3645
6037199001,2552,89,1652,44,4,725,0,7,2463
6037199002,2913,308,1748,100,7,685,2,7,2605
6037199110,2377,208,1892,33,25,174,0,8,2169
6037199120,3777,232,2708,112,11,658,7,19,3545
6037199201,3584,193,2335,75,3,919,0,16,3391
6037199202,2785,354,2046,53,5,249,2,10,2431
6037199300,3545,848,2081,82,13,382,1,17,2697
6037199400,4470,308,3339,55,10,665,1,18,4162
6037199700,3393,519,2193,95,7,479,4,28,2874
6037199801,3036,92,1946,38,2,929,0,5,2944
6037199802,2144,53,1172,7,8,859,0,4,2091
6037199900,2641,76,2025,57,0,447,4,13,2565
6037201110,2332,258,1737,54,2,250,1,3,2074
6037201120,4395,438,3288,158,11,405,1,23,3957
6037201200,2362,150,1965,17,8,181,0,9,2212
6037201301,3409,278,2484,77,9,496,0,21,3131
6037201302,3882,943,1070,213,4,1442,3,25,2939
6037201401,4701,355,3672,135,14,450,2,9,4346
6037201402,4046,240,2962,38,17,723,7,8,3806
6037201501,4974,288,4095,53,18,446,2,25,4686
6037201503,3059,165,2615,43,5,183,4,17,2894
6037201504,2254,137,1817,27,6,233,0,8,2117
6037201601,2183,160,1663,28,8,293,1,5,2023
6037201602,2686,185,2153,28,15,261,0,12,2501
6037201700,5055,524,3267,359,10,717,7,31,4531
6037203100,4688,92,4339,79,8,121,0,19,4596
6037203200,4264,147,3947,33,3,70,0,31,4117
6037203300,2280,210,1460,284,7,254,2,5,2070
6037203500,2751,140,2240,48,6,281,0,6,2611
6037203601,2662,43,2551,19,6,22,0,8,2619
6037203602,2124,87,1943,20,3,54,3,4,2037
6037203710,3087,77,2911,19,4,51,3,11,3010
6037203720,3580,101,3301,56,5,66,5,15,3479
6037203800,4502,114,4247,37,3,69,3,10,4388
6037203900,2611,67,2487,9,0,24,2,6,2544
6037204110,2811,61,2677,11,4,26,3,15,2750
6037204120,2368,42,2260,14,0,30,0,9,2326
6037204200,3393,92,3123,56,3,94,0,9,3301
6037204300,4433,116,4171,33,2,88,0,2,4317
6037204410,2174,85,1941,36,3,77,1,2,2089
6037204420,2870,82,2643,79,2,34,2,3,2788
6037204600,3740,156,3380,68,9,88,4,7,3584
6037204700,4632,123,4391,21,9,55,2,20,4509
6037204810,5166,101,4902,56,5,60,1,13,5065
6037204820,2055,32,1958,4,4,26,0,16,2023
6037204910,3184,72,3007,41,0,26,0,15,3112
6037204920,2537,48,2421,36,6,8,0,14,2489
6037205110,3850,46,3704,26,6,35,0,20,3804
6037205120,3858,48,3633,106,3,44,1,17,3810
6037206010,3335,334,1617,151,3,1156,5,13,3001
6037206020,5577,899,2602,1762,4,241,9,19,4678
6037206050,2312,127,1724,116,2,280,3,19,2185
6037206051,2591,1197,597,270,27,335,5,30,1394
6037206052,3296,998,476,199,3,1405,8,29,2298
6037206053,3261,157,2500,116,10,412,12,10,3104
6037206054,2670,51,2144,27,0,418,0,6,2619
6037206201,2647,599,664,431,25,772,10,23,2048
6037206202,3035,626,776,526,64,894,11,26,2409
6037206301,2074,366,539,924,42,53,13,22,1708
6037206302,1375,288,431,491,22,66,9,6,1087
6037206303,2858,559,1019,1043,56,48,17,23,2299
6037207101,3233,521,648,378,11,1534,2,28,2712
6037207102,3374,326,907,229,10,1833,3,14,3048
6037207103,2099,172,380,106,3,1384,2,11,1927
6037207303,2311,861,379,290,3,602,7,21,1450
6037207304,2124,621,688,450,11,184,0,25,1503
6037207305,1181,566,278,111,2,152,7,7,615
6037207306,2227,818,457,466,12,312,1,17,1409
6037207307,1160,360,221,335,7,113,2,20,800
6037207308,1407,639,313,201,6,126,0,11,768
6037207400,2002,527,602,423,10,356,4,7,1475
6037207501,2489,771,518,273,5,796,5,22,1718
6037207502,4113,918,695,535,10,1771,11,27,3195
6037207711,2280,856,401,263,0,630,6,10,1424
6037207712,4737,1831,623,462,2,1515,4,34,2906
6037207901,3645,1185,564,385,2,1244,3,50,2460
6037207902,7405,2511,1358,747,8,2343,8,52,4894
6037208001,2494,388,1048,268,14,660,0,17,2106
6037208002,4113,404,3120,199,4,293,1,20,3709
6037208301,1878,72,1683,27,0,75,5,5,1806
6037208302,4560,374,3064,494,4,510,4,23,4186
6037208401,3832,129,2749,72,14,819,0,17,3703
6037208402,2590,253,1592,68,0,602,0,20,2337
6037208501,2283,285,935,67,0,939,3,11,1998
6037208502,3540,301,2403,133,7,628,2,17,3239
6037208610,3878,289,1691,151,4,1628,0,12,3589
6037208620,4052,399,2005,254,9,1286,2,23,3653
6037208710,4147,332,1194,208,1,2287,0,16,3815
6037208720,3810,377,2900,208,2,238,6,24,3433
6037208801,3566,369,1921,409,12,722,6,41,3197
6037208802,2942,392,1663,242,9,525,2,17,2550
6037208902,2570,65,2274,44,3,152,0,9,2505
6037208903,3888,109,3301,134,21,255,1,14,3779
6037208904,3882,146,3187,132,17,337,2,42,3736
6037209103,3079,90,2751,122,13,53,0,22,2989
6037209104,2380,149,1826,174,4,155,0,10,2231
6037209105,2665,51,2334,131,3,93,5,13,2614
6037209106,2632,292,1203,278,7,761,1,17,2340
6037209201,2852,881,501,338,3,959,1,28,1971
6037209202,1234,100,813,87,6,192,0,14,1134
6037209300,4712,582,2872,355,17,739,1,33,4130
6037209401,4163,293,2813,346,8,619,2,17,3870
6037209402,4056,181,3480,168,4,165,1,24,3875
6037209403,3850,222,2594,285,18,647,0,30,3628
6037209510,2813,166,1801,150,2,618,2,28,2647
6037209520,2648,121,2144,107,5,223,0,17,2527
6037209810,2385,217,1719,135,1,262,2,16,2168
6037209820,2732,109,2283,102,4,186,2,17,2623
6037210010,3190,130,2444,106,4,463,0,13,3060
6037211000,5268,2929,443,256,4,1261,0,35,2339
6037211121,2431,339,1118,190,2,680,1,17,2092
6037211122,2877,551,1100,230,4,866,3,30,2326
6037211123,2097,339,215,122,0,1331,0,20,1758
6037211124,4070,332,1223,187,5,2185,3,26,3738
6037211201,2538,308,1677,70,7,420,1,17,2230
6037211202,2693,341,1580,85,5,586,0,17,2352
6037211310,3603,260,2476,98,6,678,4,13,3343
6037211320,2899,377,1546,163,1,694,1,39,2522
6037211410,2956,212,1120,95,0,1468,0,21,2744
6037211420,3479,455,1601,133,0,1197,2,17,3024
6037211500,4230,1585,977,143,5,1351,1,14,2645
6037211701,2733,925,291,118,0,1310,2,14,1808
6037211703,4716,434,1774,200,3,2155,0,23,4282
6037211704,2941,449,678,163,10,1542,0,9,2492
6037211802,4893,624,1563,267,8,2294,1,28,4269
6037211803,3602,280,714,193,0,2331,0,24,3322
6037211804,3247,218,986,115,7,1842,2,23,3029
6037211910,4223,467,2220,300,11,1120,4,30,3756
6037211921,2447,169,1073,92,0,1032,0,24,2278
6037211922,3182,316,1467,241,12,1041,0,19,2866
6037212101,3146,396,740,178,0,1675,3,18,2750
6037212102,2579,367,721,200,1,1178,0,23,2212
6037212202,3364,166,2384,151,4,608,1,18,3198
6037212203,3216,305,1703,162,11,960,2,9,2911
6037212204,3227,178,2288,199,3,482,8,14,3049
6037212303,3486,455,1861,214,9,823,5,17,3031
6037212304,1738,245,1015,109,12,279,3,19,1493
6037212305,2533,190,1700,136,5,450,0,7,2343
6037212306,2793,186,1150,82,8,1311,1,12,2607
6037212410,3560,360,1554,136,3,1434,3,13,3200
6037212420,2875,250,1469,137,4,918,0,10,2625
6037212501,1944,344,858,133,9,521,2,7,1600
6037212502,3363,518,986,170,2,1550,5,22,2845
6037212610,4049,512,1225,165,4,2021,4,8,3537
6037212620,4111,339,1625,219,9,1816,0,21,3772
6037212701,2487,237,677,158,4,1333,2,8,2250
6037212702,3687,878,582,280,10,1760,1,15,2809
6037212800,4121,553,2006,315,8,1059,2,23,3568
6037212900,3721,361,1923,348,1,965,5,23,3360
6037213100,2507,237,765,232,0,1221,1,9,2270
6037213201,4330,193,1823,158,10,2038,0,26,4137
6037213202,3679,155,2102,200,6,1150,0,12,3524
6037213310,3323,129,2050,47,1,1063,0,17,3194
6037213320,3006,155,1726,191,0,886,3,10,2851
6037213401,4806,151,3361,111,5,1096,5,25,4655
6037213402,5119,254,3394,194,3,1180,2,32,4865
6037214000,3808,3218,171,36,2,143,4,79,590
6037214100,4111,3318,263,82,4,172,3,83,793
6037214400,2980,2145,355,105,9,140,4,40,835
6037214501,3104,1626,401,154,4,738,0,29,1478
6037214503,3495,1452,334,214,7,1240,3,33,2043
6037214504,3871,1529,393,258,8,1454,0,38,2342
6037214505,1817,970,212,139,2,357,2,13,847
6037214600,2600,1874,265,89,5,212,3,8,726
6037214700,2731,1900,305,139,9,225,5,20,831
6037214800,2843,2080,279,129,5,173,5,33,763
6037214902,2668,1853,237,95,4,337,2,12,815
6037214903,1542,1167,104,43,0,122,1,16,375
6037214904,1696,1235,154,59,0,159,1,4,461
6037215101,2614,1359,411,211,3,412,1,21,1255
6037215102,3123,1897,416,206,6,356,5,35,1226
6037216100,2465,1110,345,364,1,470,0,17,1355
6037216201,2701,1462,297,235,2,529,4,31,1239
6037216202,2838,1074,494,611,3,394,2,47,1764
6037216301,1374,947,173,56,0,114,0,9,427
6037216302,3551,1929,446,400,1,543,2,26,1622
6037216401,4165,2833,468,149,4,345,0,99,1332
6037216402,2644,1872,233,96,8,227,1,23,772
6037216700,3938,1535,892,871,15,354,4,55,2403
6037216800,3566,2115,609,277,8,274,6,76,1451
6037216901,2888,1036,602,814,0,203,0,35,1852
6037216902,2331,1067,452,434,5,196,4,35,1264
6037217001,2863,2315,157,48,4,127,0,45,548
6037217002,5084,3254,632,315,2,448,3,109,1830
6037217101,2520,442,1328,465,1,146,1,22,2078
6037217102,2930,1095,629,745,5,187,3,44,1835
6037217200,3887,1044,1464,765,8,350,2,26,2843
6037218110,3120,265,1542,618,5,560,1,31,2855
6037218120,4250,201,2913,335,3,699,4,38,4049
6037218210,3951,303,2852,477,14,169,2,51,3648
6037218220,4123,557,2125,945,1,299,4,34,3566
6037218300,5206,741,2534,1288,20,331,5,67,4465
6037218400,4364,436,2790,806,5,114,3,66,3928
6037218500,2810,347,1517,705,6,136,2,19,2463
6037218600,2820,325,1519,670,6,152,0,32,2495
6037218701,2455,224,1059,765,13,265,1,25,2231
6037218702,2199,175,1273,576,4,89,0,21,2024
6037218800,2633,130,1639,493,4,289,0,5,2503
6037218900,5329,502,2707,1653,8,204,1,47,4827
6037219010,2749,204,1772,526,0,117,9,28,2545
6037219020,4590,326,2952,903,7,187,4,39,4264
6037219300,3757,272,2191,921,8,187,2,52,3485
6037219500,1783,173,406,800,3,255,7,26,1610
6037219700,4186,380,2623,887,6,114,0,30,3806
6037219800,2931,206,2061,481,8,82,0,20,2725
6037219901,4651,311,3506,597,3,78,0,47,4340
6037219902,3878,310,2646,651,4,122,0,32,3568
6037220000,5420,562,2552,1831,10,228,3,48,4858
6037220100,2437,260,817,1077,5,136,0,23,2177
6037221110,3289,102,2838,87,3,217,0,15,3187
6037221120,3030,37,2764,55,7,134,1,15,2993
6037221210,2917,164,2237,136,6,293,4,26,2753
6037221220,3143,166,2574,79,1,274,3,11,2977
6037221302,4330,269,2958,505,9,480,0,35,4061
6037221303,2384,95,1806,162,1,290,0,6,2289
6037221304,3032,162,1725,493,5,556,0,14,2870
6037221401,3362,243,1441,1221,5,342,3,19,3119
6037221402,2700,265,1426,502,6,372,0,40,2435
6037221500,3864,156,2607,748,6,214,4,29,3708
6037221601,3175,197,2455,271,2,157,1,22,2978
6037221602,2693,108,2256,103,14,178,4,1,2585
6037221710,2596,231,1817,149,3,335,0,14,2365
6037221810,2746,359,1453,206,7,628,0,7,2387
6037221820,2797,848,499,292,3,1044,0,18,1949
6037221900,4917,1434,1192,571,9,1538,12,22,3483
6037222001,3218,323,1915,657,2,149,10,35,2895
6037222002,4648,161,3251,991,6,81,4,29,4487
6037222100,3712,187,2443,712,3,221,0,34,3525
6037222200,3878,301,2504,719,3,203,0,22,3577
6037222500,4702,224,3303,835,18,183,2,32,4478
6037222600,5141,464,2504,860,3,1113,2,41,4677
6037222700,4704,1714,784,627,19,1442,12,8,2990
6037224010,3621,590,1783,691,17,375,17,38,3031
6037224020,3231,410,2124,370,6,220,7,27,2821
6037224200,2385,86,2101,97,1,71,0,3,2299
6037224310,2090,167,1667,95,1,127,4,5,1923
6037224320,2962,63,2619,157,11,66,2,9,2899
6037224410,2906,440,1715,201,10,467,0,18,2466
6037224420,2068,155,1597,162,5,109,1,9,1913
6037224600,3501,200,2778,360,11,91,6,7,3301
6037224701,2077,509,481,144,16,817,0,30,1568
6037224702,3287,1125,720,159,1,1111,38,46,2162
6037226001,2632,227,1914,371,10,70,3,14,2405
6037226002,3587,1041,1264,832,26,251,8,30,2546
6037226410,3456,34,3279,88,2,33,1,7,3422
6037226420,5026,53,4401,331,3,194,0,15,4973
6037226701,2969,51,2766,97,0,16,1,12,2918
6037226702,2884,42,2629,164,4,14,1,10,2842
6037227010,4506,74,4023,354,6,14,0,7,4432
6037227020,3508,38,3289,149,2,13,0,9,3470
6037228100,4796,40,4351,338,8,19,2,23,4756
6037228210,3770,42,3344,295,3,51,0,8,3728
6037228220,4458,37,3954,408,8,6,4,6,4421
6037228310,4491,62,4011,344,2,32,1,21,4429
6037228320,3023,24,2751,212,2,2,1,17,2999
6037228410,3129,32,2889,132,4,18,0,23,3097
6037228420,3041,24,2759,206,3,17,1,14,3017
6037228500,5376,83,4756,420,14,18,0,64,5293
6037228600,4882,36,4374,387,7,9,0,16,4846
6037228710,4245,54,3687,380,0,63,6,33,4191
6037228720,4394,30,3944,363,12,6,0,5,4364
6037228800,5709,70,4944,504,1,108,3,26,5639
6037228900,3420,15,2887,421,5,62,2,11,3405
6037229100,4523,35,4113,319,3,5,0,29,4488
6037229200,4636,45,3866,573,5,86,2,38,4591
6037229300,5642,76,4815,613,13,37,4,18,5566
6037229410,3471,52,2988,379,3,19,0,16,3419
6037229420,4681,42,4101,468,2,14,1,12,4639
6037231100,3148,163,2477,379,14,61,0,16,2985
6037231210,3793,111,2713,741,4,94,0,23,3682
6037231220,3942,122,2647,731,9,325,5,24,3820
6037231301,2797,63,2008,555,9,33,0,35,2734
6037231302,2733,142,1730,697,5,45,5,27,2591
6037231400,4590,173,2995,1168,1,112,4,32,4417
6037231500,4725,211,2723,1434,10,154,3,38,4514
6037231601,2254,48,1433,633,6,33,0,33,2206
6037231602,2148,60,1544,449,4,35,0,8,2088
6037231603,2737,46,2113,463,7,45,2,25,2691
6037231710,4311,102,3532,558,6,23,0,22,4209
6037231720,5060,128,3880,757,2,183,0,18,4932
6037231800,5253,99,4459,589,0,18,2,32,5154
6037231901,2741,39,2244,379,1,20,0,22,2702
6037231902,3166,58,2570,456,5,14,1,23,3108
6037232110,3336,63,2636,520,4,9,4,40,3273
6037232120,5019,59,4019,807,16,31,3,25,4960
6037232200,3204,93,2134,823,10,26,0,23,3111
6037232300,4376,93,3029,1076,0,63,1,36,4283
6037232401,3702,74,2445,987,9,56,0,48,3628
6037232402,3163,84,1969,949,5,36,0,22,3079
6037232500,5066,98,3183,1591,10,40,5,51,4968
6037232601,2052,19,1513,451,0,8,0,12,2033
6037232602,4540,95,3497,810,6,16,0,29,4445
6037232701,2228,19,1721,387,1,7,4,35,2209
6037232702,3932,58,2890,867,2,34,1,28,3874
6037232800,4034,46,3328,538,11,24,1,39,3988
6037234001,2361,235,304,1564,2,91,3,17,2126
6037234002,2977,132,1519,1108,4,72,0,32,2845
6037234200,2459,241,392,1484,4,190,5,24,2218
6037234301,1918,134,228,1413,2,22,0,22,1784
6037234302,2597,98,286,1991,7,25,11,24,2499
6037234501,3062,115,1278,1433,0,77,8,22,2947
6037234502,2912,124,1139,1411,9,92,0,17,2788
6037234600,5106,284,1831,2532,11,81,8,61,4822
6037234700,4209,123,1870,1920,24,76,4,51,4086
6037234800,3561,96,1777,1480,7,33,0,25,3465
6037234901,3103,56,1432,1458,12,33,0,21,3047
6037234902,4238,153,1953,1907,10,29,0,46,4085
6037235100,4690,489,1001,2721,5,135,6,40,4201
6037235201,2921,108,1117,1482,5,22,1,42,2813
6037235202,4765,92,1724,2662,12,55,4,38,4673
6037236001,4422,1171,519,1946,6,378,10,42,3251
6037236101,2823,168,738,1411,6,342,4,26,2655
6037236102,3141,141,477,2214,7,96,2,25,3000
6037236203,3743,114,1169,2142,8,71,11,54,3629
6037236204,3210,111,1352,1573,9,19,2,41,3099
6037236205,3403,81,1581,1561,7,13,1,39,3322
6037236206,2571,112,1154,1112,9,57,0,26,2459
6037236400,4346,404,393,3164,3,119,3,45,3942
6037237101,4144,44,3049,889,6,47,2,17,4100
6037237102,3625,36,2732,731,14,14,12,39,3589
6037237201,3546,45,2681,692,8,22,0,23,3501
6037237202,4414,64,2785,1333,6,25,2,36,4350
6037237300,5531,101,2619,2535,5,42,6,37,5430
6037237401,3765,55,2637,961,2,19,4,32,3710
6037237402,3640,32,2412,1082,8,14,1,25,3608
6037237500,2856,50,2230,509,1,3,0,20,2806
6037237600,4112,40,3243,724,2,20,0,36,4072
6037237710,3992,38,2916,920,7,23,5,21,3954
6037237720,3470,35,2641,688,2,6,22,15,3435
6037237800,4335,64,2214,1864,8,43,5,38,4271
6037237900,3726,86,1089,2295,5,37,4,48,3640
6037238000,5969,105,1566,3972,18,43,20,53,5864
6037238100,4683,109,1305,2968,17,38,8,60,4574
6037238200,5848,103,1828,3590,17,42,19,51,5745
6037238310,5087,49,3677,1232,7,15,2,32,5038
6037238320,3975,44,2682,1113,4,20,0,41,3931
6037238400,4632,96,1185,3079,7,37,3,33,4536
6037239201,3819,72,3167,475,0,15,5,48,3747
6037239202,5013,40,4280,609,2,8,0,15,4973
6037239310,4031,76,3285,563,4,21,1,32,3955
6037239320,3441,26,2942,397,15,14,2,15,3415
6037239330,2979,30,2619,259,2,5,0,24,2949
6037239501,3835,31,3012,694,3,25,1,27,3804
6037239502,3697,59,2945,628,6,11,1,21,3638
6037239601,3631,54,2875,605,3,24,1,20,3577
6037239602,3487,30,2788,591,11,16,0,20,3457
6037239701,4415,49,3396,841,7,11,0,43,4366
6037239702,4224,68,3025,1041,10,15,3,15,4156
6037239801,3873,52,2914,805,6,5,0,42,3821
6037239802,5103,58,3920,1036,0,17,0,17,5045
6037240010,3818,32,2909,783,4,20,11,5,3786
6037240020,5294,58,4118,994,5,10,2,35,5236
6037240200,5910,55,4392,1307,3,18,16,22,5855
6037240301,2831,38,2004,720,3,14,0,12,2793
6037240302,3114,37,2361,632,8,10,6,14,3077
6037240401,5493,56,4045,1266,8,49,2,20,5437
6037240402,3856,47,2382,1248,4,46,0,24,3809
6037240500,6505,128,4327,1819,29,19,0,39,6377
6037240600,5457,103,3866,1359,9,20,5,35,5354
6037240700,6573,56,4783,1536,12,47,11,38,6517
6037240800,4438,47,3140,1152,3,23,2,27,4391
6037240901,2697,35,2125,482,2,4,1,21,2662
6037240902,3304,35,2575,610,0,10,0,23,3269
6037241001,4525,53,3088,1285,3,12,12,18,4472
6037241002,3941,45,2502,1275,6,9,0,23,3896
6037241110,3295,23,2370,850,6,1,0,12,3272
6037241120,4902,53,3566,1148,8,15,1,46,4849
6037241201,3105,40,1885,1083,7,6,2,16,3065
6037241202,5148,77,3025,1817,1,42,38,22,5071
6037241300,2262,29,1252,887,4,11,3,21,2233
6037241400,3612,56,2430,1018,0,24,10,18,3556
6037242000,4459,39,3135,1152,5,30,4,12,4420
6037242100,2497,15,1616,820,0,7,3,4,2482
6037242201,3696,22,3236,404,1,14,0,6,3674
6037242202,3387,26,2100,1197,4,11,2,9,3361
6037242300,4958,69,3628,1159,13,13,6,31,4889
6037242600,4794,29,3142,1517,6,11,2,9,4765
6037242700,5932,58,4657,1123,3,22,0,28,5874
6037243001,3304,34,2717,505,2,9,1,11,3270
6037243002,3527,34,3074,340,5,27,0,24,3493
6037243100,5692,114,3949,1522,1,33,5,22,5578
6037261102,4072,3244,248,87,1,258,0,29,828
6037261103,1880,1513,110,39,1,85,1,18,367
6037261104,1638,1249,123,39,5,128,0,17,389
6037261200,4329,3270,304,55,6,407,0,32,1059
6037262100,3195,2515,171,44,1,269,2,24,680
6037262200,4553,3355,288,106,0,481,3,47,1198
6037262301,2778,1892,339,58,5,360,2,19,886
6037262302,2870,2323,182,29,0,171,0,28,547
6037262303,3157,2587,166,49,0,196,2,10,570
6037262400,3242,2620,215,43,4,194,0,18,622
6037262501,3741,3120,228,20,1,165,2,24,621
6037262601,3783,2946,218,27,0,365,7,15,837
6037262604,6116,4868,356,48,4,454,3,42,1248
6037262704,3651,2850,291,43,7,207,3,37,801
6037262706,3537,2919,197,17,3,176,3,26,618
6037262802,3907,3254,196,25,7,187,1,31,653
6037264000,3284,2743,144,14,0,168,1,10,541
6037264102,3064,2219,249,46,0,334,2,24,845
6037264103,2605,1881,231,43,2,268,2,17,724
6037264303,2733,1981,247,36,1,284,0,17,752
6037264304,2616,1823,237,66,1,314,1,30,793
6037264305,3712,2895,231,36,1,323,0,7,817
6037264306,2228,1555,184,70,5,239,4,20,673
6037265100,2835,2375,113,45,0,178,0,18,460
6037265201,2108,1545,115,29,0,281,0,32,563
6037265203,2228,1548,145,26,2,411,0,7,680
6037265204,1182,551,120,58,3,377,2,6,631
6037265301,13527,3611,2859,927,82,5872,35,65,9916
6037265303,4012,1457,627,99,14,1527,6,36,2555
6037265304,3855,1371,870,169,7,1236,5,35,2484
6037265306,2081,886,364,92,2,593,10,7,1195
6037265307,3190,1136,372,182,7,1391,3,37,2054
6037265410,1592,1212,118,22,1,132,2,8,380
6037265420,1887,1366,122,43,0,250,0,5,521
6037265521,1948,868,189,43,2,734,1,13,1080
6037265522,2090,1002,181,55,6,735,4,11,1088
6037265523,1884,1219,124,24,2,344,0,22,665
6037265524,2751,1764,197,85,4,497,4,21,987
6037265601,3140,2216,234,36,4,448,2,10,924
6037265602,3318,2493,207,37,6,358,1,25,825
6037265701,2047,1498,144,40,0,206,2,40,549
6037265702,2879,2252,177,50,2,213,1,40,627
6037267101,3142,2083,253,65,3,526,2,18,1059
6037267102,3163,2184,225,64,7,416,2,19,979
6037267201,2865,1706,255,84,6,612,4,12,1159
6037267202,3470,2170,264,57,3,683,3,27,1300
6037267300,4408,1998,775,226,6,1149,8,23,2410
6037267403,3093,1834,441,75,3,538,5,23,1259
6037267404,3403,2065,402,121,4,535,11,33,1338
6037267405,2838,1762,386,76,6,433,3,20,1076
6037267406,2180,1309,385,58,1,297,2,13,871
6037267502,3217,1601,747,66,3,606,3,24,1616
6037267503,2112,948,586,46,6,408,6,12,1164
6037267504,3482,1475,1037,67,7,704,1,15,2007
6037267600,2709,1244,581,56,3,656,1,21,1465
6037267700,3834,1542,616,106,1,1287,5,32,2292
6037267800,3034,1828,309,52,0,580,5,17,1206
6037267901,3293,2519,164,50,1,439,5,22,774
6037267902,4002,2706,337,119,7,576,4,19,1296
6037269000,5492,3990,540,131,4,464,4,47,1502
6037269100,4752,3891,275,70,6,177,0,75,861
6037269300,4096,2947,352,55,2,469,0,26,1149
6037269500,4262,3456,235,44,3,275,3,59,806
6037269601,3122,572,1874,404,1,132,1,16,2550
6037269602,2964,767,1604,259,3,204,3,5,2197
6037269700,4025,1636,1379,348,1,423,4,34,2389
6037269800,3386,1469,780,267,4,646,2,22,1917
6037269903,3815,1420,962,227,6,970,13,35,2395
6037269905,2661,1108,636,197,9,546,0,34,1553
6037269906,3037,1268,726,212,7,637,5,22,1769
6037269907,2671,1125,598,212,3,549,0,28,1546
6037269908,1861,826,380,136,2,364,0,32,1035
6037269909,2243,918,558,195,4,429,3,21,1325
6037270101,2002,904,402,164,0,391,3,20,1098
6037270102,2186,950,431,160,2,508,2,13,1236
6037270200,3487,920,1760,260,1,357,36,14,2567
6037270300,2651,727,775,683,4,290,4,22,1924
6037271100,2569,1302,520,82,3,472,8,19,1267
6037271200,2592,970,785,93,5,605,0,10,1622
6037271300,4779,2436,930,109,1,968,8,23,2343
6037271400,3482,2366,414,38,3,396,1,28,1116
6037271500,3095,1871,466,56,6,472,1,24,1224
6037271600,4826,2336,639,181,6,1374,7,27,2490
6037271702,4527,1741,720,235,4,1601,9,26,2786
6037271703,3191,1567,562,121,4,695,4,34,1624
6037271704,2878,1437,402,124,1,690,1,27,1441
6037271801,3666,1331,1115,180,3,798,4,52,2335
6037271803,3039,1164,765,213,4,683,6,35,1875
6037271804,2565,1110,605,111,3,558,6,26,1455
6037271901,2861,1291,719,125,1,524,6,44,1570
6037271902,4044,2192,902,122,4,543,2,39,1852
6037272100,4332,2600,921,58,14,381,9,25,1732
6037272201,2394,1064,762,94,9,284,0,29,1330
6037272202,3159,1499,1030,83,10,310,8,35,1660
6037272301,3000,1475,805,131,4,385,14,22,1525
6037272302,3897,1571,1621,148,13,363,4,24,2326
6037273100,3597,2360,661,86,10,234,2,25,1237
6037273200,3596,1818,1133,328,3,119,11,29,1778
6037273300,3477,1774,974,388,8,142,4,28,1703
6037273403,1564,1087,207,112,8,65,7,7,477
6037273404,1558,1135,153,63,0,87,9,9,423
6037273502,2680,1966,283,101,10,132,7,33,714
6037273600,2189,1593,309,36,3,95,0,29,596
6037273700,2748,1813,573,50,1,138,4,27,935
6037273800,2933,1923,504,64,11,185,0,30,1010
6037273902,4278,3158,470,103,4,201,5,51,1120
6037274100,4824,3089,584,264,4,558,5,47,1735
6037274202,4903,3604,459,197,2,320,0,45,1299
6037275101,1186,533,277,59,5,205,9,10,653
6037275102,3816,932,2166,97,3,431,8,10,2884
6037275200,3850,1418,1533,212,4,424,1,40,2432
6037275311,4955,2199,1285,143,8,957,22,39,2756
6037275312,2201,1422,215,103,1,297,5,23,779
6037275313,3321,1968,485,121,15,512,3,18,1353
6037275400,4625,2681,728,183,8,671,4,56,1944
6037275500,5307,853,3392,436,3,431,13,23,4454
6037275603,2731,1071,802,72,5,576,0,16,1660
6037275604,10520,5631,1076,709,11,2309,22,83,4889
6037275605,3581,1622,539,573,9,579,8,41,1959
6037276000,6674,3539,1240,356,15,1045,17,43,3135
6037276101,3787,998,451,1053,11,963,2,68,2789
6037276102,3310,752,663,1302,9,309,1,33,2558
6037276400,4099,2640,544,105,5,500,7,25,1459
6037276500,4982,2591,981,358,4,626,11,46,2391
6037276601,4058,2411,559,211,14,552,10,24,1647
6037276605,2093,1228,312,119,2,241,2,26,865
6037276606,3353,2072,464,167,8,387,9,18,1281
6037276607,2974,1513,424,214,1,515,10,50,1461
6037276608,2106,1132,359,143,3,294,3,22,974
6037277000,5637,3382,828,226,13,744,6,34,2255
6037277100,3017,1440,756,108,1,439,20,14,1577
6037277200,1969,467,542,563,3,229,19,18,1502
6037277400,3,0,0,0,0,0,0,0,3
6037278001,2687,1111,743,231,9,370,19,24,1576
6037278102,2958,2088,362,100,3,175,1,33,870
6037291110,4213,88,2034,1858,2,48,3,30,4125
6037291120,2037,33,1312,580,3,53,1,6,2004
6037291130,3454,135,2246,591,4,390,3,24,3319
6037291210,5162,332,3153,673,2,826,22,28,4830
6037291220,3255,144,2059,374,6,580,6,20,3111
6037291300,2839,311,858,294,2,1186,21,6,2528
6037292001,4791,277,3101,574,11,666,24,46,4514
6037292002,1688,362,740,67,5,398,17,19,1326
6037293203,3337,434,1651,155,10,955,7,25,2903
6037293204,3119,416,1545,159,7,830,35,27,2703
6037293205,3873,291,2290,380,11,758,30,13,3582
6037293206,3330,227,2084,229,2,664,42,14,3103
6037293301,2793,643,657,151,0,1173,10,10,2150
6037293302,4809,971,2036,298,3,1257,59,19,3838
6037293304,4150,541,2633,284,3,528,34,14,3609
6037293306,2571,955,1054,112,2,324,7,11,1616
6037293307,2460,235,1361,418,2,362,1,16,2225
6037294110,3876,190,3361,69,14,132,31,14,3686
6037294120,2324,31,2102,109,1,48,2,5,2293
6037294200,4658,246,4156,56,7,98,16,16,4412
6037294301,2501,141,2068,53,5,146,32,15,2360
6037294302,4513,233,3933,93,3,141,34,34,4280
6037294410,5310,771,2250,1126,4,870,61,19,4539
6037294421,2794,249,1747,249,0,454,23,9,2545
6037294510,4057,139,3703,63,6,71,28,15,3918
6037294520,3459,105,3216,36,10,44,5,9,3354
6037294610,4025,138,3653,70,0,78,41,12,3887
6037294620,4034,69,3757,72,3,52,33,16,3965
6037294701,3110,142,2715,125,8,53,6,11,2968
6037294810,3729,77,3361,125,3,52,29,35,3652
6037294820,3346,90,3085,107,6,11,8,7,3256
6037294830,3838,102,3489,127,5,45,6,20,3736
6037294900,3871,98,3428,237,20,26,19,22,3773
6037295103,4978,2550,1273,170,7,675,9,29,2428
6037296210,2976,231,2419,211,7,40,7,10,2745
6037296220,4449,530,2622,667,10,422,8,83,3919
6037296300,4874,1593,1677,372,10,917,26,28,3281
6037296401,3176,1585,915,181,18,298,5,16,1591
6037296402,2971,998,1539,95,2,174,8,18,1973
6037296500,3796,482,2710,293,22,143,25,24,3314
6037296600,5305,721,3792,382,10,191,24,44,4584
6037296901,4148,857,2660,257,17,196,9,14,3291
6037296902,3987,1116,2224,269,14,178,15,25,2871
6037297001,1662,1013,426,37,4,91,3,15,649
6037297002,3657,1717,1387,159,7,180,9,20,1940
6037297110,4298,816,2677,372,21,205,31,59,3482
6037297120,3425,610,2301,227,14,134,23,26,2815
6037297201,3879,956,2217,288,9,217,34,20,2923
6037297202,3546,1445,1560,147,12,128,22,45,2101
6037297300,2306,1217,670,120,2,92,18,23,1089
6037297400,3760,2617,648,111,7,200,3,25,1143
6037297501,2483,1590,560,41,12,129,1,13,893
6037297502,2508,1064,1011,135,14,135,6,21,1444
6037297601,2781,1136,865,351,12,158,28,25,1645
6037297602,3579,1664,1246,185,15,199,18,28,1915
6037300100,6060,3526,582,33,3,1575,6,32,2534
6037300200,5492,2647,630,26,14,1900,0,14,2845
6037300301,6289,3624,655,57,3,1620,2,27,2665
6037300400,5948,3182,956,58,13,1401,4,32,2766
6037300501,3124,1520,511,17,2,913,1,10,1604
6037300503,5321,2768,985,63,7,1244,5,30,2553
6037300601,5346,2553,769,41,16,1786,5,12,2793
6037300602,3580,2423,514,35,4,442,1,18,1157
6037300701,6263,4738,605,35,3,612,9,22,1525
6037300702,5725,4477,412,51,1,567,4,15,1248
6037300800,7100,4741,891,129,2,1048,3,26,2359
6037300901,6478,4113,558,53,1,1564,0,16,2365
6037300902,2012,1301,280,8,1,303,4,4,711
6037301000,5050,2899,955,97,9,810,2,35,2151
6037301100,6571,4702,906,81,0,658,2,16,1869
6037301203,4417,3117,450,70,3,598,4,19,1300
6037301204,4934,3127,685,185,6,739,1,27,1807
6037301205,2211,1629,230,17,2,222,1,5,582
6037301206,5275,3816,541,53,2,657,2,11,1459
6037301300,2070,1604,227,12,8,153,1,4,466
6037301400,3936,3200,326,17,2,271,1,6,736
6037301501,1861,1507,153,4,0,149,0,0,354
6037301502,6718,5256,619,98,1,489,4,21,1462
6037301601,5952,4164,1041,86,2,460,2,15,1788
6037301602,3904,1631,1522,107,3,470,6,30,2273
6037301701,2852,1664,609,37,5,427,0,7,1188
6037301702,5639,3616,911,106,16,795,3,11,2023
6037301801,6139,3369,979,251,10,1259,7,53,2770
6037301802,5424,3084,803,209,2,1085,2,18,2340
6037301901,4857,3272,636,117,6,662,0,9,1585
6037301902,3140,1974,583,44,2,411,0,13,1166
6037302002,3998,2610,577,74,7,559,10,20,1388
6037302003,3496,2498,429,65,2,394,5,0,998
6037302004,4175,2621,700,66,0,600,0,9,1554
6037302102,6221,3575,1326,79,11,998,5,21,2646
6037302103,5334,3118,1042,48,1,978,2,12,2216
6037302104,3859,1680,1030,98,5,910,0,11,2179
6037302201,4017,2751,581,92,0,465,0,22,1266
6037302202,4933,3044,1171,61,4,538,2,24,1889
6037302301,3804,1918,823,117,10,808,5,16,1886
6037302302,5417,2406,1678,238,18,902,4,19,3011
6037302401,6484,3072,2034,156,10,980,11,34,3412
6037302503,4011,2473,991,38,3,421,0,3,1538
6037302504,3927,2137,1194,27,3,457,3,4,1790
6037302505,3766,1827,1321,58,3,452,2,24,1939
6037302506,3410,2006,862,90,3,341,1,18,1404
6037310100,5885,4181,697,46,7,687,5,29,1704
6037310201,5521,3750,717,97,2,709,15,17,1771
6037310202,4945,3585,676,101,8,381,1,32,1360
6037310300,3132,2106,299,17,0,544,5,6,1026
6037310400,3555,2170,803,43,4,390,0,26,1385
6037310501,3788,1163,1887,150,8,428,8,11,2625
6037310601,6085,2691,1808,274,18,1021,2,33,3394
6037310602,2956,1636,688,61,0,435,0,7,1320
6037310701,2482,1655,430,66,4,229,1,3,827
6037310703,5126,3308,868,156,2,507,2,27,1818
6037310704,4989,3060,844,244,14,574,6,38,1929
6037310705,2387,1543,349,107,0,286,0,13,844
6037310800,5098,2669,1448,154,24,490,6,24,2429
6037310900,6999,3368,2164,116,25,925,5,41,3631
6037311000,3872,1836,1258,73,11,465,8,28,2036
6037311100,4010,1681,1549,63,3,499,2,41,2329
6037311200,3270,1768,930,74,0,299,5,11,1502
6037311300,3874,2181,1062,64,7,342,0,25,1693
6037311400,2454,1564,473,36,4,231,0,23,890
6037311500,5921,3341,1402,123,22,630,8,45,2580
6037311601,2532,1640,441,99,6,204,0,29,892
6037311602,5254,3133,817,283,14,677,10,44,2121
6037311700,6227,3781,1270,151,17,634,6,27,2446
6037311801,3066,1332,1193,118,6,262,0,18,1734
6037311802,3881,1197,1887,172,15,432,3,18,2684
6037320101,3632,244,3244,41,2,70,4,12,3388
6037320102,3573,159,3308,25,11,50,0,5,3414
6037320201,3818,177,3475,49,11,43,0,29,3641
6037320202,5693,424,5033,54,16,93,0,17,5269
6037320300,7230,230,6710,113,26,97,7,13,7000
6037400205,3053,1442,453,144,4,857,1,30,1611
6037400206,5184,2585,1169,127,11,980,4,32,2599
6037400207,4706,2414,1374,80,13,572,19,31,2292
6037400208,1559,858,402,19,5,208,1,15,701
6037400209,4775,2569,1077,146,6,750,3,30,2206
6037400304,8163,3324,3099,357,18,1020,10,49,4839
6037400402,4370,2168,1269,32,7,668,4,26,2202
6037400403,3993,1737,1458,145,16,472,6,12,2256
6037400404,4458,2745,884,54,1,566,0,18,1713
6037400501,2051,1234,405,24,3,277,0,19,817
6037400602,4817,746,3425,111,13,381,5,37,4071
6037400603,5514,1408,2602,257,17,1043,7,18,4106
6037400605,7161,1768,2266,219,6,2613,13,40,5393
6037400801,7039,3161,2172,158,32,1168,12,33,3878
6037401001,3051,1808,732,18,6,352,0,10,1243
6037401002,4164,2237,1325,72,15,309,0,44,1927
6037401101,5433,2149,2259,175,12,623,1,14,3284
6037401102,4051,1607,1504,136,8,612,5,5,2444
6037401201,3188,1426,1125,40,9,437,3,16,1762
6037401202,4439,1759,1873,75,7,542,0,22,2680
6037401203,5386,1860,2461,145,12,657,5,32,3526
6037401303,2235,807,628,98,1,594,4,24,1428
6037401304,5683,2427,1770,141,11,1103,2,32,3256
6037401311,6909,2738,2896,294,20,625,0,36,4171
6037401312,5210,2131,2103,96,19,605,2,28,3079
6037401500,5027,1680,2470,159,20,486,7,22,3347
6037401601,5593,2595,1923,212,12,587,6,58,2998
6037401602,5792,2292,2475,229,14,524,11,20,3500
6037401705,3112,1555,928,99,6,314,3,21,1557
6037401706,4522,1194,2116,439,28,549,10,28,3328
6037401707,8320,1949,4400,598,21,1071,9,36,6371
6037401801,4000,1948,1013,188,9,605,13,12,2052
6037401802,3967,1924,1021,128,5,614,2,14,2043
6037401901,5428,2487,935,364,9,966,22,101,2941
6037401902,5747,3528,1185,215,12,455,0,36,2219
6037402001,3693,1043,1510,279,17,667,0,16,2650
6037402002,4168,1639,1582,290,18,416,4,23,2529
6037402101,4748,288,3448,455,18,422,2,26,4460
6037402102,5118,528,3513,514,13,396,20,16,4590
6037402200,7276,1587,4207,598,30,631,19,40,5689
6037402301,5444,346,4357,191,3,444,12,15,5098
6037402303,3986,464,3009,194,24,186,6,12,3522
6037402304,3925,120,3511,116,7,111,5,12,3805
6037402403,5272,878,3292,206,13,695,4,18,4394
6037402404,2303,801,655,120,4,519,1,1,1502
6037402405,2959,80,2483,220,9,116,16,20,2879
6037402406,4739,249,3749,213,10,404,11,36,4490
6037402501,5362,207,4676,177,5,214,3,26,5155
6037402503,3984,139,3199,146,17,420,3,32,3845
6037402504,2902,78,2293,76,11,391,0,13,2824
6037402601,3545,353,2768,159,6,188,0,18,3192
6037402602,4079,888,2600,128,14,306,8,23,3191
6037402702,6354,300,5496,300,10,165,7,27,6054
6037402703,4880,424,3515,296,2,512,7,31,4456
6037402705,3432,332,2655,136,4,219,6,22,3100
6037402706,3962,291,3044,230,10,318,4,13,3671
6037402801,4911,163,4471,79,17,120,3,31,4748
6037402803,3273,92,2901,47,4,209,1,6,3181
6037402804,4027,201,3058,163,11,535,0,18,3826
6037402902,6856,411,5236,305,21,781,10,33,6445
6037402903,4324,143,3341,248,2,520,19,9,4181
6037402904,3606,218,3160,45,8,136,3,15,3388
6037403000,6757,237,5559,285,13,572,10,3,6520
6037403305,2076,190,293,19,0,1518,0,6,1886
6037403316,6784,1336,1899,427,9,2835,18,42,5448
6037403317,5098,958,1659,389,9,1866,5,23,4140
6037403318,6450,1125,2339,512,8,2192,17,28,5325
6037403319,4214,633,974,193,7,2244,7,9,3581
6037403320,5503,677,737,176,1,3738,8,16,4826
6037403321,5275,965,1431,208,6,2453,4,11,4310
6037403323,5275,685,572,112,4,3790,10,10,4590
6037403324,6516,766,749,189,15,4628,1,26,5750
6037403325,5306,783,870,102,5,3375,8,20,4523
6037403326,2606,357,774,45,2,1371,0,11,2249
6037403327,2813,606,1064,96,2,938,7,11,2207
6037403328,5936,901,1291,113,4,3453,12,11,5035
6037403401,4984,481,1250,111,4,3007,1,14,4503
6037403402,3549,362,809,65,0,2205,0,8,3187
6037403403,4750,391,576,87,0,3574,7,24,4359
6037403404,2389,276,330,65,0,1638,5,8,2113
6037403407,2526,113,209,31,0,2120,3,3,2413
6037403408,6022,398,1235,235,5,3995,1,40,5624
6037403409,4210,568,915,82,1,2524,0,15,3642
6037403500,1828,565,570,51,4,561,1,14,1263
6037403601,7102,1857,3715,189,8,1087,11,28,5245
6037403702,3884,1118,1757,99,4,726,11,33,2766
6037403703,4809,1560,2151,137,17,767,9,21,3249
6037403721,5429,1136,3258,181,17,675,6,23,4293
6037403722,5794,866,3866,284,29,547,15,51,4928
6037403801,6346,1288,3665,258,13,907,15,24,5058
6037403802,5857,1508,3126,225,29,745,3,40,4349
6037403901,3198,952,1693,72,8,346,3,17,2246
6037403902,5011,1672,2484,130,14,498,1,34,3339
6037404000,4545,741,2988,157,20,495,6,41,3804
6037404100,6137,448,5056,129,27,391,0,20,5689
6037404201,3950,496,2804,199,4,360,3,11,3454
6037404203,3899,944,2270,151,6,382,9,25,2955
6037404301,5460,324,4631,131,10,291,0,19,5136
6037404302,2388,200,1964,38,8,116,4,17,2188
6037404401,3838,354,3131,56,9,230,0,18,3484
6037404402,5042,420,3867,48,16,587,9,22,4622
6037404501,2720,177,2344,47,2,103,2,15,2543
6037404503,2986,224,2157,52,2,493,10,6,2762
6037404504,5087,263,4094,120,5,529,2,14,4824
6037404600,1472,53,1336,15,1,50,0,2,1419
6037404701,5620,128,4173,19,6,1245,0,21,5492
6037404702,5662,169,3956,61,4,1388,7,31,5493
6037404703,2912,73,2422,64,0,333,0,4,2839
6037404804,4404,123,3197,38,3,1009,0,18,4281
6037404805,2706,85,1941,14,1,642,0,9,2621
6037404806,5937,276,4455,101,12,1035,2,19,5661
6037404901,5279,134,3916,27,0,1136,0,16,5145
6037404902,3832,115,2534,12,1,1137,4,8,3717
6037404903,2742,124,1796,23,7,753,1,12,2618
6037405001,5761,173,4747,24,11,736,2,27,5588
6037405002,2971,74,2412,18,4,434,1,3,2897
6037405101,5057,201,3846,30,2,924,3,13,4856
6037405102,4793,175,3529,42,4,999,4,8,4618
6037405201,5392,233,4026,74,15,981,0,30,5159
6037405202,4894,153,3730,24,18,894,15,22,4741
6037405203,3285,137,2221,31,2,855,2,11,3148
6037405301,3614,333,2424,116,0,662,0,27,3281
6037405302,5603,618,3577,93,18,1167,8,36,4985
6037405400,4858,516,3481,87,15,673,8,15,4342
6037405500,6623,837,4181,178,15,1293,10,22,5786
6037405600,5645,787,3262,126,11,1364,0,27,4858
6037405701,3818,365,2771,96,10,501,4,16,3453
6037405702,5285,577,3509,127,16,955,8,25,4708
6037405800,5755,796,3938,212,14,672,0,21,4959
6037405900,4423,745,2712,143,1,680,11,24,3678
6037406000,5496,1082,3314,132,14,820,6,26,4414
6037406101,3583,800,2045,76,23,521,6,17,2783
6037406103,8353,1488,5299,275,28,1012,10,49,6865
6037406201,3731,408,2379,192,14,612,14,38,3323
6037406300,5796,1063,2346,212,8,2026,6,26,4733
6037406413,7129,1035,4056,197,16,1653,7,25,6094
6037406500,7397,760,4315,210,32,1860,11,82,6637
6037406601,5397,696,2919,215,17,1432,0,34,4701
6037406602,4978,493,3136,88,4,1178,5,20,4485
6037406701,3112,265,1886,138,3,749,4,29,2847
6037406702,7040,672,4134,316,7,1748,9,38,6368
6037406801,4993,497,2815,116,14,1459,10,10,4496
6037406903,7777,390,5651,182,21,1416,22,25,7387
6037407001,5623,119,4701,41,7,664,13,41,5504
6037407002,3566,77,2892,21,5,528,4,7,3489
6037407101,4645,168,3926,15,8,493,1,19,4477
6037407102,5336,115,4457,28,6,677,8,16,5221
6037407201,3251,113,2792,19,2,303,1,6,3138
6037407202,3612,120,3111,25,8,301,3,20,3492
6037407301,4593,197,3598,44,6,684,1,25,4396
6037407302,3275,87,2694,23,0,433,4,10,3188
6037407400,2126,127,1067,65,7,806,5,10,1999
6037407501,4445,156,3499,70,11,626,2,20,4289
6037407502,4052,216,3226,16,10,528,8,19,3836
6037407601,4288,129,3484,64,1,556,16,14,4159
6037407602,3732,143,3009,42,3,497,2,10,3589
6037407701,4956,117,4123,71,0,571,10,18,4839
6037407702,6249,293,4594,97,12,1178,3,19,5956
6037407801,4789,195,3429,62,15,1028,7,6,4594
6037407802,3336,174,2542,61,10,509,0,20,3162
6037407901,4339,224,3108,68,4,845,18,16,4115
6037407902,1922,116,839,62,7,847,0,5,1806
6037408003,4768,341,2893,147,3,1314,12,15,4427
6037408004,2544,207,1181,126,3,949,3,14,2337
6037408005,5269,752,1920,150,4,2291,8,23,4517
6037408006,3750,211,1643,164,1,1655,6,9,3539
6037408133,5598,365,2987,223,6,1923,17,11,5233
6037408134,2640,168,862,124,5,1416,1,7,2472
6037408135,3899,210,1354,153,9,2068,6,15,3689
6037408136,3832,326,1920,98,9,1354,1,22,3506
6037408137,4493,308,2063,197,3,1785,11,12,4185
6037408138,6131,250,5359,51,6,421,2,14,5881
6037408139,4290,86,3833,14,9,314,10,11,4204
6037408140,3775,107,3208,16,7,406,1,12,3668
6037408141,5180,127,4047,67,4,869,14,25,5053
6037408212,4519,355,1273,48,4,2740,10,21,4164
6037408213,5875,356,1891,50,2,3474,12,22,5519
6037408301,6101,227,5072,26,10,703,0,23,5874
6037408302,4071,301,3136,44,6,497,6,19,3770
6037408303,4383,366,3413,53,11,456,2,29,4017
6037408401,4377,304,2964,64,6,953,9,9,4073
6037408402,6070,959,3498,44,6,1437,10,23,5111
6037408503,6329,915,2453,69,7,2748,3,25,5414
6037408504,5336,486,2857,55,6,1846,14,10,4850
6037408505,2711,354,1216,31,3,1038,0,9,2357
6037408623,3065,287,930,58,2,1717,1,10,2778
6037408624,3167,307,820,17,5,1949,5,0,2860
6037408625,4336,567,1529,44,6,2087,1,13,3769
6037408626,4356,226,1158,77,9,2773,1,16,4130
6037408627,2818,295,685,35,1,1762,2,0,2523
6037408628,5146,420,1071,62,9,3479,5,16,4726
6037408629,3005,438,745,34,3,1706,5,5,2567
6037408631,5023,418,2574,27,19,1902,6,30,4605
6037408703,6069,415,480,60,2,4956,4,21,5654
6037408705,5355,507,1387,46,14,3291,7,14,4848
6037408707,6542,628,850,109,2,4803,5,9,5914
6037408722,4385,419,1204,22,2,2642,0,17,3966
6037408724,5486,184,3162,157,6,1899,12,12,5302
6037408725,5940,438,1682,90,4,3598,5,22,5502
6037408800,4795,688,3100,304,9,508,2,36,4107
6037408900,5821,2908,2117,117,17,439,2,14,2913
6037409000,7033,789,4997,361,30,691,14,35,6244
6037409100,5239,331,3569,25,22,1216,0,16,4908
6037430003,4553,1707,1421,166,11,1044,6,24,2846
6037430004,3692,996,1499,250,20,785,1,23,2696
6037430005,3835,761,1689,204,2,1063,0,15,3074
6037430101,5011,1007,2486,371,10,975,8,23,4004
6037430102,4636,421,3341,135,16,640,0,16,4215
6037430200,1264,636,197,17,1,362,0,4,628
6037430301,4406,2617,865,77,10,597,0,34,1789
6037430302,5831,3084,1477,161,5,739,3,44,2747
6037430400,4393,1063,445,23,5,2685,2,16,3330
6037430501,4154,2674,631,40,1,544,2,15,1480
6037430502,7114,4372,1292,113,19,864,8,52,2742
6037430600,4435,1198,451,22,0,2632,0,10,3237
6037430701,5045,1234,831,104,2,2673,1,25,3811
6037430721,3536,760,481,73,0,2109,0,17,2776
6037430723,4643,690,928,135,11,2736,0,27,3953
6037430724,5252,839,793,117,8,3283,19,39,4413
6037430801,6778,779,1098,124,11,4595,4,20,5999
6037430802,4248,675,499,54,0,2898,0,19,3573
6037430803,5363,919,610,43,3,3640,0,23,4444
6037430901,4459,1036,2175,308,6,720,5,19,3423
6037430902,5175,1230,2043,280,3,1413,0,36,3945
6037431002,3246,1375,974,188,6,531,6,16,1871
6037431003,3831,1219,1623,203,9,574,1,31,2612
6037431004,3414,1023,1722,120,11,363,10,17,2391
6037431100,7140,1222,4039,592,18,1048,3,25,5918
6037431200,6202,615,4346,366,1,763,4,35,5587
6037431300,2611,829,888,71,0,689,1,19,1782
6037431400,3898,871,993,46,9,1833,1,14,3027
6037431501,4281,558,1398,48,10,2173,0,27,3723
6037431502,4243,827,1418,70,10,1817,0,12,3416
6037431600,4173,518,391,54,0,3115,10,16,3655
6037431701,6763,881,483,56,9,5135,1,14,5882
6037431800,5246,954,714,73,8,3356,6,25,4292
6037431900,3652,585,716,28,7,2231,2,5,3067
6037432001,2627,403,366,18,12,1742,0,5,2224
6037432002,5358,782,983,42,10,3380,4,38,4576
6037432101,4113,600,843,29,0,2551,0,12,3513
6037432102,5976,679,1091,38,5,3980,0,11,5297
6037432201,4235,298,918,30,0,2921,1,12,3937
6037432202,4212,224,1515,29,7,2380,0,25,3988
6037432300,3873,253,1900,35,6,1631,0,5,3620
6037432401,3544,156,1907,14,10,1430,1,7,3388
6037432402,6040,281,3418,46,6,2226,3,22,5759
6037432501,4746,382,2274,63,15,1944,2,12,4364
6037432502,3431,289,1934,10,11,1126,1,10,3142
6037432601,6374,252,3484,52,3,2505,2,26,6122
6037432602,4504,166,2236,18,6,2011,3,23,4338
6037432700,5363,184,3677,36,4,1408,0,16,5179
6037432801,2620,44,1519,28,5,1001,2,6,2576
6037432802,5540,116,4173,74,2,1105,1,18,5424
6037432901,4202,144,1217,24,4,2777,3,7,4058
6037432902,3358,168,1228,13,5,1899,1,1,3190
6037433103,6692,118,3561,14,5,2944,2,13,6574
6037433200,6088,193,3887,47,5,1887,1,14,5895
6037433302,1701,53,1405,17,0,206,0,3,1648
6037433304,4595,153,2873,60,5,1450,1,19,4442
6037433305,4622,115,3322,39,16,1085,4,9,4507
6037433306,3111,81,1972,39,6,980,0,12,3030
6037433307,3220,59,2061,21,6,1036,0,20,3161
6037433402,4184,73,3046,20,4,1014,1,14,4111
6037433403,4783,97,3656,37,6,952,2,13,4686
6037433505,4486,63,2899,15,3,1478,0,18,4423
6037433506,3971,56,3403,8,3,487,0,2,3915
6037433601,4586,130,1314,6,9,3088,1,9,4456
6037433602,2858,65,944,3,5,1811,2,0,2793
6037433803,3037,88,2086,16,0,832,0,3,2949
6037433804,4497,118,3821,6,6,523,0,7,4379
6037433901,5097,88,3861,19,4,1069,1,27,5009
6037433903,5619,122,4619,13,4,817,0,24,5497
6037434001,4715,117,3700,19,3,834,7,8,4598
6037434003,4093,88,3389,7,8,574,0,16,4005
6037434004,2746,73,2377,10,3,251,1,15,2673
6037434100,6509,134,4949,15,11,1356,0,3,6375
6037460001,1609,1018,171,51,2,302,1,7,591
6037460002,3283,1846,488,143,2,646,4,6,1437
6037460101,5846,3522,906,600,2,451,3,52,2324
6037460200,5561,2218,1206,1393,6,343,6,46,3343
6037460301,4733,1774,1097,1139,4,329,0,22,2959
6037460302,4273,1078,1653,1062,3,198,3,39,3195
6037460401,1063,238,347,305,0,100,0,14,825
6037460501,5555,2905,409,22,6,1875,0,25,2650
6037460502,4495,2272,367,28,16,1553,1,34,2223
6037460601,5488,3051,529,46,0,1556,0,38,2437
6037460700,5035,2899,412,33,2,1424,1,32,2136
6037460800,3219,2005,415,56,1,587,1,18,1214
6037460900,6893,935,3825,1325,17,514,4,43,5958
6037461000,5817,832,3129,1302,12,275,6,45,4985
6037461100,4894,1539,1925,877,5,299,4,38,3355
6037461200,4555,2737,801,329,4,388,1,21,1818
6037461300,6533,3847,1303,366,10,597,24,30,2686
6037461400,2939,1580,735,204,6,244,8,12,1359
6037461501,3508,969,1730,375,2,256,4,15,2539
6037461502,5748,1082,3319,844,10,337,3,14,4666
6037461600,5435,650,3156,838,17,557,0,38,4785
6037461700,1492,742,286,203,0,181,0,17,750
6037461901,4609,730,2861,417,10,416,27,26,3879
6037461902,2142,784,430,216,4,577,5,24,1358
6037462001,3501,535,2198,361,3,255,3,29,2966
6037462002,3801,301,2623,520,3,250,4,19,3500
6037462100,4877,1074,2710,520,9,350,3,17,3803
6037462201,3711,1065,1559,289,12,622,6,33,2646
6037462202,3348,1409,487,226,2,1027,10,18,1939
6037462301,4407,1090,2220,353,4,560,2,20,3317
6037462302,3314,1087,934,277,8,848,5,26,2227
6037462400,4040,1932,1225,191,3,449,4,36,2108
6037462500,6157,3416,1259,248,7,869,1,48,2741
6037462600,2293,1226,532,81,4,332,1,10,1067
6037462700,5727,1823,2094,319,15,1179,3,36,3904
6037462800,2939,1054,978,188,3,542,0,24,1885
6037462900,3775,1603,1190,121,3,659,1,18,2172
6037463000,2706,1160,489,167,1,766,2,8,1546
6037463103,6074,1515,2193,165,7,1935,12,39,4559
6037463200,3478,1284,881,144,4,977,4,18,2194
6037463300,2101,987,429,66,1,499,0,14,1114
6037463400,5918,2400,1304,331,9,1494,2,43,3518
6037463500,5523,2442,900,239,3,1647,0,42,3081
6037463601,6231,2789,1087,304,10,1720,4,27,3442
6037463602,5728,2488,891,362,8,1648,4,32,3240
6037463700,3912,2023,514,235,8,955,1,18,1889
6037463800,3953,2356,604,108,0,618,1,20,1597
6037463900,3418,2005,631,140,7,461,3,9,1413
6037464000,5832,2865,931,196,6,1465,10,49,2967
6037464101,2770,860,213,14,2,1561,0,4,1910
6037464102,3989,1372,340,33,2,2080,3,1,2617
6037464200,5747,1236,333,11,0,3937,4,17,4511
6037480002,3416,701,630,26,2,1931,0,22,2715
6037480011,5238,762,1847,81,5,2382,1,16,4476
6037480012,4917,761,922,60,13,3015,0,31,4156
6037480101,4107,505,620,23,3,2826,3,34,3602
6037480102,4325,578,1056,64,3,2482,1,21,3747
6037480201,3923,1141,917,22,4,1663,2,19,2782
6037480202,2518,539,601,5,4,1239,0,9,1979
6037480302,4380,715,1608,117,7,1809,4,28,3665
6037480303,3806,331,1534,111,13,1705,3,26,3475
6037480304,4263,295,1348,114,0,2382,4,17,3968
6037480400,5698,984,1881,106,13,2473,3,32,4714
6037480500,5543,2488,1043,76,3,1532,6,31,3055
6037480601,4241,1485,967,156,3,1365,0,33,2756
6037480602,4183,1776,913,128,8,1090,0,25,2407
6037480702,4723,1268,829,125,6,2128,0,39,3455
6037480703,3410,1230,703,43,0,1165,2,17,2180
6037480704,4843,1445,1129,110,8,1855,1,27,3398
6037480802,3079,200,1601,30,4,1185,1,9,2879
6037480803,3418,417,1845,37,6,1005,0,18,3001
6037480804,4866,411,1960,98,3,2207,12,23,4455
6037480901,4611,241,1818,95,8,2338,11,10,4370
6037480902,4024,160,1629,47,7,2123,3,9,3864
6037480903,3023,148,962,23,4,1842,5,0,2875
6037481001,4271,351,1253,37,4,2582,0,12,3920
6037481002,5878,534,2187,138,5,2821,2,31,5344
6037481101,4100,372,1596,68,6,1967,2,10,3728
6037481102,4083,291,1287,108,6,2269,0,19,3792
6037481103,5340,221,1694,28,9,3318,5,4,5119
6037481201,3786,365,945,26,5,2376,2,10,3421
6037481203,6375,447,2198,50,6,3556,14,10,5928
6037481300,2938,113,775,3,0,2008,2,8,2825
6037481401,5725,212,947,23,4,4460,3,11,5513
6037481403,2933,151,624,18,5,2102,2,8,2782
6037481404,3934,167,510,21,1,3179,0,12,3767
6037481500,4344,259,812,29,5,3189,2,1,4085
6037481603,3737,188,983,62,12,2454,0,6,3549
6037481604,3863,258,1264,47,6,2225,1,12,3605
6037481605,3178,149,1128,18,6,1820,1,10,3029
6037481606,4824,222,1209,47,3,3263,7,15,4602
6037481711,4606,96,489,30,0,3926,2,11,4510
6037481712,5076,106,865,11,0,4040,1,4,4970
6037481713,2731,70,411,11,4,2212,3,1,2661
6037481714,2485,48,301,14,0,2100,3,5,2437
6037481800,2587,224,614,18,14,1636,0,8,2363
6037481901,5721,588,2769,85,13,2131,7,30,5133
6037481902,3297,267,1505,86,4,1362,4,9,3030
6037482001,2719,180,433,3,1,2006,0,15,2539
6037482002,7194,338,2274,68,8,4322,4,19,6856
6037482101,4771,184,1243,30,6,3234,0,8,4587
6037482102,2846,204,818,19,1,1707,8,8,2642
6037482201,3808,127,677,30,5,2925,3,10,3681
6037482202,5184,115,887,25,2,4082,2,12,5069
6037482301,4989,90,1253,30,2,3570,1,5,4899
6037482303,5482,87,1732,26,2,3586,0,7,5395
6037482304,3409,64,1473,6,8,1828,0,17,3345
6037482401,3535,58,1180,8,0,2259,2,9,3477
6037482403,3310,49,1203,3,0,2024,0,14,3261
6037482404,2901,180,677,25,0,1954,7,13,2721
6037482502,3213,41,753,12,0,2369,4,1,3172
6037482503,3957,44,1152,7,1,2704,0,10,3913
6037482521,5577,230,2088,65,6,3118,1,12,5347
6037482522,4455,349,2192,78,5,1753,6,9,4106
6037482600,7182,399,1806,43,14,4720,4,33,6783
6037482701,4096,140,2410,18,8,1442,5,26,3956
6037482702,2404,99,1046,4,9,1194,4,8,2305
6037482801,4193,231,1984,36,3,1861,2,10,3962
6037500100,3729,1649,1191,30,4,708,3,28,2080
6037500202,4982,1611,2511,54,11,622,4,17,3371
6037500203,4188,1629,2213,38,6,177,3,19,2559
6037500204,2343,957,834,18,6,426,1,12,1386
6037500300,3024,630,1866,62,8,373,2,7,2394
6037500402,4566,121,4275,23,4,89,0,22,4445
6037500403,4025,120,3564,31,15,269,2,6,3905
6037500404,4767,187,4097,22,5,397,3,22,4580
6037500500,2954,134,2601,13,9,156,1,15,2820
6037500600,5438,106,5143,11,18,112,2,27,5332
6037500700,6582,281,6043,33,15,113,4,39,6301
6037500800,5333,246,4861,37,14,127,3,16,5087
6037500900,5602,254,5029,41,20,198,3,13,5348
6037501001,3023,94,2805,17,17,29,18,19,2929
6037501002,4882,490,4127,39,15,124,7,25,4392
6037501200,5114,524,4299,31,28,130,12,17,4590
6037501301,3020,479,2389,11,3,68,2,16,2541
6037501302,4476,725,3430,23,2,180,8,32,3751
6037501400,3826,393,3199,82,7,70,6,10,3433
6037501501,2411,693,1408,50,9,180,0,15,1718
6037501503,5215,981,3842,78,25,155,5,15,4234
6037501504,3580,542,2623,61,14,264,8,14,3038
6037501600,6863,1789,4142,105,23,529,8,60,5074
6037501700,4114,1074,2710,38,8,153,6,24,3040
6037501802,3438,731,2488,36,11,88,1,13,2707
6037501803,4687,379,4035,73,11,123,8,19,4308
6037501804,2247,264,1846,35,18,27,9,8,1983
6037501900,4336,809,3257,25,4,120,5,32,3527
6037502003,2745,265,2346,27,4,65,2,10,2480
6037502004,4088,300,3580,49,7,112,4,19,3788
6037502005,4382,660,3441,52,16,119,0,42,3722
6037502100,5079,567,4243,43,20,126,7,13,4512
6037502200,6477,504,5728,30,22,103,0,42,5973
6037502303,8396,414,7579,141,21,160,10,27,7982
6037502401,4772,193,4286,40,12,210,2,13,4579
6037502402,3789,159,3505,19,5,53,0,34,3630
6037502500,4124,194,3780,44,1,84,0,8,3930
6037502602,4377,259,3829,62,11,164,0,27,4118
6037502603,3407,169,3138,12,2,56,2,7,3238
6037502604,3662,223,3302,9,10,75,10,19,3439
6037502700,7682,604,6413,179,12,332,10,29,7078
6037502801,6347,781,5091,86,17,248,16,21,5566
6037502901,5449,559,4484,43,20,219,22,20,4890
6037503000,5675,241,5186,27,8,142,14,13,5434
6037503103,4774,365,4027,36,7,271,12,12,4409
6037503104,2561,160,2264,5,4,89,10,10,2401
6037503105,3618,386,2746,82,11,305,10,22,3232
6037503106,3822,559,2882,56,4,242,6,21,3263
6037503201,4002,755,2876,52,10,222,2,15,3247
6037503202,4350,530,3428,56,16,239,14,9,3820
6037503301,3488,835,2441,22,14,101,0,21,2653
6037503302,6295,889,4907,78,6,276,6,44,5406
6037503401,7036,2169,3953,93,14,583,12,33,4867
6037503402,4631,1220,2891,46,19,315,15,20,3411
6037503501,6485,1085,4849,88,26,278,2,31,5400
6037503502,4297,998,2902,47,15,212,6,18,3299
6037503601,4189,1309,2145,98,15,450,10,18,2880
6037503602,3838,1305,1729,39,9,635,0,14,2533
6037503701,4941,1390,3035,92,25,235,10,26,3551
6037503702,5453,1724,2899,89,17,491,22,43,3729
6037503704,4598,771,736,88,14,2877,0,18,3827
6037503705,3222,914,1036,60,7,1121,3,21,2308
6037503801,4085,1228,1843,121,16,697,6,22,2857
6037503802,5139,1369,2010,68,15,1459,18,32,3770
6037503901,2799,762,1293,58,9,555,1,16,2037
6037503902,4663,1378,2252,99,19,709,8,31,3285
6037504001,5053,2073,1667,180,5,843,11,19,2980
6037504002,5327,1664,2536,107,6,762,35,14,3663
6037504101,5095,735,3405,84,11,712,11,36,4360
6037504200,7528,624,5320,331,18,1072,19,20,6904
6037530005,4191,374,1647,17,0,2086,1,0,3817
6037530006,4295,470,2872,44,20,806,18,14,3825
6037530007,6651,1034,4433,24,5,1046,5,20,5617
6037530101,5333,424,4441,61,11,336,5,17,4909
6037530102,4994,526,3955,24,1,448,3,11,4468
6037530202,4056,196,3426,17,2,369,0,14,3860
6037530203,3357,206,2742,11,14,328,3,16,3151
6037530204,3528,161,3007,44,14,240,16,9,3367
6037530301,2308,90,2139,15,8,37,0,6,2218
6037530302,6375,124,6094,19,15,84,0,11,6251
6037530400,4066,90,3082,78,4,769,4,7,3976
6037530500,4270,42,4135,4,3,62,1,15,4228
6037530603,4440,203,3901,51,10,231,0,4,4237
6037530700,2175,56,1965,27,7,82,0,12,2119
6037530801,5511,198,5026,52,7,173,0,20,5313
6037530802,3240,171,2863,21,9,108,1,22,3069
6037530901,3674,71,3535,22,3,23,0,6,3603
6037530902,3820,80,3504,28,5,171,0,23,3740
6037531000,5109,67,4906,15,12,76,3,19,5042
6037531101,4589,60,4474,9,8,22,4,4,4529
6037531102,3233,47,3141,11,2,15,1,10,3186
6037531201,4855,59,4744,16,5,18,0,9,4796
6037531202,4518,90,4378,12,3,6,0,18,4428
6037531301,5365,68,5177,58,0,20,1,14,5297
6037531302,6411,72,6258,17,10,31,2,7,6339
6037531502,3279,99,3124,24,4,11,0,3,3180
6037531503,2985,34,2929,0,4,7,0,3,2951
6037531504,4033,41,3928,11,17,12,0,13,3992
6037531602,4134,64,4000,23,1,15,4,10,4070
6037531603,3285,35,3158,6,18,27,2,21,3250
6037531604,3453,53,3356,20,5,11,0,2,3400
6037531701,5498,144,5233,37,8,24,0,24,5354
6037531702,4564,100,4359,33,4,26,0,12,4464
6037531800,4740,74,4584,11,21,28,0,11,4666
6037531901,6228,117,5991,23,5,39,0,22,6111
6037531902,3953,80,3760,9,4,71,0,5,3873
6037532001,3296,136,3030,5,5,88,0,11,3160
6037532002,3254,156,2864,11,2,193,0,20,3098
6037532101,6686,173,6177,23,6,256,0,22,6513
6037532102,3835,207,3235,25,8,324,6,9,3628
6037532200,6599,201,6002,115,14,192,6,28,6398
6037532302,4452,102,4272,14,19,16,0,13,4350
6037532303,4364,103,4105,36,8,84,1,9,4261
6037532304,3660,108,3351,70,13,63,2,22,3552
6037532500,3838,49,3650,36,3,73,1,9,3789
6037532605,3812,99,3562,65,0,52,0,17,3713
6037532606,4125,47,3951,58,7,34,0,15,4078
6037532607,5694,75,5482,51,5,28,4,23,5619
6037532700,2878,23,2703,94,9,9,0,30,2855
6037532800,4204,19,3860,258,4,3,3,23,4185
6037532900,6358,49,5875,356,0,10,3,28,6309
6037533001,4439,54,4168,132,3,26,0,28,4385
6037533002,2370,17,2290,33,7,3,0,10,2353
6037533103,3233,41,3142,20,4,5,0,12,3192
6037533104,3923,44,3777,56,0,14,4,9,3879
6037533105,2423,43,2316,27,2,8,0,11,2380
6037533108,5133,59,4989,14,0,29,7,22,5074
6037533201,2602,28,2544,3,0,8,3,6,2574
6037533204,4143,52,4039,20,0,18,0,7,4091
6037533300,3172,51,3068,13,3,5,0,16,3121
6037533401,4677,65,4563,15,3,9,0,10,4612
6037533402,3902,40,3819,13,4,5,1,6,3862
6037533403,2778,70,2642,27,7,18,0,2,2708
6037533501,2958,32,2877,15,0,4,0,15,2926
6037533504,3848,63,3743,5,0,7,0,25,3785
6037533601,4414,102,4226,4,12,21,8,18,4312
6037533602,5024,328,4622,8,3,17,1,17,4696
6037533603,6106,316,5703,23,10,20,0,13,5790
6037533701,3207,34,3107,23,0,12,0,12,3173
6037533702,3380,45,3287,7,3,14,0,10,3335
6037533703,4022,56,3914,8,9,17,0,10,3966
6037533803,6152,447,5481,34,1,114,0,28,5705
6037533804,4331,116,4166,6,2,17,5,7,4215
6037533805,3493,57,3360,12,0,32,1,13,3436
6037533806,3941,98,3796,5,5,16,0,5,3843
6037533901,5864,64,5698,22,16,26,9,10,5800
6037533902,3840,61,3729,5,10,20,1,4,3779
6037534001,5132,69,4993,19,9,10,0,13,5063
6037534002,4130,144,3877,56,8,30,0,8,3986
6037534101,2100,50,2017,8,3,16,0,2,2050
6037534102,5742,83,5560,21,16,29,0,16,5659
6037534201,4232,96,4015,39,27,23,4,13,4136
6037534202,5373,113,5139,31,7,27,3,26,5260
6037534203,3088,60,2966,19,2,19,2,14,3028
6037534301,4423,62,4256,25,12,35,1,16,4361
6037534302,3662,29,3558,29,4,14,0,12,3633
6037534403,2874,62,2768,20,3,1,9,4,2812
6037534404,3555,127,3320,38,2,41,4,4,3428
6037534405,4059,56,3891,34,14,32,10,11,4003
6037534406,4238,65,4079,21,2,34,2,17,4173
6037534501,5077,72,4942,14,0,16,2,15,5005
6037534502,4074,55,3972,5,1,17,0,16,4019
6037534700,4108,54,4014,0,0,23,0,5,4054
6037534802,2759,45,2672,17,0,10,2,6,2714
6037534803,4629,67,4513,16,0,9,0,9,4562
6037534804,3718,48,3618,21,2,10,0,8,3670
6037534900,6241,66,5976,89,7,42,2,38,6175
6037535001,4152,34,3752,314,5,9,0,24,4118
6037535002,3318,17,3170,101,1,0,0,17,3301
6037535101,7329,47,6390,771,26,23,0,26,7282
6037535102,4557,40,3855,581,4,19,0,13,4517
6037535200,6031,40,5257,678,3,15,0,8,5991
6037535300,6511,108,5971,354,9,11,0,24,6403
6037535400,3595,105,3033,388,4,15,0,20,3490
6037535501,3711,42,3577,21,4,27,0,25,3669
6037535502,4740,72,4584,23,6,29,3,12,4668
6037535503,2370,7,2320,16,5,5,0,5,2363
6037535603,4111,44,3853,141,7,36,2,11,4067
6037535604,4213,54,4110,14,0,14,1,15,4159
6037535605,4042,47,3952,15,0,11,0,2,3995
6037535606,1833,7,1801,4,9,0,0,7,1826
6037535607,4521,74,4369,30,6,7,2,10,4447
6037535701,6001,97,5808,23,9,12,2,18,5904
6037535702,5429,84,5255,34,1,17,1,19,5345
6037535802,6481,88,6287,18,7,8,0,45,6393
6037535803,4242,81,4079,20,13,14,1,8,4161
6037535804,5209,82,5051,24,3,16,0,21,5127
6037535901,5682,131,5458,26,0,18,3,30,5551
6037535902,6236,178,5942,19,8,30,8,23,6058
6037536000,3471,54,3346,12,5,12,0,27,3417
6037536102,3343,385,2653,94,7,154,5,20,2958
6037536103,5438,133,5209,30,8,21,0,15,5305
6037536104,4127,165,3686,190,8,38,3,9,3962
6037536201,3583,264,3149,45,8,73,2,10,3319
6037536202,3949,198,3551,85,5,67,0,6,3751
6037540000,6678,84,6206,218,17,60,6,41,6594
6037540101,6281,91,5682,420,2,26,0,18,6190
6037540102,6833,118,5973,649,9,21,19,7,6715
6037540201,2113,15,2033,26,4,16,3,5,2098
6037540202,6497,125,5806,414,6,58,7,53,6372
6037540203,5135,60,4653,340,7,20,3,22,5075
6037540300,4997,68,4759,87,3,32,3,22,4929
6037540400,2224,12,1990,183,3,4,6,6,2212
6037540501,6411,335,5060,842,5,64,34,27,6076
6037540502,6131,88,5311,620,6,25,12,27,6043
6037540600,4440,38,3110,1179,6,28,6,17,4402
6037540700,3544,78,2310,1039,16,32,0,20,3466
6037540800,6321,70,3270,2758,12,56,10,28,6251
6037540901,5324,95,3852,1238,3,38,24,9,5229
6037540902,4918,72,2168,2488,2,29,2,26,4846
6037541003,4863,420,2078,1945,17,224,28,36,4443
6037541100,3370,36,1945,1283,7,21,2,10,3334
6037541200,6048,47,2538,3204,15,30,25,45,6001
6037541300,6166,49,4377,1553,13,30,13,27,6117
6037541401,3848,55,2913,783,0,25,11,14,3793
6037541402,3801,28,3393,317,2,11,5,14,3773
6037541500,5675,42,4987,590,2,14,6,14,5633
6037541603,2748,84,2240,361,7,12,0,23,2664
6037541604,5993,51,4985,871,16,6,4,19,5942
6037541605,5132,42,4035,935,3,24,8,15,5090
6037541606,2415,28,2021,315,1,11,5,13,2387
6037541700,6278,88,5408,661,1,27,21,30,6190
6037541801,5529,98,4512,751,3,30,75,12,5431
6037541802,5293,46,4751,414,3,21,15,15,5247
6037542000,5358,50,4057,1095,5,34,28,40,5308
6037542103,4019,24,3466,468,4,8,11,16,3995
6037542104,3475,25,3161,239,4,0,4,20,3450
6037542105,4743,31,4050,603,4,15,12,13,4712
6037542106,3532,55,2995,401,0,15,28,17,3477
6037542200,6898,60,5393,1274,8,15,49,19,6838
6037542401,5049,31,3193,1636,8,20,56,28,5018
6037542402,3127,22,2040,981,1,3,26,6,3105
6037542501,4283,35,2154,1853,7,23,91,27,4248
6037542502,4310,53,2700,1385,9,28,58,19,4257
6037542601,2810,27,2343,372,1,9,25,12,2783
6037542602,5608,51,4213,1200,8,27,24,24,5557
6037542700,5684,44,4453,1061,9,24,18,23,5640
6037542800,3336,26,1860,1370,0,6,6,11,3310
6037542900,3184,23,2531,519,1,23,19,14,3161
6037543000,4684,45,2370,2049,4,35,24,39,4639
6037543100,6988,65,4198,2524,11,29,25,21,6923
6037543201,3687,34,2530,1016,9,4,14,19,3653
6037543203,4873,51,3809,904,4,6,49,14,4822
6037543304,6339,123,757,4914,9,241,46,35,6216
6037543305,3251,489,1480,919,14,197,11,23,2762
6037543306,6778,406,2485,997,10,2388,223,14,6372
6037543321,6034,384,1165,3257,21,875,52,29,5650
6037543322,6844,197,979,4715,9,544,93,54,6647
6037543400,4132,242,2510,624,6,562,66,30,3890
6037543501,7053,472,2185,693,19,3305,162,31,6581
6037543502,4424,573,2256,172,22,1213,50,26,3851
6037543503,6080,977,1897,410,7,2470,64,35,5103
6037543601,3887,298,1512,305,17,1526,79,19,3589
6037543603,3903,814,845,880,9,1116,28,23,3089
6037543605,4609,800,1440,436,12,1646,77,23,3809
6037543606,3854,597,1345,278,13,1441,34,17,3257
6037543607,5502,398,2086,286,0,2466,93,14,5104
6037543701,2845,174,1478,47,0,1018,55,15,2671
6037543703,3429,270,1888,256,1,837,54,11,3159
6037543704,3284,295,1995,86,11,781,48,5,2989
6037543705,3624,216,1804,220,5,1227,22,32,3408
6037543801,5093,452,2306,213,8,1832,95,7,4641
6037543803,5173,387,1736,795,2,1872,135,79,4786
6037543804,4835,936,1082,585,27,1984,81,7,3899
6037543903,4090,330,1694,278,3,1617,42,26,3760
6037543905,4344,117,3272,381,10,425,60,23,4227
6037544001,4689,252,3146,343,5,722,94,11,4437
6037544002,3172,281,2000,193,5,542,53,20,2891
6037550101,3974,258,3246,65,10,327,12,5,3716
6037550201,2853,205,2241,60,12,254,21,26,2648
6037550202,5358,499,4058,195,16,484,12,34,4859
6037550301,4147,418,2979,227,14,377,31,27,3729
6037550501,3604,332,2823,128,5,259,1,23,3272
6037550502,4248,794,2899,60,0,399,5,28,3454
6037550601,5861,642,4431,194,13,423,11,55,5219
6037550602,4444,805,3099,61,0,396,3,11,3639
6037550700,7215,972,5489,102,20,494,5,41,6243
6037550801,4684,860,3429,50,5,262,0,16,3824
6037550802,2632,293,2126,55,3,112,0,11,2339
6037550901,4497,489,3354,166,15,370,7,16,4008
6037550902,5675,600,4435,132,18,378,2,29,5075
6037551001,3920,647,2702,134,3,304,16,30,3273
6037551002,3765,668,2610,67,3,315,4,12,3097
6037551101,3966,309,3207,165,20,191,18,20,3657
6037551102,5451,386,4277,382,12,242,9,43,5065
6037551201,3673,430,2815,167,2,191,8,10,3243
6037551203,3737,401,2781,231,4,222,14,36,3336
6037551204,4067,650,2953,132,13,243,10,17,3417
6037551300,5450,671,4104,258,15,261,10,36,4779
6037551401,4425,490,3448,148,13,229,5,42,3935
6037551402,4567,676,3321,120,5,316,10,37,3891
6037551501,4920,711,3570,216,10,289,8,32,4209
6037551502,4255,565,3168,89,10,318,18,16,3690
6037551700,6340,578,5186,166,6,279,4,54,5762
6037551801,3225,425,2278,190,8,227,17,13,2800
6037551802,4373,503,3045,372,23,317,30,23,3870
6037551900,5561,637,3861,347,26,580,10,25,4924
6037552001,4041,414,2974,125,21,424,16,17,3627
6037552002,3419,222,2460,253,15,393,8,19,3197
6037552100,5995,505,4082,193,14,1075,13,20,5490
6037552200,6474,372,5032,328,24,587,8,17,6102
6037552301,4471,371,2932,268,10,748,42,35,4100
6037552302,3599,420,2199,212,22,637,17,20,3179
6037552400,2518,156,2075,44,4,184,3,14,2362
6037552601,5227,155,4701,32,5,249,8,36,5072
6037552602,4132,294,2105,180,4,1436,17,12,3838
6037552700,6885,604,5115,159,30,825,29,24,6281
6037552800,6267,522,4602,183,7,773,39,46,5745
6037552900,7018,701,4574,331,19,1203,16,23,6317
6037553000,4866,575,3533,181,11,421,14,12,4291
6037553100,6536,1181,3297,855,16,951,26,20,5355
6037553201,3756,622,2348,270,11,378,22,15,3134
6037553202,3620,543,2333,248,4,379,0,26,3077
6037553300,3530,441,2352,208,6,414,21,8,3089
6037553400,3926,305,3205,113,22,198,22,30,3621
6037553502,4147,187,3227,471,4,146,9,31,3960
6037553503,2730,80,2277,277,0,43,2,22,2650
6037553504,5320,209,4422,410,4,190,28,15,5111
6037553601,4839,182,3912,533,4,102,16,34,4657
6037553602,4922,142,3754,777,15,125,8,19,4780
6037553701,3861,98,3647,49,2,37,3,14,3763
6037553702,4606,68,4234,201,3,53,5,16,4538
6037553801,4021,128,3120,574,5,116,13,11,3893
6037553802,6601,377,4925,766,34,361,31,19,6224
6037553901,6709,413,5372,445,12,346,24,13,6296
6037553902,5977,389,4730,467,11,184,86,14,5588
6037554001,4426,633,2759,298,0,575,26,31,3793
6037554002,6135,751,3833,654,12,706,36,12,5384
6037554101,3778,376,2561,368,3,380,2,29,3402
6037554105,4509,489,2557,878,10,394,32,45,4020
6037554106,4368,525,2540,532,13,607,24,13,3843
6037554201,4096,613,2369,395,5,576,23,15,3483
6037554203,3635,629,2040,372,14,413,34,17,3006
6037554204,4600,441,2869,654,14,483,30,18,4159
6037554301,3499,265,2446,464,4,229,23,10,3234
6037554302,4072,283,2391,684,11,527,47,8,3789
6037554403,5602,524,3091,1036,13,675,58,55,5078
6037554404,4509,510,2448,686,19,644,56,25,3999
6037554405,3328,501,1411,721,17,513,44,10,2827
6037554406,5191,1488,1605,808,11,1011,27,19,3703
6037554511,4013,402,452,172,6,2805,12,31,3611
6037554512,6583,726,742,396,5,4493,17,32,5857
6037554513,2540,227,273,193,0,1777,13,0,2313
6037554514,4496,533,828,379,0,2554,23,32,3963
6037554515,3641,509,612,257,0,2100,10,21,3132
6037554516,3821,460,536,190,12,2478,20,8,3361
6037554517,4737,505,608,231,12,3192,14,11,4232
6037554518,5365,646,611,299,8,3609,8,11,4719
6037554519,3489,451,348,130,2,2413,1,24,3038
6037554521,5987,1091,1164,574,5,2790,39,47,4896
6037554522,4906,790,918,334,11,2599,34,23,4116
6037554600,4311,540,1942,185,6,1472,32,16,3771
6037554700,4503,238,3549,78,15,553,4,25,4265
6037554801,3281,227,2368,99,8,520,5,20,3054
6037554802,6045,1133,1527,229,4,2955,37,22,4912
6037554900,7069,1248,1930,299,14,3377,16,23,5821
6037555001,5579,744,2778,370,11,1450,53,16,4835
6037555002,3563,720,1626,342,15,648,34,16,2843
6037555105,6245,517,2862,760,12,1787,62,37,5728
6037555106,3696,188,2291,395,13,750,8,13,3508
6037555107,5729,1115,1883,447,4,2004,27,25,4614
6037555202,3551,1704,972,205,4,459,7,12,1847
6037555211,5773,202,5101,45,3,374,2,15,5571
6037555212,4680,383,3466,110,2,608,25,28,4297
6037555300,3980,382,2835,142,4,541,4,10,3598
6037570001,4430,1520,1438,314,12,863,23,21,2910
6037570002,2883,1048,1031,166,12,421,9,16,1835
6037570003,4617,1372,1891,345,6,711,46,27,3245
6037570100,2950,500,1218,497,3,583,40,4,2450
6037570202,6122,371,4091,839,22,585,102,18,5751
6037570203,4051,196,2613,740,5,297,73,21,3855
6037570204,4133,444,2427,569,4,458,118,18,3689
6037570303,3925,247,2514,573,10,381,87,27,3678
6037570304,5007,237,3437,777,23,302,79,40,4770
6037570305,5291,339,3797,678,7,293,48,27,4952
6037570306,3010,206,1805,485,15,374,36,8,2804
6037570402,3391,194,1601,1140,10,206,115,21,3197
6037570403,4556,93,3630,591,1,179,17,12,4463
6037570404,3509,83,2589,562,21,124,36,15,3426
6037570502,6558,534,3758,824,4,1097,121,39,6024
6037570503,3789,400,2192,539,4,479,39,19,3389
6037570504,3903,360,2431,419,1,481,80,21,3543
6037570601,5235,421,3133,780,10,686,58,19,4814
6037570602,6557,551,3376,699,6,1642,105,34,6006
6037570603,5391,292,1718,2733,11,243,112,36,5099
6037570701,6993,1568,2263,1197,22,1461,91,50,5425
6037570703,3473,881,1091,463,9,845,26,10,2592
6037570800,5661,2108,2014,288,20,836,50,22,3553
6037570901,5747,2497,1695,228,15,865,32,14,3250
6037570902,3653,1516,1244,233,13,408,14,38,2137
6037571000,5792,2995,1735,159,3,491,35,51,2797
6037571101,4654,2116,1538,187,10,461,25,25,2538
6037571102,4006,1912,1292,166,13,350,11,27,2094
6037571201,3775,1729,1173,218,6,405,24,21,2046
6037571202,4459,1683,1517,339,6,564,39,29,2776
6037571300,4638,1754,1495,348,15,731,28,21,2884
6037571400,4950,1538,1637,519,23,840,80,32,3412
6037571502,5067,1009,1997,714,15,1064,40,21,4058
6037571504,4935,1101,1664,1000,10,806,46,17,3834
6037571505,2969,542,1297,369,11,593,16,16,2427
6037571600,2180,60,807,1177,7,33,4,16,2120
6037571701,6495,562,3810,923,4,867,127,35,5933
6037571703,3505,264,2248,390,10,452,40,14,3241
6037571704,3947,268,2494,554,4,421,90,32,3679
6037571800,3229,1650,633,326,12,419,9,20,1579
6037571900,5769,2251,1528,833,4,690,35,26,3518
6037572001,5434,2453,1674,376,12,522,40,46,2981
6037572201,6141,996,2077,997,17,1641,89,15,5145
6037572202,3848,617,1456,530,0,1041,58,9,3231
6037572301,3840,156,2344,288,7,843,113,6,3684
6037572500,4244,510,1589,1049,16,749,154,12,3734
6037572600,5276,193,2600,466,7,1767,121,21,5083
6037572700,5405,144,2230,483,1,2317,84,9,5261
6037573002,3484,139,2363,574,7,279,13,26,3345
6037573003,1790,388,870,215,14,209,16,5,1402
6037573004,4670,404,2853,922,8,255,36,47,4266
6037573101,4220,403,2245,763,9,561,57,50,3817
6037573102,3245,465,1674,519,8,416,27,12,2780
6037573201,4606,227,2850,568,6,826,20,9,4379
6037573202,6250,213,3717,760,11,1361,16,29,6037
6037573300,4068,153,1740,558,12,1405,64,15,3915
6037573401,1575,351,660,187,10,258,15,15,1224
6037573402,6827,1367,2749,955,19,1412,33,15,5460
6037573403,3446,1113,799,408,4,916,32,18,2333
6037573601,6441,3525,1650,171,14,524,38,23,2916
6037573700,4790,2539,1304,139,4,407,14,50,2251
6037573800,4371,2419,1118,101,11,361,10,24,1952
6037573902,2263,1256,430,101,3,294,10,9,1007
6037574000,5322,3054,1232,140,9,482,12,17,2268
6037574100,5251,2998,1227,132,10,470,21,28,2253
6037574201,3287,1595,855,106,2,475,11,12,1692
6037574202,2206,970,764,173,3,180,19,4,1236
6037574300,6044,3449,1318,186,15,615,28,35,2595
6037574400,5420,3091,1255,137,5,542,15,28,2329
6037574500,6533,3734,1439,172,6,672,24,48,2799
6037574602,1243,757,144,54,4,196,2,3,486
6037574800,3165,1799,601,151,3,382,1,13,1366
6037574901,3829,2219,758,106,10,409,17,27,1610
6037574902,5192,1697,1485,627,11,992,25,43,3495
6037575001,4144,1377,1179,488,25,759,35,24,2767
6037575002,4760,1865,1587,385,13,581,12,30,2895
6037575101,4568,478,2336,640,14,905,25,18,4090
6037575102,4064,271,2524,354,11,773,16,22,3793
6037575103,5088,848,2486,893,32,557,19,31,4240
6037575201,4664,165,2425,644,3,1259,24,28,4499
6037575202,4278,160,2589,340,4,1073,11,12,4118
6037575300,4545,154,2722,678,6,816,45,26,4391
6037575401,4530,214,3441,595,0,141,18,31,4316
6037575402,3454,158,2671,362,0,157,31,21,3296
6037575801,1961,238,1417,199,5,45,2,0,1723
6037575802,4544,473,3160,586,2,148,19,22,4071
6037575803,2684,429,1492,342,4,300,27,15,2255
6037575901,3278,518,1559,775,7,232,9,22,2760
6037575902,5622,1653,1971,1095,24,514,25,98,3969
6037576001,5921,2635,1303,670,20,884,23,63,3286
6037576200,7148,1850,2970,1229,46,543,40,91,5298
6037576301,4564,759,2143,925,20,472,25,36,3805
6037576302,3901,385,2205,625,19,520,19,14,3516
6037576401,4060,239,2657,528,12,469,28,19,3821
6037576402,4705,402,3116,504,17,536,30,27,4303
6037576403,4830,438,2943,570,10,694,11,20,4392
6037576501,3094,754,1480,458,14,193,20,27,2340
6037576502,4190,1197,1856,561,18,281,6,33,2993
6037576503,4093,1264,1902,485,17,213,17,27,2829
6037576601,4770,2079,1414,548,20,379,33,57,2691
6037576602,4403,2160,1129,446,23,326,32,38,2243
6037576700,4153,2272,1021,242,11,310,12,46,1881
6037576801,4286,1702,1523,437,17,320,27,26,2584
6037576802,3989,1692,1273,415,18,307,13,30,2297
6037576901,5366,749,2939,662,11,784,14,25,4617
6037576903,3814,554,2226,532,24,340,11,12,3260
6037576904,3239,809,1541,510,9,245,6,20,2430
6037577000,7264,2658,2573,824,24,676,45,50,4606
6037577100,7051,3787,1850,371,18,467,17,62,3264
6037577200,5750,3317,1321,276,12,429,14,20,2433
6037577300,5535,3531,1150,166,14,324,12,47,2004
6037577400,3173,2133,567,87,1,191,4,29,1040
6037577501,3440,2610,412,36,5,174,15,22,830
6037577504,1393,1028,194,10,7,54,1,9,365
6037577602,3370,2256,475,114,11,325,7,25,1114
6037577604,1300,937,175,30,2,96,6,8,363
6037577605,4799,3299,693,97,8,399,8,22,1500
6037577606,3547,2197,681,124,0,233,11,29,1350
6037577700,4672,199,2431,657,14,1106,114,20,4473
6037577800,5085,650,3802,118,8,368,28,35,4435
6037577900,5481,1498,1489,959,7,1160,44,27,3983
6037578000,7189,676,4075,1198,19,940,50,35,6513
6037578100,2094,730,657,151,5,395,9,13,1364
6037599000,3322,1334,1803,27,4,27,8,11,1988
6037599100,553,252,223,40,0,17,5,2,301
6037600100,7098,90,4547,2224,12,23,9,64,7008
6037600201,4690,53,3071,1413,10,28,10,23,4637
6037600202,7071,95,4166,2510,8,32,33,37,6976
6037600302,3472,31,1248,2048,4,30,1,20,3441
6037600303,3813,26,2172,1444,13,11,0,46,3787
6037600304,3781,52,2374,1234,7,18,1,13,3729
6037600400,3988,80,817,2844,5,52,5,28,3908
6037600501,2632,78,492,1867,1,34,11,30,2554
6037600601,2571,56,361,1976,4,27,0,30,2515
6037600602,2370,46,1441,743,5,15,6,26,2324
6037600702,4182,122,647,3138,8,61,3,52,4060
6037600703,2326,60,152,1923,14,29,7,21,2266
6037600704,3010,90,481,2223,4,33,4,35,2920
6037600801,3206,91,467,2419,0,30,4,28,3115
6037600802,2643,114,455,1911,6,27,0,23,2529
6037600902,6798,299,3195,2868,9,102,11,63,6499
6037600911,3282,324,1784,914,7,63,9,31,2958
6037600912,5174,249,3960,732,10,56,7,32,4925
6037601001,2274,85,487,1486,4,72,4,27,2189
6037601002,5457,207,2464,2357,11,210,8,47,5250
6037601100,6159,171,3699,1754,3,273,35,46,5988
6037601202,3832,122,3340,208,11,90,2,17,3710
6037601211,2833,119,1393,1124,5,73,5,14,2714
6037601212,6319,220,4310,1474,11,114,10,34,6099
6037601301,1958,371,486,882,3,65,2,13,1587
6037601302,6785,469,2261,3405,21,195,10,73,6316
6037601303,4959,250,1966,2375,8,122,16,48,4709
6037601401,5012,271,2816,1562,21,114,18,52,4741
6037601402,4782,188,4197,226,6,99,1,10,4594
6037601501,3500,83,2986,311,5,65,9,17,3417
6037601502,3374,50,3175,75,3,20,16,17,3324
6037601600,4164,93,3818,114,4,75,40,8,4071
6037601700,4931,82,4444,229,7,72,39,25,4849
6037601801,3462,46,3196,138,2,33,7,20,3416
6037601802,3896,67,3704,52,3,11,14,23,3829
6037601900,5091,70,4288,568,12,45,34,19,5021
6037602002,3007,99,2329,379,0,127,13,15,2908
6037602003,4759,127,3883,587,5,33,41,19,4632
6037602103,6931,361,4857,1142,19,293,71,62,6570
6037602104,5541,235,3630,1253,4,238,52,15,5306
6037602105,4302,234,2955,784,5,176,21,26,4068
6037602106,5693,690,3281,965,5,491,31,43,5003
6037602201,4552,1610,1702,298,9,582,38,38,2942
6037602202,3112,301,2033,384,3,275,27,18,2811
6037602301,6188,1638,3454,223,10,492,66,46,4550
6037602302,5300,2727,911,171,3,985,19,32,2573
6037602402,6812,1165,4126,619,24,570,63,59,5647
6037602403,5172,387,3233,851,9,433,57,54,4785
6037602404,5848,535,3598,901,8,491,99,68,5313
6037602504,4670,176,2180,1662,10,451,12,52,4494
6037602505,4427,316,2476,1242,4,199,4,62,4111
6037602506,4429,191,1948,1828,9,233,28,39,4238
6037602507,5321,237,1919,2624,11,273,35,49,5084
6037602510,3510,236,2044,834,4,217,47,48,3274
6037602511,3602,171,1671,1404,0,160,10,56,3431
6037602512,2442,114,1824,82,3,339,39,13,2328
6037602513,1590,70,881,520,3,39,14,7,1520
6037602601,4784,169,1012,3113,12,235,20,25,4615
6037602602,3339,122,886,1971,7,207,17,19,3217
6037602700,3674,176,763,2336,0,223,19,24,3498
6037602801,4391,68,2436,1573,19,126,11,52,4323
6037602802,4365,63,1665,2417,5,60,17,27,4302
6037602900,4293,166,3077,655,13,256,20,29,4127
6037603004,1846,97,749,390,0,538,12,11,1749
6037603005,5628,259,2723,1491,10,894,28,47,5369
6037603006,2272,167,687,234,0,1050,13,30,2105
6037603007,4080,205,1756,1183,9,775,33,25,3875
6037603008,3186,199,1531,695,9,641,32,21,2987
6037603101,4448,403,1857,758,6,1234,45,15,4045
6037603102,4034,257,1787,482,0,1388,18,15,3777
6037603200,3199,338,909,313,2,1470,17,22,2861
6037603301,3914,374,1132,278,5,1911,25,28,3540
6037603302,4454,349,1685,280,11,1902,29,18,4105
6037603400,4504,451,2063,563,1,1226,5,17,4053
6037603500,3083,452,1323,304,12,835,17,24,2631
6037603600,3963,811,1326,296,9,1251,25,18,3152
6037603702,4993,1425,1813,226,14,1181,16,41,3568
6037603703,2572,618,1190,157,3,442,44,28,1954
6037603705,2589,174,1000,1097,2,210,9,14,2415
6037603706,3624,158,2404,719,7,232,10,39,3466
6037603801,4630,490,2621,804,18,527,32,16,4140
6037603802,3937,442,2424,267,5,624,14,27,3495
6037603901,4013,636,2553,301,3,346,17,24,3377
6037603902,3288,411,2196,208,15,364,5,20,2877
6037604001,4241,691,2767,246,13,321,54,37,3550
6037604002,4863,994,2820,281,4,477,27,51,3869
6037604101,3973,418,2813,286,10,274,26,51,3555
6037604102,2862,467,1824,145,7,275,10,22,2395
6037604200,6255,113,4095,1767,4,63,73,44,6142
6037609900,1804,495,1019,98,10,105,9,15,1309
6037620001,4029,2483,679,85,13,456,25,24,1546
6037620002,3629,2158,592,109,14,435,14,19,1471
6037620101,5667,3497,1015,111,8,572,10,25,2170
6037620102,3885,2480,675,72,10,332,12,20,1405
6037620201,1550,1168,164,14,4,99,2,8,382
6037620301,4753,3549,414,25,0,385,3,18,1204
6037620303,4704,3509,372,33,7,446,6,37,1195
6037620305,6114,4769,509,43,2,343,5,32,1345
6037620400,5360,3477,511,69,8,866,2,52,1883
6037620501,5786,3289,881,115,8,1011,21,46,2497
6037620521,4313,1929,990,237,1,735,18,38,2384
6037620522,5068,2677,839,143,6,911,13,39,2391
6037620601,5869,2745,1242,247,11,1120,20,44,3124
6037620602,5454,2820,1196,78,10,870,21,46,2634
6037620701,6991,3994,1135,230,17,1007,12,60,2997
6037620703,3666,2163,593,56,1,551,8,10,1503
6037620704,3727,2127,558,73,12,593,15,36,1600
6037620801,4372,2582,361,46,5,996,8,29,1790
6037620802,3185,2064,314,32,0,487,0,22,1121
6037620901,2639,1937,218,22,2,252,1,29,702
6037620904,2829,2298,209,21,0,121,2,13,531
6037621001,4346,3086,459,61,1,371,7,53,1260
6037621005,5547,4409,543,34,10,235,5,23,1138
6037621102,3049,2140,338,20,8,237,1,23,909
6037621104,6786,4928,724,80,12,528,7,53,1858
6037621201,8259,4595,1872,379,90,697,25,64,3664
6037621204,3110,2062,397,103,4,376,4,10,1048
6037621301,7291,4422,1070,191,9,1005,3,59,2869
6037621324,3849,2503,566,103,11,416,10,23,1346
6037621326,3348,2257,472,81,4,311,7,24,1091
6037621400,4845,3213,686,67,3,482,6,33,1632
6037650001,5825,1173,1276,165,10,2813,21,53,4652
6037650003,3237,700,984,313,5,985,14,38,2537
6037650004,4262,973,1032,368,3,1577,41,31,3289
6037650101,5771,994,1278,101,15,2987,31,21,4777
6037650102,2185,705,518,72,3,708,13,14,1480
6037650200,5831,1914,1646,175,9,1692,41,18,3917
6037650300,6898,2098,1910,279,7,2144,21,60,4800
6037650401,4450,1730,821,85,9,1491,20,26,2720
6037650501,3024,1365,507,27,3,903,6,14,1659
6037650502,4260,2046,603,78,5,1234,11,20,2214
6037650603,3904,1566,431,72,0,1499,14,48,2338
6037650604,5647,1396,1171,368,14,2251,8,90,4251
6037650605,2908,763,470,160,4,1305,17,42,2145
6037650606,4502,1340,773,273,12,1813,5,56,3162
6037650607,2910,625,359,224,14,1473,16,32,2285
6037650701,2626,1071,357,36,0,1004,0,18,1555
6037650702,4521,2225,659,37,9,1166,8,38,2296
6037650801,4126,821,300,84,5,2738,10,18,3305
6037650802,3483,739,231,84,10,2274,2,10,2744
6037650901,5976,2177,1891,284,3,1161,41,37,3799
6037650903,4499,1290,1584,139,9,1212,30,28,3209
6037650904,2673,455,614,58,0,1378,14,9,2218
6037651001,5776,1884,1732,150,7,1578,23,39,3892
6037651002,4741,1473,1016,134,10,1785,29,42,3268
6037651101,5050,1756,648,206,7,2100,7,12,3294
6037651102,3750,1427,487,123,11,1455,7,30,2323
6037651201,4876,2905,650,54,13,898,6,16,1971
6037651221,3412,1057,526,132,3,1503,9,7,2355
6037651222,6123,2341,1012,163,6,2187,24,20,3782
6037651302,6234,3815,764,74,4,1144,6,31,2419
6037651304,4987,3474,624,71,15,422,4,33,1513
6037651401,2585,1251,363,75,3,718,4,9,1334
6037651402,6012,2364,842,117,7,2258,20,20,3648
6037670001,3417,1289,1259,85,6,567,37,19,2128
6037670002,3906,1230,1670,138,14,629,20,18,2676
6037670003,6163,2361,2225,173,18,990,34,33,3802
6037670101,3394,1172,1064,498,9,439,12,30,2222
6037670102,4041,1217,1473,235,10,811,25,33,2824
6037670201,4050,2419,409,57,7,876,3,54,1631
6037670202,2626,1573,218,17,3,610,2,24,1053
6037670324,5160,3671,385,39,6,717,1,30,1489
6037670326,3702,2104,273,51,4,1019,1,29,1598
6037670328,4485,2769,345,76,6,977,2,26,1716
6037670405,2957,1404,146,46,4,1175,0,29,1553
6037670406,1857,728,88,28,1,911,0,4,1129
6037670407,5913,2123,471,168,3,2763,2,53,3790
6037670413,4825,2047,374,130,2,1999,4,23,2778
6037670416,4074,1827,314,152,3,1517,8,19,2247
6037670417,2866,1257,229,46,3,1166,0,23,1609
6037670418,4207,2182,332,46,2,1307,9,26,2025
6037670500,1739,1128,122,23,2,354,1,12,611
6037670603,1872,823,143,47,0,746,0,13,1049
6037670604,5356,3238,589,137,1,1067,4,35,2118
6037670701,6524,3080,1391,218,6,1384,4,45,3444
6037670702,5555,3432,696,120,17,953,4,40,2123
6037700101,5785,4083,766,272,7,320,6,40,1702
6037700102,4448,2949,702,185,10,304,2,38,1499
6037700200,6602,4654,859,243,6,383,5,72,1948
6037700300,5754,4216,642,169,12,370,5,53,1538
6037700400,5140,3688,620,180,3,347,8,34,1452
6037700501,3586,2597,384,104,4,249,6,38,989
6037700502,4442,3210,524,149,7,300,9,34,1232
6037700600,5032,4189,246,47,1,267,3,31,843
6037700700,3111,2639,153,26,3,162,2,24,472
6037700801,4941,3769,326,93,1,420,3,35,1172
6037700802,3892,2864,272,84,0,423,3,30,1028
6037700901,3863,2772,257,93,4,449,0,20,1091
6037700902,6561,4628,508,210,3,705,0,75,1933
6037701000,5301,4033,456,109,1,439,0,46,1268
6037701201,4228,3350,207,18,0,400,0,25,878
6037701202,3498,2580,303,35,0,331,0,15,918
6037701302,4951,3608,496,70,10,399,8,45,1343
6037701304,6462,4909,439,81,4,563,11,80,1553
6037701402,6494,4754,689,138,9,498,3,61,1740
6037701501,5283,3796,506,112,4,522,3,56,1487
6037701502,3665,2398,433,171,0,373,11,36,1267
6037701601,4175,3026,306,38,8,458,3,23,1149
6037701602,4356,2605,710,155,0,528,4,38,1751
6037701701,3543,2090,661,129,7,408,5,23,1453
6037701702,3326,1896,666,234,7,302,2,30,1430
6037701801,5973,2147,2153,625,7,681,15,54,3826
6037701802,4207,1860,1248,437,5,323,10,68,2347
6037701902,5478,3208,755,541,20,569,3,54,2270
6037702002,5989,4039,916,262,9,366,5,47,1950
6037702102,6447,4741,727,159,12,378,14,44,1706
6037702201,4475,2965,630,124,2,371,2,29,1510
6037702202,3890,2599,556,87,7,308,5,26,1291
6037702300,6603,4059,1138,207,18,688,5,51,2544
6037702400,4677,2270,1143,221,10,559,23,57,2407
6037702501,4952,2891,815,137,6,695,13,52,2061
6037702502,4320,1818,629,614,1,834,11,35,2502
6037702600,6459,3027,1201,326,12,1361,12,52,3432
6037702700,3798,1969,720,86,6,653,0,32,1829
6037702801,5272,2082,1539,268,3,1035,17,59,3190
6037702802,2278,928,815,74,2,269,0,23,1350
6037702803,2986,1326,1043,142,1,272,9,21,1660
6037702900,11373,8099,1121,503,10,841,17,145,3274
6037703002,6907,1048,520,4410,16,362,2,89,5859
6037703003,6037,2233,827,1275,6,1154,7,48,3804
6037703100,5619,511,579,3849,6,170,5,48,5108
6037703200,5800,493,519,4199,3,149,5,39,5307
6037800101,5476,4236,426,75,7,420,0,29,1240
6037800103,3540,2755,299,52,20,163,1,20,785
6037800104,3795,2978,338,36,5,144,6,57,817
6037800202,6044,4648,434,130,10,471,5,45,1396
6037800204,4595,3610,293,66,3,374,2,38,985
6037800205,3816,2596,418,130,11,392,8,29,1220
6037800206,3047,2327,194,103,4,232,4,33,720
6037800324,6763,4873,680,109,5,675,3,42,1890
6037800325,3387,2713,294,24,1,172,1,9,674
6037800328,1291,873,141,49,8,151,0,12,418
6037800333,2738,1818,409,61,9,239,1,11,920
6037800334,3749,2623,638,35,4,264,0,24,1126
6037800335,5189,4011,475,45,10,380,2,23,1178
6037800336,2934,2235,279,32,4,212,0,10,699
6037800337,3373,2220,403,97,1,439,0,23,1153
6037800338,6013,4657,457,30,1,518,3,45,1356
6037800406,1673,1295,192,26,1,55,5,19,378
6037800410,3847,2520,235,233,70,690,9,4,1327
6037800411,2415,1958,201,45,1,62,3,30,457
6037800412,3437,2825,258,41,0,103,0,23,612
6037800504,2261,1870,145,24,6,86,0,21,391
6037800506,2954,2327,216,25,7,192,1,9,627
6037900102,830,312,430,31,0,7,1,6,518
6037900103,6708,1567,4306,522,33,34,2,63,5141
6037900104,6556,1560,4252,423,33,42,10,42,4996
6037900301,3957,930,1943,682,40,210,0,17,3027
6037900501,7610,1092,4068,1847,23,220,5,40,6518
6037900504,7557,1520,3736,1481,48,365,24,61,6037
6037900505,4548,854,2181,1057,9,196,3,32,3694
6037900506,4944,662,2339,1582,14,107,0,37,4282
6037900508,4543,903,2233,967,2,190,4,33,3640
6037900509,4693,849,2754,764,18,111,2,32,3844
6037900510,4015,570,2144,1029,21,91,10,18,3445
6037900602,6016,727,4101,833,14,40,13,107,5289
6037900606,4090,531,1969,1281,17,56,7,34,3559
6037900607,4263,676,2201,1145,20,61,3,32,3587
6037900608,3845,591,2175,811,13,114,8,22,3254
6037900609,5805,677,3087,1629,7,114,3,63,5128
6037900610,3929,812,2596,292,13,76,18,29,3117
6037900611,4352,612,2312,1016,43,160,9,13,3740
6037900701,5591,1261,2704,1200,19,127,5,49,4330
6037900703,4667,1199,1820,1193,32,195,10,39,3468
6037900704,3584,828,1370,990,0,198,8,26,2756
6037900705,4939,1869,1713,881,18,196,11,35,3070
6037900804,3895,534,2219,868,28,91,4,30,3361
6037900805,5626,1724,2604,807,27,205,1,20,3902
6037900806,4562,930,1733,1438,55,156,7,42,3632
6037900807,4566,1092,2000,891,9,351,2,35,3474
6037900808,4590,800,2369,1046,11,159,4,35,3790
6037900901,2951,1197,1007,486,11,136,2,14,1754
6037900902,1674,1006,470,52,17,34,1,14,668
6037901003,3278,417,1104,1642,29,42,12,4,2861
6037901007,2127,1066,749,114,0,101,2,1,1061
6037901008,3093,859,1242,545,21,248,7,29,2234
6037901009,5741,2312,1901,821,24,323,6,42,3429
6037901010,6185,2024,2486,962,22,257,1,51,4161
6037901011,5374,2142,1758,701,24,406,15,33,3232
6037901012,5314,1578,1849,1109,6,449,5,42,3736
6037901013,4431,1445,1609,760,12,347,4,49,2986
6037901014,5270,1684,1808,861,21,589,16,31,3586
6037901101,6257,2560,2423,568,20,277,6,52,3697
6037901102,5703,2696,1896,547,18,196,9,39,3007
6037901209,1370,831,384,30,30,17,2,18,539
6037901210,1516,1051,331,20,9,24,0,5,465
6037901214,4519,1673,1693,568,11,275,6,44,2846
6037901215,4112,2126,1132,417,10,165,7,35,1986
6037901216,2733,1354,770,295,6,114,11,22,1379
6037901217,1529,1147,234,10,7,19,0,19,382
6037901218,2462,1205,608,254,11,200,0,20,1257
6037901300,2011,780,985,73,10,48,3,17,1231
6037910002,7697,1778,5385,245,19,74,5,27,5919
6037910210,7399,2759,2707,794,11,648,26,73,4640
6037910211,1916,799,521,216,0,285,0,8,1117
6037910212,3403,1726,1178,109,10,212,12,13,1677
6037910213,1285,546,489,109,8,59,0,17,739
6037910214,6336,1677,2872,841,28,598,23,42,4659
6037910215,7110,1572,3836,842,23,536,0,52,5538
6037910216,4722,1606,1899,557,7,357,8,22,3116
6037910217,5873,1204,2759,967,17,615,21,36,4669
6037910218,4413,1141,2286,653,28,165,1,24,3272
6037910301,4392,2380,1286,270,22,165,4,16,2012
6037910302,6514,3093,2012,527,32,413,11,59,3421
6037910401,6368,1589,2958,850,13,621,24,38,4779
6037910404,4370,610,2940,540,22,120,0,27,3760
6037910405,6149,403,4463,991,24,60,5,31,5746
6037910501,6344,498,3452,2026,12,110,10,59,5846
6037910502,4481,444,3305,554,3,68,7,26,4037
6037910504,4857,490,3664,494,13,91,9,14,4367
6037910505,3456,434,2544,295,3,85,4,12,3022
6037910601,7226,678,5555,703,37,87,11,45,6548
6037910602,4428,542,2949,611,13,138,1,28,3886
6037910605,5134,525,3867,488,18,100,11,31,4609
6037910606,3222,355,2407,255,29,84,9,9,2867
6037910607,3946,503,2664,513,7,110,12,31,3443
6037910608,3550,506,2590,299,2,68,5,22,3044
6037910706,6553,493,4883,800,3,183,13,34,6060
6037910707,5968,858,3650,1091,10,124,10,49,5110
6037910709,1818,649,984,70,4,46,0,6,1169
6037910712,3155,424,2198,364,9,67,2,10,2731
6037910713,6055,577,4227,842,23,187,1,35,5478
6037910714,3934,291,3069,394,1,66,6,29,3643
6037910715,7105,752,5139,774,19,224,13,48,6353
6037910716,6636,1016,4445,761,16,154,24,30,5620
6037910717,2403,232,1634,389,14,71,1,10,2171
6037910718,5861,470,4180,861,10,188,0,62,5391
6037910719,4484,304,3146,680,7,181,0,39,4180
6037910720,5194,597,3609,640,7,174,2,47,4597
6037910721,3330,421,2472,288,15,62,6,9,2909
6037910804,3338,2058,969,41,14,86,2,36,1280
6037910807,6092,2631,2201,356,12,599,6,30,3461
6037910808,3494,1656,1416,72,8,172,2,24,1838
6037910809,2337,1607,406,43,0,171,5,3,730
6037910810,2685,1459,720,102,1,265,11,18,1226
6037910814,3601,2400,920,44,14,64,0,9,1201
6037910815,5142,3257,1440,93,29,88,11,38,1885
6037911001,3958,2051,1422,149,24,108,3,15,1907
6037911100,7827,909,6089,507,18,79,1,55,6918
6037920013,7801,3722,1828,435,20,1288,4,36,4079
6037920015,6724,3977,1471,180,7,641,6,29,2747
6037920016,4423,2452,1064,211,5,437,5,44,1971
6037920017,4241,2194,1480,63,3,245,3,41,2047
6037920018,2184,1419,526,34,5,111,3,3,765
6037920020,7009,3865,2165,139,13,361,8,64,3144
6037920028,8017,3286,2365,425,16,1477,18,35,4731
6037920029,5931,2385,2565,249,16,438,8,39,3546
6037920030,5399,2168,2000,278,10,670,6,40,3231
6037920031,4850,2443,1170,243,15,759,6,16,2407
6037920034,4152,1638,1606,201,10,469,4,23,2514
6037920035,8172,2161,4728,297,6,689,8,45,6011
6037920038,2629,586,1670,145,8,141,0,12,2043
6037920039,1808,894,601,42,1,165,1,12,914
6037920040,5045,1674,2166,479,8,468,15,30,3371
6037920041,1473,574,583,115,5,122,1,5,899
6037920042,7762,2663,3164,503,31,974,15,53,5099
6037920043,8832,3289,2322,550,8,2113,7,65,5543
6037920044,2737,1443,826,60,2,268,8,9,1294
6037920045,4438,2570,1103,80,10,426,9,28,1868
6037920046,2914,893,1422,224,3,242,6,15,2021
6037920047,6676,1026,4373,560,18,468,14,51,5650
6037920048,6307,1608,4068,88,22,364,7,26,4699
6037920049,5777,2849,1598,228,16,755,9,29,2928
6037920050,1328,949,251,28,7,22,2,2,379
6037920102,5115,2324,1940,176,9,363,9,38,2791
6037920104,2732,1614,777,56,8,150,0,8,1118
6037920106,3096,990,1842,78,7,67,3,19,2106
6037920109,5766,3219,1127,205,13,866,13,16,2547
6037920110,3098,1807,570,82,5,434,6,16,1291
6037920111,3053,1699,819,54,5,322,4,17,1354
6037920112,4220,2461,985,81,9,472,0,20,1759
6037920114,6331,3081,1377,301,7,1159,9,52,3250
6037920115,4144,2254,770,91,15,732,8,27,1890
6037920116,5057,2619,1535,124,24,444,11,30,2438
6037920118,5931,2831,1663,216,12,812,5,78,3100
6037920119,1833,873,519,41,0,290,2,10,960
6037920120,4192,1869,844,181,9,1010,3,53,2323
6037920121,10332,4045,1906,469,11,3166,23,90,6287
6037920200,5584,590,3674,1205,1,73,22,11,4994
6037920303,1593,804,296,78,5,333,1,4,789
6037920312,5933,3056,2104,187,12,306,10,31,2877
6037920313,5304,2617,1919,80,6,410,3,20,2687
6037920314,3142,1647,948,101,11,262,3,16,1495
6037920322,2998,1697,840,64,2,221,0,11,1301
6037920326,7212,3163,1628,333,17,1632,15,57,4049
6037920328,1987,1105,339,102,2,301,2,19,882
6037920329,6723,3965,1555,172,18,642,7,31,2758
6037920330,4166,2807,702,91,4,377,3,15,1359
6037920331,3751,2224,902,57,5,379,1,25,1527
6037920332,1950,1165,533,37,0,98,0,20,785
6037920334,6363,3800,1310,158,34,710,5,37,2563
6037920338,5642,2786,909,148,13,1436,0,46,2856
6037920339,8114,3540,1238,338,10,2499,11,55,4574
6037920340,3208,750,2151,31,13,185,3,0,2458
6037920341,3287,342,2716,49,7,116,3,14,2945
6037920342,3011,180,2593,67,1,136,1,8,2831
6037920343,4297,655,2803,243,12,419,0,31,3642
6037930400,1285,674,408,92,20,37,3,2,611
6037980001,28,11,1,3,1,1,0,2,17
6037980002,9,0,5,1,2,0,1,0,9
6037980003,0,0,0,0,0,0,0,0,0
6037980004,0,0,0,0,0,0,0,0,0
6037980005,3,0,1,0,0,1,0,0,3
6037980006,2,0,0,1,0,0,0,1,2
6037980007,5,0,3,1,0,0,0,0,5
6037980008,465,162,195,92,0,5,0,5,303
6037980009,52,17,19,7,0,4,0,0,35
6037980010,144,41,33,6,1,51,1,3,103
6037980011,140,34,54,29,2,14,0,1,106
6037980012,0,0,0,0,0,0,0,0,0
6037980013,62,18,15,17,0,9,0,0,44
6037980014,150,88,39,5,1,7,0,0,62
6037980015,1267,221,403,374,7,169,17,0,1046
6037980016,222,14,168,18,0,14,0,7,208
6037980017,1192,525,277,305,4,24,3,3,667
6037980018,30,5,11,11,1,0,0,0,25
6037980019,128,80,26,5,0,5,0,0,48
6037980020,2,1,0,0,0,0,0,1,1
6037980021,56,14,20,3,0,10,0,0,42
6037980022,0,0,0,0,0,0,0,0,0
6037980023,19,8,7,0,0,0,0,0,11
6037980024,226,145,28,22,0,23,0,2,81
6037980025,518,34,134,239,1,77,5,4,484
6037980026,11,8,1,1,0,0,0,0,3
6037980028,11,2,2,1,0,0,0,0,9
6037980030,0,0,0,0,0,0,0,0,0
6037980031,1748,649,709,256,32,92,0,0,1099
6037980033,89,36,17,21,0,9,0,0,53
6037980034,110,28,47,16,0,7,3,3,82
6037980035,623,64,500,5,0,45,0,4,559
6037980036,616,35,302,12,0,242,0,10,581
6037980037,0,0,0,0,0,0,0,0,0
6037980038,4,0,2,0,0,0,0,0,4
6037980039,0,0,0,0,0,0,0,0,0
6037990100,0,0,0,0,0,0,0,0,0
6037990200,0,0,0,0,0,0,0,0,0
6037990300,0,0,0,0,0,0,0,0,0
6039000102,4081,2891,475,16,344,37,7,16,1190
6039000103,4650,3672,489,10,82,65,0,26,978
6039000104,4335,3210,712,9,83,78,3,22,1125
6039000106,5064,3717,765,34,59,110,6,33,1347
6039000109,2273,1618,357,26,56,32,1,25,655
6039000110,4527,3260,641,7,233,72,0,40,1267
6039000111,2231,1712,261,26,72,50,0,8,519
6039000201,7359,2142,3269,1508,123,92,16,47,5217
6039000203,1552,527,934,4,4,20,1,4,1025
6039000204,5549,2281,2422,199,31,350,17,30,3268
6039000301,3534,1109,2205,48,24,14,8,10,2425
6039000302,5383,2096,2807,162,23,73,0,13,3287
6039000506,6357,1208,4784,102,39,89,0,24,5149
6039000509,6290,3581,2059,67,44,197,5,26,2709
6039000510,5376,545,4357,175,26,141,3,39,4831
6039000511,6083,509,5122,157,57,96,4,46,5574
6039000512,5349,1291,3609,123,20,165,2,36,4058
6039000513,4543,826,3024,130,21,423,3,30,3717
6039000514,6847,1024,5396,158,30,104,0,25,5823
6039000515,3932,807,2890,84,35,38,0,12,3125
6039000516,2426,1380,827,20,19,75,3,9,1046
6039000517,2019,540,1296,33,29,65,1,19,1479
6039000518,3234,197,2912,47,29,11,3,7,3037
6039000602,4736,342,4270,45,23,11,0,11,4394
6039000603,5716,282,5210,107,38,29,4,10,5434
6039000604,5252,256,4826,92,12,19,2,1,4996
6039000701,5379,1462,3344,138,16,210,3,49,3917
6039000702,6194,1931,3778,89,50,180,7,21,4263
6039000801,2491,291,2071,50,17,37,2,7,2200
6039000802,4065,362,3494,101,37,25,3,6,3703
6039000901,3065,121,2826,68,11,5,0,9,2944
6039000902,4541,229,3798,111,5,337,5,9,4312
6039000903,3943,92,3695,91,18,13,2,14,3851
6039001100,7879,2888,4253,94,28,318,11,39,4991
6041101100,2682,2058,252,34,6,168,4,9,624
6041101200,2924,1815,706,42,4,183,9,20,1109
6041102100,2251,1667,230,39,6,162,2,12,584
6041102202,6003,3697,1334,140,14,412,3,25,2306
6041102203,5174,2447,1937,133,12,315,12,52,2727
6041103100,7376,5504,1035,74,11,354,7,48,1872
6041103200,6720,3812,1834,202,8,429,10,40,2908
6041104102,5321,2147,1991,159,9,618,22,64,3174
6041104103,3137,2102,577,57,6,195,4,21,1035
6041104104,4617,2803,1070,95,13,365,29,46,1814
6041104200,5733,3608,1359,134,12,301,3,30,2125
6041104300,1564,1248,113,2,4,97,0,10,316
6041105001,3650,1221,1723,238,3,246,3,40,2429
6041105002,3162,2079,392,62,1,404,2,23,1083
6041106001,5004,2559,1424,166,11,478,15,43,2445
6041106002,5666,3390,1400,127,10,435,7,47,2276
6041107000,6306,4678,597,67,7,481,15,38,1628
6041108100,6692,4992,642,57,10,473,6,40,1700
6041108201,2556,1366,765,66,7,194,2,24,1190
6041108202,4343,2641,759,75,4,538,30,52,1702
6041109001,4467,2199,1648,68,12,266,29,37,2268
6041109002,4178,3141,476,46,7,199,8,18,1037
6041110100,6176,3909,1285,113,7,463,10,80,2267
6041110200,5389,4465,311,33,3,278,10,44,924
6041111001,1209,604,301,61,11,134,4,22,605
6041111002,4967,2788,1497,85,6,213,21,67,2179
6041112100,4611,2613,1467,63,20,203,7,48,1998
6041112202,4445,814,2962,77,20,470,2,14,3631
6041112203,2981,60,2793,27,26,41,2,12,2921
6041112204,5043,307,4578,37,15,65,2,14,4736
6041113000,3910,3157,324,32,16,72,5,34,753
6041114100,5245,4111,532,65,12,129,6,41,1134
6041114200,3164,2325,435,33,4,138,12,25,839
6041115000,7489,6104,612,34,10,215,7,45,1385
6041116000,3150,2528,275,18,6,73,4,16,622
6041117000,4713,3590,458,53,4,242,2,55,1123
6041118100,2338,2052,130,1,0,40,0,19,286
6041119100,4796,3956,317,25,2,189,5,27,840
6041119201,3644,2317,689,107,3,248,2,65,1327
6041119202,3567,2803,212,11,0,245,5,34,764
6041120001,1374,1015,126,7,0,92,0,33,359
6041120002,5177,4203,320,34,9,244,7,27,974
6041121100,5799,4252,659,37,6,358,6,68,1547
6041121200,6478,4339,821,268,17,578,11,53,2139
6041122000,3669,1058,800,1528,79,77,21,16,2611
6041123000,2131,1843,110,17,5,71,0,10,288
6041124100,5590,4274,391,44,3,434,3,41,1316
6041124200,5873,4636,346,70,6,431,11,53,1237
6041125000,4211,2842,392,48,8,661,9,24,1369
6041126100,5955,5005,318,26,6,217,4,27,950
6041126200,4495,3230,363,72,8,480,6,56,1265
6041127000,4560,3795,253,26,4,183,1,27,765
6041128100,6970,5425,556,60,8,414,6,55,1545
6041128200,4876,3938,316,26,6,220,3,17,938
6041129000,2641,767,485,787,1,368,13,26,1874
6041130201,3444,2856,215,18,8,181,5,12,588
6041130203,1687,1305,134,13,0,134,2,8,382
6041130204,2813,2370,162,26,3,115,1,20,443
6041131100,1065,837,93,22,13,33,0,11,228
6041132100,2111,1713,191,15,9,39,6,18,398
6041132200,1824,1412,259,5,0,29,10,18,412
6041133000,3215,2357,658,13,14,45,4,19,858
6041990100,0,0,0,0,0,0,0,0,0
6043000101,3729,2717,496,43,127,70,1,34,1012
6043000102,2619,1996,355,20,47,27,0,17,623
6043000200,3206,2328,477,10,33,45,4,14,878
6043000301,3819,2919,393,15,123,81,0,27,900
6043000302,2814,2153,324,6,70,39,8,10,661
6043000400,944,725,95,11,10,25,2,12,219
6045010100,3100,1165,737,8,968,18,1,11,1935
6045010200,4267,3182,492,17,222,64,1,30,1085
6045010300,4233,3159,621,67,35,65,6,35,1074
6045010400,3356,2115,875,18,43,47,0,12,1241
6045010500,4333,2480,1479,28,38,72,8,33,1853
6045010601,3059,2196,556,14,112,14,1,17,863
6045010602,4528,3387,644,37,112,39,5,42,1141
6045010700,6386,3976,1514,53,291,96,8,35,2410
6045010801,6018,3758,1492,18,290,58,6,57,2260
6045010802,1849,1364,346,2,14,3,0,14,485
6045010900,4983,2535,2004,18,99,113,6,23,2448
6045011001,2027,1714,126,20,6,26,5,10,313
6045011003,2984,2321,356,18,23,29,2,25,663
6045011004,2443,2082,164,15,6,26,4,21,361
6045011102,4436,3105,867,20,151,40,5,41,1331
6045011200,3582,1963,1394,15,23,17,2,11,1619
6045011300,6010,2984,2312,43,240,99,8,49,3026
6045011400,4434,3116,754,40,93,104,11,21,1318
6045011501,3390,1779,1176,8,79,104,4,21,1611
6045011502,3596,1620,1538,22,142,102,8,26,1976
6045011600,6298,2648,2819,109,195,206,5,26,3650
6045011700,4236,2373,1111,16,153,364,13,30,1863
6045011800,2053,1183,556,1,193,24,1,2,870
6045990100,0,0,0,0,0,0,0,0,0
6047000201,3325,1020,2095,5,30,79,0,7,2305
6047000202,1807,482,1237,2,12,38,0,0,1325
6047000204,4927,677,3821,14,9,281,11,10,4250
6047000205,4318,529,3598,15,2,88,8,16,3789
6047000301,5003,405,3564,33,5,909,3,17,4598
6047000303,1996,813,1051,0,12,59,5,14,1183
6047000305,6279,562,3788,28,19,1816,12,9,5717
6047000306,3856,170,3215,37,28,344,8,15,3686
6047000401,1681,724,901,7,5,1,1,12,957
6047000403,3617,2403,980,5,20,58,1,13,1214
6047000404,4239,3001,1014,5,15,27,1,12,1238
6047000503,2903,963,1313,433,66,87,0,6,1940
6047000504,6475,822,5161,116,22,249,1,9,5653
6047000505,6974,1444,4948,48,26,335,10,24,5530
6047000601,5608,1568,3480,135,40,146,7,25,4040
6047000602,3806,1109,2266,91,19,140,10,8,2697
6047000603,6502,1782,4092,197,15,203,14,34,4720
6047000701,3484,664,2539,108,15,68,3,10,2820
6047000702,5125,2665,1752,72,24,350,3,24,2460
6047000801,6216,1793,3466,269,18,390,17,45,4423
6047000802,4709,1563,2452,144,28,290,11,16,3146
6047000901,3512,1104,2098,98,18,126,3,3,2408
6047000903,4640,936,2787,119,20,607,9,18,3704
6047000904,4945,1142,2513,107,8,981,0,12,3803
6047001003,4190,707,2413,346,18,474,5,24,3483
6047001004,3969,1271,1801,281,33,382,4,25,2698
6047001005,2285,491,1324,161,21,148,9,14,1794
6047001006,5496,2008,2387,231,20,598,12,30,3488
6047001007,4202,1084,1696,228,14,968,10,22,3118
6047001008,7278,1636,3230,384,14,1647,11,43,5642
6047001101,6089,2498,2520,245,37,485,15,40,3591
6047001200,5365,2306,2301,150,22,337,11,40,3059
6047001301,3413,949,1993,162,32,113,0,26,2464
6047001302,3016,886,1623,243,16,121,1,15,2130
6047001401,4150,1115,2515,166,17,171,3,18,3035
6047001402,4813,1662,2448,193,24,269,7,35,3151
6047001501,2689,405,1706,81,17,413,9,12,2284
6047001502,2768,128,2467,77,9,55,4,0,2640
6047001503,4844,301,3846,274,29,298,6,10,4543
6047001601,4166,292,3428,236,6,120,4,14,3874
6047001603,3847,173,2841,118,5,649,6,7,3674
6047001604,4436,371,2985,164,13,786,15,25,4065
6047001700,7032,1435,4403,341,35,591,7,24,5597
6047001801,5397,2010,2056,385,46,724,4,27,3387
6047001901,5279,471,4598,57,7,57,11,20,4808
6047001902,2376,600,1668,14,11,24,2,8,1776
6047002001,1431,442,946,0,0,15,1,0,989
6047002002,7099,2433,4333,27,7,91,2,40,4666
6047002100,4732,1086,3298,47,19,128,7,31,3646
6047002201,6720,1092,5202,100,31,109,24,28,5628
6047002203,6155,807,4838,133,26,145,54,23,5348
6047002204,5895,841,4683,123,28,82,17,36,5054
6047002301,8401,2705,4770,189,28,404,40,46,5696
6047002303,6511,1137,4786,195,16,168,43,33,5374
6047002304,2827,384,2123,46,1,135,29,34,2443
6047002305,6012,804,4721,88,17,206,45,12,5208
6047002306,3537,393,2802,83,8,130,27,21,3144
6047002401,1623,602,925,12,0,17,2,9,1021
6047002403,3416,646,2519,156,9,6,8,4,2770
6047002404,5132,1010,3813,126,20,42,2,24,4122
6047002500,2197,1137,801,7,16,138,0,11,1060
6047002601,2489,474,1436,94,7,385,7,14,2015
6047002602,3978,1596,1481,140,9,521,15,38,2382
6049000100,3342,2494,468,39,98,38,7,20,848
6049000200,1511,1056,337,2,36,1,0,12,455
6049000300,2741,2059,324,25,164,22,2,13,682
6049000400,1106,837,130,0,89,0,4,11,269
6051000101,3454,2655,476,8,72,39,15,27,799
6051000102,2542,1674,631,30,99,18,1,12,868
6051000201,2993,1877,928,15,2,40,4,25,1116
6051000202,4206,2473,1472,15,4,62,6,14,1733
6053000101,2328,411,1659,19,19,143,6,23,1917
6053000103,4354,531,3138,63,11,497,7,13,3823
6053000104,3779,589,2749,63,9,253,12,13,3190
6053000105,3346,424,2119,60,9,632,7,21,2922
6053000106,6451,407,4826,57,4,1020,15,27,6044
6053000200,7396,676,6124,85,20,325,21,22,6720
6053000300,4744,699,3543,43,16,291,10,22,4045
6053000400,8175,980,6451,159,23,341,26,45,7195
6053000501,4892,57,4769,12,14,22,0,10,4835
6053000502,4281,330,3731,8,2,155,2,9,3951
6053000600,6853,106,6666,9,5,37,0,12,6747
6053000701,6427,84,6226,15,6,28,4,33,6343
6053000702,6194,75,6022,1,18,14,1,48,6119
6053000800,5579,127,5345,16,6,18,11,20,5452
6053000900,5912,197,5590,18,15,53,0,16,5715
6053001200,3295,1307,1656,51,13,126,3,27,1988
6053001300,2733,266,2188,77,33,89,7,14,2467
6053001400,2914,923,1669,43,11,117,3,17,1991
6053001500,6412,2373,3076,110,23,474,29,25,4039
6053001600,2886,1043,1482,33,8,207,5,7,1843
6053001700,4180,749,3061,55,10,169,9,13,3431
6053001801,4405,624,3124,110,15,350,17,35,3781
6053001802,5955,734,4456,142,34,428,19,21,5221
6053010101,4410,304,3941,5,6,95,1,19,4106
6053010102,3252,1416,1546,14,7,104,1,37,1836
6053010202,4375,1555,2506,15,14,95,4,12,2820
6053010305,4827,2134,2270,17,29,132,11,44,2693
6053010306,1290,475,698,17,5,41,5,2,815
6053010400,7515,359,6872,40,7,155,8,13,7156
6053010501,6925,2799,3466,45,31,252,14,36,4126
6053010504,5388,600,4176,95,16,338,27,28,4788
6053010505,5649,652,4582,59,26,183,36,18,4997
6053010506,5542,394,4863,46,18,128,5,23,5148
6053010603,8299,981,5883,168,25,968,31,42,7318
6053010604,5954,316,4924,67,1,552,14,10,5638
6053010605,5162,122,4799,20,4,176,2,12,5040
6053010606,7928,895,6240,63,19,567,14,19,7033
6053010607,4380,58,4248,4,1,45,2,7,4322
6053010608,3563,359,2949,89,12,89,13,14,3204
6053010702,3968,3069,523,14,8,131,12,40,899
6053010804,5148,311,4681,12,14,67,5,18,4837
6053010900,5979,1022,2682,1845,91,112,56,68,4957
6053011001,3631,2927,373,18,13,73,8,23,704
6053011002,2558,1946,382,11,9,49,3,8,612
6053011101,730,336,357,4,2,9,0,0,394
6053011103,4632,94,4420,28,3,40,3,15,4538
6053011104,5106,257,4656,18,12,89,0,22,4849
6053011105,7338,432,6509,51,25,189,22,21,6906
6053011106,2094,215,1716,28,1,91,8,7,1879
6053011202,7668,318,7094,30,22,118,11,29,7350
6053011203,7798,227,7369,25,8,36,0,30,7571
6053011204,4254,226,3946,16,0,28,0,15,4028
6053011302,5253,377,4732,15,9,55,5,8,4876
6053011303,3716,1201,2290,11,20,39,2,35,2515
6053011305,4117,331,3568,11,7,106,6,19,3786
6053011306,3442,115,3239,1,3,52,3,16,3327
6053011400,3113,1789,1005,48,35,56,16,40,1324
6053011502,1474,996,374,9,3,17,0,14,478
6053011604,2043,1646,213,11,8,69,4,8,397
6053011605,2963,2420,158,26,5,207,0,11,543
6053011606,2599,2143,178,18,6,101,0,11,456
6053011700,3793,2971,296,18,8,269,17,18,822
6053011801,1654,1420,101,11,2,56,0,7,234
6053011802,1566,1373,91,2,9,48,2,9,193
6053011901,2424,1812,157,31,5,290,6,11,612
6053011902,1725,1398,85,6,1,128,1,10,327
6053012000,3637,2185,722,56,13,310,26,34,1452
6053012100,2241,1635,275,24,6,183,1,15,606
6053012200,2645,1980,322,27,7,155,0,22,665
6053012302,1854,1354,236,18,7,102,0,14,500
6053012401,1673,1295,195,20,5,68,6,6,378
6053012402,3032,2207,392,23,6,175,3,18,825
6053012503,2497,1650,405,31,8,157,16,17,847
6053012504,2617,1537,572,58,15,223,16,8,1080
6053012601,3866,2558,579,212,15,210,56,4,1308
6053012700,3480,2166,625,103,8,334,10,34,1314
6053012800,5384,3950,631,99,20,378,11,14,1434
6053013000,3279,2073,539,98,13,319,19,23,1206
6053013100,1817,1161,196,80,3,196,12,11,656
6053013200,4163,3195,393,27,11,319,8,19,968
6053013300,5921,2877,1942,181,14,463,68,38,3044
6053013400,1580,1077,242,26,7,124,5,2,503
6053013500,4557,1592,1583,487,34,480,65,27,2965
6053013600,4260,1086,2566,75,7,247,62,42,3174
6053013700,4890,491,3858,76,15,303,43,14,4399
6053013800,5368,1014,2641,554,23,661,136,35,4354
6053013900,2584,892,1132,121,6,213,52,13,1692
6053014000,2572,770,1324,60,12,219,25,15,1802
6053014102,3984,1285,1295,356,9,591,89,28,2699
6053014104,2523,1046,783,59,0,533,0,36,1477
6053014105,3380,1359,1029,270,6,413,20,34,2021
6053014108,4981,2296,1415,215,19,528,36,44,2685
6053014109,3806,1627,1018,220,13,460,54,14,2179
6053014110,7000,4650,1241,63,11,593,19,31,2350
6053014201,5152,1515,1855,215,19,948,127,20,3637
6053014202,4003,1117,1449,222,9,800,92,30,2886
6053014301,3654,1411,987,201,11,638,66,19,2243
6053014302,4251,1416,1267,259,20,811,84,23,2835
6053014500,4963,1672,2651,109,18,278,12,33,3291
6053014601,5400,818,4339,12,13,103,1,29,4582
6053014700,6991,2105,4200,48,15,283,21,50,4886
6053014800,6284,512,5586,15,22,71,6,12,5772
6053980000,10,0,8,0,0,0,0,0,10
6053990000,0,0,0,0,0,0,0,0,0
6055200201,3259,1678,1369,10,16,65,10,13,1581
6055200202,2479,1344,899,39,11,78,9,11,1135
6055200203,2312,922,1236,25,3,35,2,9,1390
6055200301,5602,2201,2854,58,30,172,10,37,3401
6055200302,2721,1529,984,19,6,78,2,10,1192
6055200400,3579,2519,744,15,6,88,9,24,1060
6055200501,5159,1737,3119,17,15,90,2,18,3422
6055200503,2645,1345,913,63,116,52,25,18,1300
6055200504,6577,2690,3363,60,18,184,12,28,3887
6055200505,2617,1183,1190,23,1,82,2,20,1434
6055200601,4892,2589,1917,19,10,102,10,26,2303
6055200602,4594,2669,1513,27,17,163,4,23,1925
6055200703,3078,2453,385,14,11,69,4,13,625
6055200704,4493,2254,1898,20,17,83,5,25,2239
6055200705,2845,1525,1120,29,8,54,9,16,1320
6055200706,3238,2069,855,16,5,108,0,14,1169
6055200707,3302,2193,771,36,12,127,0,11,1109
6055200802,5887,3128,2243,56,20,170,6,40,2759
6055200803,2149,1513,469,16,5,47,1,18,636
6055200804,5535,1372,3943,16,7,55,3,27,4163
6055200900,67,27,19,2,2,1,1,5,40
6055201003,5447,1004,1032,444,7,2578,20,24,4443
6055201004,6836,1189,2273,461,14,2470,46,20,5647
6055201005,2602,682,895,169,4,635,9,23,1920
6055201006,3422,1146,1169,107,5,759,28,22,2276
6055201007,4226,929,1487,252,12,1211,43,17,3297
6055201101,2077,1593,246,8,2,78,3,4,484
6055201102,1811,1362,312,3,13,46,3,7,449
6055201200,4700,2880,1475,12,16,110,3,33,1820
6055201300,3436,2857,348,61,15,70,2,4,579
6055201401,2709,2124,350,20,8,61,2,13,585
6055201402,2762,2263,252,5,10,65,5,15,499
6055201403,697,520,103,11,2,25,0,1,177
6055201500,1703,1037,585,0,3,22,4,7,666
6055201601,2261,1070,1060,4,7,55,2,19,1191
6055201602,3169,2201,803,7,6,36,2,11,968
6055201700,4984,2874,1212,116,11,261,12,269,2110
6055201800,1781,1182,446,15,16,13,2,1,599
6055201900,1138,778,279,2,11,34,1,0,360
6055202000,5228,2278,2698,23,9,88,3,14,2950
6057000102,6977,5772,561,23,57,92,12,37,1205
6057000104,3405,2857,253,13,24,50,2,10,548
6057000105,2807,2370,199,14,18,25,3,14,437
6057000106,1933,1572,186,10,23,14,3,9,361
6057000107,6010,5017,486,19,36,107,8,14,993
6057000200,2672,2246,181,18,19,28,0,19,426
6057000300,2496,2058,203,13,24,32,4,3,438
6057000401,5932,4939,506,25,19,99,4,29,993
6057000403,1894,1537,174,6,20,17,5,6,357
6057000404,5090,4176,425,25,45,50,12,43,914
6057000502,4718,3815,456,20,38,60,3,25,903
6057000503,1225,955,138,0,13,16,2,9,270
6057000504,5148,4120,537,39,40,99,0,28,1028
6057000601,1907,1439,252,25,16,20,8,6,468
6057000602,5130,3910,685,18,41,71,4,46,1220
6057000701,7581,6353,616,21,46,69,10,63,1228
6057000702,4079,3412,304,12,27,48,13,28,667
6057000801,5289,4486,342,26,34,48,6,50,803
6057000802,6700,5586,509,29,61,108,7,49,1114
6057000900,4274,3567,262,30,51,49,4,32,707
6057001205,4882,4222,313,14,18,52,1,15,660
6057001207,5518,3255,1937,8,10,86,7,42,2263
6057001208,1780,1484,115,0,0,47,0,12,296
6057001209,1877,1351,382,3,10,37,0,13,526
6057001210,1595,1367,101,2,3,26,0,13,228
6057001211,1322,944,293,3,2,21,1,2,378
6059001101,4611,1660,2450,63,14,268,5,28,2951
6059001102,3314,970,1826,42,3,345,4,21,2344
6059001103,4754,1064,3055,96,30,413,8,28,3690
6059001201,5200,587,4181,60,17,259,3,27,4613
6059001202,3766,402,2729,33,3,530,0,11,3364
6059001301,7755,2254,3610,202,18,1379,10,50,5501
6059001303,5626,1096,3543,102,8,729,7,26,4530
6059001304,3702,611,2691,45,16,279,6,4,3091
6059001401,5493,1500,3417,84,10,344,0,13,3993
6059001402,5261,1361,3275,89,6,410,2,7,3900
6059001403,3290,1567,1278,25,11,241,8,12,1723
6059001404,3770,593,2845,60,12,213,1,12,3177
6059001501,6659,2998,1689,74,8,1642,8,42,3661
6059001503,5302,2339,1867,84,12,693,14,27,2963
6059001504,4803,1648,1944,64,16,862,4,28,3155
6059001505,7115,3196,1792,105,15,1619,3,29,3919
6059001506,4544,1940,1111,64,15,1219,2,24,2604
6059001507,5399,1953,1724,132,11,1314,12,20,3446
6059001602,5034,2270,835,64,5,1660,0,20,2764
6059001603,3960,1810,608,79,5,1281,1,6,2150
6059001604,4284,1866,1614,81,4,530,4,14,2418
6059001704,8120,1139,789,86,5,5854,13,16,6981
6059001705,4315,1205,1914,93,0,926,5,19,3110
6059001706,4171,1754,582,51,2,1612,3,10,2417
6059001708,3736,1149,908,49,7,1510,2,7,2587
6059001709,2563,523,566,53,0,1345,4,5,2040
6059001710,4728,579,408,51,0,3600,7,3,4149
6059001801,5275,754,3434,172,16,733,7,29,4521
6059001802,7488,1150,4970,178,14,944,29,37,6338
6059001901,2714,677,1487,22,3,435,5,13,2037
6059001902,2750,725,1305,55,10,518,14,29,2025
6059001903,3539,705,2115,33,17,563,2,4,2834
6059011000,6754,2536,2594,111,23,1158,15,37,4218
6059011101,4283,1024,2361,76,3,676,1,33,3259
6059011102,4445,970,2298,109,4,925,10,17,3475
6059011200,4275,1865,1501,59,14,609,4,18,2410
6059011300,5510,2490,1543,165,42,934,16,42,3020
6059011401,2118,1098,585,40,4,217,8,22,1020
6059011402,2473,1416,545,28,1,315,2,16,1057
6059011403,5822,1842,2930,115,15,647,3,43,3980
6059011502,4206,1049,2201,75,17,667,17,40,3157
6059011503,1851,906,396,20,4,432,1,10,945
6059011504,7850,2515,2617,419,11,1779,27,49,5335
6059011601,7497,980,5512,162,12,645,9,35,6517
6059011602,6248,1126,4138,193,1,664,9,23,5122
6059011707,6240,2500,1392,143,20,1824,14,39,3740
6059011708,4975,1751,1958,144,13,834,15,22,3224
6059011709,4401,2473,919,48,10,717,7,18,1928
6059011710,3649,1875,828,51,6,701,0,16,1774
6059011711,7481,1843,3970,172,17,1186,25,29,5638
6059011712,4923,1203,2512,109,7,921,2,23,3720
6059011714,1016,269,505,58,0,132,4,1,747
6059011715,6719,3512,1474,78,17,1309,8,9,3207
6059011716,5401,1466,1494,83,5,2167,5,10,3935
6059011717,2849,1583,674,42,10,407,2,7,1266
6059011718,3291,1862,761,42,1,471,4,7,1429
6059011720,6727,318,6030,120,17,166,3,17,6409
6059011721,5091,776,3589,124,14,445,14,19,4315
6059011722,2350,1000,738,67,9,461,3,16,1350
6059021802,7826,4266,1875,98,16,1127,10,50,3560
6059021807,4268,1958,1488,81,7,533,6,30,2310
6059021809,3304,1881,655,39,5,512,2,6,1423
6059021810,3598,2104,804,53,3,445,0,21,1494
6059021812,6433,3217,1967,120,37,763,7,42,3216
6059021813,107,38,59,3,3,1,1,0,69
6059021814,7662,3202,1883,149,7,2059,6,45,4460
6059021816,4895,3008,1018,48,3,521,7,35,1887
6059021817,3506,1972,810,34,4,474,2,38,1534
6059021820,4128,2029,790,48,10,1004,5,33,2099
6059021821,7347,2411,2521,217,12,1805,12,57,4936
6059021822,9750,4080,1250,97,8,3838,10,50,5670
6059021823,4054,2075,690,41,9,1068,3,14,1979
6059021824,2581,1582,381,18,1,462,2,16,999
6059021825,3119,1866,448,23,1,631,1,14,1253
6059021826,2766,1502,598,66,7,416,13,18,1264
6059021827,3192,1572,654,52,4,718,0,23,1620
6059021828,4123,2069,593,69,5,1191,0,23,2054
6059021829,5242,2856,748,48,2,1364,4,22,2386
6059021830,5714,3366,875,60,16,1117,2,34,2348
6059021831,6497,2455,873,87,8,2830,7,21,4042
6059021832,6735,1586,1241,105,16,3530,3,29,5149
6059021903,4430,1672,1427,64,2,1021,14,25,2758
6059021905,5689,2927,1268,117,6,1047,7,15,2762
6059021912,4430,2636,611,40,13,916,3,21,1794
6059021913,7702,1692,4748,70,14,933,15,48,6010
6059021914,4213,1775,1722,56,1,459,4,22,2438
6059021915,3967,2091,705,54,3,860,9,33,1876
6059021916,3665,2173,547,41,6,703,4,24,1492
6059021917,3354,2248,521,24,6,380,1,16,1106
6059021918,5035,2457,1442,45,13,821,4,17,2578
6059021919,2841,1680,510,43,3,446,3,15,1161
6059021920,7179,3870,1101,94,5,1675,14,35,3309
6059021921,4338,2356,538,53,1,1167,4,30,1982
6059021922,4953,2722,826,101,14,981,10,27,2231
6059021923,6697,3357,1086,139,17,1679,7,20,3340
6059021924,4622,2151,915,117,6,1184,6,21,2471
6059032002,6071,4021,1120,60,9,494,8,20,2050
6059032003,4756,3197,777,16,8,439,8,17,1559
6059032011,1613,1242,212,4,13,42,5,9,371
6059032012,3591,2434,594,43,3,265,5,20,1157
6059032013,5065,3333,923,77,9,386,14,26,1732
6059032014,6039,1922,3141,58,7,694,13,27,4117
6059032015,6730,3613,1463,121,8,1077,23,52,3117
6059032020,5540,3603,1094,62,12,413,10,24,1937
6059032022,6808,2577,3274,90,9,535,8,39,4231
6059032027,6264,2296,2628,71,6,906,14,35,3968
6059032028,3610,1767,1126,60,2,465,12,16,1843
6059032029,4486,2327,1197,49,5,634,6,16,2159
6059032030,3778,2230,894,24,10,388,10,21,1548
6059032031,3580,2214,700,43,5,402,2,18,1366
6059032032,2972,2009,489,16,3,317,1,7,963
6059032033,3629,1915,854,103,4,491,4,26,1714
6059032034,5595,3742,659,62,6,777,4,29,1853
6059032035,2307,1631,283,22,1,258,2,0,676
6059032036,3495,2282,643,29,3,321,8,26,1213
6059032037,4939,3835,360,46,7,483,4,12,1104
6059032038,6439,3929,802,51,3,1219,10,27,2510
6059032039,6519,3706,1511,57,7,805,3,35,2813
6059032040,2611,1882,278,16,0,256,3,14,729
6059032041,972,691,155,10,3,53,0,3,281
6059032042,5490,3691,879,64,6,458,13,23,1799
6059032043,3775,2652,492,40,9,367,5,18,1123
6059032044,5588,4237,502,78,6,450,6,27,1351
6059032045,3173,2221,435,26,5,266,1,19,952
6059032046,5949,4264,585,74,4,638,0,27,1685
6059032047,4545,2437,1161,113,10,524,8,24,2108
6059032048,5505,3529,876,71,9,737,4,24,1976
6059032049,9627,5566,1613,148,15,1587,23,40,4061
6059032050,4950,2914,1070,86,14,503,16,27,2036
6059032051,4627,2376,1389,99,4,509,9,12,2251
6059032053,8242,5009,1505,151,15,985,13,54,3233
6059032054,5703,2975,1610,89,4,647,10,34,2728
6059032055,3864,1764,1406,64,6,404,4,14,2100
6059032057,7641,4926,1056,67,17,1041,13,33,2715
6059032058,7758,5451,836,77,11,888,6,28,2307
6059032059,10060,6286,1559,109,9,1312,8,53,3774
6059032061,5354,3979,562,34,10,456,4,26,1375
6059032062,4806,3628,538,39,7,262,4,21,1178
6059032063,7128,4924,1292,59,33,379,5,34,2204
6059032064,2799,2031,463,15,9,110,0,19,768
6059032065,6160,3610,977,78,5,1062,13,23,2550
6059032066,8194,5221,1337,98,10,1028,5,42,2973
6059042106,2156,1698,208,7,7,129,7,9,458
6059042107,4001,1812,1878,25,12,98,3,23,2189
6059042108,5434,3688,1328,30,26,85,16,37,1746
6059042109,4871,3367,930,48,15,238,8,16,1504
6059042111,5839,4586,651,16,13,247,4,41,1253
6059042112,6796,4925,1007,40,16,382,14,41,1871
6059042113,4351,3343,558,11,10,171,6,21,1008
6059042114,3836,2717,741,24,5,109,0,23,1119
6059042115,1470,1154,180,13,0,46,0,11,316
6059042116,5973,4637,878,22,14,80,4,32,1336
6059042201,5617,3768,1335,34,11,157,7,42,1849
6059042203,8429,6164,1261,32,21,478,7,47,2265
6059042205,6571,4481,1447,39,16,248,14,32,2090
6059042206,3296,2544,435,17,11,128,2,14,752
6059042305,3397,2885,218,10,1,91,3,22,512
6059042307,7263,3622,2093,80,8,1048,9,50,3641
6059042311,5965,4179,1138,38,16,265,5,29,1786
6059042312,8497,2083,6059,30,36,133,2,23,6414
6059042313,6286,3969,1812,46,22,153,0,31,2317
6059042315,6118,4173,959,77,9,510,7,42,1945
6059042317,3304,2632,341,21,5,162,0,7,672
6059042319,3195,2199,344,34,1,377,4,29,996
6059042320,5879,2871,1733,107,5,740,23,61,3008
6059042323,4607,3669,468,39,13,186,3,24,938
6059042324,4336,3414,343,42,6,349,5,13,922
6059042325,3351,2392,363,34,11,347,0,6,959
6059042326,4520,2988,716,79,11,462,4,7,1532
6059042327,4774,3021,764,75,4,584,12,14,1753
6059042328,2443,1809,175,16,3,303,1,3,634
6059042329,4048,3038,475,44,10,266,4,17,1010
6059042330,6254,3237,2077,105,18,477,10,24,3017
6059042331,5377,3223,1382,76,8,395,1,34,2154
6059042332,5197,3984,461,38,5,424,9,24,1213
6059042333,4970,3247,509,98,3,800,5,20,1723
6059042334,5118,3048,1030,67,8,603,10,32,2070
6059042335,6462,3621,1170,72,6,1130,7,50,2841
6059042336,4382,3037,499,27,6,514,1,38,1345
6059042337,3429,2537,360,28,14,317,3,21,892
6059042338,4474,3377,583,42,5,204,2,23,1097
6059042339,3364,2246,788,40,0,137,10,16,1118
6059042340,2268,484,1730,8,3,10,3,4,1784
6059042341,6220,4022,1641,16,24,150,11,30,2198
6059052408,6111,3676,1028,96,8,974,16,13,2435
6059052410,5391,2564,1622,73,13,854,6,29,2827
6059052411,5012,1754,2236,72,3,685,17,30,3258
6059052415,3933,2488,572,48,4,565,4,18,1445
6059052416,3940,1818,1248,64,7,549,1,19,2122
6059052417,6727,2726,631,63,7,2933,17,22,4001
6059052419,3413,1442,334,21,3,1387,6,19,1971
6059052421,9631,2797,619,67,3,5690,2,27,6834
6059052422,11557,4981,1780,244,12,3813,16,58,6576
6059052423,6511,2800,1773,150,26,1359,9,35,3711
6059052424,4761,2291,1301,101,5,746,8,24,2470
6059052425,5915,2794,1625,57,15,1055,16,33,3121
6059052427,5069,2383,734,92,5,1448,9,33,2686
6059052428,7200,4099,1077,100,17,1349,2,61,3101
6059052429,9524,1822,614,124,9,6506,16,48,7702
6059052430,15755,5189,1387,181,25,7992,18,99,10566
6059052431,4826,1348,387,75,3,2695,5,9,3478
6059052432,8996,2497,947,227,4,4790,17,28,6499
6059052433,15465,3941,1516,414,10,8782,21,103,11524
6059052434,7094,2080,707,85,5,3806,1,19,5014
6059052435,6906,2245,783,145,1,3344,7,35,4661
6059052436,6080,1610,317,43,2,3810,0,9,4470
6059052437,7679,1610,415,81,5,5219,7,18,6069
6059052438,6784,1561,470,112,6,4278,3,27,5223
6059052439,9926,2313,804,189,15,6021,8,34,7613
6059052502,6132,2424,1805,92,5,1498,11,34,3708
6059052505,4973,1686,870,80,9,2019,11,31,3287
6059052506,2456,1318,194,23,1,750,3,20,1138
6059052511,6066,3127,447,59,7,2025,10,49,2939
6059052513,5801,2827,696,68,3,1837,1,45,2974
6059052514,5288,2435,664,80,2,1731,5,33,2853
6059052518,7470,4161,880,184,12,1748,11,44,3309
6059052519,4217,1814,559,112,4,1376,7,33,2403
6059052520,3539,1859,361,61,4,1017,3,21,1680
6059052521,5216,1947,809,251,12,1784,11,55,3269
6059052522,4236,1524,497,77,5,1893,14,30,2712
6059052523,4088,1490,437,60,6,1876,4,12,2598
6059052524,8020,2790,2000,247,10,2408,8,37,5230
6059052526,4182,1468,582,46,2,1804,4,32,2714
6059052527,8244,2639,944,152,6,3949,9,48,5605
6059052528,3453,1191,332,73,5,1636,9,21,2262
6059052529,3370,866,351,66,1,1853,5,20,2504
6059052530,5630,1835,650,101,4,2724,10,35,3795
6059052531,4217,1661,347,78,4,1857,1,29,2556
6059052532,6488,2253,672,144,15,2953,10,48,4235
6059052533,7268,2399,738,134,21,3502,8,34,4869
6059052534,2299,870,474,105,1,687,4,15,1429
6059052535,5603,1560,652,104,0,2957,9,34,4043
6059062605,3043,2406,337,29,2,111,3,16,637
6059062610,11867,5590,1264,336,12,3955,19,88,6277
6059062611,4012,1425,539,147,7,1688,3,25,2587
6059062614,25232,6555,7625,1480,12,7549,9,90,18677
6059062619,3856,3121,314,17,0,138,4,28,735
6059062620,5031,4071,423,37,7,215,0,30,960
6059062622,4437,2728,515,67,2,970,7,4,1709
6059062625,4492,2087,1659,67,5,534,3,15,2405
6059062626,2827,720,543,43,3,1357,3,39,2107
6059062627,3184,1215,379,27,5,1374,2,23,1969
6059062628,3495,1392,364,78,9,1479,2,13,2103
6059062629,2709,1340,182,3,4,1009,2,15,1369
6059062630,1667,1002,100,7,4,433,1,14,665
6059062631,3198,1866,123,17,1,939,0,34,1332
6059062632,4208,3307,365,26,7,225,0,14,901
6059062633,6623,3831,836,79,7,1334,11,45,2792
6059062634,5441,3352,739,94,8,874,11,31,2089
6059062635,4102,2376,637,46,7,741,13,25,1726
6059062636,3758,1944,895,95,0,537,11,19,1814
6059062637,5875,3295,1203,180,3,797,21,28,2580
6059062638,6531,3449,1052,95,6,1465,28,35,3082
6059062639,7917,4800,1146,148,4,1218,15,55,3117
6059062640,3655,2111,674,90,3,471,18,20,1544
6059062641,5399,2502,1587,52,9,964,6,35,2897
6059062642,2849,2367,147,10,6,178,1,15,482
6059062643,7333,4488,412,33,5,1996,1,33,2845
6059062645,6033,4127,454,54,9,1018,0,21,1906
6059062646,3718,2677,192,27,0,702,2,5,1041
6059062647,4863,2802,786,64,4,977,10,28,2061
6059062648,3181,2207,129,29,2,721,0,4,974
6059062649,3562,2368,404,68,9,555,0,16,1194
6059062650,4776,2505,369,39,1,1519,4,36,2271
6059062651,2879,1314,400,86,8,868,3,33,1565
6059062652,4875,2562,1063,53,5,884,2,31,2313
6059062653,6694,2940,658,114,3,2469,5,98,3754
6059062654,6785,2588,684,81,4,2947,4,55,4197
6059062655,5156,2430,314,43,7,2049,4,26,2726
6059062656,3449,2879,262,16,0,123,9,14,570
6059062657,2618,1770,306,35,1,342,1,12,848
6059062658,5410,4246,453,35,1,401,5,20,1164
6059062701,2667,2289,137,17,0,108,1,3,378
6059062702,4515,3695,383,14,5,192,4,21,820
6059062800,3806,3174,312,20,6,122,8,7,632
6059062900,1716,1501,105,0,3,52,0,5,215
6059063004,6202,4773,615,53,12,442,2,45,1429
6059063005,1447,1214,86,7,0,84,0,3,233
6059063006,2490,2167,160,7,3,58,3,11,323
6059063007,6699,5021,601,58,5,682,7,27,1678
6059063008,2408,1887,168,25,1,231,0,23,521
6059063009,1767,1317,158,9,1,158,2,5,450
6059063010,6698,5131,717,75,2,361,12,35,1567
6059063101,2935,1656,666,50,6,285,8,33,1279
6059063102,6932,4840,1254,45,14,342,6,22,2092
6059063103,2763,2111,348,16,8,130,6,10,652
6059063201,4006,2849,677,23,8,169,6,26,1157
6059063202,3693,2623,755,23,4,108,6,17,1070
6059063301,3001,2176,431,38,8,134,3,20,825
6059063302,4176,3187,542,23,9,135,6,20,989
6059063400,4776,3953,368,11,5,171,6,29,823
6059063500,4938,3961,570,34,3,146,7,30,977
6059063601,3794,2326,1006,25,8,215,8,24,1468
6059063603,6450,4440,1253,74,24,319,12,35,2010
6059063604,4061,1753,1892,58,2,194,10,31,2308
6059063605,5630,1287,3949,47,7,205,3,24,4343
6059063701,5886,901,4485,38,10,287,26,29,4985
6059063702,6131,2222,3156,89,11,376,7,34,3909
6059063802,2934,1875,685,19,6,195,4,2,1059
6059063803,4353,2480,1331,32,18,232,12,18,1873
6059063805,2458,1597,465,11,7,213,6,19,861
6059063806,3943,2372,1010,40,8,248,27,22,1571
6059063807,4950,2507,1373,151,7,649,28,33,2443
6059063808,5688,1000,4276,28,18,214,19,37,4688
6059063902,6881,2963,2454,115,20,901,29,51,3918
6059063903,4159,1636,1582,59,5,664,37,16,2523
6059063904,4661,1809,2070,27,13,491,41,20,2852
6059063905,4349,2700,989,59,4,314,11,42,1649
6059063906,5947,2096,3018,91,12,419,29,30,3851
6059063908,5732,2625,1645,98,17,992,22,40,3107
6059063909,3155,1587,635,80,3,642,17,11,1568
6059063910,4356,2060,958,69,3,1014,44,19,2296
6059074003,3760,826,2310,79,3,434,13,6,2934
6059074004,7395,1159,4569,165,22,1215,25,32,6236
6059074005,6733,563,5156,69,14,812,26,29,6170
6059074006,5379,891,3611,105,6,597,13,20,4488
6059074102,6278,247,5109,38,18,780,9,17,6031
6059074103,4570,173,4168,10,12,146,24,16,4397
6059074106,6330,975,4375,87,12,711,21,28,5355
6059074107,5856,1944,2243,110,3,1256,14,23,3912
6059074108,4640,144,4000,27,9,407,15,9,4496
6059074109,3392,90,2918,17,7,324,6,9,3302
6059074110,3438,511,1478,46,4,1322,4,10,2927
6059074111,5277,673,3356,66,2,1070,12,9,4604
6059074200,8608,197,8165,4,10,179,8,11,8411
6059074300,3972,121,3749,12,4,71,0,6,3851
6059074403,5389,60,5121,18,5,149,12,11,5329
6059074405,6091,388,5410,29,9,158,5,15,5703
6059074406,3789,210,3459,16,1,53,7,17,3579
6059074407,6024,426,5160,98,3,243,1,28,5598
6059074408,5453,494,4356,142,8,307,20,35,4959
6059074501,5790,82,5174,15,12,461,7,7,5708
6059074502,5210,118,4763,9,10,255,16,16,5092
6059074601,7471,397,6776,18,27,160,12,31,7074
6059074602,8002,235,7611,14,8,76,4,27,7767
6059074701,7611,104,7102,47,23,300,5,8,7507
6059074702,5775,144,5481,7,1,112,0,14,5631
6059074801,5313,119,4727,114,0,307,7,12,5194
6059074802,6348,123,5838,43,8,253,6,28,6225
6059074803,8526,298,6396,74,14,1662,8,28,8228
6059074805,4783,65,4419,55,7,192,3,16,4718
6059074806,4765,85,4370,70,11,189,4,14,4680
6059074901,8576,161,7967,26,10,339,14,22,8415
6059074902,5850,109,5593,8,16,91,3,12,5741
6059075002,8236,714,6724,102,17,572,9,27,7522
6059075003,6493,230,6073,29,9,87,1,27,6263
6059075004,4765,222,4353,26,3,97,4,18,4543
6059075100,9883,1660,7300,260,14,490,23,28,8223
6059075201,5594,88,5001,36,8,420,0,14,5506
6059075202,5427,134,5004,30,18,200,0,8,5293
6059075301,5512,915,3761,65,6,636,39,14,4597
6059075302,4568,490,3732,42,4,216,0,10,4078
6059075303,3357,1518,1466,42,5,193,2,15,1839
6059075401,3859,1245,2173,40,10,235,2,22,2614
6059075403,7707,1570,5027,144,5,742,16,49,6137
6059075404,6362,1467,4127,67,16,502,29,29,4895
6059075405,3204,977,1793,26,5,294,2,7,2227
6059075504,4103,2025,1325,38,5,505,11,10,2078
6059075505,3763,1313,1703,69,11,491,17,18,2450
6059075506,3541,1615,1095,56,6,575,13,6,1926
6059075507,5476,1423,2747,143,7,890,48,29,4053
6059075512,3719,578,2269,78,8,654,9,10,3141
6059075513,5071,876,3137,109,8,800,3,27,4195
6059075514,3553,428,2462,96,7,466,6,16,3125
6059075516,9045,3421,1261,338,8,3493,17,70,5624
6059075517,6809,730,4748,149,8,982,18,59,6079
6059075518,9171,2606,1167,157,5,4672,7,35,6565
6059075603,3880,2283,885,25,8,414,14,27,1597
6059075604,7568,4793,988,53,3,1294,9,28,2775
6059075605,5748,3340,788,34,7,1203,6,37,2408
6059075606,6629,4010,753,40,8,1426,1,18,2619
6059075607,6484,2863,1033,90,4,2077,8,37,3621
6059075701,7228,2443,3644,144,0,621,30,47,4785
6059075702,3363,2001,752,22,2,385,10,11,1362
6059075703,4135,2643,706,21,5,491,0,23,1492
6059075805,4354,1552,2339,48,5,217,0,46,2802
6059075806,6393,2079,3492,77,12,536,6,31,4314
6059075807,4274,1665,1840,36,12,504,16,15,2609
6059075808,3456,1959,990,33,6,262,16,10,1497
6059075809,3109,1967,366,19,2,567,4,10,1142
6059075810,3045,1846,464,23,1,574,1,4,1199
6059075811,3479,858,2156,32,0,328,10,5,2621
6059075812,6200,2241,3215,80,6,414,16,24,3959
6059075813,5269,2446,1654,43,9,880,15,33,2823
6059075814,3055,1600,378,22,9,872,1,15,1455
6059075815,5261,2113,2545,40,13,326,14,30,3148
6059075816,3626,1173,1745,79,12,458,7,11,2453
6059075901,4356,2004,1662,108,9,323,25,20,2352
6059075902,6617,3004,2834,115,20,341,21,30,3613
6059076001,7901,2319,4224,179,25,827,27,53,5582
6059076002,1994,740,542,63,0,522,5,11,1254
6059076102,8150,1905,4153,380,13,1500,14,23,6245
6059076103,9182,915,5874,93,14,2086,46,35,8267
6059076104,6189,2103,2226,342,23,1119,24,37,4086
6059076105,4697,1121,2812,45,18,502,27,22,3576
6059076201,7167,2871,2376,130,24,1444,6,23,4296
6059076202,5959,2301,2651,131,17,521,40,17,3658
6059076204,5009,826,3631,55,4,376,3,23,4183
6059076205,7297,3310,2602,120,13,769,27,32,3987
6059076206,4606,2313,1704,38,9,339,8,15,2293
6059076208,5368,2393,2007,74,10,581,9,30,2975
6059086301,7486,1043,5450,102,13,734,21,8,6443
6059086303,11758,3411,4636,478,28,2635,66,44,8347
6059086304,5009,1265,2909,86,7,570,26,35,3744
6059086305,4015,1188,1801,71,3,832,14,24,2827
6059086306,3975,857,2355,85,7,539,11,11,3118
6059086402,5503,853,3912,60,9,553,17,16,4650
6059086404,6119,541,4609,50,18,813,7,8,5578
6059086405,6986,640,5476,162,11,565,22,26,6346
6059086406,4498,763,2952,64,20,547,10,25,3735
6059086407,6758,1520,4106,159,8,749,25,15,5238
6059086501,4368,598,3516,32,6,122,18,30,3770
6059086502,6053,265,5525,32,4,148,17,0,5788
6059086601,8735,649,7053,148,8,733,17,30,8086
6059086602,5967,870,3906,172,7,720,8,74,5097
6059086701,8776,1450,5032,161,21,1787,41,49,7326
6059086702,7200,803,5122,197,3,877,14,34,6397
6059086801,3593,840,1592,92,2,901,29,3,2753
6059086802,5640,963,3263,126,16,1151,23,12,4677
6059086803,8254,1768,3396,402,21,2347,34,35,6486
6059086901,8764,1589,4603,354,22,1833,65,58,7175
6059086902,5705,1409,2178,199,10,1688,36,19,4296
6059086903,6776,1303,3606,261,17,1334,67,35,5473
6059087001,5633,957,2904,235,7,1348,35,25,4676
6059087002,7457,1702,3379,256,27,1788,31,36,5755
6059087101,4706,933,1999,317,6,1267,18,25,3773
6059087102,6613,894,4267,308,5,893,32,39,5719
6059087103,8582,1611,4077,157,12,2478,22,46,6971
6059087105,4729,888,2287,115,11,1291,21,18,3841
6059087106,4793,731,3134,74,11,732,14,22,4062
6059087200,7538,1636,4860,127,18,642,25,12,5902
6059087301,4526,489,3469,49,4,436,5,11,4037
6059087302,6021,858,3872,155,10,972,0,22,5163
6059087401,5110,914,2641,99,5,1247,6,17,4196
6059087403,3144,244,2729,7,1,129,16,1,2900
6059087404,3764,272,3128,66,1,243,6,12,3492
6059087405,5509,420,4702,41,3,275,6,18,5089
6059087503,6031,987,3857,139,15,853,31,28,5044
6059087504,7109,586,5720,79,20,563,34,38,6523
6059087505,4742,713,2960,213,9,671,22,17,4029
6059087601,4839,905,2620,127,3,972,43,36,3934
6059087602,7807,1418,4073,108,11,2004,16,14,6389
6059087701,5518,1231,2280,164,14,1647,21,22,4287
6059087703,6462,1013,3295,102,13,1875,48,6,5449
6059087704,4780,922,2093,108,9,1486,37,8,3858
6059087801,5280,1217,2274,114,14,1456,23,26,4063
6059087802,7431,1221,3598,211,7,2102,44,42,6210
6059087803,5599,447,3436,123,17,1457,36,28,5152
6059087805,7065,913,4044,200,6,1666,43,38,6152
6059087806,5552,805,3194,133,18,1229,31,27,4747
6059087901,3540,588,1490,55,3,1312,15,18,2952
6059087902,5599,480,3134,28,5,1817,55,14,5119
6059088001,4928,849,1460,41,3,2376,34,27,4079
6059088002,3990,828,1095,42,13,1876,12,16,3162
6059088101,2252,583,1004,72,5,463,10,21,1669
6059088104,4924,1055,1958,91,10,1599,12,55,3869
6059088105,4194,724,1215,38,2,2067,38,19,3470
6059088106,4951,849,1794,79,8,2053,25,9,4102
6059088107,6103,731,1643,31,10,3514,22,19,5372
6059088201,4090,836,1522,39,6,1546,9,25,3254
6059088202,3184,673,867,39,1,1497,6,11,2511
6059088203,5013,854,1842,73,5,2092,14,18,4159
6059088301,6561,1139,2769,63,3,2369,58,19,5422
6059088302,6222,1324,1677,90,17,2929,24,31,4898
6059088401,5190,929,2055,39,5,2007,26,6,4261
6059088402,4679,628,2608,76,7,1229,16,10,4051
6059088403,6676,947,3610,143,11,1781,33,20,5729
6059088501,7282,693,3993,32,13,2389,5,37,6589
6059088502,5252,623,2564,46,6,1862,32,48,4629
6059088601,6752,763,2487,69,11,3214,57,26,5989
6059088602,4535,741,1640,46,4,1987,19,3,3794
6059088701,6307,789,2359,83,2,2906,32,13,5518
6059088702,6022,415,1797,12,7,3660,44,13,5607
6059088801,8252,863,2723,134,5,4318,28,40,7389
6059088802,5500,593,1785,30,6,2939,20,20,4907
6059088901,6450,585,1049,57,2,4573,28,29,5865
6059088902,5132,403,1388,29,21,3194,32,9,4729
6059088903,8479,525,2310,30,16,5436,16,12,7954
6059088904,5687,375,565,27,0,4584,28,9,5312
6059088905,5115,380,793,25,3,3804,13,8,4735
6059089001,6727,285,2619,20,10,3701,17,12,6442
6059089003,3822,233,2122,51,6,1310,28,15,3589
6059089004,7230,366,3707,55,15,2975,19,21,6864
6059089102,7012,537,4401,54,13,1875,42,24,6475
6059089104,5243,216,3780,37,3,1120,18,14,5027
6059089105,6179,116,5257,22,2,721,8,24,6063
6059089106,3972,185,2717,18,3,1009,4,15,3787
6059089107,5672,484,2837,31,2,2207,23,11,5188
6059099202,8308,728,4335,52,13,2965,52,20,7580
6059099203,5832,750,1179,21,0,3714,30,14,5082
6059099204,4429,596,638,39,5,3041,13,5,3833
6059099212,5023,2127,1573,75,9,921,24,30,2896
6059099214,3716,2447,579,17,10,428,18,21,1269
6059099215,5381,3144,1084,34,17,656,31,39,2237
6059099216,4272,2597,674,30,11,635,8,15,1675
6059099217,2465,1798,283,11,4,237,3,10,667
6059099220,5709,3888,859,51,21,503,8,44,1821
6059099222,5102,891,692,49,13,3294,34,3,4211
6059099223,5430,1050,858,36,10,3289,15,20,4380
6059099224,3596,1117,425,28,7,1861,2,25,2479
6059099225,3500,1164,343,30,4,1816,6,15,2336
6059099226,3862,934,527,16,1,2271,4,11,2928
6059099227,6512,1463,2221,77,10,2502,19,27,5049
6059099229,6745,2771,1296,109,10,2238,26,17,3974
6059099230,4511,2451,664,30,7,1060,6,13,2060
6059099231,5536,2962,515,24,2,1720,11,25,2574
6059099232,5602,2783,682,43,10,1748,10,17,2819
6059099233,3390,1528,424,23,0,1192,10,18,1862
6059099234,3580,1417,414,22,4,1535,6,19,2163
6059099235,5314,3049,1117,68,13,689,24,24,2265
6059099237,3565,2331,497,17,1,448,4,25,1234
6059099238,3982,2463,397,22,12,789,14,18,1519
6059099239,3792,2544,408,24,0,592,2,25,1248
6059099240,5339,3653,783,63,10,448,17,41,1686
6059099241,4835,1691,1089,68,18,1663,30,57,3144
6059099242,3570,1419,1168,39,6,736,22,28,2151
6059099243,4298,2969,528,23,3,466,2,30,1329
6059099244,3829,2889,366,19,6,350,4,14,940
6059099245,2954,1880,451,26,1,380,1,9,1074
6059099246,3507,2103,364,20,6,755,7,16,1404
6059099247,3142,142,1354,38,4,1567,3,0,3000
6059099248,5148,280,3331,30,12,1423,10,22,4868
6059099249,3939,55,3261,16,3,573,6,3,3884
6059099250,2918,1115,449,42,8,1158,8,13,1803
6059099251,5771,1993,1351,86,6,2039,22,36,3778
6059099305,7419,4294,2010,88,33,468,30,43,3125
6059099306,6060,4060,1010,56,25,444,16,71,2000
6059099307,2741,1962,384,18,9,203,6,22,779
6059099308,5667,3563,539,34,8,1180,6,32,2104
6059099309,4981,3569,654,45,17,407,9,21,1412
6059099310,4286,2936,594,20,18,342,8,21,1350
6059099311,3496,2510,447,37,5,256,11,42,986
6059099402,7663,1523,5251,46,27,641,11,37,6140
6059099404,4449,2966,725,27,11,434,1,16,1483
6059099405,4555,2616,1009,93,1,483,24,19,1939
6059099406,4550,2639,777,54,4,762,8,30,1911
6059099407,2378,1460,393,30,8,296,5,18,918
6059099408,4354,2702,660,49,1,617,5,38,1652
6059099410,5104,2203,1503,133,13,902,22,37,2901
6059099411,5569,2301,2140,116,6,599,35,34,3268
6059099412,4689,2821,912,90,22,504,14,22,1868
6059099415,5168,3507,568,16,8,739,8,32,1661
6059099416,4883,2928,1152,74,10,348,18,33,1955
6059099417,4952,3127,661,51,0,766,7,35,1825
6059099418,4681,2549,945,66,6,806,9,21,2132
6059099419,3960,2181,666,50,5,805,3,34,1779
6059099502,647,252,221,56,0,40,15,5,395
6059099504,2696,1986,327,14,3,196,8,6,710
6059099506,1167,875,148,5,2,74,6,8,292
6059099508,4840,3161,1031,39,20,323,18,39,1679
6059099509,3832,2533,265,46,4,895,2,5,1299
6059099510,4359,2837,315,49,7,1047,4,8,1522
6059099511,3222,2444,448,16,7,134,4,15,778
6059099512,3091,2146,456,81,21,216,6,11,945
6059099513,2006,1443,255,20,6,182,0,16,563
6059099514,5362,3622,567,22,10,837,12,30,1740
6059099601,6654,1043,2247,70,0,3074,66,17,5611
6059099602,3530,1572,869,35,5,846,8,8,1958
6059099603,6433,3456,1152,68,18,1339,20,16,2977
6059099604,3597,2116,585,35,6,578,11,16,1481
6059099605,5091,2603,973,100,9,1105,6,23,2488
6059099701,6270,660,1427,14,7,4023,9,7,5610
6059099702,8240,1452,1974,66,7,4502,29,24,6788
6059099703,5884,1768,869,109,18,2867,6,23,4116
6059099801,6122,785,2179,86,11,2927,33,9,5337
6059099802,5225,782,1695,57,7,2562,31,11,4443
6059099803,5911,521,1306,40,2,3931,5,16,5390
6059099902,4592,1548,1343,66,15,1343,26,15,3044
6059099903,5600,813,2427,52,9,2141,32,20,4787
6059099904,6105,803,2460,40,9,2601,28,15,5302
6059099905,3801,1105,1654,92,11,748,36,22,2696
6059099906,4941,2506,897,35,21,1163,9,29,2435
6059110001,4509,2370,983,45,10,769,12,47,2139
6059110003,3175,1683,679,35,7,528,14,16,1492
6059110004,4852,2637,954,47,4,856,9,34,2215
6059110005,3182,1911,579,27,3,430,6,11,1271
6059110006,3092,1829,468,45,2,521,10,17,1263
6059110007,4724,3111,726,25,6,550,9,8,1613
6059110008,4571,2769,784,57,8,660,6,13,1802
6059110010,4486,1936,812,66,1,1423,14,12,2550
6059110011,3020,1379,462,72,9,926,13,8,1641
6059110012,5167,3170,722,82,5,855,5,29,1997
6059110014,5242,2012,1650,252,8,933,42,33,3230
6059110015,3546,2101,665,24,18,461,8,10,1445
6059110102,5791,1400,1213,188,14,2667,46,20,4391
6059110104,6077,1850,1034,197,3,2703,34,17,4227
6059110106,3779,1435,696,102,2,1292,21,16,2344
6059110108,2784,1268,674,69,8,577,19,24,1516
6059110109,5143,1546,1094,165,6,2077,27,17,3597
6059110110,6037,1419,2016,194,13,2063,40,33,4618
6059110111,6410,1875,1425,260,7,2484,24,31,4535
6059110113,2745,1010,629,48,0,933,10,10,1735
6059110114,4779,2012,1146,56,18,1234,30,20,2767
6059110115,3555,755,660,220,3,1763,14,15,2800
6059110116,4760,871,871,212,7,2631,12,15,3889
6059110117,6392,2049,1496,318,5,2141,31,30,4343
6059110118,2470,534,200,64,1,1586,7,4,1936
6059110201,8372,1806,2828,274,22,3077,34,33,6566
6059110202,7874,1596,3271,412,36,2243,49,29,6278
6059110203,5620,2094,1620,85,10,1468,49,15,3526
6059110301,6966,1783,2113,297,6,2437,31,37,5183
6059110302,6153,1211,3104,96,19,1485,39,35,4942
6059110303,5185,1412,1826,137,15,1528,41,34,3773
6059110304,4661,1322,1191,91,10,1810,25,27,3339
6059110401,5704,1304,2336,122,4,1711,26,10,4400
6059110402,5342,787,3015,149,10,1203,38,34,4555
6059110500,8557,739,5113,384,27,2050,41,47,7818
6059110603,8556,805,5087,294,20,2122,53,26,7751
6059110604,8278,1567,1320,186,0,4950,7,25,6711
6059110605,6704,947,829,122,16,4633,10,14,5757
6059110606,4991,333,2831,171,8,1540,12,18,4658
6059110607,4537,835,1588,109,8,1866,6,10,3702
6059980000,30,8,10,0,0,7,0,0,22
6059990100,0,0,0,0,0,0,0,0,0
6061020104,1327,1147,93,6,2,30,5,2,180
6061020105,1319,1179,65,3,5,12,5,5,140
6061020106,1643,1105,437,2,8,25,0,14,538
6061020107,3315,1469,1677,3,5,60,8,20,1846
6061020200,6429,5268,520,19,96,51,11,39,1161
6061020300,4639,3531,601,44,56,88,11,26,1108
6061020401,2242,1628,385,23,8,29,2,15,614
6061020402,3511,2837,342,20,34,59,6,26,674
6061020501,2973,2384,290,9,18,72,1,31,589
6061020502,4317,3547,290,23,39,129,0,30,770
6061020601,7257,5632,731,50,33,361,10,33,1625
6061020604,5927,4411,580,68,25,414,7,34,1516
6061020605,5885,4202,498,41,20,743,8,38,1683
6061020606,4296,2906,348,69,7,660,1,21,1390
6061020607,5099,3786,482,52,25,375,7,17,1313
6061020608,3811,3062,335,11,35,98,8,14,749
6061020710,4408,3234,555,48,22,256,10,36,1174
6061020711,4558,2933,669,114,18,448,14,37,1625
6061020712,3855,2526,927,65,9,119,5,18,1329
6061020713,3323,2197,596,76,13,174,14,14,1126
6061020714,3848,2751,512,70,31,231,8,25,1097
6061020715,3074,2096,602,38,17,124,0,15,978
6061020717,4888,2864,597,115,15,916,21,24,2024
6061020805,4202,2667,856,88,25,219,16,31,1535
6061020806,3576,2401,762,34,17,101,2,13,1175
6061020901,2777,1361,1092,74,15,67,3,13,1416
6061020908,7512,4190,2126,117,65,479,13,40,3322
6061021003,6784,4313,1257,146,32,506,37,50,2471
6061021034,4331,2554,645,94,7,618,30,23,1777
6061021037,2209,1423,326,59,5,247,5,12,786
6061021038,7627,4715,1469,186,20,629,28,47,2912
6061021039,1703,1513,96,12,4,41,1,1,190
6061021040,3123,2745,166,27,2,107,6,5,378
6061021043,3760,2501,460,90,12,340,9,33,1259
6061021044,5765,3766,898,121,20,516,12,23,1999
6061021045,3533,2104,864,86,16,167,11,17,1429
6061021046,5056,2960,970,142,16,568,36,23,2096
6061021047,4463,2708,661,102,19,597,20,13,1755
6061021048,3439,2108,557,88,23,415,10,25,1331
6061021103,4904,3212,902,77,35,299,12,18,1692
6061021106,2401,1822,282,36,12,109,4,5,579
6061021108,3410,2176,659,53,23,231,8,29,1234
6061021109,5594,3864,588,84,34,544,5,49,1730
6061021122,3455,2562,352,24,5,320,0,19,893
6061021123,7558,5549,893,70,11,495,11,26,2009
6061021128,3244,2110,515,81,12,248,14,26,1134
6061021129,3453,2234,649,74,28,169,13,23,1219
6061021130,2272,1320,360,58,8,316,5,30,952
6061021131,5722,3877,829,97,30,439,20,37,1845
6061021203,7431,5610,943,48,64,270,6,46,1821
6061021204,2748,2228,258,10,27,45,1,18,520
6061021304,6258,4680,1026,34,42,90,4,16,1578
6061021323,11223,6060,1484,211,45,2438,53,68,5163
6061021324,6321,4050,676,65,15,1030,16,39,2271
6061021325,9279,4960,1184,287,30,2134,28,32,4319
6061021326,4394,1933,630,183,8,1236,16,23,2461
6061021327,5643,3068,787,155,13,1220,15,22,2575
6061021328,8556,4562,1180,208,16,1900,22,17,3994
6061021401,3056,1819,954,37,12,54,5,2,1237
6061021403,7164,3035,3461,83,40,157,24,27,4129
6061021501,5911,4408,779,76,56,154,9,31,1503
6061021502,3806,2993,441,13,23,75,0,29,813
6061021603,4927,3001,1498,32,41,130,10,13,1926
6061021604,3421,2790,342,7,21,46,0,17,631
6061021801,4663,3922,391,12,28,57,1,17,741
6061021802,6052,4724,762,52,75,81,14,19,1328
6061021901,3315,2638,354,44,20,52,9,13,677
6061021902,4462,3768,394,4,15,36,2,37,694
6061022002,6569,5268,614,23,74,69,12,42,1301
6061022011,2292,1863,261,5,2,48,4,15,429
6061022013,2833,2379,190,11,38,20,5,17,454
6061022014,1529,1320,84,7,0,21,0,18,209
6061022100,901,779,48,0,0,8,1,2,122
6061022200,902,773,83,0,1,10,0,11,129
6061022300,646,566,34,1,1,11,2,0,80
6061022400,4893,3216,546,85,21,774,2,14,1677
6061022500,4689,2612,557,164,46,981,7,25,2077
6061022600,4982,2995,743,196,16,646,32,18,1987
6061022800,4986,2871,625,122,8,952,25,23,2115
6061022900,5765,3321,820,129,21,977,18,14,2444
6061023000,3914,2459,570,106,9,490,9,25,1455
6061023100,8697,5199,1094,273,16,1472,26,52,3498
6061023200,6078,3578,1000,159,24,780,30,46,2500
6061023300,6333,3715,1230,187,23,608,22,42,2618
6061023400,5721,3714,1062,100,17,384,19,23,2007
6061023501,1245,828,131,25,2,185,2,7,417
6061023502,5315,3645,828,66,21,403,5,15,1670
6061023600,4361,3877,215,21,8,147,2,3,484
6061023700,3301,2987,121,18,7,99,5,9,314
6061023800,3211,2763,182,32,12,111,4,7,448
6061023900,3129,2044,680,60,15,114,7,12,1085
6061990000,0,0,0,0,0,0,0,0,0
6063000100,5271,4273,414,55,73,42,7,44,998
6063000201,1830,1663,68,7,8,10,1,13,167
6063000202,1248,1044,108,4,23,11,1,6,204
6063000300,4897,3677,804,19,73,32,20,15,1220
6063000400,2564,1947,220,10,175,10,5,20,617
6063000501,2200,1867,175,3,18,28,1,4,333
6063000502,1780,1528,108,4,12,12,5,12,252
6065030101,1243,175,823,64,14,122,4,12,1068
6065030103,2091,379,1476,72,19,70,10,9,1712
6065030104,7253,1091,4867,506,22,536,26,36,6162
6065030200,4944,2069,2167,241,20,143,17,38,2875
6065030300,4440,1549,2068,466,26,115,10,41,2891
6065030400,6978,730,5436,536,22,126,3,37,6248
6065030501,4888,512,3249,638,18,314,13,32,4376
6065030502,2120,126,1814,108,21,23,3,6,1994
6065030503,3747,193,3106,247,14,47,19,36,3554
6065030602,3334,2092,762,128,9,132,6,23,1242
6065030603,3181,2035,802,62,8,79,5,16,1146
6065030604,2848,1665,611,131,11,303,0,13,1183
6065030605,2630,1311,631,168,8,351,6,2,1319
6065030700,5842,2731,2481,207,17,129,15,27,3111
6065030800,7501,2777,3634,392,20,290,28,54,4724
6065030900,3256,698,2175,169,12,121,0,11,2558
6065031001,5893,2172,2790,414,21,205,18,43,3721
6065031002,4655,663,3642,136,7,97,9,18,3992
6065031100,5047,2022,2322,315,16,94,7,30,3025
6065031200,7018,2643,3634,231,16,208,15,38,4375
6065031300,2698,95,2509,41,4,22,6,3,2603
6065031401,6985,1670,4524,343,26,169,16,39,5315
6065031402,6980,2009,3953,397,40,286,28,71,4971
6065031501,5954,1694,3350,341,57,314,10,15,4260
6065031503,4339,1271,2544,193,24,137,15,20,3068
6065031504,4280,861,2733,333,27,185,3,15,3419
6065031601,4467,774,3247,140,28,171,18,16,3693
6065031602,5377,1129,3621,215,35,186,10,22,4248
6065031701,2966,770,1799,146,4,162,3,31,2196
6065031702,2341,839,1193,75,12,127,5,10,1502
6065031703,3711,1075,2125,155,19,199,8,16,2636
6065031704,5540,1469,3206,323,9,320,39,36,4071
6065040101,4304,451,3459,266,12,26,14,9,3853
6065040102,5788,827,4166,258,14,352,19,39,4961
6065040201,6421,1147,4575,220,10,290,25,31,5274
6065040202,3129,805,2058,89,10,35,7,14,2324
6065040203,3788,213,3381,99,4,29,0,37,3575
6065040204,3742,190,3297,188,10,18,3,5,3552
6065040302,7522,2177,4418,277,28,355,11,68,5345
6065040303,4072,576,2954,114,11,313,13,26,3496
6065040304,4099,446,3395,112,5,70,5,20,3653
6065040305,3498,553,2690,101,6,42,17,14,2945
6065040402,4243,904,3152,44,11,40,10,11,3339
6065040403,5646,945,4471,41,13,84,3,37,4701
6065040404,3313,748,2063,89,13,277,15,12,2565
6065040405,5386,1770,3030,197,9,204,8,15,3616
6065040501,7196,1199,5617,99,8,134,16,41,5997
6065040502,5995,746,4759,183,12,162,7,31,5249
6065040503,3874,988,2134,426,22,155,11,33,2886
6065040603,2346,363,1910,11,0,13,0,10,1983
6065040604,5670,1791,3475,72,25,95,13,34,3879
6065040605,3410,415,2938,0,9,11,14,9,2995
6065040606,3337,400,2840,30,0,12,0,6,2937
6065040609,16631,3625,5434,988,26,5711,30,78,13006
6065040611,8431,1625,2912,889,13,2592,23,46,6806
6065040616,11213,1991,3693,1233,26,3838,31,45,9222
6065040617,7275,1310,2881,570,5,2156,26,54,5965
6065040618,10472,2019,5237,793,21,2049,38,41,8453
6065040619,5933,964,2039,531,15,2153,13,40,4969
6065040620,7702,1596,3162,683,1,1902,8,46,6106
6065040621,4230,909,1539,375,11,1198,11,22,3321
6065040622,6140,1096,2528,612,7,1619,31,38,5044
6065040701,2167,1339,596,40,6,62,0,28,828
6065040702,2685,1552,985,8,14,34,4,6,1133
6065040703,2800,1571,1038,25,20,29,3,10,1229
6065040806,2826,1340,1068,76,10,182,7,31,1486
6065040807,3429,1308,1604,111,16,211,27,26,2121
6065040808,6939,1468,4240,403,3,562,23,41,5471
6065040809,3508,907,1802,178,10,453,11,15,2601
6065040812,3419,1799,1371,39,20,57,4,15,1620
6065040813,6155,3156,1977,162,16,540,9,39,2999
6065040814,4941,1357,1950,571,11,780,22,38,3584
6065040815,3651,847,1406,375,11,833,4,23,2804
6065040816,2408,809,753,267,3,449,9,19,1599
6065040821,5825,1636,2256,568,23,1004,24,50,4189
6065040901,7668,1641,3870,767,35,971,42,54,6027
6065040902,5290,1794,2503,206,17,550,13,20,3496
6065040903,2739,580,1786,129,5,119,12,12,2159
6065040904,3970,740,2682,119,11,294,19,27,3230
6065041001,2725,301,2214,119,10,29,5,8,2424
6065041002,3283,402,2603,128,7,89,5,3,2881
6065041003,2627,675,1737,36,1,102,2,7,1952
6065041004,4475,844,3061,184,9,241,15,8,3631
6065041101,5411,252,4787,178,37,80,18,11,5159
6065041102,4524,591,3462,84,8,256,12,10,3933
6065041201,4532,793,3007,229,11,367,7,21,3739
6065041202,4454,410,3809,32,19,104,1,13,4044
6065041203,3442,348,2790,136,6,105,6,16,3094
6065041301,3585,410,2989,43,6,74,7,8,3175
6065041302,4317,374,3549,79,17,200,30,20,3943
6065041403,4566,1319,2059,296,16,674,11,43,3247
6065041404,3799,845,2419,90,14,295,12,23,2954
6065041405,4782,990,3285,119,6,215,49,15,3792
6065041406,5957,1396,3068,482,14,670,31,59,4561
6065041407,5936,1047,3894,425,16,354,45,31,4889
6065041408,4566,910,2841,380,16,208,33,31,3656
6065041410,3059,105,2887,11,7,18,0,23,2954
6065041411,3095,363,2494,47,4,147,5,4,2732
6065041412,4599,1113,2573,198,19,539,20,15,3486
6065041413,7148,2749,2191,462,13,1371,14,65,4399
6065041414,4217,1584,1423,250,7,723,18,39,2633
6065041415,4530,1288,1988,268,15,759,8,20,3242
6065041500,3835,616,2364,353,8,335,23,14,3219
6065041601,2899,312,2410,49,11,76,1,7,2587
6065041602,3245,248,2757,42,22,100,3,20,2997
6065041702,4643,1177,3132,76,10,97,0,18,3466
6065041703,5760,581,4557,283,14,206,3,33,5179
6065041704,3746,206,3336,35,13,95,0,22,3540
6065041803,5998,2631,1507,212,27,1222,9,56,3367
6065041804,4332,1930,1448,172,7,550,18,16,2402
6065041805,5832,1788,2790,405,25,548,18,41,4044
6065041806,4112,1705,1337,237,11,639,33,14,2407
6065041807,2305,808,1242,44,4,111,0,10,1497
6065041808,6771,2741,2101,374,9,1229,10,42,4030
6065041809,5852,1995,2546,381,13,601,55,11,3857
6065041810,5895,2415,1711,274,27,1123,25,36,3480
6065041812,3488,1225,1777,104,24,225,8,9,2263
6065041813,6599,1635,4310,229,26,237,17,12,4964
6065041904,4950,1860,2466,74,7,373,21,14,3090
6065041905,3005,798,1797,130,16,170,19,11,2207
6065041906,6360,1476,4140,221,13,288,21,32,4884
6065041909,5388,1784,2956,121,28,295,7,24,3604
6065041910,7655,3313,2768,578,21,556,18,38,4342
6065041912,6158,2486,1830,236,17,1231,25,34,3672
6065041913,5564,2403,1824,207,17,823,14,16,3161
6065041914,5972,2090,1835,634,7,1039,11,30,3882
6065041915,7451,3291,2110,531,18,1015,17,64,4160
6065042003,6027,2608,2046,416,12,694,3,35,3419
6065042004,3344,1666,1155,139,21,147,16,21,1678
6065042005,5452,2407,1613,302,14,841,7,41,3045
6065042007,5559,2946,1847,207,26,302,12,19,2613
6065042008,8742,3700,3442,495,36,633,21,41,5042
6065042009,7514,1706,4744,462,26,323,7,27,5808
6065042010,6434,861,5225,182,6,64,4,18,5573
6065042012,6332,2320,2184,557,12,846,26,25,4012
6065042015,5521,2378,1746,429,6,622,13,28,3143
6065042016,2621,1041,1000,189,5,223,13,26,1580
6065042017,3978,1664,1413,273,16,400,8,9,2314
6065042018,6017,2473,1795,495,8,893,12,21,3544
6065042206,6400,2384,2044,690,11,865,6,46,4016
6065042207,3097,1739,739,176,16,269,10,20,1358
6065042208,2562,1468,726,93,9,141,0,15,1094
6065042209,4627,886,2572,500,17,436,14,33,3741
6065042210,4995,1177,2430,555,36,590,9,40,3818
6065042212,7124,1452,3723,1070,16,529,21,32,5672
6065042213,5520,2055,1746,411,49,1005,8,21,3465
6065042214,6843,1857,3247,763,36,612,15,34,4986
6065042217,5488,2825,1442,377,12,498,28,18,2663
6065042300,10335,1990,6512,652,27,781,27,61,8345
6065042401,2075,718,1037,168,5,73,7,2,1357
6065042402,5127,982,3167,521,20,252,12,19,4145
6065042403,4541,820,2712,560,22,242,31,30,3721
6065042404,2515,230,1707,391,6,71,20,17,2285
6065042405,5668,562,3149,1466,23,166,26,37,5106
6065042406,4267,699,2728,493,8,164,22,42,3568
6065042407,3313,691,2167,247,7,72,8,9,2622
6065042408,3370,636,2151,337,9,104,28,9,2734
6065042409,3385,550,2218,337,14,119,13,24,2835
6065042410,5852,1026,2983,1112,16,373,27,36,4826
6065042411,2683,626,1328,406,16,111,13,20,2057
6065042412,5566,1898,2468,602,12,317,10,33,3668
6065042505,3949,273,3179,275,15,78,33,15,3676
6065042507,5714,522,3824,798,16,338,50,23,5192
6065042508,4968,316,3940,435,13,131,11,22,4652
6065042509,3460,421,2547,265,12,123,6,32,3039
6065042510,5133,462,3788,538,10,183,31,9,4671
6065042511,4430,439,3157,528,1,165,24,33,3991
6065042512,3260,214,2433,449,10,53,13,14,3046
6065042513,3387,443,2343,358,6,133,6,5,2944
6065042514,3311,288,2252,457,5,192,32,11,3023
6065042515,3794,229,2881,433,13,99,44,20,3565
6065042516,3740,359,2726,403,15,126,12,20,3381
6065042517,3361,323,2387,402,4,132,28,16,3038
6065042518,3816,386,2371,724,6,178,16,21,3430
6065042519,1887,191,1286,285,7,56,2,15,1696
6065042520,4866,378,3720,413,13,207,29,13,4488
6065042521,5127,468,3867,490,4,125,31,26,4659
6065042522,4703,558,2383,903,6,657,18,33,4145
6065042523,5160,605,2777,1172,7,381,26,27,4555
6065042621,8004,901,4676,1326,8,766,32,49,7103
6065042622,5482,700,2601,1121,15,810,20,55,4782
6065042623,3962,856,1771,806,14,300,11,28,3106
6065042624,4571,1036,2372,527,9,355,26,55,3535
6065042625,6046,761,3932,695,20,388,16,32,5285
6065042626,9775,855,6699,1268,26,650,17,85,8920
6065042627,5637,289,4562,492,19,157,13,17,5348
6065042628,5759,319,4704,446,16,120,24,29,5440
6065042629,5176,460,3620,671,12,233,14,37,4716
6065042630,6727,611,4598,940,6,290,26,73,6116
6065042631,5190,314,4321,359,3,95,9,15,4876
6065042632,3245,173,2858,104,8,60,6,12,3072
6065042708,5364,2214,2338,241,21,263,32,23,3150
6065042709,5288,2593,1927,322,18,206,12,27,2695
6065042711,5114,3250,1095,358,21,166,20,23,1864
6065042714,3376,2503,505,87,18,80,5,25,873
6065042716,5222,3821,932,54,21,122,6,15,1401
6065042717,5463,2134,2789,133,9,124,20,35,3329
6065042719,5438,1324,3686,171,20,69,14,17,4114
6065042720,4936,1465,3165,82,15,72,6,13,3471
6065042723,7675,2333,4428,315,35,249,13,37,5342
6065042724,4581,1638,1810,366,11,426,31,24,2943
6065042726,10185,3797,4054,1005,42,678,35,58,6388
6065042728,2370,956,1110,109,9,73,9,15,1414
6065042730,6028,1346,4097,162,22,170,10,43,4682
6065042731,7691,1806,4638,556,12,375,34,41,5885
6065042732,6259,2587,2774,227,15,296,15,32,3672
6065042733,14643,6126,5216,1071,48,1282,83,77,8517
6065042737,3471,1315,1319,297,9,296,25,26,2156
6065042738,8924,3990,2965,532,33,794,52,38,4934
6065042739,9259,3667,3284,719,37,1000,57,61,5592
6065042740,2384,1720,362,163,11,65,5,7,664
6065042741,2479,1590,462,214,21,104,9,7,889
6065042742,6035,2539,2333,390,18,429,29,18,3496
6065042743,4180,1819,1536,265,27,276,7,37,2361
6065042744,3597,1100,2285,37,6,31,10,19,2497
6065042745,6212,2891,2431,310,28,274,17,9,3321
6065042746,4435,208,3695,383,6,62,10,32,4227
6065042747,4310,204,3295,551,12,158,22,18,4106
6065042748,6271,2689,2021,581,27,590,8,20,3582
6065042749,5614,1290,2825,518,23,650,26,43,4324
6065042750,4325,1349,1754,357,3,575,17,45,2976
6065042751,5369,2244,1988,484,17,295,31,35,3125
6065042752,5409,3010,1504,287,15,343,18,14,2399
6065042801,4345,392,3324,473,15,48,3,8,3953
6065042802,6222,394,5081,518,19,66,17,29,5828
6065042902,4993,895,3732,159,24,60,4,18,4098
6065042903,5673,817,4469,202,23,46,2,33,4856
6065042905,3670,461,2954,132,9,46,0,21,3209
6065042906,6396,362,5476,350,40,58,7,22,6034
6065042907,3461,490,2780,90,9,30,2,7,2971
6065042908,4371,466,3495,212,9,76,12,27,3905
6065043001,9758,2776,5221,578,28,621,78,35,6982
6065043003,6647,1400,4553,295,27,121,26,29,5247
6065043005,5744,1601,3489,251,17,164,8,18,4143
6065043006,5079,1042,3468,239,29,111,17,25,4037
6065043007,6918,2714,2960,503,13,392,8,41,4204
6065043008,6146,2312,3047,197,16,304,16,52,3834
6065043009,6064,1914,3201,298,18,401,14,16,4150
6065043010,6039,2016,3341,203,21,185,4,28,4023
6065043201,4040,1788,1117,254,0,606,4,20,2252
6065043202,5630,2977,1051,224,51,872,31,19,2653
6065043203,3482,1816,733,63,365,263,16,10,1666
6065043204,7450,3205,2217,622,32,772,27,41,4245
6065043205,4667,1914,1620,288,28,525,31,18,2753
6065043206,7819,3398,2706,466,58,626,22,61,4421
6065043207,4504,1822,1309,304,26,692,52,33,2682
6065043208,5039,2161,1168,273,67,992,36,26,2878
6065043209,4105,2003,966,301,24,554,16,17,2102
6065043210,4898,2674,1422,178,42,280,6,28,2224
6065043211,5517,2523,1955,243,19,423,35,29,2994
6065043216,7142,3006,2639,415,34,592,18,46,4136
6065043217,3277,1661,966,153,17,304,11,10,1616
6065043218,5680,3230,1620,148,21,322,4,38,2450
6065043220,4742,1911,1748,267,14,510,14,22,2831
6065043222,4775,2742,1147,144,25,444,10,16,2033
6065043227,8221,3405,2743,561,56,796,56,53,4816
6065043228,4503,1958,1551,303,19,341,28,22,2545
6065043229,5186,3486,1056,143,9,276,16,9,1700
6065043235,11292,4322,3072,1028,29,1819,65,85,6970
6065043246,5451,3397,1114,131,26,416,8,20,2054
6065043248,4284,2214,939,215,28,598,25,15,2070
6065043252,9821,4366,2151,452,201,1785,57,63,5455
6065043254,5069,2408,1760,132,69,369,14,35,2661
6065043256,3585,1345,1219,230,31,453,13,34,2240
6065043262,5061,3134,1228,148,22,275,13,26,1927
6065043264,7314,3999,1946,168,37,620,20,39,3315
6065043265,7944,4484,1813,234,51,742,16,32,3460
6065043266,4823,1710,1821,319,55,593,31,45,3113
6065043267,6676,4338,1272,178,21,416,19,38,2338
6065043270,6018,2699,2084,275,34,463,53,34,3319
6065043271,4543,2003,2055,72,34,196,3,38,2540
6065043272,5311,3426,1134,136,24,267,10,39,1885
6065043274,2229,888,969,101,27,128,1,12,1341
6065043276,4092,1891,1149,250,10,506,49,7,2201
6065043278,6510,3502,1554,376,24,603,16,35,3008
6065043279,5302,2935,1771,110,38,159,15,19,2367
6065043292,3656,2436,803,52,26,161,10,14,1220
6065043293,3086,2017,756,41,24,101,5,6,1069
6065043294,4338,2288,1222,160,29,337,20,15,2050
6065043295,4889,1997,1643,306,18,528,31,18,2892
6065043296,3303,1494,865,201,4,510,19,17,1809
6065043297,8903,3578,2555,631,35,1454,11,47,5325
6065043298,4864,2430,1302,292,9,533,27,12,2434
6065043304,7744,4214,2579,256,65,305,35,41,3530
6065043306,5172,1840,2517,367,21,187,15,21,3332
6065043307,6770,2594,3073,551,33,239,16,26,4176
6065043308,3230,789,1901,318,30,82,4,0,2441
6065043309,3329,895,1887,295,31,69,5,13,2434
6065043310,3634,1066,1977,380,25,51,4,10,2568
6065043311,2483,954,1246,127,5,51,7,10,1529
6065043312,4391,1197,2685,209,22,82,26,14,3194
6065043313,3802,1096,2267,188,40,63,11,11,2706
6065043314,4126,1601,2079,144,41,78,4,16,2525
6065043315,2350,1100,969,108,27,49,5,8,1250
6065043316,4014,2199,906,428,20,256,4,21,1815
6065043318,4406,1858,1712,356,31,215,10,27,2548
6065043319,4968,1484,2361,536,18,290,30,43,3484
6065043401,6548,1660,3816,691,42,105,11,34,4888
6065043403,3081,835,1701,343,25,76,6,15,2246
6065043404,2855,1365,1052,229,31,70,5,7,1490
6065043405,5108,1620,2274,771,39,82,23,31,3488
6065043503,4898,2053,1774,618,23,141,44,25,2845
6065043505,3244,1554,1098,372,16,75,2,17,1690
6065043506,7253,2630,3535,476,44,254,28,46,4623
6065043509,6058,1728,3637,273,28,130,28,35,4330
6065043512,7733,1645,4789,681,66,230,32,44,6088
6065043513,2943,902,1547,285,25,63,15,7,2041
6065043517,8501,1646,5169,778,76,464,50,38,6855
6065043518,4781,1291,2557,437,22,220,25,20,3490
6065043519,986,759,147,29,4,15,3,2,227
6065043520,2443,1051,1041,149,14,90,4,8,1392
6065043521,5087,1173,3096,527,10,60,7,36,3914
6065043522,3215,684,1905,417,37,71,4,5,2531
6065043523,3895,1089,2179,334,15,78,9,28,2806
6065043524,4357,1671,2051,249,62,100,37,14,2686
6065043601,5022,774,3527,440,46,58,28,33,4248
6065043602,4412,627,3214,354,33,34,15,16,3785
6065043701,3776,1869,1560,100,24,36,9,21,1907
6065043702,4719,2178,1863,266,41,102,33,23,2541
6065043703,2996,1204,1503,79,24,33,3,16,1792
6065043802,6950,4114,2153,100,36,188,4,24,2836
6065043807,6122,2529,2802,274,24,198,15,25,3593
6065043809,6853,3165,2191,522,33,630,5,32,3688
6065043810,5298,2767,1612,263,21,371,24,18,2531
6065043812,6969,5361,745,359,24,326,2,25,1608
6065043813,4764,1447,1997,177,735,114,9,28,3317
6065043818,4257,1474,1701,339,20,470,10,26,2783
6065043820,5520,1967,2203,551,37,527,11,36,3553
6065043821,5622,1460,2597,683,34,561,11,25,4162
6065043822,3451,1478,1462,128,36,170,14,33,1973
6065043823,11441,4044,4398,1044,58,1312,12,76,7397
6065043824,5063,3448,1119,97,43,133,11,18,1615
6065043900,6430,2233,3539,181,47,183,1,19,4197
6065044000,2026,453,1275,135,26,72,3,9,1573
6065044101,3030,681,1916,152,43,136,2,5,2349
6065044102,2825,794,1637,159,34,114,0,14,2031
6065044103,6106,2531,2420,375,90,438,11,33,3575
6065044104,2755,1054,1321,105,39,113,1,10,1701
6065044200,5969,1016,3551,779,68,354,11,31,4953
6065044300,5085,1232,2798,518,46,343,1,16,3853
6065044403,4219,2118,1082,45,425,326,5,12,2101
6065044404,2071,1466,408,21,19,59,0,13,605
6065044405,2368,1840,347,24,14,32,3,8,528
6065044406,2927,1939,636,33,45,103,0,25,988
6065044407,3586,2304,856,49,32,184,3,25,1282
6065044505,6864,2133,4311,80,22,186,0,17,4731
6065044507,7840,1373,5713,388,34,102,5,64,6467
6065044509,4580,1025,2757,516,37,62,10,20,3555
6065044510,7010,1212,4782,605,32,116,11,30,5798
6065044515,4001,760,2963,132,7,49,9,12,3241
6065044516,7480,1682,4897,459,27,173,15,30,5798
6065044517,2797,1553,847,117,21,118,8,19,1244
6065044518,6562,2378,3191,417,31,201,6,54,4184
6065044520,1618,851,656,12,9,20,0,11,767
6065044521,1304,497,633,53,14,29,8,1,807
6065044523,2254,1190,877,30,8,52,6,7,1064
6065044524,3277,813,2152,132,30,70,2,9,2464
6065044602,2707,1693,691,90,11,124,2,13,1014
6065044604,3772,1901,1473,86,24,164,6,23,1871
6065044605,5222,1816,2256,723,22,211,8,37,3406
6065044606,2986,1729,933,96,19,90,4,26,1257
6065044701,3261,1776,1030,135,27,179,12,17,1485
6065044702,2087,154,1764,42,5,81,1,8,1933
6065044804,2302,745,1067,57,3,347,5,13,1557
6065044805,1580,1218,210,24,4,54,0,24,362
6065044806,1883,1327,367,50,12,42,4,8,556
6065044807,1343,958,195,37,0,100,6,3,385
6065044904,4721,1640,2326,142,45,337,9,32,3081
6065044907,5226,334,4606,78,4,113,5,31,4892
6065044911,5034,2844,1606,103,14,244,3,38,2190
6065044916,4881,1760,2661,155,22,140,5,17,3121
6065044917,3854,3278,277,53,8,110,1,10,576
6065044918,2994,2476,218,53,0,144,7,12,518
6065044919,4857,4121,368,94,12,135,4,8,736
6065044921,2340,1746,237,42,13,205,0,16,594
6065044922,5980,3690,1198,181,25,600,8,14,2290
6065044923,3364,961,1955,75,20,208,8,39,2403
6065044924,3886,1018,2323,77,22,343,2,20,2868
6065044925,3439,824,2200,71,9,241,3,12,2615
6065044926,4714,772,3078,106,37,567,0,27,3942
6065044927,3637,2469,815,73,4,149,6,20,1168
6065044928,3453,2888,346,35,11,92,3,12,565
6065044929,4151,2992,711,60,17,237,10,14,1159
6065044930,3188,1592,1319,48,4,131,4,9,1596
6065044931,2330,497,1513,57,5,213,0,4,1833
6065044932,3104,1075,1458,55,19,371,6,26,2029
6065044933,3456,191,3040,48,5,137,1,11,3265
6065044934,2753,266,2369,56,2,36,0,4,2487
6065045000,3054,1438,1342,86,15,52,0,13,1616
6065045103,3291,2164,843,65,14,76,5,25,1127
6065045109,3617,1744,1583,67,25,45,0,20,1873
6065045110,4971,1843,2700,143,20,74,6,32,3128
6065045114,1912,1666,141,10,0,36,0,0,246
6065045115,1811,1552,144,7,3,38,1,11,259
6065045116,1438,989,319,17,0,34,7,8,449
6065045117,3911,2497,956,98,8,151,1,21,1414
6065045118,2676,1170,1284,57,3,79,0,17,1506
6065045119,2751,1430,1018,28,5,162,2,8,1321
6065045120,4458,1820,2289,61,6,90,27,28,2638
6065045122,1326,1151,74,22,1,40,4,2,175
6065045123,2274,1618,444,24,0,112,0,16,656
6065045124,1471,1058,268,13,7,46,7,10,413
6065045125,2655,2205,317,19,1,58,3,7,450
6065045126,2835,915,1700,40,6,99,1,25,1920
6065045127,2572,1444,858,67,11,98,3,8,1128
6065045128,1580,1276,208,21,0,21,0,3,304
6065045129,4677,2425,1867,72,14,140,2,11,2252
6065045207,5521,682,4551,143,11,54,2,16,4839
6065045209,6497,527,5690,116,3,59,3,25,5970
6065045212,2148,1305,631,94,6,56,2,4,843
6065045213,5619,1380,3767,86,7,226,3,26,4239
6065045214,6009,3653,1582,110,16,344,1,23,2356
6065045216,2253,1647,415,49,3,72,2,3,606
6065045217,7230,721,6102,87,16,168,0,30,6509
6065045222,2455,985,1185,63,9,131,3,8,1470
6065045224,5696,1910,3429,70,19,141,3,17,3786
6065045226,6528,221,6138,41,4,47,5,44,6307
6065045228,5662,2829,2254,139,12,201,12,18,2833
6065045233,4735,1970,2242,122,34,175,6,37,2765
6065045234,4699,2582,1478,68,26,322,3,24,2117
6065045235,3562,1793,1219,45,14,322,2,28,1769
6065045302,4362,234,4045,17,15,9,1,7,4128
6065045303,3141,146,2913,39,5,15,0,3,2995
6065045305,4744,1345,2866,133,12,195,7,26,3399
6065045306,6242,1462,4199,106,37,224,4,50,4780
6065045501,5906,487,5005,220,22,104,0,23,5419
6065045502,3846,427,3230,73,21,43,4,18,3419
6065045606,3660,2068,1295,78,16,107,2,11,1592
6065045610,4124,35,4004,33,0,17,3,17,4089
6065045611,4276,36,4205,2,0,2,0,17,4240
6065045612,4810,107,4657,5,15,6,0,10,4703
6065045613,1947,1696,120,18,1,57,0,14,251
6065045614,1149,967,95,21,1,44,1,0,182
6065045615,3535,236,3217,11,6,16,0,19,3299
6065045616,1818,54,1741,3,0,17,0,0,1764
6065045617,2598,1468,948,22,71,35,2,10,1130
6065045618,2181,11,2082,3,20,27,0,27,2170
6065045619,4407,54,4245,4,65,17,0,9,4353
6065045703,6297,87,6132,14,2,17,0,22,6210
6065045704,3135,47,3049,8,8,2,1,4,3088
6065045706,4297,45,4233,8,0,0,0,3,4252
6065045707,6289,112,6099,16,7,10,0,25,6177
6065045708,4412,72,4281,14,10,15,0,10,4340
6065045709,4579,41,4452,13,24,14,1,24,4538
6065045900,1511,428,928,73,10,7,1,4,1083
6065046101,2862,893,1591,153,23,74,3,18,1969
6065046102,2028,315,1445,181,10,22,1,6,1713
6065046103,2757,975,1458,117,23,90,4,8,1782
6065046200,3084,499,2044,361,27,34,1,13,2585
6065046401,3953,1623,1886,114,30,139,11,12,2330
6065046402,5261,2192,2649,113,12,81,11,26,3069
6065046403,7686,2772,3955,208,44,288,35,36,4914
6065046404,6160,2188,3081,254,20,310,3,33,3972
6065046405,4128,1791,1925,88,13,105,16,37,2337
6065046501,3455,1660,836,162,47,587,2,1,1795
6065046502,4364,1022,1518,481,26,1102,6,43,3342
6065046601,4560,1169,1931,1227,53,72,4,8,3391
6065046602,3497,1996,1267,48,8,47,6,11,1501
6065046700,4243,673,2781,516,14,131,33,16,3570
6065046800,6517,732,4345,851,12,356,40,30,5785
6065046900,1725,628,967,54,7,12,2,7,1097
6065047000,1567,803,609,58,12,15,0,3,764
6065047201,2165,1148,896,30,11,24,0,3,1017
6065047202,1891,1079,635,31,10,30,4,22,812
6065047901,5122,2151,1607,306,18,759,13,22,2971
6065047902,6414,2865,1719,327,16,1123,14,43,3549
6065048100,6631,3140,1865,288,18,992,16,24,3491
6065048200,4251,1257,1846,241,2,695,16,33,2994
6065048300,6497,635,3693,1375,5,479,28,65,5862
6065048700,4908,667,2231,1191,8,556,33,29,4241
6065048800,4556,393,2924,757,5,310,12,35,4163
6065048901,3828,518,2612,418,3,131,13,23,3310
6065048902,7472,605,5389,1072,35,155,28,52,6867
6065049001,6345,729,2898,1613,16,729,15,64,5616
6065049002,2848,440,1091,749,26,357,21,20,2408
6065049101,2491,750,1567,88,10,40,0,9,1741
6065049102,3074,1628,1141,84,13,85,0,29,1446
6065049400,2849,1542,1169,35,7,44,1,1,1307
6065049501,4600,217,4266,35,13,39,0,7,4383
6065049502,4222,308,3686,81,32,20,2,35,3914
6065049600,7361,3637,1781,350,19,975,27,44,3724
6065049701,4126,2461,982,111,17,254,13,21,1665
6065049702,5401,3477,1146,132,16,250,7,27,1924
6065049800,4012,1765,1584,170,12,243,6,21,2247
6065050301,6337,2335,1933,453,21,1113,37,65,4002
6065050302,5752,2209,1771,385,10,914,9,35,3543
6065050401,4855,2044,1657,238,16,541,16,29,2811
6065050402,5134,2195,1965,218,21,387,43,26,2939
6065050501,5398,1720,2277,382,34,623,12,48,3678
6065050502,3940,1774,912,283,6,650,14,24,2166
6065050503,5542,1997,1708,414,41,962,20,35,3545
6065050600,7869,4186,2227,378,30,495,40,31,3683
6065050701,8318,3037,2914,651,25,1032,57,41,5281
6065050702,4768,2061,1549,432,19,428,16,31,2707
6065050901,2147,667,678,284,8,396,3,16,1480
6065050902,2503,831,864,214,5,418,14,26,1672
6065051100,6506,640,3464,1696,11,386,37,32,5866
6065051200,4682,2182,1624,195,30,364,11,24,2500
6065051301,5459,1383,3079,495,41,246,10,5,4076
6065051302,5018,1875,2464,319,54,162,20,14,3143
6065051401,3644,3375,112,48,0,54,4,2,269
6065051402,3050,2743,147,34,6,54,3,10,307
6065940100,174,153,9,0,7,0,0,0,21
6065940400,6242,233,5815,54,31,52,2,29,6009
6065940500,2421,2011,225,30,23,42,1,9,410
6065940600,3660,2862,418,36,37,168,17,22,798
6065940700,2561,1899,387,62,14,99,1,6,662
6065940800,2852,2338,283,38,15,81,2,9,514
6065940900,2044,1617,239,43,21,39,5,3,427
6065941001,1788,1204,426,47,1,40,4,6,584
6065941002,2217,1677,295,77,20,61,0,10,540
6065941100,2122,1791,173,40,13,36,0,7,331
6065941200,2845,2143,422,68,13,98,2,8,702
6065941300,3067,2074,539,118,26,159,8,17,993
6065941400,3985,2368,1074,197,31,182,1,18,1617
6065941500,4858,1782,1997,298,487,80,4,8,3076
6065980004,6,0,4,0,0,1,1,0,6
6065981000,5996,896,3705,1128,60,63,11,15,5100
6067000100,3749,2810,439,35,13,158,7,19,939
6067000200,3889,2833,540,48,13,162,2,17,1056
6067000300,3347,2426,462,25,10,153,4,29,921
6067000400,3840,2298,835,168,10,182,6,31,1542
6067000501,1905,922,501,177,11,127,7,19,983
6067000502,1433,785,295,59,9,120,10,13,648
6067000600,1686,831,357,210,15,117,4,17,855
6067000700,2676,845,517,712,43,389,20,24,1831
6067000800,1637,854,305,148,5,193,5,20,783
6067001102,1443,792,283,127,12,93,3,17,651
6067001103,1604,726,321,224,10,167,9,4,878
6067001201,2141,1196,444,173,11,162,15,17,945
6067001202,1855,970,357,147,4,201,9,18,885
6067001300,3320,1987,697,132,4,223,0,20,1333
6067001400,2930,1732,620,152,16,183,4,21,1198
6067001500,4946,3445,760,103,9,257,9,35,1501
6067001601,3908,2497,627,110,20,302,49,29,1411
6067001602,2645,2010,315,15,5,132,0,17,635
6067001701,2574,1135,693,228,9,248,9,22,1439
6067001702,3620,2258,588,156,4,339,13,21,1362
6067001800,5346,2527,1233,594,30,537,12,47,2819
6067001900,3509,1844,792,205,20,319,9,32,1665
6067002000,3882,1507,1010,422,34,693,11,16,2375
6067002100,2773,1149,577,226,16,558,6,61,1624
6067002200,4898,1596,1033,1217,29,484,121,44,3302
6067002300,3380,2360,439,42,10,257,6,22,1020
6067002400,4627,3222,649,57,2,338,6,32,1405
6067002500,1935,1329,244,75,3,110,0,17,606
6067002600,2538,1633,438,104,13,145,0,25,905
6067002700,3545,1348,1063,580,30,197,25,37,2197
6067002800,3317,800,1313,702,34,211,23,11,2517
6067002900,4617,2651,1062,211,25,254,39,36,1966
6067003001,2757,940,1165,163,6,292,15,16,1817
6067003002,3897,2008,1126,256,24,208,20,30,1889
6067003101,3583,1026,1847,218,36,263,21,21,2557
6067003102,3168,945,1439,212,19,324,44,14,2223
6067003202,5354,926,2234,252,25,1622,66,17,4428
6067003203,3149,196,964,257,4,1530,89,3,2953
6067003204,5553,525,2210,415,32,2098,70,26,5028
6067003300,4256,2344,735,84,13,739,7,27,1912
6067003400,4335,1774,1081,486,14,646,37,19,2561
6067003501,2760,1258,742,164,22,319,18,23,1502
6067003502,3034,1101,980,102,11,638,17,10,1933
6067003600,2728,777,1367,141,7,258,30,11,1951
6067003700,4611,705,2408,566,64,591,32,26,3906
6067003800,5348,892,1989,1061,37,887,112,49,4456
6067003900,3598,1676,730,242,3,621,47,28,1922
6067004005,4418,1708,800,577,16,956,18,21,2710
6067004006,5175,1551,1090,842,15,1123,34,48,3624
6067004008,3665,1305,727,304,9,997,3,28,2360
6067004011,3185,879,362,338,0,1374,22,12,2306
6067004012,3338,1060,505,383,0,1107,19,3,2278
6067004013,3580,1158,753,379,20,944,19,25,2422
6067004014,2708,743,707,461,14,494,19,22,1965
6067004015,4254,1408,777,443,10,1278,31,14,2846
6067004016,2108,903,324,138,2,562,3,7,1205
6067004017,2813,864,487,288,11,884,32,11,1949
6067004018,2441,587,401,493,21,729,25,19,1854
6067004019,2996,853,603,338,17,922,25,13,2143
6067004020,2135,745,354,435,6,421,8,11,1390
6067004100,5459,713,1919,869,18,1450,244,34,4746
6067004201,5564,724,2312,1139,45,875,127,17,4840
6067004202,5774,612,2341,1073,18,1240,175,52,5162
6067004203,5889,453,1969,1168,23,1549,349,23,5436
6067004301,4919,463,1623,932,24,1463,188,38,4456
6067004302,4730,311,1368,735,9,1748,283,16,4419
6067004401,4431,907,1878,610,50,589,162,20,3524
6067004402,4343,560,2173,603,17,755,38,17,3783
6067004501,3643,295,1794,285,9,1094,71,10,3348
6067004502,5362,692,2946,695,20,706,77,39,4670
6067004602,5663,899,2736,591,48,838,248,27,4764
6067004603,2789,464,1272,302,16,377,255,17,2325
6067004604,5080,672,2497,482,24,1134,77,22,4408
6067004701,3895,439,1315,586,16,1124,147,28,3456
6067004702,5050,639,2044,955,46,1145,47,25,4411
6067004801,6041,568,1454,830,20,2808,123,27,5473
6067004802,4958,706,1645,536,37,1564,211,43,4252
6067004904,6468,1254,2557,872,17,1319,109,38,5214
6067004906,3279,333,1019,665,12,883,168,14,2946
6067004907,2523,167,462,1190,8,449,58,17,2356
6067004908,4740,380,1508,666,23,1633,292,23,4360
6067004909,2892,350,1105,673,15,551,63,12,2542
6067004910,4103,430,2018,496,12,834,114,44,3673
6067005002,7436,960,2662,1390,44,1759,175,45,6476
6067005003,5240,770,1516,659,11,1937,108,13,4470
6067005004,3703,384,1164,467,18,1391,134,5,3319
6067005101,4879,771,1723,584,18,1381,102,23,4108
6067005102,4632,1326,1287,460,35,1190,54,21,3306
6067005201,4645,1952,1458,308,56,522,180,0,2693
6067005202,3513,1880,886,158,2,299,22,16,1633
6067005204,4900,2716,1110,282,30,333,25,42,2184
6067005205,3096,1183,871,348,16,380,12,41,1913
6067005301,5508,2275,1189,971,90,318,33,161,3233
6067005402,3272,1449,704,419,18,445,23,19,1823
6067005403,2234,1623,265,29,1,223,3,8,611
6067005404,6080,4021,851,252,27,533,19,42,2059
6067005502,6031,1470,2399,786,35,737,81,36,4561
6067005505,5619,1993,1450,656,32,925,61,11,3626
6067005506,3410,970,1088,529,30,446,26,31,2440
6067005508,3491,1862,663,375,4,313,21,27,1629
6067005509,2008,609,518,519,5,221,3,6,1399
6067005510,5238,1942,1303,953,8,551,62,56,3296
6067005601,6136,2732,961,501,26,1169,27,39,3404
6067005605,3758,1501,951,377,24,491,26,40,2257
6067005606,4461,2516,943,275,16,342,14,46,1945
6067005701,3175,2241,401,78,2,211,4,24,934
6067005702,4887,3755,478,53,7,242,12,28,1132
6067005801,5335,3658,723,212,19,321,22,37,1677
6067005803,3731,2737,369,34,4,350,8,20,994
6067005804,2659,1986,239,35,2,262,0,10,673
6067005901,6722,4470,950,211,35,425,23,22,2252
6067005903,2996,1387,435,323,8,560,7,7,1609
6067005904,5348,3279,795,351,36,333,19,38,2069
6067006002,5309,2772,841,391,31,651,19,36,2537
6067006003,5029,2599,943,473,24,537,43,35,2430
6067006004,2626,1680,373,143,14,183,15,16,946
6067006101,5500,2531,1218,705,33,508,58,8,2969
6067006102,4047,1809,705,363,35,704,29,22,2238
6067006202,4319,1466,1576,575,26,326,30,15,2853
6067006203,3873,1280,795,357,25,930,15,18,2593
6067006204,4137,1559,939,363,32,706,17,40,2578
6067006300,5262,1679,2192,580,52,380,64,38,3583
6067006400,5918,1792,2278,644,53,656,83,31,4126
6067006501,5005,552,1835,1207,13,988,132,28,4453
6067006502,2565,719,887,260,20,449,52,10,1846
6067006600,7103,1752,2747,1046,65,1008,104,31,5351
6067006703,4985,815,2340,652,24,830,105,36,4170
6067006704,3903,865,1445,627,13,656,128,19,3038
6067006705,4982,873,1645,834,17,1150,172,7,4109
6067006706,3943,460,1452,544,17,1107,153,52,3483
6067006801,1990,253,1165,204,10,229,40,0,1737
6067006802,2806,445,1478,545,15,109,9,11,2361
6067006803,3151,490,1726,316,39,423,35,13,2661
6067006901,1774,991,418,135,13,92,0,12,783
6067006902,3608,942,1530,575,32,257,34,34,2666
6067007001,4493,837,2651,329,27,398,77,15,3656
6067007007,5691,1044,3180,585,28,507,28,38,4647
6067007010,4015,1613,869,546,17,606,26,36,2402
6067007011,6494,1566,2138,1271,46,917,78,62,4928
6067007012,3605,1024,1279,658,9,363,22,10,2581
6067007013,3015,620,1257,367,1,497,67,26,2395
6067007016,5971,1341,1204,798,14,2048,140,41,4630
6067007017,2986,964,732,316,16,686,25,23,2022
6067007019,2815,408,557,572,10,1038,30,20,2407
6067007020,4225,1817,986,375,25,636,38,31,2408
6067007021,4795,917,1990,828,16,717,81,26,3878
6067007022,3489,604,1144,726,6,622,72,28,2885
6067007023,5137,1183,2114,806,57,541,67,44,3954
6067007024,2626,657,1016,479,13,201,70,34,1969
6067007025,3695,1104,745,515,30,1001,43,21,2591
6067007026,5697,1761,961,873,14,1616,24,29,3936
6067007027,2145,440,422,444,8,678,24,23,1705
6067007028,5110,1150,971,788,15,1708,111,45,3960
6067007101,218,171,27,3,2,4,1,2,47
6067007103,4058,1016,853,647,14,1194,40,24,3042
6067007105,7408,1997,1514,1032,24,2171,96,60,5411
6067007106,7378,2004,1595,920,19,2166,91,63,5374
6067007107,4076,1185,654,476,17,1350,35,36,2891
6067007108,6138,1213,1073,930,11,2444,57,38,4925
6067007109,3801,1875,476,422,1,779,15,28,1926
6067007110,4272,1252,854,536,6,1154,38,28,3020
6067007111,4327,1331,868,526,10,1205,42,17,2996
6067007202,4282,2238,1240,109,25,359,25,21,2044
6067007204,5509,1875,1706,489,39,1020,77,39,3634
6067007206,4067,2631,834,85,52,189,14,38,1436
6067007207,4330,2853,947,73,20,180,16,13,1477
6067007208,4819,2728,1329,122,33,210,31,14,2091
6067007209,3881,2392,1018,69,23,129,6,21,1489
6067007301,5251,1962,1644,635,51,425,46,55,3289
6067007402,6992,3034,2457,475,60,393,39,38,3958
6067007403,4969,2021,1843,406,33,265,54,21,2948
6067007413,7556,3027,2152,748,55,824,99,78,4529
6067007414,4409,2068,1207,508,14,243,58,27,2341
6067007415,3445,1858,773,347,15,210,13,7,1587
6067007416,4175,2040,1150,397,21,257,16,36,2135
6067007417,3685,1898,703,269,26,487,44,30,1787
6067007422,2849,1408,673,260,8,269,26,11,1441
6067007423,5803,1791,1526,1146,34,667,34,57,4012
6067007424,4087,1589,1225,567,43,317,45,17,2498
6067007426,2444,1004,618,352,16,198,4,6,1440
6067007427,7278,3591,1451,674,55,860,54,46,3687
6067007428,3756,2341,654,210,7,297,40,23,1415
6067007429,5186,2236,1111,788,18,565,74,31,2950
6067007430,8078,4284,1374,735,41,902,69,42,3794
6067007431,3613,1929,570,280,25,556,28,29,1684
6067007432,5236,3002,883,327,38,561,36,33,2234
6067007434,6339,2542,2276,501,30,537,63,32,3797
6067007435,2420,1467,496,184,16,77,14,11,953
6067007436,2251,1169,354,92,12,476,12,10,1082
6067007437,7076,3802,1028,383,34,1219,61,38,3274
6067007438,3455,1784,477,312,10,654,31,15,1671
6067007439,4749,2510,748,339,17,730,42,26,2239
6067007501,7168,4027,1507,631,35,419,41,61,3141
6067007503,5605,2901,993,917,35,266,33,21,2704
6067007504,2256,1385,405,160,9,149,13,23,871
6067007602,5108,3310,761,289,29,348,16,21,1798
6067007603,3167,1938,492,189,21,212,25,32,1229
6067007604,4100,2382,687,324,19,304,39,22,1718
6067007701,7420,4058,1137,518,30,1023,18,47,3362
6067007702,4855,3166,571,170,13,450,46,35,1689
6067007801,5807,3952,747,259,27,388,25,37,1855
6067007802,4951,3401,658,226,20,280,13,32,1550
6067007903,4869,3248,806,155,24,221,18,39,1621
6067007904,5212,3592,819,113,38,205,52,33,1620
6067007905,4484,3184,550,102,35,238,38,35,1300
6067007906,3832,2677,466,139,12,220,15,26,1155
6067008005,4647,3586,464,44,5,255,5,35,1061
6067008006,5869,4342,595,111,24,332,8,44,1527
6067008007,3290,2373,446,131,10,108,4,24,917
6067008008,4939,3558,692,115,22,218,9,39,1381
6067008009,4692,3377,670,94,24,205,3,21,1315
6067008010,5032,3652,576,114,21,288,7,36,1380
6067008111,6467,4420,1155,102,31,286,14,35,2047
6067008113,3852,2332,967,92,26,96,8,30,1520
6067008117,2168,1356,481,60,21,78,9,11,812
6067008119,5857,3844,1107,221,27,191,21,40,2013
6067008120,4839,3134,901,169,28,218,32,15,1705
6067008122,3890,2511,662,120,22,268,8,28,1379
6067008124,4692,3436,649,94,27,147,5,13,1256
6067008125,5405,3895,833,110,38,187,18,23,1510
6067008127,4925,2974,1193,117,45,269,29,41,1951
6067008128,2392,1559,482,71,16,80,2,3,833
6067008129,3519,2027,891,129,21,158,32,12,1492
6067008130,4014,2337,867,222,31,223,37,26,1677
6067008131,5796,3493,1060,489,35,241,23,38,2303
6067008132,3758,2599,516,109,24,234,42,19,1159
6067008133,2794,1696,482,180,14,198,6,8,1098
6067008134,5086,3207,869,289,20,271,32,37,1879
6067008135,4283,2745,737,228,31,208,4,25,1538
6067008136,2848,1970,420,124,8,130,7,15,878
6067008137,2430,1765,359,59,15,93,2,8,665
6067008138,3724,2136,893,165,20,181,38,19,1588
6067008139,3818,2153,887,198,27,219,39,19,1665
6067008140,3095,2114,557,129,22,84,9,25,981
6067008141,7300,4016,1928,501,39,232,43,68,3284
6067008142,3724,2354,760,129,32,195,19,21,1370
6067008143,4379,2789,920,156,24,146,7,30,1590
6067008144,3018,2057,428,85,12,174,2,5,961
6067008145,7520,5424,1049,100,37,250,24,47,2096
6067008203,4923,3849,507,64,33,142,17,37,1074
6067008204,4702,3477,654,48,22,175,13,20,1225
6067008206,5930,4266,921,72,32,218,10,50,1664
6067008207,4529,3472,504,52,17,133,10,46,1057
6067008208,4715,3340,646,143,34,156,15,34,1375
6067008209,4372,3158,528,113,4,275,4,37,1214
6067008210,5660,4273,536,57,17,398,7,39,1387
6067008211,2959,2307,348,11,14,50,1,42,652
6067008402,5447,3655,860,49,20,249,11,29,1792
6067008403,6060,3613,876,128,26,886,21,58,2447
6067008404,3329,2256,506,60,27,180,24,23,1073
6067008501,7064,4422,900,98,5,1138,22,36,2642
6067008504,5367,2949,555,88,10,1377,4,35,2418
6067008505,2200,1306,184,20,3,531,4,9,894
6067008506,2827,1242,301,76,15,988,12,8,1585
6067008507,4109,2263,528,89,9,930,13,23,1846
6067008508,8897,4047,712,129,20,3428,26,37,4850
6067008509,4748,2713,498,42,5,1150,4,41,2035
6067008510,5292,3313,548,65,17,983,11,35,1979
6067008512,5453,2883,522,46,9,1662,3,35,2570
6067008513,3962,1818,377,55,17,1466,4,22,2144
6067008601,5563,4235,584,152,25,197,12,33,1328
6067008602,1729,1131,325,38,10,128,1,7,598
6067008702,2867,2055,173,52,2,402,2,15,812
6067008703,5786,3390,634,198,15,1159,25,26,2396
6067008704,3605,1295,520,280,11,1229,13,12,2310
6067008706,1998,833,305,137,25,498,17,6,1165
6067008707,6648,2584,827,481,16,2071,68,52,4064
6067008708,3173,1300,452,168,9,935,15,12,1873
6067008802,3001,1456,503,224,11,484,29,28,1545
6067008803,1766,842,346,228,8,144,12,32,924
6067008905,4912,2250,1542,318,50,334,48,34,2662
6067008907,5277,2538,1291,472,31,457,81,39,2739
6067008908,5204,2706,1390,282,30,423,35,44,2498
6067008909,2481,1072,450,329,8,354,7,34,1409
6067008910,3768,1907,884,392,24,227,36,34,1861
6067008911,2434,800,768,348,11,256,48,13,1634
6067008912,3130,1957,500,181,13,232,7,38,1173
6067008913,4320,2653,790,242,7,274,28,28,1667
6067009004,4041,1837,947,453,9,446,39,29,2204
6067009005,3511,1541,932,367,27,352,54,30,1970
6067009006,5649,2519,1406,593,27,551,154,26,3130
6067009007,3084,1061,812,508,12,367,47,20,2023
6067009008,5143,2066,1660,504,24,459,55,29,3077
6067009010,6018,2226,1257,721,31,1146,84,60,3792
6067009011,5547,2566,605,276,24,1675,41,34,2981
6067009103,3472,1676,729,413,14,362,21,30,1796
6067009105,2905,1213,775,332,18,311,27,10,1692
6067009106,4247,2285,828,391,8,343,39,39,1962
6067009107,3361,1873,615,281,10,236,27,36,1488
6067009108,3800,1951,785,268,20,473,10,27,1849
6067009109,4875,2428,1140,432,19,429,43,22,2447
6067009110,1873,443,608,462,9,187,10,12,1430
6067009111,5800,2334,1428,697,31,775,70,38,3466
6067009112,3690,1468,898,471,15,492,38,35,2222
6067009201,6781,1934,1160,532,26,2571,114,37,4847
6067009307,5436,2761,1105,321,20,783,71,23,2675
6067009308,6197,2978,1576,309,40,738,57,40,3219
6067009309,2424,1487,468,62,27,200,14,12,937
6067009310,7303,3762,1898,314,37,627,39,46,3541
6067009311,6750,1763,1336,579,19,2482,110,36,4987
6067009312,7749,1490,1539,714,38,3260,230,38,6259
6067009314,6350,1700,1170,536,19,2387,98,41,4650
6067009316,4915,694,1051,578,19,2200,81,28,4221
6067009317,7182,1361,1765,914,43,2473,137,46,5821
6067009318,2497,300,583,257,19,1097,97,16,2197
6067009319,5588,700,1204,543,18,2705,142,41,4888
6067009320,4688,623,1251,624,15,1763,104,44,4065
6067009321,5975,919,1420,780,11,2384,87,33,5056
6067009323,5605,2201,911,542,12,1369,86,26,3404
6067009326,5117,1722,705,376,12,1909,56,28,3395
6067009328,6022,1662,1069,496,17,2209,105,34,4360
6067009329,2471,506,517,326,5,903,10,4,1965
6067009330,4541,1377,741,295,14,1786,37,13,3164
6067009331,7663,2225,1310,617,19,2726,89,59,5438
6067009332,1609,587,245,48,4,581,21,11,1022
6067009333,2374,546,434,230,3,953,59,6,1828
6067009334,5840,1014,999,546,13,2816,137,40,4826
6067009335,6166,544,799,816,10,3365,231,47,5622
6067009336,3850,1954,616,124,28,839,18,37,1896
6067009403,2077,1242,561,23,23,76,5,36,835
6067009404,6603,4097,1398,155,57,368,31,33,2506
6067009406,2443,1517,595,44,19,110,1,11,926
6067009408,1767,855,578,60,10,150,5,16,912
6067009409,4876,2280,1960,78,18,228,24,8,2596
6067009410,5869,2654,2455,107,33,254,24,22,3215
6067009501,2784,1016,1583,22,18,48,4,7,1768
6067009502,7414,3560,3034,121,40,270,10,9,3854
6067009503,3326,1292,1783,54,12,67,6,8,2034
6067009504,2713,1107,1311,77,22,49,4,13,1606
6067009601,6954,626,2103,1152,18,2381,270,21,6328
6067009608,10056,1232,1870,1742,36,4140,285,60,8824
6067009609,5308,569,1393,953,8,1855,181,43,4739
6067009610,6864,838,2170,1168,31,2061,204,56,6026
6067009611,3553,1077,797,466,10,879,29,18,2476
6067009612,5321,1430,1349,653,15,1415,56,19,3891
6067009614,7234,1566,1689,931,26,2275,164,59,5668
6067009616,6117,2574,1508,513,34,1001,36,24,3543
6067009617,3613,1720,625,321,18,651,19,33,1893
6067009618,4834,1166,1184,609,4,1413,90,52,3668
6067009622,7565,2571,1245,861,10,2206,64,74,4994
6067009632,7195,1473,1231,785,13,3012,119,35,5722
6067009633,3573,357,1363,657,11,826,138,28,3216
6067009634,5150,380,1869,1147,14,1235,243,24,4770
6067009635,6077,1470,1118,665,9,2259,48,30,4607
6067009637,6374,1203,963,824,16,2772,137,37,5171
6067009639,3897,663,754,515,3,1542,71,26,3234
6067009640,3124,377,964,893,7,592,109,30,2747
6067009641,4229,657,1204,767,16,1207,122,18,3572
6067009642,1874,494,446,252,5,494,41,12,1380
6067009643,6361,1915,1672,776,9,1436,65,46,4446
6067009644,3328,1147,624,344,7,938,24,26,2181
6067009645,4579,1069,878,510,17,1708,45,20,3510
6067009646,3783,831,578,418,18,1597,36,28,2952
6067009647,6617,1237,1288,887,11,2607,113,41,5380
6067009648,3562,810,643,349,7,1354,66,44,2752
6067009649,5314,1085,904,491,26,2345,67,45,4229
6067009650,3455,487,440,306,2,1937,45,14,2968
6067009651,5683,1519,694,476,10,2580,32,31,4164
6067009652,3810,595,473,390,7,2017,58,18,3215
6067009653,3282,1067,859,577,8,605,42,20,2215
6067009800,2183,1403,528,41,18,53,5,9,780
6067009900,3730,1491,1843,34,24,168,5,17,2239
6067988300,5667,1061,2072,2227,65,101,15,27,4606
6069000100,5421,2256,2822,23,27,100,5,15,3165
6069000200,6729,2877,3183,58,30,234,15,69,3852
6069000300,5553,533,4618,42,17,223,13,25,5020
6069000400,6748,1322,5110,28,22,82,4,49,5426
6069000501,5834,2104,3170,53,15,229,7,41,3730
6069000502,6952,1259,5168,35,23,222,26,32,5693
6069000601,4691,1744,2457,44,23,229,5,19,2947
6069000602,4260,1260,2672,39,23,145,3,18,3000
6069000701,4742,609,3816,21,9,156,17,17,4133
6069000702,6423,1940,3816,79,13,356,14,13,4483
6069000801,3295,1968,1041,22,8,122,5,14,1327
6069000802,3561,1913,1368,35,11,91,13,20,1648
6071000103,4307,873,1024,245,4,1970,5,34,3434
6071000104,6106,1073,1516,248,7,3061,24,30,5033
6071000105,6087,1049,1192,216,12,3365,4,31,5038
6071000107,2806,1123,892,74,4,584,8,20,1683
6071000108,5060,1476,1463,285,3,1589,6,8,3584
6071000109,6483,2604,2253,129,9,1192,8,48,3879
6071000111,2753,937,626,67,9,985,1,3,1816
6071000115,9722,2019,2542,591,7,4078,22,49,7703
6071000117,6736,1517,1269,222,4,3471,11,24,5219
6071000118,4846,862,789,128,1,2907,10,7,3984
6071000119,4687,1072,2289,182,6,973,7,23,3615
6071000120,7649,1349,3646,201,24,2217,2,48,6300
6071000121,8633,2025,2104,390,26,3713,7,43,6608
6071000122,3194,699,708,157,10,1475,10,18,2495
6071000201,5356,848,3498,342,21,484,6,34,4508
6071000203,4189,504,2979,126,10,474,4,18,3685
6071000205,4853,782,3370,221,11,338,9,13,4071
6071000207,4194,362,3324,109,8,311,4,11,3832
6071000208,4145,493,3186,79,3,279,3,24,3652
6071000304,6163,615,3912,239,13,1260,5,23,5548
6071000305,5660,150,4640,233,6,581,8,15,5510
6071000306,3419,224,2463,145,7,526,4,15,3195
6071000307,3198,323,2621,66,7,147,3,5,2875
6071000308,3678,236,3137,50,3,221,0,9,3442
6071000401,6359,1667,3542,124,18,870,5,13,4692
6071000403,4672,1178,2808,67,17,465,7,33,3494
6071000404,5037,1186,2605,250,16,821,2,31,3851
6071000501,6885,1390,4219,177,9,879,11,32,5495
6071000503,5150,912,3063,283,9,726,9,29,4238
6071000504,5414,1435,2906,201,20,684,7,13,3979
6071000603,5068,1028,3259,162,15,481,6,14,4040
6071000604,5667,1077,3869,162,8,408,4,40,4590
6071000605,4829,320,4268,28,3,153,0,16,4509
6071000606,4325,583,3071,142,8,383,8,27,3742
6071000804,3441,2003,858,64,18,331,4,30,1438
6071000808,6173,2230,2952,276,20,457,9,24,3943
6071000812,4069,1810,1580,180,20,269,15,14,2259
6071000813,3481,1792,885,110,4,534,8,17,1689
6071000814,3867,2152,1046,104,8,400,0,14,1715
6071000815,3612,1628,1108,183,5,490,7,29,1984
6071000816,4069,2094,1247,171,11,342,2,11,1975
6071000817,4021,1696,1482,197,16,421,8,17,2325
6071000818,5531,2483,2185,265,1,398,11,18,3048
6071000819,5518,2388,1432,256,13,1155,3,34,3130
6071000820,3979,2204,1124,94,8,381,8,18,1775
6071000821,4929,1203,2285,478,13,727,13,25,3726
6071000823,6839,1632,3653,704,22,540,9,71,5207
6071000824,5305,1399,2921,423,10,322,28,30,3906
6071000825,4311,659,2796,392,18,303,11,32,3652
6071000826,4183,1142,2278,280,13,283,12,17,3041
6071000901,4912,1465,2564,302,13,366,12,33,3447
6071000903,4383,809,2732,353,16,337,2,21,3574
6071000904,3927,766,2500,196,4,326,4,37,3161
6071001001,5069,695,3578,337,12,312,15,14,4374
6071001002,5283,394,4417,192,7,150,19,44,4889
6071001101,4161,371,3344,155,23,155,3,38,3790
6071001103,4113,1127,2660,105,8,97,3,16,2986
6071001104,5338,1159,3696,151,5,183,4,34,4179
6071001200,4728,1388,2981,102,5,109,3,26,3340
6071001305,5287,464,4220,159,21,309,16,23,4823
6071001307,3966,432,3176,68,28,182,17,13,3534
6071001308,4943,380,4066,138,5,242,16,11,4563
6071001309,4572,329,3396,579,12,138,6,38,4243
6071001310,5600,763,4413,155,15,111,27,41,4837
6071001311,3652,619,1595,319,2,981,12,5,3033
6071001312,5865,826,3321,667,16,820,21,39,5039
6071001400,3258,468,2191,296,13,194,11,23,2790
6071001501,3974,213,3597,49,13,53,9,11,3761
6071001503,3751,155,3468,30,5,55,9,10,3596
6071001504,5545,364,3918,517,13,586,13,21,5181
6071001600,5289,309,4753,65,9,64,4,43,4980
6071001702,5774,1359,3588,250,15,382,6,38,4415
6071001703,5478,1367,2990,206,6,740,8,22,4111
6071001704,5086,695,3444,197,17,591,7,17,4391
6071001706,6259,549,4815,381,14,365,4,29,5710
6071001707,5567,609,4084,215,15,518,21,14,4958
6071001803,3240,688,1937,275,9,216,12,21,2552
6071001804,6458,1025,3658,306,14,1248,9,25,5433
6071001806,4528,968,2639,322,6,505,5,21,3560
6071001808,4340,690,3103,224,2,216,8,21,3650
6071001809,4503,552,3526,157,3,145,9,25,3951
6071001810,4561,324,3806,117,7,238,8,17,4237
6071001812,3811,223,3228,121,11,159,9,28,3588
6071001813,4048,125,3716,97,1,79,0,11,3923
6071001901,5493,1441,2733,190,8,943,1,33,4052
6071001906,12054,1946,5544,1184,39,2864,50,59,10108
6071001907,11611,2333,3786,1620,53,3248,12,85,9278
6071001908,5106,694,1641,403,2,2164,27,18,4412
6071001909,2869,496,838,129,5,1248,9,15,2373
6071001910,2231,376,1158,172,6,435,3,23,1855
6071001911,5583,1261,2357,279,8,1463,0,20,4322
6071002011,4058,2312,1078,118,2,360,1,23,1746
6071002013,4120,2024,1432,235,8,204,9,26,2096
6071002014,4770,2601,1510,150,3,286,7,21,2169
6071002015,4749,2138,1875,174,20,314,14,15,2611
6071002016,3787,1603,1664,109,10,193,2,12,2184
6071002017,5686,2975,1466,174,8,798,0,44,2711
6071002018,5240,2342,1674,311,8,596,4,27,2898
6071002019,4816,1663,1626,478,6,804,3,16,3153
6071002021,5252,1999,1541,310,13,1124,6,34,3253
6071002023,5314,1900,2042,614,10,463,14,31,3414
6071002025,5079,2435,1885,193,11,341,1,16,2644
6071002027,5598,2146,2430,301,33,446,4,16,3452
6071002028,5507,1847,2451,474,13,463,19,27,3660
6071002029,5860,2340,2116,286,5,824,17,35,3520
6071002031,6318,2039,1873,437,16,1653,3,31,4279
6071002035,7441,2413,2479,695,16,1409,9,47,5028
6071002037,7729,1505,3523,1035,12,1312,17,57,6224
6071002038,5598,1013,2283,1011,18,1008,22,26,4585
6071002039,5997,1640,2293,820,2,953,9,35,4357
6071002040,5159,1597,2144,489,17,624,7,50,3562
6071002041,5179,1822,1661,378,7,1068,4,29,3357
6071002042,2553,983,771,238,0,435,0,10,1570
6071002043,6295,1783,1422,483,6,2294,15,31,4512
6071002044,4696,1484,1838,291,9,838,7,23,3212
6071002045,2799,1190,1069,140,2,296,4,10,1609
6071002046,6865,1809,2335,709,3,1647,13,62,5056
6071002047,3682,1024,1478,443,10,505,57,29,2658
6071002048,3950,1086,1137,330,3,1208,5,21,2864
6071002049,3207,848,1250,448,9,465,14,32,2359
6071002050,5760,1709,1737,875,18,1093,21,31,4051
6071002051,5149,1411,1758,902,10,742,33,31,3738
6071002101,4379,681,2825,475,18,224,7,38,3698
6071002103,4681,1225,2143,715,19,350,3,44,3456
6071002105,5402,1450,2714,396,12,608,12,45,3952
6071002107,5212,1274,2907,422,10,409,14,33,3938
6071002109,6303,1160,2537,1274,17,948,26,40,5143
6071002111,4066,839,1781,694,4,530,6,27,3227
6071002112,3347,934,1185,618,3,419,19,22,2413
6071002204,6141,494,4885,325,11,295,14,40,5647
6071002206,6654,1324,4037,538,11,518,10,53,5330
6071002207,5918,1173,2933,1125,10,527,13,29,4745
6071002306,3696,365,2522,472,12,245,16,11,3331
6071002307,5004,469,3934,326,16,168,2,28,4535
6071002308,9109,849,5939,806,33,1164,19,65,8260
6071002309,3781,434,2571,279,10,394,9,12,3347
6071002310,5229,894,2624,723,26,744,2,43,4335
6071002311,5102,1112,2332,733,5,708,6,32,3990
6071002312,5638,924,2943,614,11,915,14,52,4714
6071002313,6874,749,4644,601,10,697,6,34,6125
6071002314,6558,1518,2746,843,11,1101,6,82,5040
6071002315,4712,847,2017,765,13,803,11,41,3865
6071002403,5128,300,4601,56,8,71,19,23,4828
6071002404,3412,188,2975,90,6,102,6,14,3224
6071002405,5500,273,4867,191,4,115,4,22,5227
6071002406,2646,113,2261,135,11,78,1,9,2533
6071002501,5613,362,5048,86,2,57,0,22,5251
6071002503,3573,234,3153,81,7,30,28,11,3339
6071002504,4010,191,3554,74,1,120,16,28,3819
6071002602,7248,616,5778,361,12,333,5,42,6632
6071002604,5569,524,4352,338,4,227,12,31,5045
6071002606,7171,549,5050,709,12,610,25,81,6622
6071002608,6008,515,4093,493,31,703,12,33,5493
6071002609,3577,350,2923,95,9,152,6,5,3227
6071002610,3589,208,2433,480,10,320,0,30,3381
6071002611,4380,364,2899,528,4,445,7,21,4016
6071002703,5856,1232,3307,839,7,225,3,58,4624
6071002705,5718,857,3665,849,34,152,4,49,4861
6071002706,14194,3107,7427,2082,29,978,29,72,11087
6071002707,3146,464,1837,553,8,149,27,12,2682
6071002708,6397,1322,2664,916,6,1239,6,36,5075
6071002709,3986,757,2173,402,26,453,17,31,3229
6071002801,5580,367,4381,492,9,222,16,21,5213
6071002803,3974,246,3302,259,9,62,8,24,3728
6071002804,5749,215,4738,565,19,104,11,26,5534
6071002901,4715,364,4022,173,4,86,0,21,4351
6071002902,6514,751,5100,402,13,129,34,17,5763
6071003000,3158,319,2539,178,3,53,4,8,2839
6071003101,4927,393,4194,143,3,86,21,15,4534
6071003102,5844,274,5252,198,14,42,14,20,5570
6071003201,3875,510,3062,144,17,86,0,1,3365
6071003202,4424,561,3545,178,12,34,5,39,3863
6071003301,5578,450,4550,206,15,244,26,43,5128
6071003302,6937,852,5449,364,23,90,7,41,6085
6071003401,7500,798,6197,227,23,130,21,28,6702
6071003403,4320,558,3575,61,17,39,8,25,3762
6071003404,4776,417,3650,419,25,141,16,15,4359
6071003405,5338,415,3870,742,21,118,17,34,4923
6071003503,5641,437,4109,754,13,170,10,21,5204
6071003505,6554,310,4996,879,37,206,16,28,6244
6071003506,5069,368,3653,750,18,115,23,18,4701
6071003507,4787,368,3671,489,14,119,34,32,4419
6071003509,5066,402,4303,234,10,39,5,12,4664
6071003510,4824,247,3665,661,14,75,19,13,4577
6071003603,4259,382,3406,293,15,93,11,12,3877
6071003605,4308,431,3403,284,8,112,20,9,3877
6071003606,5316,449,4492,160,7,97,21,22,4867
6071003607,6230,489,4964,488,21,141,5,26,5741
6071003609,5163,472,4188,272,12,113,11,37,4691
6071003611,4827,224,3786,489,1,225,18,29,4603
6071003612,4574,468,3416,344,6,242,6,28,4106
6071003700,4018,260,3131,509,11,44,6,15,3758
6071003801,5120,417,3683,750,4,108,31,29,4703
6071003803,5020,385,4107,337,5,53,32,27,4635
6071003804,4957,334,3564,800,5,132,34,10,4623
6071003900,5514,379,4882,140,3,38,0,31,5135
6071004001,4431,326,3984,54,6,33,4,5,4105
6071004003,6176,432,5544,79,22,53,4,2,5744
6071004004,5785,797,4522,186,15,126,9,20,4988
6071004101,5736,386,4879,274,7,83,9,13,5350
6071004103,5907,267,5017,334,12,203,14,14,5640
6071004104,5183,360,4539,150,12,27,5,43,4823
6071004201,7125,185,5202,1270,17,256,50,24,6940
6071004202,5515,179,4328,760,20,102,31,27,5336
6071004301,4542,166,3629,547,13,91,15,13,4376
6071004302,4348,275,3510,383,13,62,16,30,4073
6071004401,4406,341,3667,233,5,104,2,8,4065
6071004403,5736,330,4869,307,11,101,29,34,5406
6071004404,6047,417,5088,331,19,82,14,34,5630
6071004503,3829,1546,1628,318,8,147,7,31,2283
6071004505,5456,1072,3326,738,37,93,10,21,4384
6071004507,5543,844,3747,682,23,100,11,21,4699
6071004509,5210,1188,3110,526,25,161,18,61,4022
6071004510,5337,1029,2535,1018,3,547,1,44,4308
6071004511,3863,852,2144,558,7,156,2,35,3011
6071004512,5075,1237,2505,628,17,449,19,24,3838
6071004601,7431,1298,4420,1096,15,285,28,49,6133
6071004603,6454,1252,3577,1027,31,268,8,50,5202
6071004604,5709,736,4345,413,18,43,3,33,4973
6071004700,6090,193,5493,290,10,48,0,8,5897
6071004800,3486,113,3114,183,15,26,1,7,3373
6071004901,4270,147,3791,228,5,27,8,21,4123
6071004902,3299,144,2957,111,13,37,7,11,3155
6071005101,4601,1266,2684,349,18,102,16,29,3335
6071005102,4189,687,2632,630,15,35,18,33,3502
6071005200,4521,868,3040,337,21,89,26,21,3653
6071005300,6064,680,4542,573,30,82,10,21,5384
6071005400,6981,732,4999,879,18,164,14,44,6249
6071005501,2865,174,2211,365,15,25,7,6,2691
6071005502,6482,454,4632,1098,25,120,28,15,6028
6071005601,4060,331,3040,505,12,71,11,30,3729
6071005602,3354,176,2779,320,5,41,0,13,3178
6071005701,2150,298,1333,211,2,252,4,15,1852
6071005800,4039,288,2742,595,16,276,19,12,3751
6071006101,4867,936,3127,505,26,87,21,23,3931
6071006102,4752,1011,2907,442,14,145,15,42,3741
6071006201,4109,631,2958,318,15,61,25,19,3478
6071006203,5500,625,3374,1172,29,91,17,31,4875
6071006204,4506,549,2811,887,21,79,14,22,3957
6071006301,5370,814,3800,532,22,96,17,19,4556
6071006303,4983,439,3879,410,15,125,2,28,4544
6071006304,4743,517,3596,312,25,181,17,8,4226
6071006401,3090,206,2562,197,0,74,0,10,2884
6071006402,5286,401,3763,680,17,285,8,16,4885
6071006501,3727,370,2368,720,11,184,12,10,3357
6071006502,3628,276,2862,270,5,138,0,16,3352
6071006601,4537,438,3959,54,23,8,3,9,4099
6071006603,5125,410,4343,177,27,108,6,7,4715
6071006604,4099,192,3452,311,5,89,4,17,3907
6071006700,4484,241,4067,63,7,50,0,3,4243
6071007001,3596,170,3285,67,2,29,0,13,3426
6071007002,4952,302,4243,265,9,51,13,11,4650
6071007104,4030,1568,1738,171,17,334,15,45,2462
6071007105,3259,933,1345,408,8,402,8,15,2326
6071007106,4254,1409,2073,314,13,214,15,37,2845
6071007107,3416,580,1991,621,11,62,15,36,2836
6071007108,2309,389,1165,473,7,133,4,32,1920
6071007110,4917,875,2364,338,11,1111,19,31,4042
6071007111,3640,1194,1729,312,14,235,6,40,2446
6071007112,3345,484,1620,820,14,224,22,27,2861
6071007201,3671,593,1628,244,2,1071,8,8,3078
6071007202,3027,273,2052,97,17,513,16,7,2754
6071007303,4969,1127,1844,622,18,1061,27,37,3842
6071007305,4915,959,2026,552,13,1105,21,21,3956
6071007306,6044,1664,1744,609,26,1668,19,36,4380
6071007307,5162,1598,992,266,12,1949,7,47,3564
6071007308,5074,2112,1017,412,11,1224,11,34,2962
6071007404,4638,1712,2010,405,17,255,39,19,2926
6071007407,3119,274,1961,590,7,111,63,15,2845
6071007408,4432,463,2901,735,17,134,22,39,3969
6071007409,6278,1243,3987,476,26,310,15,27,5035
6071007410,6091,1463,2936,1010,9,415,17,24,4628
6071007411,1729,501,943,157,6,56,8,7,1228
6071007412,6645,1380,3615,1029,30,275,42,91,5265
6071007603,5059,713,3171,645,24,324,9,17,4346
6071007604,4844,1052,2744,397,18,463,19,11,3792
6071007605,4233,281,3109,489,12,229,8,9,3952
6071007606,3556,276,2704,372,5,125,0,14,3280
6071007800,6632,2364,2144,546,23,1197,22,34,4268
6071007903,4931,1894,1722,335,13,687,12,27,3037
6071007904,7061,2949,2561,413,18,758,12,27,4112
6071007905,3600,1639,1139,221,20,378,18,13,1961
6071007906,4343,1799,1239,357,10,694,5,34,2544
6071008001,7038,1504,3816,268,39,1081,33,35,5534
6071008003,4222,546,2704,489,14,236,32,18,3676
6071008004,3250,431,2357,216,9,134,6,22,2819
6071008100,3326,1253,1295,338,15,244,2,22,2073
6071008201,3323,1806,991,112,12,191,2,23,1517
6071008202,2576,1968,373,35,4,79,0,4,608
6071008301,6616,3668,1559,215,23,749,12,39,2948
6071008302,3268,2209,548,65,9,243,8,11,1059
6071008402,6501,3349,2220,220,8,337,17,36,3152
6071008403,5791,3436,1402,157,7,502,11,25,2355
6071008404,2931,834,1511,292,15,141,1,5,2097
6071008405,5752,2463,2178,231,27,510,21,43,3289
6071008406,5254,2006,1888,300,20,777,8,35,3248
6071008501,3945,2720,570,66,12,346,6,5,1225
6071008502,4782,3067,768,68,14,546,6,34,1715
6071008601,6404,2561,2763,316,31,341,29,16,3843
6071008602,3641,1937,1298,86,8,135,6,11,1704
6071008705,4669,2242,2077,43,25,73,10,14,2427
6071008708,4415,2705,1372,59,34,38,1,21,1710
6071008709,4627,2413,1852,62,23,63,7,24,2214
6071008710,4700,2111,2243,68,21,71,7,24,2589
6071008711,3720,2643,704,36,13,101,6,5,1077
6071008712,4102,2951,804,25,34,94,4,21,1151
6071008713,4224,2330,1372,85,17,158,13,38,1894
6071008714,4314,2223,1741,57,24,77,9,35,2091
6071008715,7091,4143,1973,114,24,484,11,35,2948
6071008716,6650,3738,2172,108,12,285,7,45,2912
6071008800,6520,3461,2518,92,37,114,6,44,3059
6071008901,1890,1213,420,87,25,16,1,12,677
6071009109,5922,3243,1959,64,58,307,24,31,2679
6071009119,5761,2678,2438,134,32,192,7,39,3083
6071009120,4433,2489,1549,22,24,172,3,41,1944
6071009121,2825,1912,588,13,15,167,0,20,913
6071009122,3823,1686,1717,76,27,136,4,22,2137
6071009123,2760,1279,1219,39,14,103,12,11,1481
6071009124,5135,563,3504,777,10,92,22,20,4572
6071009125,6019,648,3926,952,18,169,55,51,5371
6071009126,6912,1229,3853,1090,31,344,28,58,5683
6071009127,8155,963,4530,1835,15,381,49,58,7192
6071009128,5552,740,2957,1135,13,377,56,42,4812
6071009129,6763,664,4560,1161,11,128,47,37,6099
6071009130,5075,473,3368,867,15,114,55,42,4602
6071009131,4882,620,2465,1463,11,50,26,33,4262
6071009132,2606,326,1529,622,5,21,0,31,2280
6071009133,8582,1319,5351,1226,15,407,29,68,7263
6071009134,862,299,466,22,8,30,7,1,563
6071009135,5560,1106,3120,766,31,227,31,35,4454
6071009136,5789,869,3273,1190,24,156,36,51,4920
6071009137,4269,891,2353,621,19,187,14,21,3378
6071009138,5260,875,3084,824,15,198,33,41,4385
6071009139,5833,791,3412,963,12,396,17,34,5042
6071009201,4761,3513,846,22,27,89,1,39,1248
6071009202,1856,1128,445,47,9,156,1,18,728
6071009300,1193,523,525,61,22,8,4,5,670
6071009400,3939,843,1492,1242,54,42,31,20,3096
6071009501,4121,1093,1970,675,48,94,25,20,3028
6071009502,3820,922,1608,956,26,62,22,25,2898
6071009708,5106,3126,1407,138,23,110,5,20,1980
6071009709,6492,2735,3024,333,27,97,13,32,3757
6071009712,6400,2397,3046,485,22,111,30,25,4003
6071009713,7303,3273,3037,388,44,132,19,48,4030
6071009714,4269,1845,1751,329,24,116,26,13,2424
6071009717,4473,2322,1452,271,22,139,17,22,2151
6071009718,4066,2903,460,365,12,217,1,18,1163
6071009719,3276,1696,1080,133,19,197,10,8,1580
6071009720,1743,640,884,100,21,34,3,6,1103
6071009721,5911,1877,2931,630,23,146,23,10,4034
6071009722,3413,1517,1284,284,11,107,11,15,1896
6071009723,5853,2979,1976,290,42,167,5,66,2874
6071009724,4298,2161,1362,294,19,188,11,50,2137
6071009725,5666,2695,1878,488,12,311,16,27,2971
6071009726,3474,1567,1378,228,13,94,9,25,1907
6071009727,4599,1240,2033,960,21,66,10,23,3359
6071009800,5051,821,3229,684,29,68,23,29,4230
6071009906,5401,1041,3186,669,15,241,15,46,4360
6071009908,5270,1172,2948,661,8,194,11,45,4098
6071009910,5249,1088,3195,551,13,170,7,36,4161
6071009911,7099,1439,4237,835,20,268,31,56,5660
6071009912,5695,1290,2967,1008,38,101,45,48,4405
6071009913,6582,1315,3855,931,50,104,21,65,5267
6071009914,3348,561,1490,971,18,106,4,29,2787
6071009915,2930,419,1791,448,10,113,26,28,2511
6071009916,6303,1013,3696,965,12,262,72,17,5290
6071009917,6607,895,3561,1624,23,166,46,34,5712
6071009918,3766,442,2200,860,10,83,9,30,3324
6071010009,4386,1344,2283,326,28,193,4,56,3042
6071010010,7129,1510,4815,403,29,145,20,29,5619
6071010011,5377,1108,3534,412,23,88,11,33,4269
6071010012,5228,1749,2927,188,16,95,27,48,3479
6071010014,5020,880,3627,298,9,58,11,36,4140
6071010015,5940,1629,3749,248,24,109,7,36,4311
6071010016,6228,1373,4003,395,21,194,17,56,4855
6071010019,5664,1683,3469,172,21,82,11,26,3981
6071010021,7189,3088,3433,217,44,92,5,36,4101
6071010022,4542,1957,2156,155,13,59,18,19,2585
6071010023,6399,2318,3575,115,42,80,3,34,4081
6071010024,5711,2686,2546,144,26,95,7,26,3025
6071010027,3966,2089,1064,280,12,287,17,26,1877
6071010028,4453,1304,2813,109,24,63,10,14,3149
6071010029,4295,1442,2515,121,22,47,8,11,2853
6071010030,3070,955,1837,79,5,90,5,16,2115
6071010031,5099,1131,3066,389,17,341,8,25,3968
6071010032,6546,1902,3629,608,26,100,16,40,4644
6071010033,2002,649,955,295,3,30,5,4,1353
6071010034,4861,2614,1766,123,41,103,2,27,2247
6071010035,3577,758,2272,267,14,118,21,17,2819
6071010036,4709,1165,2145,905,33,236,15,24,3544
6071010037,7242,1786,3430,1354,14,304,34,37,5456
6071010038,4736,1090,2458,619,22,301,35,28,3646
6071010039,2488,1311,783,135,0,153,6,13,1177
6071010040,3287,1935,815,166,8,212,1,25,1352
6071010041,6221,1566,3608,438,45,253,9,49,4655
6071010042,5246,1070,3238,485,14,220,10,34,4176
6071010300,2973,1604,986,61,35,144,20,11,1369
6071010402,12280,5926,3142,1467,155,916,40,85,6354
6071010410,3085,2199,615,27,14,59,5,6,886
6071010413,6324,4100,1524,194,60,108,32,21,2224
6071010415,5540,2797,1263,555,44,278,101,35,2743
6071010417,3257,2252,691,45,18,58,5,13,1005
6071010419,4112,2769,784,158,38,81,10,21,1343
6071010420,3813,2564,798,82,32,72,5,20,1249
6071010422,1716,917,324,192,18,86,46,9,799
6071010424,1739,1263,306,12,17,29,0,13,476
6071010425,826,579,120,20,8,32,3,6,247
6071010426,2020,1183,405,105,9,84,25,21,837
6071010427,2805,1752,676,93,25,71,10,12,1053
6071010428,4232,2757,939,168,28,100,13,22,1475
6071010429,4245,2607,1049,166,30,123,9,16,1638
6071010430,3915,2592,860,95,26,143,0,23,1323
6071010431,1307,921,212,24,0,62,4,11,386
6071010432,1759,1114,351,87,11,53,16,14,645
6071010433,4354,1951,1238,511,37,177,86,52,2403
6071010434,1443,737,341,138,15,73,29,6,706
6071010435,2207,1555,454,19,13,54,1,15,652
6071010436,1062,721,199,14,11,34,0,9,341
6071010700,3731,2211,985,98,187,37,2,26,1520
6071010803,3669,2474,810,48,26,62,5,43,1195
6071010804,3180,2082,808,33,24,44,2,16,1098
6071010805,2634,1487,801,108,9,92,6,14,1147
6071010806,3149,2090,805,56,15,30,3,16,1059
6071010903,2737,2053,495,16,6,27,1,17,684
6071010904,2664,1767,672,34,10,53,4,17,897
6071010905,2288,1727,388,16,6,50,8,19,561
6071010906,1158,742,334,23,6,12,0,7,416
6071011002,1746,926,601,59,46,39,0,11,820
6071011003,1439,946,380,12,5,19,3,9,493
6071011004,1118,588,470,5,9,7,3,4,530
6071011101,3943,2787,754,40,24,80,9,39,1156
6071011102,2315,1634,460,28,14,41,8,10,681
6071011203,1325,979,236,18,4,16,4,20,346
6071011204,1241,924,206,13,3,26,0,6,317
6071011205,1355,673,567,6,9,28,2,7,682
6071011206,1065,787,182,8,5,31,0,5,278
6071011300,1522,1131,255,15,2,28,0,5,391
6071011404,3902,2771,759,36,36,33,12,32,1131
6071011405,1686,1153,402,7,7,20,4,16,533
6071011406,2578,1522,850,22,19,30,9,7,1056
6071011407,1946,1421,370,9,14,19,3,20,525
6071011408,1839,1298,350,15,7,27,0,18,541
6071011500,2109,1490,422,49,9,25,1,19,619
6071011601,6320,3498,1694,411,27,294,20,45,2822
6071011602,1575,886,488,51,19,18,9,4,689
6071011700,1432,526,770,32,13,22,0,3,906
6071011801,4049,1588,1789,250,54,106,25,17,2461
6071011802,3277,1113,1583,264,18,44,24,19,2164
6071011900,2603,1215,1054,105,17,48,15,26,1388
6071012001,6351,1652,2906,897,69,307,145,49,4699
6071012002,5882,1641,2762,798,90,168,84,28,4241
6071012101,5985,2794,1813,616,24,344,15,41,3191
6071012103,3390,1980,1010,75,33,78,1,32,1410
6071012105,2955,1801,793,92,27,74,5,41,1154
6071012106,2107,964,849,62,28,70,9,11,1143
6071012201,9002,1378,2600,609,22,4061,15,51,7624
6071012202,2898,977,1178,617,48,21,5,5,1921
6071012300,1481,457,515,418,2,75,4,7,1024
6071012400,3140,278,2523,140,19,112,18,18,2862
6071012500,4329,241,3760,182,30,44,0,23,4088
6071012700,4000,853,2272,338,10,342,5,28,3147
6071025000,8111,3562,2143,1067,91,508,145,55,4549
6071025100,2038,1040,404,22,451,28,15,9,998
6071940100,1213,902,178,9,63,10,1,1,311
6071980100,4,1,3,0,0,0,0,0,3
6071980200,3953,754,2041,877,195,84,0,0,3199
6073000100,2908,2290,280,28,4,129,1,11,618
6073000201,2001,1500,262,25,2,105,6,3,501
6073000202,4441,3063,746,75,7,266,6,42,1378
6073000301,2155,1473,350,49,12,153,0,7,682
6073000302,2811,1853,495,91,9,176,9,20,958
6073000400,3794,2221,728,171,8,395,10,30,1573
6073000500,3012,1932,565,60,9,197,5,27,1080
6073000600,3182,1979,590,105,4,239,8,21,1203
6073000700,4072,2640,735,127,11,282,6,32,1432
6073000800,4890,2661,1218,449,8,263,16,38,2229
6073000901,3184,1506,1008,243,8,221,12,18,1678
6073000902,2479,1317,639,124,4,211,3,15,1162
6073001000,4690,2589,1226,213,20,278,17,32,2101
6073001100,3000,1661,746,159,11,183,10,32,1339
6073001201,2235,974,758,195,0,144,18,18,1261
6073001202,3216,1491,943,307,15,226,13,28,1725
6073001301,2696,1347,743,175,6,238,6,18,1349
6073001302,3331,1621,986,238,6,246,4,22,1710
6073001400,3205,2039,661,76,6,185,10,6,1166
6073001500,3827,2197,989,158,11,231,3,9,1630
6073001600,5244,1567,2576,443,18,364,10,32,3677
6073001700,4521,1995,1624,294,20,280,3,32,2526
6073001801,2003,792,831,150,6,103,0,15,1211
6073001802,3061,1357,1110,249,7,162,9,21,1704
6073001900,3036,2028,582,58,8,142,7,16,1008
6073002001,3459,2669,405,48,6,143,0,21,790
6073002002,2671,1702,530,130,4,122,14,14,969
6073002100,5235,2152,1957,386,11,394,11,42,3083
6073002201,3593,442,2019,619,8,384,10,14,3151
6073002202,4928,425,2714,553,6,1109,5,19,4503
6073002301,2976,522,1271,352,12,670,6,15,2454
6073002302,6215,444,3383,658,8,1577,9,24,5771
6073002401,4061,976,2272,301,8,318,8,26,3085
6073002402,4735,331,3047,546,9,658,4,25,4404
6073002501,5172,653,3256,366,5,721,10,11,4519
6073002502,5929,1434,2886,611,22,651,21,43,4495
6073002601,5326,505,3288,217,14,1143,11,26,4821
6073002602,4117,443,2502,418,13,621,6,26,3674
6073002702,5695,1655,1922,1104,18,654,28,38,4040
6073002703,7181,1492,3176,866,29,1261,28,41,5689
6073002705,4373,623,1126,687,12,1776,11,22,3750
6073002707,4687,347,2486,742,6,978,14,18,4340
6073002708,5570,532,2756,980,1,1142,11,11,5038
6073002709,3487,403,1837,544,11,550,18,9,3084
6073002710,3943,314,1428,847,6,1186,13,3,3629
6073002711,3170,613,1018,590,4,720,37,13,2557
6073002712,4952,698,1936,1196,10,898,10,30,4254
6073002801,5347,2886,1161,202,37,610,9,14,2461
6073002803,5495,2163,1589,538,9,893,25,23,3332
6073002804,4864,2798,1035,194,18,451,17,34,2066
6073002902,6540,3061,1744,594,18,618,19,38,3479
6073002903,3826,1320,1263,399,13,556,23,32,2506
6073002904,8957,4305,1977,899,50,1048,15,83,4652
6073002905,4335,1620,1333,514,14,473,16,38,2715
6073003001,4567,522,2270,1227,8,357,25,33,4045
6073003003,5233,1123,2486,851,19,389,42,68,4110
6073003004,4974,402,3472,624,19,200,44,26,4572
6073003101,3919,259,2108,1118,13,226,41,28,3660
6073003103,6242,463,3014,1582,16,890,58,9,5779
6073003105,4261,426,2891,371,10,369,57,11,3835
6073003107,5870,771,2491,873,11,1392,69,16,5099
6073003108,3454,645,2013,262,13,331,36,25,2809
6073003109,3037,169,371,148,0,2188,24,10,2868
6073003111,6139,250,3551,901,1,1194,40,31,5889
6073003112,4754,330,2179,926,8,1117,39,12,4424
6073003113,5045,306,1207,677,19,2561,38,21,4739
6073003114,3133,155,588,392,8,1831,36,5,2978
6073003115,6554,765,2305,667,13,2488,58,21,5789
6073003201,5077,1040,1647,745,26,1194,67,18,4037
6073003202,4755,592,3268,212,13,497,26,16,4163
6073003204,3725,828,2128,139,6,453,18,22,2897
6073003207,6024,1666,2987,300,28,720,30,28,4358
6073003208,6944,557,2615,997,3,2357,47,25,6387
6073003209,5397,445,1858,739,8,2039,54,10,4952
6073003211,3144,436,1662,179,20,668,44,17,2708
6073003212,4231,508,1960,318,14,1165,58,9,3723
6073003213,3965,287,876,351,10,2217,51,7,3678
6073003214,4764,663,1731,858,13,1196,38,20,4101
6073003301,3394,144,2433,621,4,108,10,8,3250
6073003303,4330,203,3166,424,4,396,8,31,4127
6073003304,3601,188,2287,480,6,527,16,14,3413
6073003305,5823,201,3614,1270,7,493,94,22,5622
6073003401,6259,1135,2474,1359,30,951,16,38,5124
6073003403,4054,230,3034,356,5,315,20,12,3824
6073003404,4481,168,2846,721,12,592,55,15,4313
6073003501,3994,194,3340,303,10,61,6,11,3800
6073003502,4599,200,3838,416,3,63,2,30,4399
6073003601,2951,99,2573,153,1,68,10,10,2852
6073003602,3056,113,2582,185,0,126,5,14,2943
6073003603,4092,216,3510,149,7,144,8,17,3876
6073003800,7014,2957,1568,1496,49,560,49,44,4057
6073003901,3892,165,3391,246,6,40,3,13,3727
6073003902,4673,237,3947,272,20,74,9,19,4436
6073004000,4521,257,3897,241,2,69,2,9,4264
6073004101,3986,1364,1991,216,6,181,12,21,2622
6073004102,1899,530,1101,97,8,75,1,2,1369
6073004200,5818,3569,1465,143,14,251,11,37,2249
6073004300,3660,2334,804,100,9,133,11,31,1326
6073004400,3750,2266,1008,90,11,141,9,22,1484
6073004501,2612,1093,1184,82,6,123,3,15,1519
6073004600,1912,958,630,101,7,81,11,20,954
6073004700,1493,380,965,62,4,33,2,5,1113
6073004800,3384,403,2700,152,0,48,7,17,2981
6073004900,4978,308,4272,264,5,52,1,20,4670
6073005000,2312,218,1916,95,16,22,3,12,2094
6073005101,3199,1318,1041,375,27,212,15,35,1881
6073005102,4428,2559,833,319,20,371,12,46,1869
6073005103,4242,1602,1786,393,74,114,19,53,2640
6073005201,3562,1728,895,383,16,288,5,30,1834
6073005202,4270,2096,985,483,16,367,23,41,2174
6073005301,2975,1566,594,298,22,297,12,11,1409
6073005302,4328,2107,1365,381,18,335,5,16,2221
6073005401,1723,1137,245,58,8,150,2,12,586
6073005402,4126,2802,572,120,4,436,2,26,1324
6073005403,3705,2304,631,267,52,205,12,36,1401
6073005500,390,187,98,71,4,21,2,0,203
6073005601,2728,1414,625,220,10,311,7,24,1314
6073005602,2365,1332,512,120,9,215,4,24,1033
6073005700,1416,764,328,141,8,100,6,11,652
6073005801,1959,1238,290,79,10,202,6,16,721
6073005802,2535,1715,418,54,4,185,5,11,820
6073005900,2959,1940,621,85,6,138,5,30,1019
6073006000,4381,3066,676,107,18,255,9,47,1315
6073006100,2274,1466,483,45,12,141,2,9,808
6073006200,109,83,19,1,0,0,0,0,26
6073006300,2183,1022,860,85,26,96,9,4,1161
6073006500,3338,1768,903,261,22,189,9,34,1570
6073006600,1845,638,481,408,6,108,24,14,1207
6073006801,2739,1568,516,160,7,169,17,42,1171
6073006802,5704,3078,1346,261,25,330,19,87,2626
6073006900,5427,4030,724,60,16,188,7,72,1397
6073007002,3155,2551,321,19,9,77,4,22,604
6073007100,4646,3803,457,24,8,108,2,42,843
6073007200,5589,4267,731,45,7,228,2,31,1322
6073007302,2193,1814,194,7,0,45,5,2,379
6073007303,1744,1352,221,16,1,43,3,8,392
6073007304,3303,2468,447,37,9,96,7,28,835
6073007401,3197,2109,559,63,19,91,7,43,1088
6073007402,3631,2658,515,33,16,93,6,36,973
6073007501,3993,2873,592,51,7,108,15,53,1120
6073007502,3150,2275,483,48,11,81,8,34,875
6073007601,2419,1729,396,67,14,61,4,26,690
6073007602,1876,1467,189,40,6,51,0,18,409
6073007701,3682,2789,431,44,6,110,1,48,893
6073007702,3837,2897,432,41,7,173,14,36,940
6073007800,5764,3444,1350,165,21,249,21,74,2320
6073007905,2508,1874,320,25,3,107,9,30,634
6073007907,3039,2181,440,41,12,103,7,34,858
6073007908,2874,1958,497,55,8,145,9,38,916
6073007910,2740,2010,360,46,10,94,8,35,730
6073007911,2571,1846,355,32,5,130,7,25,725
6073007912,1932,1413,255,25,8,79,6,11,519
6073008002,2598,2022,280,14,1,84,0,27,576
6073008003,3288,2540,368,20,5,116,4,16,748
6073008006,3885,3049,403,29,4,142,2,29,836
6073008101,3859,3016,359,22,4,179,4,31,843
6073008102,3424,2735,306,19,6,125,3,24,689
6073008201,1845,1367,207,16,0,151,2,15,478
6073008202,1524,1245,108,6,16,109,9,1,279
6073008301,3371,2643,318,16,3,197,3,16,728
6073008303,3531,2591,384,24,4,319,4,21,940
6073008305,14126,6420,2519,634,7,3896,8,13,7706
6073008306,3163,2262,333,16,10,308,5,19,901
6073008307,3887,2607,408,42,8,505,7,40,1280
6073008310,5731,3968,732,27,5,606,5,40,1763
6073008311,2849,2184,283,10,1,168,2,7,665
6073008312,3787,2753,413,29,5,338,2,35,1034
6073008313,2245,1511,230,21,6,326,0,18,734
6073008324,6745,5119,494,43,8,634,2,51,1626
6073008327,6247,3868,511,49,7,1427,2,44,2379
6073008328,8213,3609,542,57,1,3504,9,44,4604
6073008330,5524,2987,415,16,0,1737,0,56,2537
6073008331,2568,1569,232,20,0,521,2,17,999
6073008336,2191,1186,225,27,1,615,1,3,1005
6073008337,4358,2021,434,49,4,1479,14,25,2337
6073008339,1886,751,281,35,0,658,2,12,1135
6073008343,4322,1763,675,99,7,1486,9,32,2559
6073008344,3609,2321,429,58,1,547,8,10,1288
6073008345,3609,2484,405,60,6,425,2,14,1125
6073008346,4831,1842,432,74,4,2095,1,31,2989
6073008347,6598,1848,831,125,3,3307,32,47,4750
6073008348,5178,1236,554,143,7,2893,37,12,3942
6073008349,3526,922,476,126,0,1711,20,9,2604
6073008350,6228,1407,655,136,7,3553,27,26,4821
6073008351,4393,995,647,122,14,2329,15,19,3398
6073008352,3544,844,557,94,8,1764,25,37,2700
6073008353,4941,1529,630,162,10,2160,29,32,3412
6073008355,3366,661,431,126,6,1905,10,10,2705
6073008356,3697,892,438,95,8,2025,12,26,2805
6073008357,4500,761,538,120,1,2816,26,14,3739
6073008358,6856,1527,1133,214,16,3488,44,39,5329
6073008359,4121,844,1035,228,11,1739,14,15,3277
6073008360,6159,1292,1135,316,13,2980,33,15,4867
6073008361,2616,1339,300,35,1,790,1,15,1277
6073008362,3334,1963,404,34,1,685,6,29,1371
6073008363,5025,1448,682,83,9,2572,5,27,3577
6073008364,5132,2220,700,63,1,1777,10,22,2912
6073008365,2881,1254,218,30,0,1192,8,9,1627
6073008366,7113,2840,604,84,18,3108,27,20,4273
6073008367,3491,1405,474,75,1,1273,5,21,2086
6073008368,6580,2659,423,81,3,2955,12,39,3921
6073008369,3151,1583,434,57,5,886,1,28,1568
6073008370,4080,2302,335,36,10,1112,2,21,1778
6073008371,4434,2287,463,88,2,1297,6,20,2147
6073008372,4260,2164,412,21,6,1338,1,21,2096
6073008373,3317,1703,276,41,0,1040,2,23,1614
6073008374,4298,1802,330,15,7,1820,7,24,2496
6073008375,4318,1792,518,77,3,1686,8,26,2526
6073008376,5686,2395,735,96,2,2115,3,51,3291
6073008377,2608,1098,277,32,3,1054,7,16,1510
6073008378,1024,361,92,16,0,509,0,2,663
6073008379,4287,1544,334,86,0,2109,5,29,2743
6073008380,7165,2004,1064,433,9,3095,27,50,5161
6073008381,2722,751,349,89,0,1323,8,9,1971
6073008501,5271,3460,1065,63,11,269,11,43,1811
6073008502,6218,3419,1685,84,14,598,7,46,2799
6073008503,6869,4263,1517,74,14,497,21,41,2606
6073008504,6150,3648,1473,61,16,474,21,43,2502
6073008505,5657,2779,1462,113,13,837,34,29,2878
6073008506,3981,1986,1007,66,5,635,16,21,1995
6073008507,7520,3429,1997,266,7,1259,43,64,4091
6073008509,6949,3435,1311,538,24,1114,17,54,3514
6073008510,6912,2940,1701,330,22,1419,41,40,3972
6073008511,5480,2032,1162,277,19,1556,15,53,3448
6073008512,4386,2951,700,80,12,316,14,27,1435
6073008513,2798,1873,413,33,8,243,4,10,925
6073008600,6535,1282,3248,299,23,1421,27,24,5253
6073008701,3353,1479,708,231,17,585,26,28,1874
6073008702,4750,1900,1362,402,35,682,25,31,2850
6073008800,6128,1122,1883,348,10,2487,18,31,5006
6073008901,5036,2331,1428,220,14,713,12,41,2705
6073008902,2601,1465,553,124,2,255,9,29,1136
6073009000,3746,1185,1669,190,0,537,11,22,2561
6073009101,5652,3826,954,82,13,328,11,50,1826
6073009102,3529,1799,920,126,10,352,14,27,1730
6073009103,3850,2746,559,53,3,204,4,16,1104
6073009104,2886,2160,402,28,4,113,5,25,726
6073009107,5739,2985,1209,266,9,825,25,48,2754
6073009108,1943,1248,405,22,11,111,0,22,695
6073009109,4033,1918,759,171,2,1114,0,2,2115
6073009201,6165,2297,1429,898,32,822,71,39,3868
6073009203,4141,2183,715,201,8,701,17,20,1958
6073009204,3362,1748,631,149,8,530,26,20,1614
6073009301,4337,1851,1061,281,24,707,33,39,2486
6073009305,4948,2619,947,295,8,666,30,31,2329
6073009306,6125,2868,1322,358,20,999,29,48,3257
6073009307,4863,2300,1070,401,17,697,26,26,2563
6073009308,4319,2032,991,370,14,590,18,35,2287
6073009400,8035,3908,2353,740,55,676,100,34,4127
6073009502,3801,2134,656,172,13,485,13,22,1667
6073009504,7198,4240,692,153,4,1570,8,33,2958
6073009505,6559,3862,865,177,18,1066,26,50,2697
6073009506,4385,2565,696,176,11,499,16,79,1820
6073009507,3550,1963,613,179,3,413,13,98,1587
6073009509,5314,2753,1064,468,27,569,29,48,2561
6073009510,4813,2572,1225,354,22,162,35,33,2241
6073009511,3852,1934,837,453,24,147,41,15,1918
6073009602,3946,2434,787,96,9,316,27,16,1512
6073009603,6293,2538,1691,648,18,852,43,63,3755
6073009604,3553,1941,784,220,24,306,9,17,1612
6073009703,3590,2365,694,81,13,173,15,8,1225
6073009704,6152,3896,990,292,11,449,32,41,2256
6073009705,3847,2421,679,184,8,238,17,18,1426
6073009706,7520,5234,1116,187,15,443,24,41,2286
6073009801,5164,3341,890,211,13,316,14,18,1823
6073009802,6586,3502,1431,530,15,531,50,30,3084
6073009804,5024,3278,856,173,12,320,24,32,1746
6073009805,4802,3249,774,111,8,282,18,22,1553
6073009901,678,402,122,77,9,40,4,3,276
6073009902,6,4,0,0,0,0,0,0,2
6073010001,4032,349,2770,117,5,597,36,27,3683
6073010003,5806,512,4085,132,5,858,32,15,5294
6073010004,4538,296,3633,81,0,408,15,13,4242
6073010005,7060,190,6621,45,3,135,9,15,6870
6073010009,6517,188,6018,97,6,139,0,20,6329
6073010010,5506,462,4313,106,7,503,17,20,5044
6073010011,3603,309,2508,124,6,512,20,14,3294
6073010012,4567,102,4341,58,2,43,0,7,4465
6073010013,6009,100,5837,18,1,19,1,9,5909
6073010015,4582,311,3278,373,1,489,9,24,4271
6073010016,4126,1030,1535,1391,55,44,13,8,3096
6073010017,5818,637,3097,575,8,1231,21,22,5181
6073010018,6718,660,3994,533,17,1233,22,34,6058
6073010019,4045,474,2152,311,10,830,26,30,3571
6073010103,6248,925,4540,206,17,335,22,24,5323
6073010104,3378,865,1817,86,7,395,13,13,2513
6073010106,5237,295,4596,74,1,182,3,12,4942
6073010107,6578,649,5062,132,0,560,30,15,5929
6073010109,4597,288,3475,176,6,513,4,16,4309
6073010110,7510,734,5226,243,18,1003,41,30,6776
6073010111,3289,81,3071,22,2,66,2,19,3208
6073010112,5204,288,4453,186,10,154,6,5,4916
6073010201,2768,1607,741,81,8,123,5,8,1161
6073010202,3499,1612,1432,99,20,106,10,6,1887
6073010300,4485,1616,2098,111,25,283,18,31,2869
6073010401,2452,567,1583,98,5,82,15,16,1885
6073010402,5800,1104,3708,203,25,505,32,14,4696
6073010501,1365,734,461,28,5,60,0,9,631
6073010502,5766,1472,3345,253,9,341,38,35,4294
6073010601,2106,1488,415,19,1,85,3,7,618
6073010800,2339,1855,253,12,3,53,4,15,484
6073010900,1627,1261,244,6,3,34,1,11,366
6073011000,2983,2202,447,66,10,91,9,25,781
6073011100,3795,2819,539,21,9,118,3,20,976
6073011300,4036,1835,985,765,29,170,33,11,2201
6073011601,5713,239,4644,117,11,579,18,26,5474
6073011602,3520,314,2649,169,5,305,8,1,3206
6073011700,7569,546,4511,283,11,1997,29,17,7023
6073011801,3692,266,2860,70,12,415,4,16,3426
6073011802,6636,342,4938,223,6,917,38,18,6294
6073011902,5797,686,3207,268,6,1428,42,10,5111
6073012002,3394,167,1385,170,7,1557,17,11,3227
6073012003,3372,316,1951,82,9,893,7,8,3056
6073012101,2167,271,1559,34,5,209,21,7,1896
6073012102,3160,298,2353,77,0,345,8,6,2862
6073012200,3513,344,2678,89,10,290,17,3,3169
6073012302,1889,335,1293,59,4,125,5,3,1554
6073012303,3669,1104,2027,182,17,220,19,11,2565
6073012304,3997,1150,2276,113,13,248,11,28,2847
6073012401,3693,454,2739,122,14,227,23,13,3239
6073012402,5822,785,4399,216,2,240,10,42,5037
6073012501,4401,353,3513,210,7,182,37,20,4048
6073012502,4576,427,3544,212,6,262,12,9,4149
6073012600,5143,594,4034,166,13,196,22,10,4549
6073012700,4945,575,3757,231,14,235,17,8,4370
6073012800,4009,912,2750,59,0,156,18,28,3097
6073012900,3540,911,2274,80,6,173,2,2,2629
6073013000,5997,891,4309,269,31,279,34,21,5106
6073013102,7294,832,5366,468,9,340,41,51,6462
6073013103,2922,276,2369,83,6,101,22,11,2646
6073013104,6017,523,4844,199,14,273,24,36,5494
6073013203,6471,431,5513,125,4,282,10,24,6040
6073013204,4114,215,3631,54,5,117,5,13,3899
6073013205,2473,178,2075,95,1,81,0,3,2295
6073013206,6909,598,5797,150,5,250,6,16,6311
6073013301,5271,1033,3665,101,13,242,23,18,4238
6073013302,5073,878,3643,88,20,271,13,22,4195
6073013303,5130,565,4025,103,12,274,40,12,4565
6073013306,4615,566,3303,138,13,445,9,25,4049
6073013307,4274,408,3208,130,7,384,12,6,3866
6073013308,3962,292,3316,104,18,115,4,19,3670
6073013309,6866,1095,4149,172,7,1111,42,20,5771
6073013312,2798,350,2097,64,4,158,22,9,2448
6073013315,3431,745,1580,183,1,727,7,16,2686
6073013316,7461,1370,3650,349,4,1662,30,30,6091
6073013317,16159,1972,5817,1462,22,5697,76,94,14187
6073013318,7876,1064,3479,653,16,2153,46,30,6812
6073013319,7458,1386,3562,546,14,1466,24,26,6072
6073013320,6556,1166,3045,586,5,1260,26,33,5390
6073013321,8312,1076,3835,632,10,2176,52,28,7236
6073013322,4635,788,2076,317,1,1139,24,24,3847
6073013323,6428,943,2930,373,2,1790,21,17,5485
6073013324,2644,327,1394,242,11,509,9,24,2317
6073013325,5367,794,2545,419,5,1293,23,14,4573
6073013326,4478,413,1679,169,0,2018,14,21,4065
6073013327,5401,966,2457,346,2,1391,27,21,4435
6073013401,4499,1258,2726,61,7,237,18,20,3241
6073013409,5590,1281,3037,330,14,616,31,27,4309
6073013411,5270,1718,2435,119,11,681,19,36,3552
6073013412,5187,1287,2697,170,7,768,19,36,3900
6073013414,7375,1445,3859,290,11,1322,35,27,5930
6073013415,1640,394,884,56,0,234,7,0,1246
6073013416,3930,1266,1859,186,15,401,14,21,2664
6073013417,1971,489,950,83,0,342,7,3,1482
6073013418,6095,1175,3486,192,13,916,41,37,4920
6073013420,3608,557,1922,228,10,691,8,12,3051
6073013421,4720,834,2464,123,9,1060,25,21,3886
6073013422,3964,1243,1845,109,14,535,6,27,2721
6073013423,3934,819,1648,197,8,977,18,11,3115
6073013424,5698,1198,2904,243,13,1010,20,22,4500
6073013425,2243,425,1185,92,6,411,4,21,1818
6073013503,6168,2339,2239,735,18,323,45,55,3829
6073013504,3847,1629,1087,442,6,412,29,13,2218
6073013505,5060,2177,1709,558,23,232,28,48,2883
6073013506,4422,1574,1935,365,1,293,21,24,2848
6073013601,5253,2808,1529,371,9,181,24,19,2445
6073013604,6256,4404,1043,253,10,252,19,17,1852
6073013605,5804,4185,871,151,36,237,12,31,1619
6073013607,2665,1454,566,306,2,134,10,28,1211
6073013608,4048,2623,724,193,11,241,22,11,1425
6073013701,2588,1634,604,60,5,110,16,18,954
6073013702,5530,1491,2660,599,20,377,37,37,4039
6073013801,5178,2162,1957,409,15,303,42,16,3016
6073013802,3311,657,1969,328,6,180,15,17,2654
6073013903,3927,994,1871,281,10,493,33,16,2933
6073013905,4084,1363,1325,594,17,411,39,35,2721
6073013906,4965,1327,2396,606,30,280,22,37,3638
6073013907,4159,550,2564,587,22,252,26,19,3609
6073013908,3972,591,2497,342,8,344,10,12,3381
6073013909,4521,844,2686,365,5,390,10,23,3677
6073014001,4941,1528,2263,451,14,390,42,24,3413
6073014002,4291,1131,1987,452,12,443,21,28,3160
6073014101,3867,1171,1983,197,6,273,12,31,2696
6073014102,3827,454,1636,988,7,470,60,10,3373
6073014200,7130,1998,3168,721,21,755,76,43,5132
6073014300,3957,1012,2007,349,6,352,24,16,2945
6073014400,4270,810,2015,1011,17,182,44,24,3460
6073014500,4076,1507,1510,393,9,403,19,9,2569
6073014601,4779,2071,1593,419,6,289,25,26,2708
6073014602,4902,2590,1056,403,16,455,30,30,2312
6073014701,4045,2152,1081,189,11,262,45,21,1893
6073014702,4239,2199,1118,196,23,312,12,21,2040
6073014803,5048,2863,1173,296,15,305,39,29,2185
6073014804,4588,2823,930,218,9,243,22,21,1765
6073014805,5104,2815,1172,355,15,394,22,41,2289
6073014806,2677,1057,887,328,9,195,16,23,1620
6073014901,4742,2628,1143,335,7,206,21,30,2114
6073014902,3340,1989,831,150,20,123,8,18,1351
6073015001,4294,2405,1114,143,11,283,13,20,1889
6073015002,2468,1253,627,261,6,148,19,17,1215
6073015100,5011,3057,1093,231,24,247,20,34,1954
6073015200,3958,2799,678,79,15,147,3,26,1159
6073015301,3411,1858,1005,142,7,211,13,17,1553
6073015302,4591,2928,923,199,3,266,11,33,1663
6073015403,2545,1973,304,49,2,71,4,15,572
6073015405,5980,4283,1061,124,18,163,13,24,1697
6073015406,2520,2013,301,27,13,50,4,9,507
6073015407,4323,2815,830,196,19,155,14,30,1508
6073015408,3817,2616,712,162,7,125,8,24,1201
6073015501,5346,3620,1250,55,34,97,11,15,1726
6073015502,2950,1987,563,37,114,49,4,7,963
6073015601,6340,3828,1690,264,32,182,14,18,2512
6073015602,2472,1781,431,31,6,65,16,15,691
6073015701,6503,2663,2335,680,27,382,32,40,3840
6073015704,4559,2332,1488,258,15,207,16,32,2227
6073015705,4515,2499,1236,344,11,200,27,9,2016
6073015706,2473,1188,856,152,7,114,4,15,1285
6073015801,4010,1675,1339,446,7,238,20,40,2335
6073015802,5027,2664,1582,296,10,171,10,30,2363
6073015901,3671,976,1869,359,5,211,24,23,2695
6073015902,5340,2431,1911,336,27,248,24,50,2909
6073016000,2628,1372,850,150,11,82,10,6,1256
6073016100,5991,3537,1431,268,29,276,23,48,2454
6073016201,6079,4196,1067,102,13,264,38,21,1883
6073016202,3793,1555,1231,476,17,200,25,31,2238
6073016301,5533,2485,1889,454,21,282,23,29,3048
6073016302,5750,2586,1978,508,10,298,12,25,3164
6073016401,5311,3197,1382,172,12,234,19,30,2114
6073016403,4778,3042,1154,155,17,187,11,14,1736
6073016404,3190,1350,1280,178,9,185,9,14,1840
6073016502,7271,3849,2211,410,25,247,34,50,3422
6073016503,3056,1720,855,154,10,82,18,12,1336
6073016504,7171,2583,3124,710,19,283,47,51,4588
6073016606,3576,2303,692,31,11,230,35,20,1273
6073016607,7111,4687,1395,121,30,386,24,38,2424
6073016608,2475,1802,380,14,9,70,6,6,673
6073016609,5470,3849,903,54,29,181,26,32,1621
6073016610,4334,2769,921,88,16,181,12,41,1565
6073016613,2006,1302,406,28,1,103,2,22,704
6073016614,4115,2671,821,45,5,227,19,27,1444
6073016615,4278,2277,1213,216,21,288,10,37,2001
6073016616,4452,2699,1004,137,18,236,20,58,1753
6073016617,3550,2013,950,88,9,221,36,24,1537
6073016618,3947,2531,749,122,30,180,11,27,1416
6073016619,4576,2739,923,127,11,373,21,28,1837
6073016620,2664,1731,571,31,8,91,16,16,933
6073016621,4386,2891,681,24,10,416,26,35,1495
6073016703,2750,1625,764,50,16,117,12,6,1125
6073016704,7174,4506,1563,175,28,376,18,37,2668
6073016705,4629,2664,1277,184,31,116,27,26,1965
6073016706,2966,2016,612,34,31,73,8,23,950
6073016804,7727,4173,2406,282,46,198,37,38,3554
6073016806,4462,2512,1463,89,17,113,19,21,1950
6073016807,7707,4858,1882,187,31,216,11,65,2849
6073016809,6056,3623,1603,148,20,240,14,26,2433
6073016810,2733,1919,511,17,16,73,1,7,814
6073016811,4677,3161,1068,35,28,126,3,19,1516
6073016812,3463,2609,614,25,17,44,14,10,854
6073016813,3441,2620,522,32,10,62,10,20,821
6073016901,7217,5023,1287,305,29,132,12,38,2194
6073016902,2562,1337,485,18,527,33,2,20,1225
6073017006,2924,2169,288,15,9,250,3,10,755
6073017009,4482,2472,1126,52,12,504,13,28,2010
6073017010,3110,1842,530,44,11,400,11,11,1268
6073017014,2493,1999,168,30,2,217,4,4,494
6073017018,3727,1462,672,102,4,1166,16,19,2265
6073017020,3986,2845,448,33,7,375,6,15,1141
6073017021,3182,2393,276,29,2,249,2,16,789
6073017022,5665,3381,691,164,7,898,13,41,2284
6073017031,4003,2141,623,91,2,807,18,18,1862
6073017033,5608,2414,577,95,5,2017,18,24,3194
6073017034,4893,2504,768,142,15,1050,10,33,2389
6073017035,3319,1408,500,205,2,918,2,26,1911
6073017036,3352,1456,427,123,4,1067,26,24,1896
6073017037,5876,2672,693,115,7,1952,17,25,3204
6073017039,6915,3084,814,164,2,2360,26,48,3831
6073017040,4277,2311,804,55,7,760,16,20,1966
6073017041,6111,3386,1270,110,12,859,22,24,2725
6073017043,5891,2248,654,161,15,2370,11,31,3643
6073017044,5638,2439,414,81,9,2325,8,41,3199
6073017045,2703,1289,236,45,7,933,2,16,1414
6073017046,3727,2118,341,43,7,991,8,19,1609
6073017047,3996,2681,353,42,6,617,10,23,1315
6073017048,6627,2791,2032,151,8,1170,24,31,3836
6073017049,3033,1652,732,53,4,386,1,15,1381
6073017050,3011,1498,652,40,12,625,0,25,1513
6073017051,4669,2671,515,91,4,1099,11,23,1998
6073017052,5137,2465,682,104,13,1562,8,16,2672
6073017053,3406,2510,326,23,0,286,2,31,896
6073017054,5654,3841,648,70,4,710,9,14,1813
6073017055,5125,2282,473,83,0,1923,12,13,2843
6073017056,4426,2142,608,154,15,1143,17,26,2284
6073017057,3763,2423,442,46,2,575,4,28,1340
6073017058,4048,2084,541,149,5,943,5,26,1964
6073017059,3609,2769,284,32,7,319,3,22,840
6073017060,2728,2003,197,36,0,332,6,19,725
6073017061,3838,2824,316,21,0,467,2,8,1014
6073017062,5489,3500,546,70,9,1039,11,26,1989
6073017063,4659,2665,535,73,1,1067,10,15,1994
6073017064,7844,2205,550,95,12,4487,4,46,5639
6073017065,9344,4352,838,141,8,3255,12,72,4992
6073017066,5989,3384,582,100,10,1453,6,41,2605
6073017067,3213,1553,309,51,1,1099,6,27,1660
6073017068,4778,1999,498,122,2,1819,16,9,2779
6073017069,2544,1338,248,42,2,709,1,8,1206
6073017070,6376,2426,551,86,2,2793,9,42,3950
6073017071,5073,2060,681,116,4,1792,23,38,3013
6073017104,4014,3013,567,7,10,153,2,28,1001
6073017106,5100,4096,422,35,11,267,13,36,1004
6073017107,2858,2161,262,24,0,206,0,11,697
6073017108,4717,3578,541,28,6,203,5,37,1139
6073017109,6845,5025,704,56,0,549,4,40,1820
6073017111,4415,3488,368,42,3,276,1,28,927
6073017112,2602,1890,305,19,4,203,0,12,712
6073017113,5381,2914,1406,84,10,577,9,30,2467
6073017201,1905,1579,135,9,0,76,3,11,326
6073017202,2035,1695,136,6,2,69,1,15,340
6073017303,3033,2494,208,12,6,123,0,21,539
6073017305,3100,2528,226,15,0,170,3,9,572
6073017306,2855,2336,197,16,10,156,0,24,519
6073017307,2264,1806,232,12,5,83,0,15,458
6073017308,3178,1804,1092,23,7,110,3,14,1374
6073017403,4998,3928,530,22,9,209,2,27,1070
6073017405,3604,2479,711,18,4,126,4,32,1125
6073017406,3135,2509,292,8,5,132,6,16,626
6073017407,3080,2554,235,10,7,97,2,24,526
6073017408,2684,1956,401,10,5,109,16,23,728
6073017501,2755,2196,304,13,10,68,1,15,559
6073017502,3674,2173,1112,22,7,164,5,18,1501
6073017601,5511,4453,500,23,8,241,4,23,1058
6073017603,2498,1772,470,7,6,75,0,10,726
6073017605,3692,2320,837,25,2,281,0,9,1372
6073017606,3988,2513,1020,21,14,196,10,26,1475
6073017701,5379,3932,901,23,14,137,3,45,1447
6073017702,2923,2261,375,10,8,81,4,24,662
6073017801,7000,4851,1220,114,16,324,14,59,2149
6073017808,6166,4641,517,34,10,524,7,24,1525
6073017809,2324,1802,298,11,7,57,3,23,522
6073017810,5067,3905,599,30,18,211,13,20,1162
6073017811,6806,4757,726,57,18,789,12,42,2049
6073017813,4370,3387,483,46,22,169,3,23,983
6073017901,3767,2219,1143,38,4,126,15,28,1548
6073017902,2883,1585,1044,17,13,77,6,11,1298
6073018000,3089,2376,378,21,15,92,9,18,713
6073018101,3474,2178,950,30,14,74,21,18,1296
6073018102,2544,1769,478,42,19,56,15,18,775
6073018201,2942,1355,1272,52,8,65,16,20,1587
6073018202,3122,1239,1643,65,7,47,1,24,1883
6073018301,1008,747,123,17,1,31,1,8,261
6073018302,1335,911,268,34,2,36,4,16,424
6073018400,3561,1871,1083,93,8,246,32,36,1690
6073018504,6797,4347,1480,141,16,289,54,31,2450
6073018509,4974,1442,2837,262,13,155,43,24,3532
6073018510,3419,1174,1657,152,7,213,31,5,2245
6073018511,4959,1984,2142,191,18,235,58,30,2975
6073018512,3647,2395,732,141,14,193,19,25,1252
6073018515,5064,3189,1011,191,18,329,35,28,1875
6073018516,3940,1704,1521,122,12,242,73,22,2236
6073018517,3996,2161,1203,137,13,226,25,18,1835
6073018518,3132,720,1997,76,9,141,55,23,2412
6073018519,5575,1239,3585,162,21,267,100,23,4336
6073018520,5540,1480,3132,181,15,388,70,38,4060
6073018521,4888,1986,1318,273,14,855,105,25,2902
6073018522,5371,2492,1494,265,20,557,75,27,2879
6073018523,5116,2379,1468,279,11,524,40,43,2737
6073018524,3642,1697,1011,221,10,423,19,23,1945
6073018525,4395,2253,941,230,12,569,25,30,2142
6073018601,4622,2424,1235,97,21,433,57,29,2198
6073018608,3103,1401,900,188,8,314,44,33,1702
6073018609,6286,1560,3473,299,6,529,76,24,4726
6073018612,4098,1781,1516,184,8,327,33,41,2317
6073018613,4117,1325,1740,298,12,349,105,21,2792
6073018615,2814,585,1950,68,3,86,28,15,2229
6073018616,3724,1152,1907,244,9,166,53,38,2572
6073018617,3561,1187,1497,165,6,357,101,16,2374
6073018618,3969,515,2926,116,1,220,47,15,3454
6073018619,6194,3451,1263,186,15,770,64,30,2743
6073018620,2718,478,1690,118,5,188,90,6,2240
6073018621,1640,444,870,97,3,123,11,15,1196
6073018622,5130,1910,2066,270,43,470,84,29,3220
6073018700,37892,20474,10948,3085,339,1296,359,98,17418
6073018801,3808,2498,964,23,12,103,8,6,1310
6073018803,5056,3287,1183,75,14,197,10,18,1769
6073018804,5536,4109,842,39,22,207,15,31,1427
6073018805,3572,2475,710,27,16,114,2,10,1097
6073018903,5161,2072,2686,63,16,102,28,23,3089
6073018904,6316,2145,3750,65,29,135,19,32,4171
6073018905,6764,1917,4330,142,19,108,14,23,4847
6073018906,6298,2212,3509,138,12,143,10,34,4086
6073019001,6395,4272,1571,45,24,184,18,27,2123
6073019002,3581,1607,1317,112,5,303,8,17,1974
6073019103,7046,4109,2167,48,47,249,10,36,2937
6073019105,6920,4721,1248,110,28,393,8,42,2199
6073019107,2470,1280,721,19,306,35,3,16,1190
6073019108,3072,738,1240,10,939,41,3,25,2334
6073019109,4793,2318,1711,92,121,232,41,11,2475
6073019110,5438,2682,1858,22,514,105,27,10,2756
6073019111,4417,1989,1577,68,365,199,5,36,2428
6073019203,2952,1586,948,33,11,133,23,16,1366
6073019205,6472,1847,3868,155,22,310,69,38,4625
6073019206,5586,1022,4028,119,12,196,25,28,4564
6073019208,3564,2304,910,20,6,127,3,15,1260
6073019209,3270,2271,640,30,9,123,13,14,999
6073019210,5882,1496,3695,137,10,277,42,32,4386
6073019301,6651,3512,1629,190,18,781,57,30,3139
6073019303,8025,3821,2756,210,45,586,73,48,4204
6073019304,3548,1766,1080,155,13,245,38,22,1782
6073019305,3983,2089,1168,156,10,273,32,22,1894
6073019403,6489,2263,3082,205,31,461,53,39,4226
6073019404,3697,514,2933,30,4,92,31,2,3183
6073019405,3813,1125,2083,127,16,196,64,19,2688
6073019406,4959,1946,2304,105,14,266,25,27,3013
6073019501,3831,284,3295,63,6,87,17,20,3547
6073019502,5492,622,4607,68,14,74,12,25,4870
6073019503,5032,1242,3239,119,8,181,25,31,3790
6073019601,6622,2938,2864,138,20,215,30,61,3684
6073019602,5438,2504,2310,127,24,160,23,40,2934
6073019701,7022,3224,2525,321,14,492,49,29,3798
6073019702,5069,2941,1550,74,13,168,15,27,2128
6073019803,5937,3675,1226,94,13,476,15,41,2262
6073019804,4567,3336,713,17,10,194,2,11,1231
6073019805,4138,1899,1747,99,12,178,10,22,2239
6073019808,4853,3720,602,65,3,253,7,22,1133
6073019809,4096,2964,635,43,3,200,4,26,1132
6073019810,6412,3839,1249,117,17,676,16,33,2573
6073019811,7330,4332,1333,106,25,978,19,41,2998
6073019902,4211,1591,2114,83,23,179,24,19,2620
6073019903,4718,2399,1767,98,19,178,14,35,2319
6073019904,6865,3880,1740,208,19,548,27,27,2985
6073019905,4326,2538,1021,101,9,369,20,15,1788
6073020015,5171,3759,576,41,14,392,18,13,1412
6073020017,3187,1222,1500,102,21,191,29,16,1965
6073020019,6728,3969,1942,70,11,464,6,29,2759
6073020021,6034,1255,3555,100,13,808,26,41,4779
6073020023,4734,2051,1859,89,19,397,12,32,2683
6073020024,4129,2072,1488,62,23,241,17,14,2057
6073020025,5021,2212,1783,154,17,466,25,39,2809
6073020026,4345,2903,780,40,5,341,8,32,1442
6073020028,3690,295,3083,52,4,156,18,16,3395
6073020029,6854,1965,3937,224,15,435,20,40,4889
6073020030,7193,4671,1156,110,13,776,4,50,2522
6073020031,6659,4326,967,96,9,745,6,43,2333
6073020032,3649,2674,374,42,1,343,1,11,975
6073020033,3720,2616,487,33,8,307,10,14,1104
6073020034,2737,2071,296,20,3,143,5,23,666
6073020035,6858,5308,640,33,13,425,6,26,1550
6073020036,3613,421,2979,35,1,124,9,3,3192
6073020037,4331,1165,2694,40,0,294,6,26,3166
6073020038,5773,2500,1605,121,4,1132,24,47,3273
6073020039,2226,933,585,35,2,490,9,12,1293
6073020040,4299,2772,766,63,12,405,11,17,1527
6073020041,3028,1059,1510,86,2,227,14,16,1969
6073020042,3794,2634,601,55,9,296,2,14,1160
6073020043,6475,4227,866,80,13,771,12,26,2248
6073020044,8509,4989,1427,133,6,1358,14,59,3520
6073020105,4122,1942,1543,112,10,319,12,18,2180
6073020106,3852,1422,1789,36,17,416,6,11,2430
6073020107,4248,1576,1810,67,16,499,17,29,2672
6073020108,5901,883,4280,125,10,409,17,20,5018
6073020109,5178,1245,3219,54,11,476,7,21,3933
6073020110,7812,3755,2039,203,32,1279,28,37,4057
6073020111,4128,2377,1063,58,12,402,6,18,1751
6073020202,6955,802,5623,146,14,224,10,14,6153
6073020206,5009,666,3966,71,11,178,10,13,4343
6073020207,5183,591,4198,105,2,185,5,24,4592
6073020208,2615,614,1703,37,10,172,0,6,2001
6073020209,4882,1254,3034,131,20,283,14,10,3628
6073020210,5105,1352,2905,137,17,467,7,12,3753
6073020211,6918,1565,4494,183,36,367,22,47,5353
6073020213,3674,390,3039,63,2,110,4,20,3284
6073020214,5808,1145,4027,200,31,231,10,25,4663
6073020304,6641,4036,1452,109,13,620,16,40,2605
6073020305,6124,2926,2059,177,20,621,7,18,3198
6073020308,5981,2144,2897,209,25,417,25,28,3837
6073020309,4093,1347,1854,98,5,535,19,32,2746
6073020310,8703,3967,2338,398,22,1289,13,67,4736
6073020311,3600,2265,531,83,10,488,6,18,1335
6073020312,4487,2402,1267,94,12,409,4,24,2085
6073020313,3012,1324,1133,88,22,244,9,28,1688
6073020401,2373,1848,270,22,5,109,0,19,525
6073020403,4220,1854,1666,57,15,407,3,11,2366
6073020404,5426,2696,1608,155,21,605,18,34,2730
6073020405,3685,2633,516,27,9,319,6,12,1052
6073020500,4952,1059,3502,47,8,203,10,14,3893
6073020601,5715,1100,4126,117,14,174,12,28,4615
6073020602,5970,2302,3047,125,33,218,7,16,3668
6073020705,4861,2467,1754,59,19,334,8,26,2394
6073020706,6656,4396,1235,92,21,451,5,42,2260
6073020707,5077,1417,2918,157,20,294,8,21,3660
6073020708,3728,2056,897,72,9,421,10,33,1672
6073020710,1798,1212,295,15,11,196,9,4,586
6073020711,3593,2203,789,42,17,327,9,10,1390
6073020712,4856,2301,1758,60,16,423,9,28,2555
6073020801,5295,3855,908,49,13,134,2,23,1440
6073020805,3674,2087,1256,29,54,36,18,15,1587
6073020806,6158,3148,2452,74,39,109,25,33,3010
6073020807,3070,2195,622,22,27,43,1,28,875
6073020810,5349,3860,915,55,15,110,15,32,1489
6073020811,5923,4337,966,62,42,134,10,59,1586
6073020812,2003,969,908,5,16,19,4,9,1034
6073020813,4983,2934,1660,17,37,61,6,21,2049
6073020902,2306,1728,355,33,8,31,1,16,578
6073020903,3030,1892,581,39,347,49,4,9,1138
6073020904,3266,2396,552,20,25,47,5,36,870
6073021001,2085,1259,654,30,26,15,1,15,826
6073021002,1946,1074,783,6,13,14,0,9,872
6073021101,5310,2339,2383,90,172,65,8,27,2971
6073021102,2613,1363,698,82,273,30,9,19,1250
6073021202,3073,2000,506,15,326,38,3,13,1073
6073021204,5491,4275,686,65,49,114,2,36,1216
6073021205,7029,4512,1625,144,50,157,35,53,2517
6073021206,3039,2224,520,19,41,46,12,24,815
6073021302,7237,3326,2928,541,31,130,12,53,3911
6073021304,2709,1671,788,43,12,50,4,14,1038
6073021305,4389,3237,739,78,16,126,5,9,1152
6073021306,5762,1642,2534,159,18,1039,24,47,4120
6073021401,4383,2679,829,303,25,227,22,32,1704
6073021402,2793,1895,495,44,16,125,9,16,898
6073021501,3882,2254,297,5,4,1066,3,7,1628
6073021502,9851,4481,1164,185,10,3309,9,68,5370
6073021600,3584,2152,877,192,19,103,5,27,1432
6073021800,1980,1584,233,13,0,46,0,5,396
6073021900,2625,347,1925,116,15,141,17,14,2278
6073022000,4526,260,2511,164,15,1402,49,16,4266
6073022101,2631,1867,306,58,5,218,4,6,764
6073022102,7024,3982,1713,113,16,782,12,46,3042
6073990100,0,0,0,0,0,0,0,0,0
6075010101,2026,963,197,69,3,666,5,10,1063
6075010102,2000,724,200,173,1,766,26,13,1276
6075010201,2468,1848,190,21,0,266,2,11,620
6075010202,2074,1435,135,26,0,351,3,19,639
6075010300,4062,2494,263,45,0,1028,4,29,1568
6075010401,2214,1259,166,14,1,643,7,9,955
6075010402,2293,1473,189,15,3,462,1,14,820
6075010500,3234,1529,237,93,5,1202,9,31,1705
6075010600,3718,1415,332,69,0,1727,11,27,2303
6075010701,3721,248,124,95,4,3188,7,8,3473
6075010702,1626,649,135,16,0,771,1,4,977
6075010800,4573,2239,265,44,0,1813,1,28,2334
6075010901,2338,1574,168,18,2,418,0,16,764
6075010902,2332,1351,204,38,2,613,5,4,981
6075011001,3079,1445,241,50,4,1177,4,5,1634
6075011002,2363,1096,164,46,1,913,2,16,1267
6075011101,3143,1512,300,62,3,1089,0,15,1631
6075011102,2504,1080,259,107,10,871,6,19,1424
6075011200,3441,1934,252,44,2,1047,2,17,1507
6075011300,3068,517,114,48,2,2304,2,8,2551
6075011700,1905,655,232,136,3,774,4,15,1250
6075011800,1589,144,58,10,4,1338,0,8,1445
6075011901,2275,1172,220,79,8,662,13,22,1103
6075011902,2738,1360,373,73,6,754,1,19,1378
6075012001,2002,853,372,86,2,554,0,9,1149
6075012002,2267,861,374,91,13,797,5,26,1406
6075012100,3455,1474,518,208,25,999,17,27,1981
6075012202,2490,760,612,266,12,692,17,16,1730
6075012203,1931,591,570,166,3,487,2,14,1340
6075012204,2570,924,768,121,9,619,6,22,1646
6075012301,3088,881,752,424,47,811,31,17,2207
6075012302,2875,1042,414,224,12,1008,13,20,1833
6075012403,2157,499,611,157,7,763,8,26,1658
6075012404,3849,809,1770,460,18,603,24,31,3040
6075012405,4152,1732,718,334,13,1128,9,21,2420
6075012406,1936,501,520,175,5,619,19,12,1435
6075012502,4482,883,902,677,51,1757,18,36,3599
6075012503,4260,1154,1052,614,20,1137,20,28,3106
6075012504,2277,805,419,477,56,404,21,17,1472
6075012601,2577,1921,234,20,2,248,3,23,656
6075012602,3058,2306,243,25,2,301,3,18,752
6075012700,3769,2871,269,17,6,377,0,21,898
6075012801,2742,2023,222,36,7,263,7,26,719
6075012802,1901,1449,117,22,0,216,2,11,452
6075012901,2853,2039,208,33,4,428,0,16,814
6075012902,3667,2593,302,48,13,502,2,9,1074
6075013001,2405,1755,186,30,4,298,2,1,650
6075013002,2144,1582,122,13,0,272,3,16,562
6075013101,4197,2758,337,54,4,764,12,23,1439
6075013102,2938,1999,261,38,2,453,2,23,939
6075013200,4464,3316,299,54,2,533,12,46,1148
6075013300,4344,3179,288,53,0,541,1,23,1165
6075013401,1623,1132,119,29,0,221,0,5,491
6075013402,2253,1578,159,32,0,326,0,8,675
6075013500,2912,1907,231,65,4,469,2,32,1005
6075015100,3104,1615,255,80,2,980,0,17,1489
6075015201,1888,1029,179,81,3,500,6,13,859
6075015202,2286,1335,178,71,5,542,6,10,951
6075015300,2387,1509,210,115,3,353,7,19,878
6075015401,3659,2029,305,107,8,938,7,12,1630
6075015402,2541,1642,225,44,3,443,3,13,899
6075015500,3899,1602,379,307,2,1331,25,7,2297
6075015600,3274,1576,339,71,0,996,4,26,1698
6075015701,4882,1922,755,279,4,1417,10,294,2960
6075015702,3220,1787,281,137,5,730,3,43,1433
6075015801,3869,1469,454,785,7,862,16,22,2400
6075015802,3116,1896,315,241,7,411,2,19,1220
6075015900,4630,1495,464,445,14,1889,13,47,3135
6075016000,2969,1211,365,201,13,988,8,25,1758
6075016101,2780,1085,179,601,7,755,5,19,1695
6075016102,2880,201,384,1231,6,868,22,43,2679
6075016200,3672,1768,465,254,11,944,4,41,1904
6075016300,4296,2038,496,679,0,758,4,27,2258
6075016400,3920,2321,498,266,12,551,0,25,1599
6075016500,5171,3088,600,296,7,722,8,45,2083
6075016601,3133,2006,336,104,2,418,2,33,1127
6075016602,2350,1514,294,63,5,280,5,15,836
6075016700,4835,3184,530,180,5,596,1,47,1651
6075016801,4282,2330,592,296,4,753,17,30,1952
6075016802,3928,1928,594,324,20,735,14,35,2000
6075016900,3425,2201,385,102,2,473,2,14,1224
6075017000,4088,2831,389,75,8,493,5,29,1257
6075017101,3766,2700,340,80,0,361,1,40,1066
6075017102,3798,2643,344,121,3,366,0,31,1155
6075017602,3649,970,581,529,25,1375,7,30,2679
6075017603,5518,1736,912,416,24,2062,31,38,3782
6075017604,4008,1269,685,485,24,1339,18,21,2739
6075017700,2841,1039,763,247,9,582,8,31,1802
6075017801,3567,866,174,139,2,2253,3,14,2701
6075017803,2254,810,389,208,13,689,10,11,1444
6075017804,4752,1648,675,396,14,1737,15,41,3104
6075017903,2747,762,746,441,25,537,32,29,1985
6075018000,4758,1667,660,662,15,1394,40,32,3091
6075020101,3841,1265,1212,264,26,851,13,27,2576
6075020102,3081,803,1230,299,24,559,9,24,2278
6075020201,2494,1038,656,122,4,517,3,20,1456
6075020202,3914,1683,879,227,12,864,13,26,2231
6075020300,3624,2125,511,71,7,674,3,33,1499
6075020401,3235,2144,318,40,5,497,0,22,1091
6075020402,4547,2681,590,130,9,782,9,48,1866
6075020500,2663,1797,271,43,0,346,6,20,866
6075020601,2906,1867,346,64,7,393,4,25,1039
6075020602,2272,1581,209,35,0,293,4,5,691
6075020701,2987,1828,472,72,2,368,7,26,1159
6075020702,2520,1370,439,48,1,450,3,22,1150
6075020801,3618,1217,1484,82,19,613,17,32,2401
6075020802,3143,930,1494,63,10,501,1,15,2213
6075020900,4296,1443,1830,99,3,648,0,44,2853
6075021000,4213,2404,810,76,0,635,9,46,1809
6075021100,4111,2788,405,58,5,549,6,29,1323
6075021200,3015,2036,269,31,4,397,3,34,979
6075021300,2652,1738,235,26,2,376,1,25,914
6075021400,3404,2292,391,38,1,453,2,22,1112
6075021500,5237,3068,851,66,5,790,4,53,2169
6075021600,4403,2386,548,187,7,922,6,39,2017
6075021700,4222,2159,530,316,9,862,9,33,2063
6075021800,4091,2594,562,74,1,494,12,25,1497
6075022600,5001,2403,538,191,9,1459,5,59,2598
6075022702,2194,1330,262,43,7,369,4,14,864
6075022704,3734,2251,313,69,5,721,7,28,1483
6075022801,4956,1956,1801,179,8,732,7,31,3000
6075022802,1975,734,561,85,2,440,9,12,1241
6075022803,4380,1578,1931,76,5,559,5,30,2802
6075022901,4275,1186,2289,177,2,429,21,16,3089
6075022902,2283,762,1024,53,7,305,5,23,1521
6075022903,3007,1121,1214,68,5,424,7,35,1886
6075023001,5412,294,820,533,11,3621,16,16,5118
6075023003,4143,431,949,621,19,1961,6,24,3712
6075023102,3377,265,642,1662,14,534,43,23,3112
6075023103,4901,157,940,2431,24,461,536,70,4744
6075023200,4987,457,2061,1278,28,901,23,29,4530
6075023300,4369,316,964,558,9,2365,11,24,4053
6075023400,4110,214,1464,1019,3,1040,172,45,3896
6075025100,3364,1818,654,119,8,517,1,19,1546
6075025200,5164,2845,1124,100,4,653,12,25,2319
6075025300,4412,2200,1148,70,0,695,7,28,2212
6075025401,3331,1393,1130,147,6,402,19,28,1938
6075025402,2869,1184,692,84,5,685,5,15,1685
6075025403,4430,1210,1425,310,10,1206,36,26,3220
6075025501,3606,749,1005,79,0,1596,6,17,2857
6075025502,4354,935,1345,55,9,1790,13,25,3419
6075025600,5482,803,1461,101,4,2925,18,20,4679
6075025701,4716,514,1083,93,5,2925,4,11,4202
6075025702,4551,431,1146,79,5,2754,5,9,4120
6075025800,2030,241,464,112,0,1132,6,12,1789
6075025900,4537,792,966,294,3,2270,21,15,3745
6075026001,5553,663,2502,77,3,2119,9,35,4890
6075026002,3282,712,1086,131,0,1204,6,21,2570
6075026003,4890,727,1768,72,10,2158,19,18,4163
6075026004,4162,574,1412,48,4,2006,6,25,3588
6075026100,6890,754,1713,70,13,4109,13,35,6136
6075026201,4174,258,1198,88,4,2509,14,22,3916
6075026202,3323,301,918,63,0,1963,8,8,3022
6075026301,4761,439,1321,38,2,2861,2,15,4322
6075026302,4760,590,1184,205,9,2620,28,14,4170
6075026303,4632,471,1296,86,0,2634,11,30,4161
6075026401,3954,166,786,292,1,2546,47,22,3788
6075026402,4174,397,932,293,2,2390,25,13,3777
6075026403,4050,195,801,168,2,2782,15,23,3855
6075026404,3100,58,881,442,4,1549,101,4,3042
6075030101,4592,2643,454,91,8,1039,5,27,1949
6075030102,5500,3122,486,170,0,1288,3,72,2378
6075030201,3988,1979,362,67,2,1284,8,27,2009
6075030202,4507,2308,411,99,6,1268,2,44,2199
6075030301,6076,2699,477,88,2,2330,4,54,3377
6075030302,3670,1471,286,21,0,1604,9,32,2199
6075030400,5269,2341,393,47,7,2079,7,41,2928
6075030500,3220,1533,401,258,7,817,8,17,1687
6075030600,2343,1207,234,25,1,685,1,22,1136
6075030700,6859,3582,737,144,4,1782,2,51,3277
6075030800,5898,3052,424,87,5,1866,13,57,2846
6075030900,6707,2837,600,176,2,2699,8,41,3870
6075031000,4192,1734,499,133,3,1503,2,23,2458
6075031100,6305,2652,1056,170,12,1954,22,37,3653
6075031201,6064,933,1069,326,8,3473,24,47,5131
6075031202,3051,368,501,289,0,1754,4,17,2683
6075031301,3786,765,463,431,4,1846,10,35,3021
6075031302,5673,727,833,584,5,3269,28,24,4946
6075031401,2942,157,761,200,4,1697,32,4,2785
6075031402,4287,510,925,487,9,2188,18,17,3777
6075032601,4412,1493,409,77,8,2152,2,24,2919
6075032602,4289,1361,277,43,1,2358,0,46,2928
6075032700,6472,2127,443,78,1,3440,8,35,4345
6075032801,4234,1172,323,59,6,2490,0,23,3062
6075032802,4097,1132,240,53,5,2467,3,28,2965
6075032901,5015,1334,322,44,6,3060,4,23,3681
6075032902,3850,1004,295,27,4,2357,2,29,2846
6075033001,3893,1221,308,37,1,2109,6,23,2672
6075033002,4021,1473,325,52,5,1917,0,25,2548
6075033100,4025,1300,222,35,9,2300,1,14,2725
6075033201,1729,554,448,215,5,373,26,19,1175
6075033203,4003,1210,862,372,10,1258,18,42,2793
6075033204,3839,1155,876,349,13,1222,6,32,2684
6075035101,3551,1370,337,43,7,1560,7,31,2181
6075035102,4252,1128,290,42,0,2532,10,22,3124
6075035201,5288,1926,401,94,6,2461,6,42,3362
6075035202,4353,1847,491,93,7,1609,16,33,2506
6075035300,7360,1873,556,88,9,4484,9,31,5487
6075035400,6696,2182,603,98,10,3374,6,43,4514
6075040100,4417,2269,422,71,0,1334,5,23,2148
6075040200,5539,2603,491,114,1,1893,9,58,2936
6075042601,3917,1791,354,61,0,1438,3,37,2126
6075042602,3469,1723,309,50,7,1104,6,35,1746
6075042700,5496,2324,525,101,9,2186,11,51,3172
6075042800,2433,1606,136,11,0,504,4,14,827
6075045100,5048,2169,487,90,0,1938,3,25,2879
6075045201,3368,1478,306,46,5,1290,1,15,1890
6075045202,3405,1425,284,55,2,1387,5,19,1980
6075047600,5302,2086,400,69,3,2321,4,34,3216
6075047701,4435,1663,423,80,4,1977,8,28,2772
6075047702,3823,1505,298,69,10,1723,9,16,2318
6075047801,4140,1552,265,59,2,1991,4,30,2588
6075047802,3786,1329,371,65,4,1764,6,20,2457
6075047902,3691,1651,293,46,6,1401,2,32,2040
6075047903,3782,1585,288,53,5,1561,7,35,2197
6075047904,3026,1400,229,80,3,1106,2,28,1626
6075060100,3690,2480,463,87,12,315,3,40,1210
6075060400,2325,1109,311,106,4,654,15,22,1216
6075060502,3214,124,968,665,7,997,281,20,3090
6075060701,8610,3099,1158,459,23,3266,55,107,5511
6075060702,3142,933,323,154,5,1518,6,18,2209
6075060703,5680,1742,585,244,2,2777,7,43,3938
6075061000,5044,594,985,670,8,2525,21,31,4450
6075061101,2008,185,46,56,0,1681,8,0,1823
6075061102,2443,54,60,39,2,2267,5,5,2389
6075061200,4166,439,1749,809,5,976,23,14,3727
6075061401,3336,1407,674,338,17,606,58,26,1929
6075061402,2545,1145,370,248,0,522,61,19,1400
6075061501,2106,1120,181,70,3,597,0,12,986
6075061502,2454,1190,237,93,6,768,1,37,1264
6075061503,4039,1429,383,176,13,1783,4,55,2610
6075061504,2246,880,151,76,2,1023,2,12,1366
6075061505,1051,393,49,20,0,546,0,9,658
6075061506,4452,1706,307,119,2,2077,0,47,2746
6075061507,1738,595,248,161,2,637,2,23,1143
6075061508,2507,1069,187,68,6,1011,4,32,1438
6075980200,79,46,6,21,0,5,0,0,33
6075980300,284,112,52,38,5,38,16,3,172
6075980401,0,0,0,0,0,0,0,0,0
6075980501,125,0,5,0,0,116,0,0,125
6075980600,1340,266,186,328,9,472,9,23,1074
6075980900,1248,421,338,225,14,168,15,8,827
6075990100,0,0,0,0,0,0,0,0,0
6075990200,0,0,0,0,0,0,0,0,0
6077000101,2220,196,1525,159,15,282,1,1,2024
6077000102,2678,493,1190,678,13,161,9,10,2185
6077000300,2938,488,1468,572,35,224,3,26,2450
6077000401,3351,1060,1541,337,12,164,16,23,2291
6077000402,4640,806,2223,1052,39,200,16,24,3834
6077000500,3071,284,2323,219,21,144,6,11,2787
6077000600,2305,151,1693,143,15,231,2,24,2154
6077000700,5939,380,4297,362,47,661,44,37,5559
6077000802,2030,150,1456,205,18,117,15,13,1880
6077000803,5242,295,2831,596,13,1298,49,16,4947
6077000900,6351,1413,3376,585,67,518,28,49,4938
6077001000,5632,1941,2535,467,40,324,35,28,3691
6077001101,5400,1546,2736,335,34,445,20,19,3854
6077001102,5343,1438,2674,498,36,370,43,25,3905
6077001200,5750,2716,1656,650,17,387,28,37,3034
6077001300,5350,1564,2791,353,50,238,21,23,3786
6077001400,5015,1330,2207,355,17,810,31,28,3685
6077001501,4887,607,2641,496,15,920,55,13,4280
6077001502,4596,672,3404,154,28,168,18,22,3924
6077001600,2522,261,1918,87,10,149,3,10,2261
6077001700,4026,533,3210,63,17,92,8,11,3493
6077001800,4036,527,3142,99,17,143,6,7,3509
6077001900,5782,340,4703,415,16,159,26,8,5442
6077002000,4068,306,3188,372,31,73,3,6,3762
6077002100,5996,240,4434,723,15,446,9,17,5756
6077002201,3169,97,2187,674,15,117,2,13,3072
6077002202,5693,247,4026,650,11,616,7,28,5446
6077002300,5285,239,4039,288,40,540,0,23,5046
6077002401,5226,184,3490,253,9,1113,26,33,5042
6077002402,2284,82,1666,159,8,298,9,6,2202
6077002503,2440,121,1221,490,14,473,18,9,2319
6077002504,4156,214,2182,461,6,1172,0,14,3942
6077002701,7161,1107,5550,115,47,147,5,22,6054
6077002702,4237,633,3313,51,23,102,10,8,3604
6077002800,6992,444,4867,756,32,665,25,17,6548
6077003106,3862,1805,1138,283,6,365,22,14,2057
6077003108,4653,1695,1588,542,18,457,23,48,2958
6077003109,5961,2137,2473,449,30,471,31,23,3824
6077003110,4175,1171,1669,659,11,387,28,15,3004
6077003111,4253,935,1500,748,12,795,25,22,3318
6077003112,3183,1168,942,318,5,560,30,6,2015
6077003115,3543,678,1280,841,7,490,28,25,2865
6077003116,3011,596,1359,524,7,408,10,33,2415
6077003117,3607,1726,554,150,5,951,17,26,1881
6077003118,2923,1076,836,224,13,613,18,23,1847
6077003119,3751,1129,798,295,5,1239,25,20,2622
6077003203,3882,1781,1316,176,10,328,9,14,2101
6077003205,4016,1465,1434,306,22,470,36,29,2551
6077003209,3964,1324,1334,372,11,611,46,26,2640
6077003210,3025,1184,892,292,6,497,12,11,1841
6077003213,5007,975,1786,856,19,1029,33,14,4032
6077003214,3221,1040,1135,278,10,517,34,10,2181
6077003215,4074,1002,1309,941,14,557,31,27,3072
6077003216,3046,728,1222,397,5,501,36,12,2318
6077003217,3399,510,1566,491,10,595,27,18,2889
6077003218,3666,774,1267,519,14,805,44,14,2892
6077003219,9976,2142,2398,854,35,3923,80,75,7834
6077003305,4275,1158,1906,455,35,452,50,21,3117
6077003306,4444,657,2033,505,16,943,66,23,3787
6077003307,5262,1007,2317,808,25,806,32,29,4255
6077003308,1665,277,813,223,2,226,21,17,1388
6077003310,4678,676,1895,637,31,1191,40,16,4002
6077003311,3812,544,1802,524,14,670,45,18,3268
6077003312,3450,328,1685,827,13,393,22,21,3122
6077003313,3356,371,1440,658,3,713,8,19,2985
6077003403,5064,389,1634,438,14,2335,49,29,4675
6077003404,5849,867,2005,493,24,2164,90,13,4982
6077003405,4216,409,1433,379,14,1836,49,18,3807
6077003406,3769,406,1121,925,14,1092,36,16,3363
6077003407,3083,359,1159,689,13,653,38,20,2724
6077003409,4638,423,1593,486,10,1907,32,21,4215
6077003410,6188,498,2215,690,15,2436,69,46,5690
6077003501,2837,1468,709,34,12,404,5,19,1369
6077003502,3140,1384,1329,53,15,233,2,6,1756
6077003503,9397,691,2415,775,26,4996,119,42,8706
6077003504,8310,615,2418,705,23,4090,147,21,7695
6077003601,3519,1578,1501,40,7,216,12,6,1941
6077003602,3274,1242,1792,30,12,93,2,14,2032
6077003700,3845,785,2748,44,21,167,4,2,3060
6077003803,5968,1147,3446,621,14,571,18,19,4821
6077003804,6409,654,3044,1024,11,1299,101,34,5755
6077003805,3366,225,1381,574,11,984,43,10,3141
6077003806,3772,265,1607,626,9,1069,39,6,3507
6077003807,2256,243,786,392,13,649,69,27,2013
6077003808,4791,453,2315,778,25,965,55,30,4338
6077003900,1494,378,1061,3,0,23,3,10,1116
6077004001,2484,924,1286,49,5,116,10,6,1560
6077004003,5433,1333,1683,590,13,1403,33,34,4100
6077004004,6185,1376,1765,646,8,1959,39,32,4809
6077004104,4123,2678,799,34,15,318,10,9,1445
6077004105,4973,2857,1488,70,6,251,16,38,2116
6077004106,1969,1054,684,6,3,118,0,12,915
6077004107,3604,1686,1319,61,7,358,7,21,1918
6077004108,8480,1177,1897,650,16,4270,66,44,7303
6077004202,1707,1306,216,6,5,94,2,1,401
6077004203,4009,1843,1686,33,15,227,4,20,2166
6077004204,2986,1860,784,27,19,97,8,28,1126
6077004205,3476,2067,1083,11,15,112,6,21,1409
6077004206,3231,1910,946,20,7,153,2,14,1321
6077004302,6122,3208,2124,63,11,434,6,21,2914
6077004305,5898,3315,1352,109,25,709,19,29,2583
6077004307,3984,1844,1535,64,10,339,12,20,2140
6077004308,3968,964,2309,55,11,523,1,21,3004
6077004309,2437,1579,551,35,3,109,7,17,858
6077004310,2549,1783,426,20,7,192,0,6,766
6077004402,5599,2023,2458,107,43,661,24,40,3576
6077004403,4108,456,2761,29,11,763,2,6,3652
6077004404,3869,555,2612,22,20,557,4,21,3314
6077004501,2422,1075,1001,32,13,206,5,6,1347
6077004502,4160,547,2991,65,8,458,2,26,3613
6077004600,6099,3353,2224,34,15,188,22,52,2746
6077004701,2815,1608,1002,17,7,30,11,20,1207
6077004703,3744,2403,1049,31,17,69,13,12,1341
6077004704,5013,2863,1746,17,10,153,14,16,2150
6077004800,5509,3043,2096,16,26,72,5,16,2466
6077004903,2679,1618,849,14,7,62,1,10,1061
6077004904,4916,2948,1535,20,22,56,6,20,1968
6077004905,3177,1860,940,12,14,45,0,19,1317
6077004906,2941,1539,1235,3,13,36,0,11,1402
6077005001,5781,3800,1447,44,24,176,2,29,1981
6077005003,6555,3961,1574,77,29,552,12,37,2594
6077005004,5959,3662,1607,56,10,223,10,34,2297
6077005106,12643,4214,3759,595,36,3224,140,130,8429
6077005108,4582,1320,2619,116,31,260,18,21,3262
6077005109,3996,1259,2101,119,29,250,14,15,2737
6077005119,9931,1412,3213,944,20,3694,134,60,8519
6077005122,7036,1950,2556,300,20,1718,81,82,5086
6077005123,4676,1556,1778,314,33,699,35,43,3120
6077005124,3725,1389,1684,130,23,323,3,17,2336
6077005125,1899,807,891,32,6,72,8,9,1092
6077005126,4294,1361,2037,167,34,449,18,20,2933
6077005127,6129,910,2649,408,24,1697,104,56,5219
6077005129,3857,697,2377,169,12,460,20,11,3160
6077005130,3275,652,2070,95,16,307,28,24,2623
6077005131,7255,2688,2834,1124,78,261,55,26,4567
6077005132,3295,1037,1785,80,21,154,22,20,2258
6077005133,4319,1471,2257,152,23,204,32,8,2848
6077005134,4783,2000,2012,137,42,261,7,19,2783
6077005135,8680,4398,2432,277,32,1055,57,44,4282
6077005136,3210,1181,1216,125,11,482,10,22,2029
6077005137,7717,2062,2751,487,44,1855,72,53,5655
6077005138,2968,1066,1060,139,16,448,27,39,1902
6077005139,3580,1409,1176,201,17,483,36,21,2171
6077005140,3748,1325,1935,113,30,150,30,6,2423
6077005141,3085,1356,1355,77,9,107,5,11,1729
6077005208,6267,2144,2044,468,20,1141,38,58,4123
6077005211,5476,867,1607,381,35,2098,133,70,4609
6077005212,7169,1401,1804,521,33,2830,112,36,5768
6077005213,3656,1285,903,196,4,1008,40,17,2371
6077005214,9131,2457,2599,555,19,2855,68,91,6674
6077005215,4299,1683,1100,251,10,878,17,36,2616
6077005216,5138,1536,1632,305,9,1266,69,20,3602
6077005217,3327,1211,1074,208,10,533,32,34,2116
6077005218,4117,940,1282,370,5,1231,44,26,3177
6077005219,5164,1735,1594,245,6,1104,36,33,3429
6077005220,2547,801,1047,168,7,346,16,15,1746
6077005221,9532,2116,1327,719,31,4656,59,66,7416
6077005222,4712,1156,891,432,3,1835,40,57,3556
6077005223,10774,1562,1105,614,60,6871,54,66,9212
6077005224,4902,1234,1585,284,11,1373,32,46,3668
6077005225,3419,1228,1189,239,3,519,18,27,2191
6077005303,4966,1159,3042,169,15,359,26,17,3807
6077005307,3294,914,1488,181,26,487,36,11,2380
6077005308,4391,1274,1810,274,14,733,70,32,3117
6077005309,3283,956,1905,89,19,190,12,5,2327
6077005310,4003,939,2297,189,9,403,21,15,3064
6077005311,3056,646,1625,189,14,430,18,19,2410
6077005312,3615,1043,1723,156,7,475,28,13,2572
6077005403,6046,2000,2534,340,22,779,41,53,4046
6077005405,3644,749,1970,259,17,440,25,28,2895
6077005406,3428,652,1795,241,11,510,21,21,2776
6077005502,2312,868,748,75,0,483,5,9,1444
6077005503,1878,1142,581,15,13,18,19,2,736
6077980000,1904,591,715,496,45,19,2,4,1313
6079010016,5643,2891,2418,38,29,74,2,19,2752
6079010017,3618,2807,556,18,24,26,7,15,811
6079010101,1672,1173,352,13,10,32,0,7,499
6079010103,3621,1811,1478,85,14,67,11,20,1810
6079010104,3285,773,2298,47,10,51,5,15,2512
6079010202,5499,2811,2248,85,21,114,17,27,2688
6079010204,6120,3220,2334,81,13,138,19,44,2900
6079010205,4470,2336,1709,79,17,104,9,15,2134
6079010206,4001,2790,825,43,13,101,11,36,1211
6079010207,4256,2931,936,56,17,107,6,25,1325
6079010301,3949,2454,1230,27,19,27,6,11,1495
6079010302,3394,2598,480,6,8,63,7,13,796
6079010303,3241,1997,975,18,22,31,1,20,1244
6079010403,3466,2623,617,8,11,67,0,16,843
6079010404,2219,1443,646,2,2,24,4,12,776
6079010504,2505,2033,274,12,7,47,0,13,472
6079010505,3280,2405,573,17,18,90,7,17,875
6079010506,2338,1716,405,31,5,57,1,10,622
6079010602,3956,2947,635,20,18,117,8,17,1009
6079010603,1407,1057,197,9,4,55,3,9,350
6079010701,4717,3369,766,24,12,246,7,28,1348
6079010703,3497,2196,715,24,18,316,1,23,1301
6079010707,5874,4628,741,32,24,155,4,32,1246
6079010902,3726,2562,601,29,7,229,0,26,1164
6079010903,7459,4891,1137,122,9,924,6,108,2568
6079010904,3284,2098,516,68,2,441,0,49,1186
6079011001,5603,3723,1171,71,11,252,4,18,1880
6079011002,2933,2219,405,20,3,113,8,10,714
6079011101,3666,2539,671,67,7,143,11,20,1127
6079011103,3522,2185,852,50,7,220,2,31,1337
6079011104,2063,1375,329,32,1,140,4,18,688
6079011105,3534,2463,660,26,18,139,1,17,1071
6079011201,4276,2828,713,33,6,398,4,39,1448
6079011202,3502,2661,406,13,6,192,0,36,841
6079011300,7850,4817,1801,97,27,630,7,48,3033
6079011400,3806,762,1209,1687,29,41,15,5,3044
6079011501,1788,1118,445,29,12,82,2,7,670
6079011505,4920,3627,743,58,8,204,5,16,1293
6079011600,4334,3583,450,10,8,85,1,42,751
6079011704,3514,2678,496,14,18,100,3,25,836
6079011705,1462,1148,176,16,7,55,1,8,314
6079011706,3105,2443,317,32,13,157,6,21,662
6079011800,7510,5774,970,38,23,255,8,40,1736
6079011901,3101,2198,535,26,13,116,0,14,903
6079011903,1725,1211,309,16,2,75,3,3,514
6079011904,7289,4405,2026,89,37,274,4,39,2884
6079012001,2549,1498,790,18,4,101,5,7,1051
6079012002,4612,2546,1512,58,23,182,5,28,2066
6079012102,5482,3165,1660,55,39,228,8,49,2317
6079012201,3185,1284,1662,26,14,47,4,15,1901
6079012202,3785,1802,1659,29,22,87,8,21,1983
6079012302,5774,4340,941,23,28,96,1,32,1434
6079012305,5987,4459,981,28,16,210,1,19,1528
6079012306,4770,3313,1095,45,39,130,0,8,1457
6079012403,3903,2123,1456,16,14,82,11,20,1780
6079012404,6295,3349,2459,44,17,146,15,25,2946
6079012405,3303,1332,1682,14,13,73,0,14,1971
6079012406,3677,1343,2040,44,12,98,2,20,2334
6079012502,5201,3398,1230,62,39,111,0,30,1803
6079012503,6462,3745,1741,222,38,335,12,37,2717
6079012505,4971,3624,811,30,26,113,13,41,1347
6079012601,6319,4526,1192,70,22,143,1,34,1793
6079012602,1760,1311,287,3,11,43,2,16,449
6079012705,6120,4737,875,15,31,112,1,37,1383
6079012706,4233,3426,434,26,26,52,1,13,807
6079012707,4752,3480,898,28,26,88,6,12,1272
6079012708,1074,746,227,6,9,9,0,9,328
6079013000,2644,1783,677,7,12,52,7,6,861
6079013100,5566,3821,1266,43,45,89,6,37,1745
6079990000,0,0,0,0,0,0,0,0,0
6081600100,5474,2049,997,93,11,1886,29,59,3425
6081600200,4368,244,1397,174,8,2286,109,33,4124
6081600300,4057,659,957,93,0,2138,21,33,3398
6081600401,3263,388,857,86,8,1777,0,20,2875
6081600402,4772,296,1681,99,12,2574,21,21,4476
6081600501,3900,486,1341,84,5,1798,17,26,3414
6081600502,3748,241,907,48,2,2402,13,9,3507
6081600600,5464,393,2260,88,6,2522,41,31,5071
6081600701,4884,353,1720,89,13,2541,31,30,4531
6081600702,2958,224,956,83,0,1596,8,20,2734
6081600800,7648,969,2168,277,15,3741,47,108,6679
6081600900,4039,1131,405,53,0,2216,7,41,2908
6081601000,6826,1156,1131,223,0,3915,41,76,5670
6081601100,5917,1064,804,91,6,3653,25,39,4853
6081601200,6746,1292,1835,112,17,3084,49,83,5454
6081601301,3982,409,1360,82,5,1948,26,47,3573
6081601302,4629,422,1804,104,1,2122,36,21,4207
6081601400,7129,775,930,102,5,4999,38,63,6354
6081601501,5194,439,520,84,5,3941,22,42,4755
6081601502,5479,515,1399,174,4,2942,92,100,4964
6081601601,2884,584,966,63,8,1100,7,17,2300
6081601603,5923,666,716,134,5,4071,43,35,5257
6081601604,2431,541,409,70,1,1242,11,23,1890
6081601605,6157,536,731,94,5,4456,64,48,5621
6081601700,4313,895,1276,38,20,1810,51,14,3418
6081601800,6366,1700,1595,48,3,2565,68,38,4666
6081601901,4117,797,1298,69,13,1620,87,41,3320
6081601902,5841,1114,1735,131,8,2411,52,88,4727
6081602001,4730,1117,1648,58,3,1542,89,40,3613
6081602002,3233,476,1085,51,6,1472,41,12,2757
6081602100,3710,308,2506,75,7,574,109,40,3402
6081602201,4929,677,2942,111,26,925,53,34,4252
6081602202,3857,421,2388,102,7,775,41,19,3436
6081602300,4238,611,1828,77,8,1351,158,41,3627
6081602400,6924,2188,1787,96,12,2319,110,78,4736
6081602500,5156,705,503,165,5,3500,65,33,4451
6081602601,4276,446,522,69,3,3029,32,16,3830
6081602602,4034,419,495,91,5,2797,43,13,3615
6081602700,6080,1442,1260,198,18,2607,96,59,4638
6081602800,4639,1244,857,131,5,2058,42,37,3395
6081602900,3958,1863,763,98,10,809,17,70,2095
6081603000,4597,2553,873,80,6,605,28,45,2044
6081603100,3306,2036,501,37,10,418,10,23,1270
6081603200,3966,2385,870,29,18,304,16,25,1581
6081603300,6568,3994,1242,56,24,640,31,50,2574
6081603400,5561,3240,1012,55,10,746,18,55,2321
6081603700,5667,1580,1072,74,7,2392,136,50,4087
6081603801,2291,780,410,37,3,909,13,28,1511
6081603802,5267,2286,898,61,7,1569,61,86,2981
6081603900,5590,2489,1275,81,7,1315,54,89,3101
6081604000,3314,1519,708,25,2,803,46,15,1795
6081604102,3565,881,602,108,3,1678,66,25,2684
6081604103,4847,788,2397,78,11,1078,179,62,4059
6081604104,3267,601,1619,45,10,673,149,27,2666
6081604200,4197,544,2257,38,7,825,358,33,3653
6081604400,5287,1243,1069,70,4,2548,116,27,4044
6081604500,3648,1277,355,15,0,1811,22,23,2371
6081604600,2808,832,166,9,5,1628,13,30,1976
6081604700,2879,964,236,8,1,1529,9,23,1915
6081604800,5207,1536,608,51,4,2632,50,53,3671
6081604900,3387,1015,187,17,2,2007,6,17,2372
6081605000,8603,3583,722,57,4,3610,42,41,5020
6081605100,3339,1715,554,39,3,771,10,37,1624
6081605200,3816,2309,345,24,6,857,8,23,1507
6081605300,5022,2911,558,51,0,1102,9,51,2111
6081605400,6364,3163,1216,59,0,1369,26,113,3201
6081605501,2999,1449,531,41,7,740,8,45,1550
6081605502,2479,1346,423,24,0,508,5,34,1133
6081605600,5832,3131,281,13,0,2022,21,20,2701
6081605700,5563,3034,251,30,2,1905,8,29,2529
6081605800,2621,1815,241,9,5,384,5,8,806
6081605901,3267,1434,787,88,10,686,36,39,1833
6081605902,2989,923,1147,62,7,673,20,23,2066
6081606000,5242,1585,2087,82,8,1135,39,70,3657
6081606100,4380,1270,1603,65,8,887,262,56,3110
6081606201,4083,382,2680,197,4,551,111,42,3701
6081606202,3854,769,1987,123,3,721,78,23,3085
6081606300,4159,1692,1040,74,1,1100,27,30,2467
6081606400,5261,2573,701,68,16,1480,22,35,2688
6081606500,3713,2387,281,30,5,752,7,23,1326
6081606600,3740,1705,801,31,3,893,26,25,2035
6081606700,2617,1447,241,19,1,704,11,12,1170
6081606800,3344,1579,264,16,2,1243,29,22,1765
6081606900,2446,1286,158,20,0,748,10,4,1160
6081607000,3582,1733,444,38,13,1089,20,15,1849
6081607100,2967,1631,274,27,5,776,16,18,1336
6081607200,4971,1350,1987,76,5,1144,27,122,3621
6081607300,3642,2044,393,38,4,882,8,19,1598
6081607400,4919,2158,860,57,6,1506,45,37,2761
6081607500,6613,2075,1359,129,29,2542,70,62,4538
6081607600,4269,1647,1044,44,4,1225,72,14,2622
6081607701,3998,992,1362,67,5,1080,271,37,3006
6081607702,2893,744,989,63,5,762,200,7,2149
6081607800,3198,1211,720,29,6,931,91,23,1987
6081607900,3518,1506,388,62,5,1314,14,21,2012
6081608001,3534,1093,236,51,5,1956,6,23,2441
6081608002,3728,1362,217,34,2,1883,16,23,2366
6081608013,4188,1352,285,65,1,2194,17,44,2836
6081608023,2531,770,164,23,0,1402,14,14,1761
6081608024,3025,1095,146,34,3,1575,21,33,1930
6081608025,5931,1664,510,107,10,3298,42,44,4267
6081608100,3645,1128,289,54,2,1937,28,16,2517
6081608200,3749,1260,305,50,5,1872,31,19,2489
6081608300,3474,1010,269,61,3,1875,4,42,2464
6081608400,5664,1434,1897,100,11,1814,77,81,4230
6081608501,5013,2238,1171,64,3,1145,45,35,2775
6081608502,2750,996,537,49,3,965,10,21,1754
6081608600,4729,1744,787,83,5,1693,35,71,2985
6081608700,7670,3855,960,109,9,2051,33,66,3815
6081608800,6179,3279,497,36,1,1779,16,45,2900
6081608900,7261,3405,934,98,6,2190,33,91,3856
6081609000,2808,1457,354,28,1,718,15,34,1351
6081609100,1647,834,409,16,7,261,11,15,813
6081609201,3902,2489,487,17,12,621,18,23,1413
6081609202,4357,2232,686,70,13,1030,24,26,2125
6081609300,3499,2363,320,27,0,467,3,28,1136
6081609400,3458,2386,297,13,0,439,2,29,1072
6081609500,5161,2946,604,11,1,1172,11,32,2215
6081609601,3243,1824,293,45,0,800,3,35,1419
6081609602,1818,1094,167,15,0,378,8,14,724
6081609603,5510,3764,478,63,12,834,5,26,1746
6081609700,4462,3230,349,33,2,484,8,36,1232
6081609800,4733,2955,772,52,11,574,10,40,1778
6081609900,3068,2191,452,7,2,245,15,14,877
6081610000,4782,2691,1077,73,6,612,29,19,2091
6081610100,2489,995,1112,30,1,206,19,15,1494
6081610201,5501,708,3929,100,17,480,114,21,4793
6081610202,5118,1997,1252,170,27,1372,9,43,3121
6081610203,3244,342,2562,62,4,160,46,13,2902
6081610302,4796,1558,2141,165,13,692,52,22,3238
6081610303,8278,3181,570,93,7,3857,18,56,5097
6081610304,4503,2014,416,75,0,1690,19,32,2489
6081610400,5580,1150,3822,72,7,299,72,29,4430
6081610500,4737,648,3680,46,2,208,52,20,4089
6081610601,5797,614,4662,76,4,259,67,24,5183
6081610602,3403,1407,1381,31,16,361,31,14,1996
6081610700,5200,2024,2109,173,10,562,55,31,3176
6081610800,4664,1025,2923,72,5,406,48,22,3639
6081610901,3115,981,1674,33,7,260,17,21,2134
6081610902,3631,1214,1906,43,5,291,14,15,2417
6081611000,5978,2860,2001,84,2,598,31,40,3118
6081611100,6423,4168,932,57,3,802,32,53,2255
6081611200,3013,1851,548,20,2,322,15,14,1162
6081611300,4891,2924,988,33,1,613,17,48,1967
6081611400,4453,2913,327,84,9,822,36,15,1540
6081611500,2735,1818,157,10,2,582,9,6,917
6081611600,2466,1416,304,37,4,483,45,10,1050
6081611700,6437,827,3604,714,9,864,212,31,5610
6081611800,4481,218,2895,716,3,162,387,11,4263
6081611901,4465,430,2761,454,4,385,286,21,4035
6081611902,6335,606,3568,1012,2,427,412,56,5729
6081612001,4120,155,3079,342,0,109,316,16,3965
6081612002,3249,222,2259,261,2,145,255,6,3027
6081612101,4174,881,2583,167,3,240,131,22,3293
6081612102,4187,426,2935,251,10,223,230,13,3761
6081612500,4728,2950,499,37,6,896,39,27,1778
6081612600,4653,3023,340,60,3,859,19,21,1630
6081612700,2291,1734,122,8,0,298,0,13,557
6081612800,3354,2538,149,9,2,421,3,15,816
6081612900,4728,3074,323,42,1,904,5,41,1654
6081613000,3279,2074,213,12,5,754,0,9,1205
6081613200,6846,5268,452,24,0,564,3,31,1578
6081613300,2759,2084,173,17,3,281,2,16,675
6081613400,3134,2449,277,20,0,201,3,19,685
6081613501,4148,2104,1597,21,8,213,7,18,2044
6081613502,6047,4465,843,34,12,267,5,15,1582
6081613600,6053,3859,1479,46,6,290,9,47,2194
6081613701,4312,3042,730,22,4,293,6,10,1270
6081613702,4899,2191,2266,42,3,226,2,30,2708
6081613800,4299,2788,1144,21,9,110,11,18,1511
6081613900,5963,3605,699,107,0,1059,34,38,2358
6081614000,6172,1563,1236,174,18,2687,68,29,4609
6081984300,0,0,0,0,0,0,0,0,0
6081990100,0,0,0,0,0,0,0,0,0
6083000101,5922,3090,2114,88,23,338,30,16,2832
6083000102,5386,2970,1709,71,12,316,3,31,2416
6083000103,3477,2694,401,9,2,160,3,20,783
6083000201,2651,1841,557,14,4,105,1,23,810
6083000202,2423,1293,796,41,10,151,2,19,1130
6083000301,2884,1457,1157,39,1,99,0,35,1427
6083000302,4136,2008,1723,66,14,171,1,23,2128
6083000400,4913,3448,905,51,21,206,6,38,1465
6083000501,3328,2743,359,10,5,65,1,22,585
6083000502,5946,4336,1045,32,15,175,0,38,1610
6083000600,4817,3276,1060,39,15,146,3,44,1541
6083000700,6536,4303,1562,58,12,241,9,53,2233
6083000801,4021,920,2831,49,14,73,0,25,3101
6083000805,1332,900,288,38,15,42,0,3,432
6083000806,5689,868,4512,90,20,79,1,28,4821
6083000900,3497,1577,1569,71,22,102,6,18,1920
6083001001,2665,1136,1269,51,6,90,3,20,1529
6083001002,3104,1442,1325,58,7,141,0,16,1662
6083001101,4422,1605,2478,38,20,103,2,22,2817
6083001102,4372,933,3178,45,7,76,2,37,3439
6083001203,2834,1929,570,28,6,142,4,14,905
6083001206,4238,1435,2416,47,17,157,1,10,2803
6083001208,4276,2957,816,62,17,172,6,19,1319
6083001306,3250,2440,512,31,7,117,10,20,810
6083001307,3867,2162,1305,48,8,140,4,34,1705
6083001308,3607,2501,719,37,10,139,3,25,1106
6083001403,1483,1234,145,8,6,20,3,6,249
6083001404,1663,1485,109,2,8,18,3,7,178
6083001500,2834,2445,188,13,12,48,4,15,389
6083001601,5405,2512,2476,23,26,155,1,24,2893
6083001604,4833,2268,2229,32,10,86,5,36,2565
6083001704,3101,1189,1719,20,1,78,2,16,1912
6083001706,4569,3162,1061,43,7,109,5,25,1407
6083001800,1120,467,589,2,15,6,1,5,653
6083001905,3172,2364,638,27,7,16,5,14,808
6083001907,940,613,254,5,5,4,2,4,327
6083001908,5303,3862,945,39,162,57,2,28,1441
6083001909,3914,2552,1099,33,10,61,0,27,1362
6083001910,2719,1719,803,14,13,54,0,10,1000
6083001911,2813,1431,1195,10,34,23,1,15,1382
6083001912,5269,3110,1706,30,30,115,5,34,2159
6083002005,5396,3194,1600,75,38,174,3,18,2202
6083002006,2790,1658,862,8,37,107,3,19,1132
6083002008,6580,3298,2560,86,29,221,10,20,3282
6083002009,4229,2242,1533,47,17,159,13,12,1987
6083002010,4583,2649,1428,47,21,167,7,22,1934
6083002011,5953,1790,3619,69,22,241,2,30,4163
6083002012,3209,1925,928,24,12,98,4,14,1284
6083002013,2887,1803,712,28,19,141,4,19,1084
6083002014,6335,2158,3111,123,25,605,11,36,4177
6083002015,4161,2146,1572,31,32,142,10,14,2015
6083002101,4754,877,3519,83,17,100,18,15,3877
6083002102,2435,642,1613,15,10,65,7,24,1793
6083002103,5044,954,3630,59,4,247,8,16,4090
6083002205,5395,651,4361,42,16,223,1,9,4744
6083002206,5358,939,4060,86,12,153,0,24,4419
6083002209,3635,405,3014,16,12,87,6,22,3230
6083002210,6401,1151,4530,52,16,465,8,15,5250
6083002211,6298,2128,3387,69,15,381,15,128,4170
6083002303,6535,220,5964,20,6,262,0,17,6315
6083002304,6478,223,5970,12,18,198,0,26,6255
6083002307,4994,624,3942,49,5,308,0,7,4370
6083002308,3688,945,2329,56,11,271,3,12,2743
6083002309,3849,160,3521,21,8,102,0,1,3689
6083002310,3452,100,3203,25,11,85,5,8,3352
6083002405,4373,140,4074,0,10,118,0,7,4233
6083002406,3583,173,3279,13,8,59,0,13,3410
6083002407,5039,195,4733,19,16,31,0,19,4844
6083002408,2222,96,2038,8,23,36,0,13,2126
6083002409,9707,1693,6700,180,33,796,10,54,8014
6083002410,6166,368,5493,30,15,155,3,21,5798
6083002503,2317,305,1877,21,25,34,0,3,2012
6083002504,6078,400,5436,16,17,139,2,10,5678
6083002703,4222,1199,2528,136,32,143,8,16,3023
6083002705,4634,1311,2782,162,31,129,14,14,3323
6083002706,6222,1185,4589,118,13,115,10,18,5037
6083002707,2526,1034,1182,92,24,49,4,6,1492
6083002708,2665,1280,1060,78,13,67,4,11,1385
6083002709,3474,645,2306,167,23,146,12,17,2829
6083002710,4365,579,3472,117,36,51,1,20,3786
6083002802,7574,2749,3726,266,33,464,16,21,4825
6083002806,2878,1117,1293,118,11,144,15,15,1761
6083002808,7314,4254,1916,249,36,301,51,54,3060
6083002809,4992,2675,1687,108,27,190,15,13,2317
6083002906,3974,2488,964,38,6,268,0,18,1486
6083002907,3883,2912,509,21,13,213,2,7,971
6083002909,5884,2674,2404,69,10,435,2,18,3210
6083002913,4090,2854,708,19,9,296,4,31,1236
6083002914,3295,2160,558,26,2,339,2,31,1135
6083002924,6055,2529,1421,116,1,1522,1,31,3526
6083002926,5492,2099,1774,142,14,1077,9,31,3393
6083002932,2449,1442,738,19,4,135,2,8,1007
6083002933,6742,2809,2116,82,6,1284,0,72,3933
6083002934,3620,1632,1143,47,5,584,0,26,1988
6083002935,3507,1519,1350,66,7,371,2,15,1988
6083002936,3953,1885,1044,58,0,611,4,72,2068
6083002937,3160,1474,854,79,12,523,1,43,1686
6083003001,6243,1693,3572,107,19,673,3,23,4550
6083003004,4820,2488,1693,37,5,358,9,32,2332
6083003005,5020,2200,2192,45,22,314,0,42,2820
6083003007,3766,2911,484,13,13,110,8,30,855
6083003102,3337,1684,1310,70,10,78,4,25,1653
6083980000,15,9,5,0,0,1,0,0,6
6083980100,3,0,2,0,0,0,0,0,3
6083980200,3533,1832,796,314,13,215,36,20,1701
6083980300,4909,1537,199,78,0,3048,4,6,3372
6083980400,2929,939,1271,468,64,158,6,5,1990
6083980500,29,19,6,0,1,0,0,0,10
6083990000,0,0,0,0,0,0,0,0,0
6085500100,7969,1442,3868,236,26,2054,26,36,6527
6085500200,5281,1554,1886,284,8,1194,21,61,3727
6085500300,4765,1705,1702,146,42,898,7,22,3060
6085500400,2476,1013,827,86,17,373,12,17,1463
6085500500,5506,2564,1431,122,15,945,12,38,2942
6085500600,5548,2346,1377,345,16,1083,10,40,3202
6085500800,4669,1613,1369,384,18,1054,9,24,3056
6085500901,4011,1162,894,309,13,1391,19,29,2849
6085500902,4957,1955,1895,290,41,556,35,10,3002
6085501000,5468,1285,2634,339,12,930,16,44,4183
6085501101,4305,1181,1481,132,11,1298,3,11,3124
6085501102,4437,915,2607,74,25,612,5,19,3522
6085501200,4129,857,2331,126,18,606,14,23,3272
6085501300,3786,1618,1127,166,17,623,11,44,2168
6085501401,3496,413,2459,134,14,357,12,17,3083
6085501402,2962,491,1945,77,12,345,14,16,2471
6085501501,4392,194,2683,94,8,1339,5,9,4198
6085501502,4734,621,2821,107,3,1014,22,17,4113
6085501601,3728,1022,1595,181,11,725,4,28,2706
6085501602,3441,607,1900,205,7,552,16,28,2834
6085501700,5155,668,3758,138,15,395,11,43,4487
6085501800,4852,1762,2311,72,23,407,14,31,3090
6085501901,2918,888,728,283,1,858,5,22,2030
6085501902,4176,1285,1406,225,8,1024,10,13,2891
6085502001,5010,1476,2297,155,10,812,11,55,3534
6085502002,5166,959,3272,153,20,564,3,27,4207
6085502101,5101,2108,1311,142,6,1176,29,18,2993
6085502103,4449,943,2382,225,10,683,33,20,3506
6085502104,2645,733,1117,123,8,474,22,17,1912
6085502202,3018,1721,506,73,4,548,17,12,1297
6085502203,4118,1664,931,173,4,1123,29,12,2454
6085502204,3220,671,1588,246,11,527,34,14,2549
6085502301,3338,1921,810,60,4,334,9,24,1417
6085502302,2995,1402,1016,71,13,323,7,10,1593
6085502400,7235,4358,1403,113,10,847,18,38,2877
6085502500,6540,4040,1215,65,4,761,5,41,2500
6085502601,2831,1916,330,21,4,410,4,7,915
6085502603,2655,1631,381,37,0,408,9,16,1024
6085502604,4494,2204,1057,144,10,744,24,35,2290
6085502701,5048,2374,1174,156,9,974,3,32,2674
6085502703,4744,2237,722,110,7,1375,0,41,2507
6085502704,4006,1792,468,49,8,1385,6,33,2214
6085502800,4422,2170,772,52,5,1142,5,15,2252
6085502901,6250,3049,1225,135,17,1421,21,40,3201
6085502902,7864,4212,1324,94,2,1611,12,32,3652
6085502903,5333,3134,845,47,7,955,9,21,2199
6085502906,4848,2060,1104,163,22,1168,20,46,2788
6085502907,3857,2074,540,33,9,917,29,25,1783
6085502908,6951,3011,1449,145,17,1872,8,46,3940
6085502909,5324,2219,1647,166,10,966,18,17,3105
6085502910,3908,1630,1185,101,7,756,12,22,2278
6085503001,4430,2761,684,50,2,627,11,28,1669
6085503002,3611,1935,851,86,4,526,4,12,1676
6085503003,5218,2635,1082,67,5,1039,15,27,2583
6085503105,2417,173,751,38,8,1397,1,4,2244
6085503110,4407,151,2837,83,5,1259,2,25,4256
6085503111,4739,198,1942,67,3,2463,7,10,4541
6085503112,4379,638,2589,137,3,867,6,30,3741
6085503113,4604,536,3464,96,7,393,0,16,4068
6085503116,5785,1384,1610,216,14,2258,13,31,4401
6085503117,2911,69,1675,23,2,1094,6,13,2842
6085503118,5223,364,2723,160,4,1841,31,26,4859
6085503121,4767,657,2821,344,23,779,22,36,4110
6085503122,4108,415,1431,177,16,1971,11,8,3693
6085503123,3889,873,1903,307,8,611,21,25,3016
6085503124,4723,814,2108,420,13,1200,13,13,3909
6085503125,3680,1123,928,146,6,1272,14,32,2557
6085503126,3943,856,807,122,5,1971,5,23,3087
6085503127,5065,1647,952,191,5,1968,13,26,3418
6085503207,4115,285,717,81,0,2945,22,19,3830
6085503208,3737,247,2179,67,6,1148,27,7,3490
6085503210,4114,211,1748,72,10,1967,10,15,3903
6085503211,4731,354,1523,109,3,2618,24,20,4377
6085503212,4117,264,1098,82,13,2565,18,1,3853
6085503213,4769,281,1569,89,9,2721,8,12,4488
6085503217,4406,148,2860,97,11,1216,11,28,4258
6085503218,4359,146,3103,94,4,948,13,23,4213
6085503219,2890,143,1225,71,5,1369,28,4,2747
6085503220,5635,433,3201,125,24,1716,12,24,5202
6085503221,2980,120,849,33,3,1898,12,6,2860
6085503222,4691,173,1966,84,8,2395,21,0,4518
6085503304,6537,258,2577,162,21,3421,13,10,6279
6085503305,6333,205,2475,84,10,3395,35,31,6128
6085503306,4069,100,2290,55,14,1541,13,3,3969
6085503312,3562,758,1263,101,9,1262,20,16,2804
6085503313,4600,570,860,105,7,2845,31,17,4030
6085503315,7722,490,2425,170,14,4402,25,14,7232
6085503321,4571,166,572,61,0,3668,12,15,4405
6085503322,4310,452,1491,193,17,2036,24,6,3858
6085503323,4712,408,1308,179,11,2639,17,28,4304
6085503324,3577,194,594,62,4,2602,18,13,3383
6085503325,4449,275,1085,94,6,2865,21,17,4174
6085503326,6625,401,681,65,4,5275,27,26,6224
6085503327,4856,764,1198,117,4,2611,9,18,4092
6085503329,3953,325,364,40,0,3108,6,18,3628
6085503330,7319,478,571,94,14,5978,0,13,6841
6085503331,3273,1034,667,91,4,1355,5,16,2239
6085503332,5435,2834,450,91,2,1861,8,25,2601
6085503333,4714,647,1216,140,11,2523,12,30,4067
6085503336,3370,170,1059,58,3,1998,14,21,3200
6085503337,3851,205,866,81,5,2613,5,21,3646
6085503338,4726,730,263,73,2,3505,7,20,3996
6085503339,4047,929,249,65,2,2634,4,12,3118
6085503401,4910,134,3703,50,5,955,29,8,4776
6085503402,4843,142,3159,117,16,1304,36,19,4701
6085503504,5888,110,4248,82,0,1356,41,15,5778
6085503506,6180,211,3827,124,11,1823,53,27,5969
6085503507,2224,33,1576,35,1,495,39,17,2191
6085503508,6172,329,4287,82,20,1288,42,27,5843
6085503509,3897,221,2190,83,2,1308,15,2,3676
6085503510,5901,375,4211,72,28,1127,7,23,5526
6085503511,3622,199,1506,52,11,1776,22,8,3423
6085503601,2993,645,1594,26,4,682,0,4,2348
6085503602,4735,278,2941,84,13,1315,10,30,4457
6085503703,3927,50,2784,71,2,964,26,9,3877
6085503707,5406,249,2590,116,11,2281,19,34,5157
6085503708,2686,129,540,38,3,1906,19,6,2557
6085503709,6878,285,2127,131,17,4204,23,19,6593
6085503710,3836,135,2436,65,13,1129,9,9,3701
6085503711,4632,129,3529,60,10,823,10,15,4503
6085503712,4217,255,1853,101,6,1884,19,8,3962
6085503713,3014,157,1772,80,2,926,15,10,2857
6085503802,8208,1069,3391,187,12,3244,18,40,7139
6085503803,4617,421,897,108,13,3000,18,21,4196
6085503804,5700,621,1438,138,14,3311,38,17,5079
6085503902,6023,579,3711,46,7,1538,14,29,5444
6085503903,3289,288,1470,46,12,1383,3,6,3001
6085504001,6022,380,4178,109,5,1235,9,27,5642
6085504002,5908,202,3556,101,21,1915,8,23,5706
6085504101,4217,439,2679,53,21,898,13,21,3778
6085504102,5818,505,3822,71,13,1276,16,26,5313
6085504201,5269,1775,1822,113,10,1244,27,35,3494
6085504202,4896,1513,1598,88,9,1439,25,25,3383
6085504307,5722,627,868,86,7,3954,24,13,5095
6085504308,4613,927,676,70,3,2663,20,20,3686
6085504311,8308,770,670,149,9,6448,13,29,7538
6085504314,4745,515,652,54,4,3338,25,7,4230
6085504315,6696,774,969,129,8,4613,15,25,5922
6085504316,4902,371,840,106,6,3437,19,11,4531
6085504317,4312,412,608,59,13,3075,24,19,3900
6085504318,7427,868,2156,130,17,4021,27,34,6559
6085504319,7917,700,1293,184,4,5482,15,24,7217
6085504320,2866,322,301,29,2,2100,25,12,2544
6085504321,5419,521,963,99,5,3634,27,16,4898
6085504322,5505,632,612,280,21,3743,19,54,4873
6085504323,5738,447,596,95,1,4377,17,37,5291
6085504410,4282,410,800,89,3,2822,14,6,3872
6085504411,5350,718,862,70,7,3479,21,24,4632
6085504412,4703,362,1073,95,7,2967,25,22,4341
6085504413,1906,173,104,25,0,1553,3,4,1733
6085504414,5059,429,295,59,3,4116,13,19,4630
6085504415,5218,703,458,60,8,3807,24,11,4515
6085504416,3758,438,432,75,10,2649,18,18,3320
6085504418,4852,352,1429,64,2,2801,54,31,4500
6085504421,4804,487,499,93,4,3475,16,27,4317
6085504422,3680,303,637,96,4,2502,19,3,3377
6085504423,2307,448,402,27,2,1293,25,29,1859
6085504424,4869,632,513,66,2,3444,20,11,4237
6085504505,11204,995,1012,184,5,8628,34,72,10209
6085504506,6951,687,700,112,15,5183,28,24,6264
6085504507,5973,645,1045,87,4,3964,19,17,5328
6085504508,3810,403,1242,225,9,1818,11,4,3407
6085504509,5600,355,271,88,18,4746,0,23,5245
6085504510,4119,246,336,191,5,3231,10,7,3873
6085504601,1031,318,310,25,16,285,21,1,713
6085504602,2056,322,1151,19,4,488,8,7,1734
6085504700,661,291,148,53,1,74,15,8,370
6085504802,5393,1206,1189,71,9,2633,28,35,4187
6085504805,7454,2591,1509,140,17,2748,30,48,4863
6085504806,2776,449,753,42,2,1379,44,7,2327
6085504807,6001,1416,469,91,0,3780,13,35,4585
6085504808,1623,325,688,94,6,445,16,7,1298
6085504902,4579,749,494,185,3,2932,9,20,3830
6085504903,5353,1045,276,92,3,3695,6,40,4308
6085505006,11912,2652,803,191,9,7806,13,72,9260
6085505007,3760,716,881,125,8,1850,10,12,3044
6085505010,4315,793,644,94,8,2557,20,27,3522
6085505011,5413,1170,687,139,13,3163,13,25,4243
6085505012,2861,752,144,41,0,1824,0,10,2109
6085505013,5705,901,480,168,7,3954,34,23,4804
6085505014,6446,1355,1323,355,13,3068,65,45,5091
6085505015,4580,894,1373,75,5,2057,27,5,3686
6085505100,4616,1021,1351,240,11,1760,18,32,3595
6085505202,7715,1726,2448,269,16,2928,21,52,5989
6085505203,5673,2283,1218,187,5,1546,20,46,3390
6085505301,5484,1119,1447,113,11,2533,38,37,4365
6085505302,4690,1442,861,60,9,2044,32,25,3248
6085505303,6127,1231,1813,112,8,2713,23,32,4896
6085505304,3281,1030,579,26,1,1458,14,18,2251
6085505305,6114,1706,1178,101,11,2857,12,35,4408
6085505401,6492,1418,917,100,13,3775,29,25,5074
6085505402,3090,938,638,48,5,1319,22,3,2152
6085505403,8695,2235,1372,157,8,4517,20,62,6460
6085505500,4217,1623,927,63,4,1304,5,24,2594
6085505600,4338,1942,789,100,7,1206,8,28,2396
6085505700,5738,2488,1406,151,15,1306,26,50,3250
6085505800,4027,1919,956,117,7,761,14,25,2108
6085505901,3794,1409,620,69,5,1487,10,28,2385
6085505902,3829,1543,789,168,5,1029,9,39,2286
6085506000,4938,1927,872,83,1,1722,17,50,3011
6085506101,4829,1885,688,92,6,1882,19,18,2944
6085506102,4574,1523,432,53,0,2327,5,28,3051
6085506103,5052,1326,544,59,4,2837,1,36,3726
6085506202,7512,2585,654,127,5,3769,25,25,4927
6085506203,7138,1160,810,146,12,4752,12,22,5978
6085506204,6423,1550,796,77,7,3710,11,21,4873
6085506301,5631,1652,1461,359,5,1844,21,50,3979
6085506302,6210,2321,1104,177,3,2191,30,68,3889
6085506304,5412,1288,1512,252,7,2088,55,35,4124
6085506305,7257,1604,3048,539,16,1733,39,28,5653
6085506401,5096,1891,1226,193,23,1445,2,53,3205
6085506402,5719,2130,1793,294,9,1172,22,42,3589
6085506502,4723,2701,837,91,8,773,3,27,2022
6085506503,6802,2980,1707,207,13,1405,34,41,3822
6085506504,2712,398,1514,196,3,487,30,11,2314
6085506505,4788,972,2310,241,6,1025,30,20,3816
6085506601,4726,1605,1024,116,2,1666,13,41,3121
6085506603,4084,1834,443,36,8,1468,17,21,2250
6085506604,7714,3062,860,194,9,3095,2,33,4652
6085506605,4320,1387,1092,108,3,1472,12,29,2933
6085506606,4537,1744,1018,88,8,1421,13,13,2793
6085506701,4093,1891,395,76,10,1423,10,26,2202
6085506702,5956,2507,1278,209,20,1539,8,32,3449
6085506703,3937,2013,673,117,16,838,17,22,1924
6085506801,6454,3859,554,50,9,1518,6,36,2595
6085506802,5533,2971,655,41,7,1464,0,54,2562
6085506803,7357,3295,1447,116,7,2099,23,30,4062
6085506804,3936,2304,332,37,1,965,10,14,1632
6085506900,8031,5333,561,20,12,1609,3,41,2698
6085507002,3012,2317,175,10,5,322,0,24,695
6085507003,2793,2004,166,7,0,442,1,13,789
6085507004,4154,3024,310,29,7,544,0,21,1130
6085507100,3020,2020,365,30,5,415,2,15,1000
6085507203,2891,1678,326,16,3,629,1,35,1213
6085507205,4853,3003,430,19,0,1146,5,28,1850
6085507206,2928,1925,202,21,7,574,2,16,1003
6085507301,6725,2944,292,13,7,3138,13,23,3781
6085507302,2883,1606,118,12,2,969,3,21,1277
6085507401,5709,1621,117,24,9,3693,14,22,4088
6085507402,4091,1807,274,24,0,1772,3,30,2284
6085507500,5984,1631,124,10,1,3971,3,20,4353
6085507600,5815,2153,185,17,3,3229,1,29,3662
6085507701,4092,885,134,8,4,2931,4,10,3207
6085507702,6107,1393,134,14,0,4347,0,16,4714
6085507704,3466,1095,150,27,6,2018,6,30,2371
6085507705,4560,1388,216,28,4,2707,0,23,3172
6085507805,5180,1335,434,39,4,3147,4,45,3845
6085507806,5824,714,204,20,11,4711,1,10,5110
6085507807,3191,394,91,17,2,2625,0,6,2797
6085507808,5674,906,126,38,3,4397,0,17,4768
6085507903,4888,790,85,9,1,3870,0,8,4098
6085507904,3404,689,84,2,7,2493,8,18,2715
6085507905,6188,871,282,70,3,4801,16,28,5317
6085507906,4508,713,109,11,1,3531,1,7,3795
6085508003,2266,549,119,38,0,1457,1,12,1717
6085508004,6561,1182,368,49,2,4672,8,48,5379
6085508005,4321,978,118,22,1,3068,0,2,3343
6085508006,3690,755,162,17,7,2588,2,20,2935
6085508101,6726,1369,274,26,8,4853,5,13,5357
6085508102,4143,950,192,45,6,2799,0,20,3193
6085508203,5573,1852,291,37,5,3117,1,48,3721
6085508204,4339,1249,266,40,2,2589,13,18,3090
6085508205,3862,965,517,80,2,2118,14,31,2897
6085508206,4341,1651,317,26,6,2130,7,26,2690
6085508301,4689,1884,239,52,1,2271,9,16,2805
6085508303,2631,1209,58,3,0,1247,1,7,1422
6085508305,5103,906,797,146,2,3103,8,24,4197
6085508306,3192,1280,286,47,0,1422,2,12,1912
6085508401,7168,2659,504,60,3,3516,5,26,4509
6085508403,3092,1397,148,27,0,1313,2,28,1695
6085508404,6884,2591,542,83,9,3232,11,31,4293
6085508503,6909,1654,829,71,14,4119,26,23,5255
6085508505,4741,1591,476,66,7,2383,5,17,3150
6085508507,3191,570,419,63,14,2048,0,16,2621
6085508508,5894,1142,1660,64,16,2766,21,46,4752
6085508509,4231,924,565,77,5,2510,0,19,3307
6085508510,3428,669,754,57,12,1826,8,18,2759
6085508601,4169,1516,649,30,0,1729,3,35,2653
6085508602,5461,1939,715,81,2,2436,8,23,3522
6085508705,4581,925,678,67,7,2694,15,19,3656
6085508706,4505,983,419,94,7,2792,8,18,3522
6085508707,4095,935,847,83,8,2052,24,21,3160
6085508708,4653,828,307,64,1,3262,5,24,3825
6085508800,3635,811,1286,38,8,1290,20,28,2824
6085508900,4887,815,1838,84,14,1940,34,29,4072
6085509001,3355,702,1522,51,1,928,13,24,2653
6085509002,3833,835,1467,57,4,1296,15,22,2998
6085509102,5094,1314,370,57,5,3156,10,25,3780
6085509106,4678,1290,1023,63,1,2106,7,27,3388
6085509107,5242,999,1436,64,9,2529,18,32,4243
6085509108,4654,1471,1077,66,2,1730,25,27,3183
6085509109,5663,1958,585,50,2,2749,4,32,3705
6085509110,3633,1439,299,77,5,1609,4,29,2194
6085509111,4326,1599,724,90,12,1620,20,23,2727
6085509201,5324,2157,754,101,21,1897,35,46,3167
6085509202,4655,1856,810,71,15,1619,6,24,2799
6085509302,3122,1634,410,86,2,752,10,21,1488
6085509303,3536,1479,465,70,2,1339,5,21,2057
6085509304,3316,1082,708,46,6,1249,17,23,2234
6085509401,3754,1438,548,72,1,1478,4,20,2316
6085509403,5095,1407,2104,72,6,1307,9,36,3688
6085509404,6651,2050,1316,98,5,2855,9,42,4601
6085509500,5553,1961,1674,80,2,1477,14,44,3592
6085509600,3614,1760,461,63,5,1119,1,8,1854
6085509700,3230,1722,471,30,2,786,5,21,1508
6085509801,6196,3066,729,65,2,1884,9,60,3130
6085509802,2967,1351,345,27,1,1013,6,20,1616
6085509901,2244,1313,129,5,3,633,6,27,931
6085509902,5301,2495,512,46,0,1887,13,40,2806
6085510001,6295,3284,264,29,4,2281,6,37,3011
6085510002,3754,1886,205,16,3,1393,1,23,1868
6085510100,3016,1670,144,21,0,1005,2,13,1346
6085510200,4549,2443,181,26,2,1554,8,38,2106
6085510300,4621,2618,252,25,7,1428,11,21,2003
6085510400,3631,1690,181,26,8,1454,6,30,1941
6085510500,5371,3020,225,24,5,1775,0,23,2351
6085510600,6286,2795,753,99,5,2236,5,33,3491
6085510700,5487,2064,496,124,4,2394,10,52,3423
6085510801,5999,2469,295,49,0,2798,8,55,3530
6085510802,1971,986,127,26,0,697,14,20,985
6085510803,2781,1123,136,40,2,1319,5,30,1658
6085510900,5404,2403,388,65,8,2101,3,40,3001
6085511000,6939,2659,536,115,1,3156,17,33,4280
6085511100,5513,2698,253,29,1,2195,9,47,2815
6085511200,4706,2905,222,51,0,1121,18,44,1801
6085511301,3860,2311,435,121,0,719,16,10,1549
6085511302,4118,2441,240,76,2,1109,5,13,1677
6085511400,3649,2118,168,31,5,1031,11,30,1531
6085511501,4914,2690,399,123,7,1299,12,55,2224
6085511502,3176,2005,283,60,3,562,21,25,1171
6085511608,3705,1710,450,200,6,962,59,42,1995
6085511609,3481,1819,275,110,0,1052,4,12,1662
6085511701,4285,2476,187,13,1,1326,7,33,1809
6085511702,2906,1705,108,12,2,900,0,26,1201
6085511704,4702,2552,186,13,2,1667,15,19,2150
6085511705,1716,905,214,62,1,431,6,16,811
6085511707,2959,1847,176,19,2,727,3,23,1112
6085511800,4185,3145,420,28,11,264,2,26,1040
6085511905,3243,1387,225,18,6,1423,5,9,1856
6085511907,4033,1562,338,35,1,1899,0,11,2471
6085511910,3097,1893,210,6,3,754,2,11,1204
6085511911,4885,2678,490,198,6,1161,8,29,2207
6085511912,5348,1999,296,42,6,2754,5,16,3349
6085511913,4336,2496,456,27,15,1066,3,17,1840
6085511914,5664,3066,514,81,9,1583,3,33,2598
6085511915,3562,963,1626,135,15,664,7,11,2599
6085511916,4836,2099,851,71,11,1503,12,24,2737
6085511917,5060,1704,225,32,5,2832,1,14,3356
6085511918,3545,1701,254,14,4,1338,8,17,1844
6085512001,7025,1465,1556,204,18,3442,22,36,5560
6085512005,6601,2857,1640,192,13,1479,21,34,3744
6085512019,4653,1253,1436,191,12,1506,18,31,3400
6085512021,6292,1713,1765,206,15,2232,28,44,4579
6085512022,5877,1166,2260,207,13,2003,9,16,4711
6085512023,5655,1044,2742,290,12,1274,27,28,4611
6085512024,4698,1847,1218,331,6,981,12,20,2851
6085512025,3232,1292,779,58,14,880,4,23,1940
6085512026,3949,1074,1362,184,0,1115,18,30,2875
6085512027,4371,1504,1331,136,13,1128,11,36,2867
6085512029,6813,2408,2096,200,12,1619,43,49,4405
6085512030,3096,1327,671,65,2,829,18,11,1769
6085512031,4447,1938,995,82,14,1114,25,16,2509
6085512032,3487,1130,1145,105,3,919,11,13,2357
6085512034,3179,1102,891,103,4,844,14,27,2077
6085512035,4234,1664,1097,89,7,1045,20,18,2570
6085512036,5047,1651,1155,243,2,1597,26,58,3396
6085512037,3149,1152,883,72,1,825,3,23,1997
6085512038,3086,796,1031,124,11,967,20,19,2290
6085512039,5097,822,1542,158,10,2368,14,13,4275
6085512042,2972,271,1230,131,12,1204,40,8,2701
6085512043,6028,455,3762,295,12,1387,10,24,5573
6085512045,5635,2343,1458,91,6,1353,11,32,3292
6085512047,5379,2350,1480,142,11,1035,7,28,3029
6085512052,4119,1856,1060,149,1,783,19,16,2263
6085512053,4687,1654,1724,145,20,849,23,18,3033
6085512054,4373,731,1876,250,11,1323,12,27,3642
6085512055,2998,583,928,130,9,1178,19,25,2415
6085512056,4084,536,1982,119,5,1287,30,14,3548
6085512057,3883,557,1699,101,7,1383,26,21,3326
6085512058,6070,1348,1351,403,14,2536,31,82,4722
6085512059,6299,2201,1659,150,10,1822,14,57,4098
6085512100,1755,566,787,9,5,304,1,3,1189
6085512200,4790,2724,1073,48,12,579,20,37,2066
6085512305,4761,2345,1119,60,26,914,10,30,2416
6085512307,6841,3751,1873,61,24,634,13,38,3090
6085512308,8984,4474,2058,171,14,1694,30,58,4510
6085512309,4983,2682,1247,84,8,595,8,35,2301
6085512310,5163,1503,2445,160,8,798,15,17,3660
6085512311,4123,1622,1503,70,17,679,10,20,2501
6085512312,3756,1695,1222,115,7,476,32,23,2061
6085512313,4151,1326,2102,110,12,360,23,24,2825
6085512314,6940,2561,3134,114,20,718,25,41,4379
6085512401,4830,2060,2173,42,22,316,6,25,2770
6085512402,5136,2224,2253,29,12,369,16,16,2912
6085512505,7643,1648,4657,170,18,832,28,40,5995
6085512509,6469,1721,3102,187,6,1105,14,27,4748
6085512510,7791,2963,3270,162,20,962,26,55,4828
6085512511,3716,1375,1884,45,8,216,6,16,2341
6085512512,4458,952,3108,34,13,182,12,31,3506
6085512513,4133,609,3045,78,7,272,6,19,3524
6085512514,3404,571,2080,114,15,482,7,13,2833
6085512515,5695,2491,1757,141,9,912,11,26,3204
6085512516,4069,1814,1596,56,13,348,10,30,2255
6085512602,3531,1158,2050,23,15,159,4,7,2373
6085512603,5303,410,4585,84,16,85,12,26,4893
6085512604,5101,547,4142,70,9,176,6,38,4554
6085513000,14272,6781,1715,801,14,3674,158,137,7491
6085513500,960,505,331,11,2,36,6,18,455
6087100100,2294,1659,324,32,9,89,0,17,635
6087100200,6825,4176,1769,86,21,341,20,29,2649
6087100300,4020,2663,566,99,24,376,6,24,1357
6087100400,8452,2227,3552,678,5,1539,4,20,6225
6087100500,5490,3376,855,76,6,785,9,43,2114
6087100600,3358,2383,482,28,8,183,1,22,975
6087100700,2275,1381,499,78,19,135,0,16,894
6087100801,3956,1863,1486,90,26,202,9,39,2093
6087100802,3010,2132,516,33,5,92,0,15,878
6087100900,4274,3012,761,49,12,145,2,42,1262
6087101001,4030,2201,1061,52,27,393,3,43,1829
6087101002,4771,2179,1768,97,35,390,4,41,2592
6087101100,5501,3947,722,86,19,259,5,45,1554
6087101200,3461,2344,577,68,33,202,4,28,1117
6087110101,2788,597,1981,11,5,146,0,13,2191
6087110102,4629,732,3676,24,11,97,2,17,3897
6087110201,2796,369,2311,3,14,27,3,19,2427
6087110202,4899,756,3772,22,17,210,2,12,4143
6087110301,4327,397,3757,19,18,60,3,12,3930
6087110302,2879,167,2615,20,8,19,0,17,2712
6087110401,3681,198,3395,8,12,32,0,12,3483
6087110402,4774,800,3394,39,11,387,1,18,3974
6087110503,3862,293,3440,18,3,53,0,8,3569
6087110504,2511,200,2214,5,4,46,4,11,2311
6087110505,4580,550,3856,15,14,60,1,8,4030
6087110506,3189,573,2410,16,5,111,0,9,2616
6087110601,5322,588,4509,17,12,123,0,16,4734
6087110602,2828,231,2455,18,5,93,0,1,2597
6087110700,3307,752,2355,15,4,73,4,13,2555
6087120200,4680,3496,705,47,15,104,10,23,1184
6087120301,5019,3987,502,27,15,115,1,45,1032
6087120302,3152,2477,376,20,17,34,4,30,675
6087120400,5411,4089,655,33,24,113,11,57,1322
6087120500,6007,4717,557,22,8,224,7,49,1290
6087120600,4735,3804,493,21,27,81,5,39,931
6087120700,4567,3472,605,30,16,94,3,48,1095
6087120800,6157,4821,569,23,11,310,3,40,1336
6087120901,3450,2595,372,23,14,214,5,19,855
6087120902,5231,3511,832,32,13,397,2,56,1720
6087121000,3579,2871,328,6,5,148,2,21,708
6087121100,3041,2297,471,16,9,74,1,16,744
6087121200,6914,5234,726,52,9,327,27,58,1680
6087121300,4210,2519,1247,39,8,145,7,25,1691
6087121401,2691,1634,660,42,8,137,7,16,1057
6087121402,4109,2166,1437,24,14,214,9,43,1943
6087121403,3355,2034,938,50,16,106,8,19,1321
6087121501,2859,1974,580,25,12,68,3,18,885
6087121502,2085,1204,632,39,1,71,3,4,881
6087121601,3455,2468,616,19,9,84,10,28,987
6087121602,2777,1698,814,19,14,70,3,15,1079
6087121701,4059,2522,992,44,11,211,4,34,1537
6087121702,3462,1938,1061,35,18,216,1,14,1524
6087121801,2007,1474,288,23,0,77,0,17,533
6087121802,2660,1789,581,23,8,110,1,16,871
6087122001,5135,3740,850,37,9,172,4,40,1395
6087122002,3548,2738,398,32,21,112,6,40,810
6087122004,2941,2005,570,23,23,147,11,22,936
6087122005,3889,2597,807,30,12,189,0,17,1292
6087122100,3315,2324,659,15,19,96,0,19,991
6087122202,2235,1689,304,13,5,83,10,14,546
6087122203,3688,2767,504,18,4,175,5,13,921
6087122204,3025,2108,647,20,6,86,1,5,917
6087122205,3205,2508,394,25,7,93,2,22,697
6087122300,3965,2248,1399,17,9,117,3,5,1717
6087122401,2956,1765,897,25,3,95,3,21,1191
6087122402,4280,3034,918,22,18,66,1,33,1246
6087122500,6717,1009,5311,32,14,175,4,32,5708
6087123100,2640,940,1567,3,5,39,3,2,1700
6087123300,1561,542,959,2,4,15,0,4,1019
6087990100,0,0,0,0,0,0,0,0,0
6089010100,1680,1113,268,59,58,68,8,12,567
6089010200,2225,1764,162,41,31,52,3,16,461
6089010300,4125,2917,489,71,74,242,3,13,1208
6089010400,4452,3295,500,97,100,98,16,12,1157
6089010500,4927,3483,625,112,140,135,17,27,1444
6089010601,2495,1966,210,18,30,103,6,8,529
6089010602,5683,4430,560,70,66,162,7,20,1253
6089010603,906,785,45,0,14,9,0,0,121
6089010702,3731,2978,325,42,53,95,8,19,753
6089010703,3423,2558,370,57,46,162,9,19,865
6089010704,4623,3363,540,83,105,151,5,15,1260
6089010803,5768,4072,613,125,55,442,6,44,1696
6089010804,2279,1791,196,33,14,88,0,13,488
6089010805,5012,3823,563,59,79,143,9,45,1189
6089010806,3128,2410,301,50,48,84,1,15,718
6089010807,4647,3699,401,28,53,157,12,41,948
6089010900,4248,2944,520,75,120,225,9,36,1304
6089011001,1674,1332,119,5,27,36,3,12,342
6089011002,5429,4031,600,39,156,120,4,40,1398
6089011100,3467,2644,322,19,97,88,0,13,823
6089011209,6384,3938,949,108,161,675,34,25,2446
6089011300,5379,3512,967,51,131,270,7,45,1867
6089011401,3969,2943,429,32,68,198,6,11,1026
6089011402,3279,2495,338,28,36,160,1,15,784
6089011403,3255,2443,316,22,54,161,4,26,812
6089011501,3412,2502,447,12,71,80,3,30,910
6089011502,2631,2097,219,7,46,44,12,8,534
6089011600,3788,2818,393,18,107,126,2,29,970
6089011701,2695,2073,244,24,67,51,6,26,622
6089011702,3449,2534,355,34,106,135,5,19,915
6089011703,3134,2387,280,11,82,57,3,15,747
6089011801,2482,2085,177,2,36,34,0,8,397
6089011802,2540,2077,190,9,50,52,5,7,463
6089011803,2818,2265,208,17,92,61,2,26,553
6089011900,4910,4051,350,27,60,67,11,42,859
6089012000,5357,3683,823,55,178,184,20,26,1674
6089012101,4915,3566,663,26,129,119,7,36,1349
6089012102,2152,1659,263,23,53,25,0,5,493
6089012200,5579,4223,690,22,124,81,3,20,1356
6089012301,2604,1779,537,4,57,25,3,17,825
6089012302,5426,4084,593,31,139,209,11,35,1342
6089012303,4009,3155,350,20,88,93,2,5,854
6089012400,3464,2773,280,11,65,64,13,22,691
6089012500,1408,1165,89,5,18,17,1,14,243
6089012603,4295,3605,268,10,108,50,9,23,690
6089012604,2205,1839,155,7,41,36,0,13,366
6089012605,1985,1701,114,5,16,18,4,10,284
6089012606,3346,2540,312,42,155,48,7,24,806
6089012701,4154,3132,470,8,218,23,6,9,1022
6089012702,3209,2372,532,7,125,16,10,26,837
6091010000,3236,2615,377,7,18,7,1,25,621
6093000100,1234,399,784,2,2,7,1,0,835
6093000200,1671,890,623,7,24,36,0,3,781
6093000300,3966,3125,376,22,96,84,2,12,841
6093000600,1759,1288,177,4,68,15,2,9,471
6093000701,3884,3077,285,39,106,59,0,34,807
6093000702,4525,2915,595,33,489,77,7,14,1610
6093000703,3291,2410,363,32,123,66,3,23,881
6093000800,3370,2628,214,10,243,23,5,6,742
6093000901,4135,2710,646,173,61,175,3,27,1425
6093000902,3339,2563,338,46,42,150,1,28,776
6093001001,1299,1115,67,12,10,20,0,14,184
6093001002,1698,1411,161,7,13,22,0,8,287
6093001003,3914,3144,341,49,26,66,4,10,770
6093001100,2183,1692,260,17,24,30,4,20,491
6093001200,1279,1035,102,7,13,12,4,6,244
6093001300,2529,1655,195,11,417,24,2,51,874
6095250103,4804,947,1170,930,16,1394,49,27,3857
6095250104,2257,605,362,342,1,753,18,23,1652
6095250105,7243,797,959,1332,16,3596,88,41,6446
6095250106,3684,693,424,531,12,1752,27,31,2991
6095250200,4280,1063,1227,839,24,786,36,16,3217
6095250300,3539,871,1267,511,19,605,55,6,2668
6095250400,3372,1031,1190,518,23,302,49,29,2341
6095250501,2215,738,758,257,14,281,17,14,1477
6095250502,3266,935,706,542,8,719,50,22,2331
6095250601,4833,842,2122,957,15,472,67,64,3991
6095250604,3848,1023,649,660,15,1148,22,40,2825
6095250605,4012,1138,613,666,0,1241,38,31,2874
6095250701,3473,548,1712,678,0,331,14,15,2925
6095250801,4916,1560,976,1171,17,784,67,30,3356
6095250900,3038,625,606,1114,16,441,14,18,2413
6095251000,2742,988,738,559,17,140,8,39,1754
6095251100,3490,621,1672,651,43,246,51,19,2869
6095251200,3639,706,1520,757,20,414,50,13,2933
6095251300,3168,1505,823,266,14,260,8,41,1663
6095251400,6010,1879,1603,964,16,1000,77,43,4131
6095251500,3992,777,1705,827,14,358,39,41,3215
6095251600,2694,753,887,568,16,213,20,74,1941
6095251701,3800,1063,1085,875,24,421,25,72,2737
6095251702,2819,524,597,747,13,748,19,18,2295
6095251802,3132,443,1071,720,7,731,19,14,2689
6095251803,5526,763,2549,575,13,1305,56,47,4763
6095251804,3621,312,1051,386,9,1649,35,20,3309
6095251901,5264,752,1492,1574,13,1100,49,54,4512
6095251902,6123,473,2504,1264,17,1414,98,33,5650
6095251903,5906,394,2119,1747,20,1275,85,35,5512
6095252000,4361,3100,525,90,9,277,11,28,1261
6095252102,3992,2337,749,169,13,339,22,19,1655
6095252103,5643,1018,867,1216,16,2069,39,67,4625
6095252104,5981,2720,747,379,16,1564,8,34,3261
6095252105,3204,1943,437,114,8,451,7,17,1261
6095252106,4122,2319,583,292,3,539,29,17,1803
6095252107,3535,2101,567,194,4,318,11,19,1434
6095252108,3067,1847,502,205,9,240,15,3,1220
6095252203,4964,2080,774,401,6,1273,20,24,2884
6095252204,5267,2279,800,337,7,1409,10,27,2988
6095252205,8669,2232,1781,830,19,2965,83,40,6437
6095252206,4908,1660,899,404,9,1558,33,25,3248
6095252305,6084,2299,1286,634,19,1356,45,45,3785
6095252306,3523,1487,866,406,14,398,52,19,2036
6095252310,3067,1722,389,237,4,493,13,26,1345
6095252311,4623,1707,829,680,5,995,39,25,2916
6095252312,3443,1293,814,446,20,516,50,12,2150
6095252313,5887,2163,994,1023,22,1161,49,26,3724
6095252314,4599,1337,1390,761,25,606,85,15,3262
6095252315,4283,1294,941,677,6,934,45,26,2989
6095252316,3622,840,1069,699,8,680,41,29,2782
6095252317,11656,2725,2097,1935,18,3764,106,57,8931
6095252401,4855,989,2637,597,30,357,13,41,3866
6095252402,5419,1041,2698,638,34,644,35,20,4378
6095252501,2870,620,1384,435,8,213,28,25,2250
6095252502,1896,509,749,294,16,175,3,10,1387
6095252604,3652,723,1343,802,22,420,64,19,2929
6095252605,5985,861,3073,886,21,701,75,41,5124
6095252606,5423,904,2664,993,27,497,35,26,4519
6095252607,3836,586,2174,541,2,318,37,17,3250
6095252608,4190,714,1991,759,9,438,45,8,3476
6095252610,3317,863,1141,507,7,413,82,25,2454
6095252611,3607,625,1362,934,12,319,76,34,2982
6095252702,7039,1790,1764,1250,24,1576,54,33,5249
6095252703,4263,753,1423,837,22,850,77,22,3510
6095252704,5325,1212,1643,988,31,925,75,43,4113
6095252705,6144,1628,1809,1095,12,979,50,63,4516
6095252706,4182,973,1109,640,14,1033,68,42,3209
6095252707,5044,1468,1642,813,11,620,61,24,3576
6095252801,2635,1348,559,219,12,150,32,7,1287
6095252802,1472,695,305,238,13,79,9,7,777
6095252903,4475,3166,764,27,16,145,13,41,1309
6095252904,8478,3632,1946,571,42,1579,36,51,4846
6095252908,3825,1813,1090,288,21,241,12,41,2012
6095252909,4421,2199,944,254,13,531,44,31,2222
6095252910,5788,2873,1531,412,10,386,30,29,2915
6095252911,5070,3295,762,349,28,303,42,20,1775
6095252912,5612,3174,1028,346,14,491,30,24,2438
6095252913,4998,2596,1110,369,8,431,34,24,2402
6095252914,5592,2293,1497,484,3,606,45,53,3299
6095252915,6318,2716,1213,518,7,1158,51,68,3602
6095253000,6640,1236,2087,2945,88,131,27,26,5404
6095253101,5302,2815,1589,126,24,293,29,27,2487
6095253105,6489,2353,2298,597,12,569,82,46,4136
6095253106,3427,1492,1038,306,13,263,20,19,1935
6095253107,5999,2467,2056,562,32,343,42,35,3532
6095253108,4353,2001,1310,284,32,354,18,37,2352
6095253201,4821,3388,867,106,18,117,13,24,1433
6095253203,4179,2304,1214,144,8,177,20,13,1875
6095253205,3091,1348,1134,180,12,163,25,27,1743
6095253206,3688,2086,687,134,7,387,21,35,1602
6095253207,2332,1343,454,122,6,183,16,31,989
6095253208,5173,1783,2395,385,18,236,35,24,3390
6095253300,2527,1253,1070,18,8,58,4,15,1274
6095253402,8381,3228,4037,215,39,324,31,58,5153
6095253403,5369,2690,2034,112,21,185,21,25,2679
6095253404,5815,2580,2402,241,27,200,13,51,3235
6095253501,6327,3899,977,671,25,512,20,19,2428
6095253502,4637,2928,1087,161,33,95,19,16,1709
6095980000,4,0,1,1,0,1,0,1,4
6097150100,2148,1528,470,2,9,30,1,9,620
6097150203,4529,3314,841,28,19,128,8,20,1215
6097150204,3559,2612,636,21,5,119,13,10,947
6097150205,3977,2682,993,29,13,98,6,12,1295
6097150206,1247,1041,102,5,3,25,3,10,206
6097150303,4013,3339,423,13,3,95,7,19,674
6097150304,5834,3057,2319,13,18,166,9,29,2777
6097150305,5353,1677,3373,42,16,76,7,11,3676
6097150306,3746,2070,1347,25,16,80,14,9,1676
6097150501,2457,1973,252,13,11,52,5,16,484
6097150502,1736,1004,600,8,3,32,8,13,732
6097150601,4411,2139,1692,113,14,187,10,36,2272
6097150602,4347,2812,1010,53,7,185,8,25,1535
6097150603,7277,4287,2096,92,25,328,12,46,2990
6097150607,5157,3473,758,48,7,467,3,29,1684
6097150609,4988,2940,1389,54,12,298,29,33,2048
6097150610,3956,2665,759,57,15,208,5,22,1291
6097150611,4180,2422,1123,83,10,272,13,42,1758
6097150612,4449,3059,786,53,10,263,10,31,1390
6097150701,4744,3112,1071,65,20,157,14,25,1632
6097150702,5187,4177,451,28,9,179,8,28,1010
6097150800,4941,3710,773,43,16,124,10,32,1231
6097150901,5104,2818,1682,74,29,140,34,30,2286
6097150902,3406,2643,444,27,9,69,1,15,763
6097151000,3359,2480,568,12,14,70,8,25,879
6097151100,4855,3556,817,58,19,82,21,28,1299
6097151203,5269,3407,1160,81,23,186,18,32,1862
6097151204,3651,2268,912,44,20,149,5,20,1383
6097151205,2786,2019,481,35,22,51,7,21,767
6097151206,5137,2443,1945,66,53,254,15,42,2694
6097151301,4467,2051,1829,81,44,180,23,20,2416
6097151305,5533,2393,2338,166,18,236,47,38,3140
6097151306,3795,2180,1090,51,18,199,8,31,1615
6097151307,5218,3351,1115,90,16,288,10,38,1867
6097151308,4870,3232,868,76,29,317,27,25,1638
6097151309,6361,4030,1237,120,26,570,9,24,2331
6097151310,6959,2579,1967,234,21,1726,14,128,4380
6097151311,6792,3975,1663,143,25,487,10,49,2817
6097151403,4932,2062,1729,140,44,673,16,23,2870
6097151404,3290,719,2225,66,30,134,1,24,2571
6097151405,6755,1747,4270,119,75,282,40,24,5008
6097151406,3669,1205,1819,122,21,277,21,26,2464
6097151503,3446,2877,246,14,6,132,3,18,569
6097151504,3705,2699,512,74,18,123,17,18,1006
6097151505,1451,1186,133,3,5,45,4,4,265
6097151506,5469,3593,1081,98,21,267,78,25,1876
6097151601,2983,2641,164,12,14,58,2,7,342
6097151602,3212,2823,203,24,2,65,7,17,389
6097151701,3327,1945,882,68,32,122,61,27,1382
6097151702,3876,2633,767,77,12,125,49,9,1243
6097151800,5056,3664,818,45,31,117,15,17,1392
6097151900,2921,1688,873,51,33,91,12,20,1233
6097152000,2168,1111,699,77,25,89,16,19,1057
6097152100,2804,1526,783,133,33,184,5,11,1278
6097152201,3839,2290,974,85,24,176,21,24,1549
6097152203,3628,2498,669,58,17,124,20,15,1130
6097152204,5103,3112,1153,105,31,386,44,36,1991
6097152205,2004,1222,528,35,19,74,27,2,782
6097152300,4153,3330,403,18,12,103,14,24,823
6097152401,4009,3128,354,25,5,240,10,28,881
6097152402,3418,2431,440,47,19,257,4,16,987
6097152501,4396,2684,986,60,38,275,48,25,1712
6097152502,3498,2358,638,65,19,143,19,30,1140
6097152601,6554,4868,660,49,17,582,11,20,1686
6097152602,1163,948,114,2,2,20,4,9,215
6097152701,5122,3247,1315,48,41,142,24,22,1875
6097152702,5007,2919,1441,68,41,235,22,33,2088
6097152801,4526,2602,1267,72,31,240,8,33,1924
6097152803,4164,1349,2239,76,26,229,51,29,2815
6097152804,2807,930,1336,87,48,225,37,28,1877
6097152903,5185,1335,2893,211,33,484,18,28,3850
6097152904,5366,2960,1536,104,55,370,11,38,2406
6097152905,4058,2047,1367,86,59,254,12,15,2011
6097152906,6084,3488,1535,154,24,484,20,30,2596
6097153001,7397,2830,3436,228,72,426,44,28,4567
6097153002,6578,2274,3692,104,63,121,13,33,4304
6097153003,5834,2308,2711,140,56,237,42,28,3526
6097153005,6614,3955,1796,138,50,304,5,29,2659
6097153006,7343,4026,2316,114,45,388,38,37,3317
6097153102,5566,934,4169,68,59,204,7,12,4632
6097153103,4860,1274,2939,99,63,266,36,29,3586
6097153104,4093,1016,2728,62,30,111,13,19,3077
6097153201,4705,1252,2389,159,35,642,11,29,3453
6097153202,3910,1100,2375,55,31,197,23,17,2810
6097153301,6622,2621,2745,258,96,446,52,73,4001
6097153302,5611,2030,2462,171,77,543,29,22,3581
6097153403,4010,2985,607,31,21,95,6,28,1025
6097153404,4094,3199,462,26,28,89,6,33,895
6097153405,3513,2604,527,39,15,85,6,34,909
6097153406,2662,2007,372,34,10,57,8,29,655
6097153501,4505,3512,580,32,21,90,15,24,993
6097153502,3720,3008,388,18,9,71,3,23,712
6097153601,1880,1390,314,11,8,28,2,20,490
6097153602,3150,2564,316,11,8,44,4,30,586
6097153705,3382,2630,394,19,39,46,4,33,752
6097153707,1517,1189,145,15,13,23,4,15,328
6097153708,1696,1377,137,14,20,24,1,19,319
6097153709,1591,1156,273,12,36,5,1,15,435
6097153710,2269,1663,369,32,13,27,1,20,606
6097153711,2213,1689,300,16,17,21,2,20,524
6097153712,1929,1545,216,4,10,30,0,15,384
6097153804,3231,1953,970,16,12,92,24,13,1278
6097153806,2686,1627,781,23,31,76,0,6,1059
6097153807,3957,2867,755,16,23,103,3,0,1090
6097153808,4313,2056,1864,48,29,87,0,18,2257
6097153809,4510,2552,1535,37,31,112,5,13,1958
6097153810,4135,1931,1840,33,45,59,9,22,2204
6097153811,5154,2985,1571,48,34,229,15,29,2169
6097153902,4436,2000,2150,21,18,56,0,21,2436
6097153903,3588,2538,767,12,34,56,6,17,1050
6097153904,1753,1300,347,5,7,19,0,12,453
6097153905,3391,2081,1060,16,8,50,10,24,1310
6097154000,2235,1623,451,8,13,18,3,14,612
6097154100,3399,2125,1050,11,13,33,7,23,1274
6097154201,4088,1768,2025,23,45,41,10,15,2320
6097154202,6306,3915,1881,44,51,61,6,43,2391
6097154304,2181,1581,299,10,92,39,0,35,600
6097154305,1665,1350,182,10,0,31,0,8,315
6097154306,2093,1735,173,6,3,36,0,23,358
6097154307,745,632,52,3,7,9,2,12,113
6097154308,787,652,95,1,2,12,0,0,135
6097990100,0,0,0,0,0,0,0,0,0
6099000101,5672,3986,1176,32,29,82,1,40,1686
6099000102,3765,2575,864,6,16,113,4,28,1190
6099000201,6211,4216,1455,33,46,79,18,26,1995
6099000202,8312,4770,2654,79,44,297,39,51,3542
6099000204,5178,3092,1594,36,30,85,13,27,2086
6099000205,4115,2272,1490,20,31,72,5,6,1843
6099000301,2038,632,1277,21,18,16,0,5,1406
6099000302,2782,1044,1514,53,4,42,14,23,1738
6099000303,6285,1882,3767,111,28,234,36,18,4403
6099000304,5126,914,3903,101,19,54,3,19,4212
6099000403,4651,2616,1268,114,17,283,40,23,2035
6099000404,5991,2697,1999,191,35,676,51,32,3294
6099000405,2613,1228,1168,31,21,59,9,12,1385
6099000406,6247,2501,2663,135,4,579,72,36,3746
6099000407,3027,1586,939,42,5,302,16,25,1441
6099000501,7672,3280,3050,197,22,662,71,29,4392
6099000503,5252,2032,2084,244,17,470,76,28,3220
6099000505,5187,2088,1790,261,35,605,109,24,3099
6099000506,4607,2067,1736,236,31,221,48,31,2540
6099000511,6096,2459,1638,261,10,1231,105,51,3637
6099000512,2999,1772,707,76,14,263,39,9,1227
6099000513,4574,1609,2323,115,7,235,58,22,2965
6099000514,3743,1043,2455,33,5,86,14,7,2700
6099000601,4737,1905,2086,123,14,351,33,26,2832
6099000602,3035,1075,1480,79,12,220,43,18,1960
6099000801,6826,3693,2201,180,33,261,46,38,3133
6099000803,5153,1326,2681,196,54,545,55,45,3827
6099000805,6584,2167,3186,259,57,461,88,36,4417
6099000806,4474,1902,1674,173,6,402,57,48,2572
6099000807,3782,1623,1349,159,28,377,65,12,2159
6099000905,6221,3165,2030,178,35,376,45,38,3056
6099000906,6106,3334,1798,229,19,315,35,31,2772
6099000907,3371,2119,819,64,26,109,23,10,1252
6099000908,5480,2463,2022,258,27,373,28,15,3017
6099000909,4746,2313,1672,187,34,235,30,12,2433
6099000910,6936,2746,2793,361,39,473,88,54,4190
6099000911,4966,2220,1767,305,19,329,21,21,2746
6099000913,7366,3441,2225,283,29,867,91,19,3925
6099000914,7093,2390,2047,254,15,1876,143,55,4703
6099000915,4833,2091,1444,184,20,705,79,15,2742
6099001001,6746,3408,2346,238,55,257,51,26,3338
6099001002,3427,1676,1186,73,37,134,36,43,1751
6099001100,4381,2095,1511,164,30,234,32,36,2286
6099001200,3961,2150,1271,102,30,132,9,37,1811
6099001300,6342,3822,1689,194,28,192,25,34,2520
6099001400,7546,2762,3410,327,46,452,106,35,4784
6099001500,7108,1489,4483,244,37,520,66,27,5619
6099001601,4968,582,3648,124,16,469,9,15,4386
6099001603,5959,936,4385,111,22,340,7,30,5023
6099001604,4031,306,3029,199,15,344,11,5,3725
6099001700,2645,314,1909,139,24,182,1,9,2331
6099001800,2011,850,837,110,21,47,8,15,1161
6099001900,5863,2954,2133,137,62,182,24,37,2909
6099002002,4662,1652,2718,58,42,49,14,9,3010
6099002004,6759,2058,3476,440,44,271,73,32,4701
6099002005,3988,1019,2247,165,28,210,113,28,2969
6099002006,4765,1459,2318,178,9,471,105,24,3306
6099002100,3713,826,2536,95,27,61,2,21,2887
6099002200,6502,958,4759,131,40,393,19,37,5544
6099002302,3991,502,3269,30,13,79,5,19,3489
6099002303,5729,573,4589,147,6,292,22,20,5156
6099002304,2841,437,2263,18,14,35,13,22,2404
6099002401,3852,248,3294,66,11,139,32,6,3604
6099002402,5509,489,4858,15,13,45,10,10,5020
6099002503,4755,948,3529,58,15,106,15,15,3807
6099002504,4532,858,3203,75,27,211,26,4,3674
6099002505,5064,510,3832,74,2,521,28,21,4554
6099002506,2015,325,1552,49,11,15,6,15,1690
6099002602,5495,1300,3656,113,33,181,12,18,4195
6099002603,3131,1311,1464,34,22,117,17,11,1820
6099002604,4917,862,3484,126,27,221,16,28,4055
6099002605,4231,1279,2568,57,14,123,39,5,2952
6099002701,4186,1279,2374,72,17,258,18,23,2907
6099002702,7175,1227,5060,146,19,471,69,40,5948
6099002801,6122,2893,2688,60,24,82,34,50,3229
6099002802,6931,3210,3222,88,23,72,1,36,3721
6099002803,2933,1640,922,74,12,134,15,12,1293
6099002901,4990,2935,1684,15,36,71,3,25,2055
6099002903,6235,2608,3157,42,48,121,8,30,3627
6099002904,2208,1468,579,10,1,42,1,10,740
6099003002,7207,1815,4804,51,35,280,22,30,5392
6099003003,7984,1387,4161,146,37,1888,105,47,6597
6099003004,2112,791,1124,9,6,95,12,10,1321
6099003100,3843,1458,2116,25,38,72,0,25,2385
6099003201,5641,895,4281,100,24,158,24,28,4746
6099003203,5614,1411,2889,562,23,438,62,24,4203
6099003204,2614,533,1929,33,16,39,5,7,2081
6099003205,4654,842,3177,192,6,189,64,32,3812
6099003206,5753,969,2967,695,17,677,154,34,4784
6099003300,5992,1645,3610,181,13,278,13,56,4347
6099003400,1675,542,1028,21,2,7,5,4,1133
6099003501,7529,1944,4881,247,19,183,23,22,5585
6099003502,5297,1199,3817,72,13,48,11,21,4098
6099003603,4012,2050,1781,9,13,21,3,15,1962
6099003607,2403,1360,916,5,9,17,3,4,1043
6099003608,6530,3883,1898,34,27,328,7,37,2647
6099003609,3693,2026,1018,50,13,372,15,11,1667
6099003610,4826,2219,1803,106,29,442,21,21,2607
6099003611,4172,2140,1100,76,16,636,11,16,2032
6099003612,7303,3347,2188,171,20,1131,27,43,3956
6099003700,4996,1664,2803,64,35,253,39,33,3332
6099003802,5724,1069,4234,97,33,158,6,29,4655
6099003803,3045,630,2083,50,6,197,10,19,2415
6099003804,6826,2076,4145,114,54,210,22,36,4750
6099003805,3087,1194,1207,51,10,441,20,23,1893
6099003904,4732,2099,2190,61,13,124,22,26,2633
6099003905,3940,2688,933,13,22,60,6,16,1252
6099003906,5129,1895,2488,197,34,251,15,19,3234
6099003907,7566,4999,1735,122,34,307,7,31,2567
6099003908,2449,955,1044,80,10,201,14,4,1494
6099003909,6625,3414,2379,125,29,269,39,18,3211
6099004000,3834,2217,1323,45,9,102,14,8,1617
6101050101,7292,2733,2500,267,57,1213,19,49,4559
6101050102,5008,2153,2088,184,58,231,13,25,2855
6101050201,3277,1193,1324,86,43,411,16,25,2084
6101050202,3982,1470,1972,89,68,148,10,24,2512
6101050301,2593,1356,758,30,16,228,2,9,1237
6101050302,6286,1672,3678,130,46,388,33,67,4614
6101050401,5109,2216,1398,93,40,988,29,31,2893
6101050402,4270,1921,1094,72,25,871,12,43,2349
6101050403,3970,1638,1241,116,46,647,16,33,2332
6101050501,6325,1755,1452,101,54,2619,12,39,4570
6101050503,7368,2288,1631,100,53,2962,18,60,5080
6101050504,7395,2575,1873,98,59,2386,22,34,4820
6101050601,6281,3120,1146,66,50,1540,9,53,3161
6101050603,5350,2887,973,53,41,1054,3,16,2463
6101050604,4379,2382,884,122,43,645,14,24,1997
6101050701,4533,1666,2148,49,41,429,17,19,2867
6101050702,6616,2278,2923,78,26,953,26,23,4338
6101050800,3518,2592,558,10,47,34,0,21,926
6101050900,1388,733,583,0,13,6,0,4,655
6101051000,2237,1109,811,7,20,180,2,9,1128
6101051100,2456,1629,533,23,16,81,6,3,827
6103000100,4670,3556,671,31,89,40,0,30,1114
6103000201,3775,2964,411,18,59,38,0,8,811
6103000202,4358,3356,446,24,100,85,3,45,1002
6103000300,4682,3186,929,57,83,120,12,32,1496
6103000400,5598,4411,633,26,69,109,10,38,1187
6103000500,5858,3848,1293,56,181,65,17,22,2010
6103000600,5813,3944,1266,44,116,106,12,25,1869
6103000701,4380,2814,1038,32,98,67,7,17,1566
6103000702,3517,2098,1024,45,49,66,10,9,1419
6103000800,3905,1976,1639,13,67,34,6,12,1929
6103000900,3820,2393,1032,17,89,31,3,10,1427
6103001000,7139,3464,3109,11,76,101,5,37,3675
6103001101,2554,1112,1287,4,21,46,0,7,1442
6103001102,5760,2218,3160,13,70,77,11,32,3542
6105000101,2686,2133,144,9,58,45,5,38,553
6105000102,4405,3508,323,43,125,62,5,27,897
6105000200,2014,1579,133,2,90,28,6,8,435
6105000500,7007,4154,337,12,143,2077,8,33,2853
6107000101,2538,1967,369,18,6,25,2,10,571
6107000102,2542,1342,999,3,13,33,1,44,1200
6107000202,2381,204,2061,3,4,56,0,11,2177
6107000203,4861,141,4344,7,7,331,0,13,4720
6107000204,4081,59,3647,1,0,341,0,2,4022
6107000302,2971,357,2533,2,8,15,0,13,2614
6107000303,3662,1754,1731,10,8,70,3,20,1908
6107000304,2869,551,2224,7,3,26,0,12,2318
6107000401,6976,647,5969,22,14,178,9,58,6329
6107000402,6999,968,5678,30,16,176,1,35,6031
6107000501,7313,309,6884,10,13,47,3,6,7004
6107000502,4065,276,3670,11,7,65,10,7,3789
6107000600,5670,235,5297,7,0,85,0,18,5435
6107000701,2625,606,1953,17,9,0,1,3,2019
6107000702,5533,501,4825,23,37,58,0,18,5032
6107000801,4540,453,3992,9,13,29,0,9,4087
6107000802,2804,1355,1318,3,14,33,1,19,1449
6107000901,5899,719,4481,51,19,477,3,46,5180
6107000902,3377,950,2249,26,14,98,0,7,2427
6107001005,2808,1578,899,21,22,146,2,17,1230
6107001006,5861,3056,2211,86,30,213,10,40,2805
6107001007,5167,2390,1979,63,12,482,9,31,2777
6107001008,5763,2888,2079,86,14,430,7,27,2875
6107001009,4289,228,3451,36,21,488,3,23,4061
6107001010,4157,259,3404,41,16,366,3,24,3898
6107001011,8227,1898,5213,99,32,690,3,47,6329
6107001012,10311,3248,5578,207,22,859,7,38,7063
6107001101,2460,288,1972,43,15,83,3,4,2172
6107001102,4026,559,3113,51,27,185,2,21,3467
6107001200,1276,479,684,43,3,25,0,8,797
6107001303,5149,1356,3312,77,31,217,1,34,3793
6107001304,3965,1450,2059,30,25,266,1,23,2515
6107001305,2806,628,1868,69,19,132,0,8,2178
6107001306,5516,1830,3072,98,44,282,6,20,3686
6107001400,5562,2096,3201,8,29,77,0,28,3466
6107001501,5257,2563,2325,37,46,63,11,34,2694
6107001502,5915,2362,3217,19,40,70,8,14,3553
6107001601,5059,512,4446,19,26,2,0,12,4547
6107001602,5792,1157,4430,15,28,67,0,16,4635
6107001701,6634,1939,4090,173,36,167,8,32,4695
6107001703,8210,3597,3900,99,40,248,8,39,4613
6107001705,3122,1240,1526,53,26,147,6,14,1882
6107001706,5401,2135,2449,85,45,414,4,19,3266
6107001800,5137,2150,2464,127,42,115,11,27,2987
6107001901,3559,1517,1763,57,29,61,0,16,2042
6107001902,4201,2021,1703,61,31,188,3,28,2180
6107002002,4834,2024,2349,84,29,116,0,26,2810
6107002003,6178,2579,3009,142,34,182,6,29,3599
6107002004,5026,2115,2382,104,33,201,6,7,2911
6107002006,4369,2438,1468,74,24,185,3,14,1931
6107002008,2855,1098,1410,90,39,94,0,14,1757
6107002009,4760,1992,2339,106,28,117,2,11,2768
6107002010,5498,2305,2527,54,56,321,18,35,3193
6107002011,3207,1141,1569,61,31,282,0,26,2066
6107002100,2470,847,1500,8,8,50,0,12,1623
6107002202,5992,763,4834,188,29,76,6,15,5229
6107002203,5644,908,4369,134,6,106,0,35,4736
6107002204,6175,1060,4661,174,32,104,0,23,5115
6107002302,5244,2170,2562,170,47,76,0,32,3074
6107002303,6696,3487,2639,109,50,98,14,61,3209
6107002304,1786,675,955,48,17,16,0,9,1111
6107002401,5202,2100,2305,132,30,391,2,37,3102
6107002402,5182,2083,2594,74,33,176,2,30,3099
6107002403,6905,2607,3554,134,33,305,5,61,4298
6107002500,4183,847,3195,8,19,40,2,24,3336
6107002601,4422,328,4001,13,13,25,0,17,4094
6107002602,5517,449,4912,0,5,102,14,11,5068
6107002701,1542,1177,215,28,32,13,1,8,365
6107002702,4849,2502,1040,17,991,77,0,17,2347
6107002800,3607,392,3036,31,19,51,1,15,3215
6107002901,3629,451,2867,201,15,17,5,11,3178
6107002903,5157,1748,3046,97,12,59,15,28,3409
6107002904,5379,1659,3365,165,21,52,0,20,3720
6107003001,4810,469,4110,54,23,65,0,29,4341
6107003002,3513,544,2707,119,18,27,11,12,2969
6107003100,3317,819,2369,20,17,20,2,15,2498
6107003201,3656,697,2889,13,6,4,0,14,2959
6107003202,2526,176,2320,0,8,4,1,8,2350
6107003301,4586,886,3555,5,32,18,2,24,3700
6107003302,3057,970,1937,8,21,53,0,8,2087
6107003401,4465,866,3063,9,33,382,5,11,3599
6107003402,2626,1037,1408,7,28,45,1,4,1589
6107003501,2882,1217,1331,8,21,177,8,25,1665
6107003503,6072,1410,3852,24,26,549,1,38,4662
6107003504,5505,1564,3500,28,36,207,12,32,3941
6107003601,7894,1943,5190,49,51,370,9,53,5951
6107003602,7878,1933,5141,55,57,486,4,32,5945
6107003700,6762,1564,4651,48,85,210,17,32,5198
6107003801,3614,1083,2325,31,40,76,3,13,2531
6107003802,4615,975,3315,52,41,95,32,12,3640
6107003902,6028,1398,4125,40,98,148,92,23,4630
6107003903,3342,394,2792,9,13,74,7,6,2948
6107003904,3811,576,3089,14,19,26,38,10,3235
6107004000,24,11,8,2,0,0,0,0,13
6107004102,2011,451,1423,0,19,66,0,14,1560
6107004103,5374,511,4519,31,28,173,9,15,4863
6107004104,4778,451,4192,26,30,31,0,20,4327
6107004200,6673,728,5667,121,19,48,2,27,5945
6107004301,3064,111,2818,3,0,115,0,3,2953
6107004302,2385,194,2106,22,10,17,1,0,2191
6107004401,3958,87,3613,10,2,225,0,2,3871
6107004402,3808,45,3503,11,1,225,0,11,3763
6107004500,6439,1149,5042,4,34,103,2,16,5290
6109001100,3880,2986,479,10,40,92,7,28,894
6109001200,4079,3058,532,22,56,132,15,18,1021
6109002101,3280,2558,372,19,39,54,5,24,722
6109002102,1496,1226,141,5,24,11,2,6,270
6109002201,5340,4146,656,24,51,40,18,30,1194
6109002202,2862,2416,226,3,30,18,0,14,446
6109003101,2455,2000,229,1,12,25,6,16,455
6109003102,2570,2151,208,6,27,20,8,22,419
6109003103,1314,1102,97,0,6,10,0,7,212
6109003200,5672,4296,690,14,241,37,16,23,1376
6109004101,3082,2512,321,0,34,21,1,19,570
6109004102,2472,2020,242,15,11,59,1,8,452
6109004201,1976,1578,205,29,9,26,7,13,398
6109004202,2088,1710,197,0,12,29,3,14,378
6109005101,5502,4270,672,16,89,76,4,39,1232
6109005102,2989,2302,376,15,54,45,9,15,687
6109005201,1829,1235,353,41,13,30,4,10,594
6109985202,2734,688,1128,769,36,45,4,7,2046
6111000302,8101,2043,5612,43,27,141,4,57,6058
6111000303,5194,1008,3972,25,17,53,0,16,4186
6111000304,4818,741,3915,11,26,33,5,27,4077
6111000400,6338,1132,5020,12,9,27,2,17,5206
6111000500,1786,516,1203,2,4,19,2,1,1270
6111000600,6229,535,5549,24,10,22,3,23,5694
6111000701,6974,563,6233,13,18,37,0,32,6411
6111000702,3113,450,2555,5,11,40,0,7,2663
6111000800,8724,2268,6123,37,25,79,8,33,6456
6111000901,2555,2031,329,12,8,55,4,7,524
6111000902,2107,1551,374,11,9,40,1,5,556
6111000903,5689,4042,1131,30,17,152,5,39,1647
6111001002,6934,4516,1834,29,33,123,8,36,2418
6111001101,4708,2914,1464,23,21,71,3,31,1794
6111001102,3657,2470,820,19,15,120,4,27,1187
6111001201,6018,2831,2482,124,14,287,9,28,3187
6111001202,6954,4485,1651,50,11,330,9,33,2469
6111001204,2620,1013,1392,51,10,34,0,17,1607
6111001302,2526,818,1472,49,11,98,4,11,1708
6111001303,4826,2023,2194,70,7,245,6,31,2803
6111001304,3272,1646,1230,61,8,117,1,27,1626
6111001401,3954,2300,1164,23,15,233,1,21,1654
6111001402,5656,3152,1827,91,22,238,10,32,2504
6111001506,4876,2625,1717,55,23,178,11,26,2251
6111001507,4705,2077,2024,84,35,241,10,26,2628
6111001508,4680,2526,1380,109,14,383,7,20,2154
6111001509,4644,1800,2233,146,29,222,22,25,2844
6111001510,2574,1264,984,94,6,82,3,13,1310
6111001511,2423,1058,1049,58,7,109,1,16,1365
6111001602,2471,1547,699,17,5,47,11,8,924
6111001801,3738,2701,599,32,18,122,6,33,1037
6111001901,3498,2426,774,43,13,79,4,19,1072
6111002000,2533,1959,313,17,10,84,0,26,574
6111002102,1664,1217,288,15,6,49,0,7,447
6111002200,6791,2438,3803,83,18,170,6,47,4353
6111002301,2859,736,1957,20,7,41,5,19,2123
6111002302,4456,1051,3129,68,3,60,3,14,3405
6111002400,3112,1776,925,146,20,83,1,24,1336
6111002500,5038,3750,745,80,12,135,8,25,1288
6111002600,3094,1817,951,26,31,66,6,43,1277
6111002700,4267,2590,1250,59,23,117,7,26,1677
6111002800,6296,3591,2062,87,34,150,10,37,2705
6111002901,5682,1679,2976,191,13,617,15,35,4003
6111002905,5305,1046,3346,216,9,501,10,33,4259
6111003010,3238,501,2317,128,10,188,2,12,2737
6111003011,5361,577,4343,113,8,181,27,27,4784
6111003013,4833,915,3237,150,10,348,20,26,3918
6111003101,4403,330,3207,86,9,680,12,10,4073
6111003102,4766,469,2998,107,13,1033,28,16,4297
6111003201,4040,39,3971,0,2,11,0,9,4001
6111003301,3192,408,2484,98,10,101,7,11,2784
6111003302,5522,600,4472,127,11,179,11,30,4922
6111003608,3746,527,2623,117,13,344,13,20,3219
6111003613,3866,918,2220,121,6,432,10,22,2948
6111003614,5139,1604,2714,172,23,388,25,28,3535
6111003615,2680,2003,413,33,4,99,4,17,677
6111003616,3556,2695,417,48,18,187,2,23,861
6111003617,1992,1410,375,33,12,77,0,17,582
6111003618,2174,1550,364,20,6,63,7,14,624
6111003700,6426,221,5903,140,14,55,7,13,6205
6111003801,5377,117,5043,80,12,54,28,13,5260
6111003802,2821,153,2559,35,1,31,3,4,2668
6111003901,3265,96,3120,10,2,19,0,6,3169
6111003902,3761,188,3100,48,6,367,0,14,3573
6111004000,6247,409,5442,50,5,267,16,16,5838
6111004101,6570,308,5808,64,26,250,16,15,6262
6111004200,5206,771,3940,88,7,219,27,19,4435
6111004304,7051,2226,3859,258,34,366,33,35,4825
6111004305,1985,1022,472,171,22,114,37,19,963
6111004400,7712,2188,4374,237,40,503,24,52,5524
6111004503,4600,224,3545,63,5,682,8,9,4376
6111004504,5086,304,3851,70,4,758,3,13,4782
6111004505,2077,127,1722,42,0,144,5,16,1950
6111004507,3142,182,2767,33,7,124,0,6,2960
6111004508,4120,71,3777,31,1,211,6,6,4049
6111004600,1430,865,246,134,12,49,10,12,565
6111004704,1537,141,1340,13,2,25,0,3,1396
6111004710,5298,441,4117,72,6,544,12,16,4857
6111004711,3163,153,1860,34,4,1002,15,13,3010
6111004715,5213,460,4124,113,3,410,8,11,4753
6111004716,4240,230,3526,43,4,387,8,6,4010
6111004717,3851,145,3367,46,10,220,8,16,3706
6111004901,7081,971,4217,294,15,1306,15,41,6110
6111004902,4502,107,4273,40,4,60,1,2,4395
6111005002,3182,154,2969,5,2,20,2,9,3028
6111005004,10297,2622,5434,390,6,1264,40,74,7675
6111005005,4830,286,4416,16,12,43,8,3,4544
6111005006,3252,259,2884,11,8,51,0,6,2993
6111005202,2740,1698,694,32,10,155,5,5,1042
6111005203,5548,3419,1316,93,9,332,17,61,2129
6111005204,3274,2114,588,18,10,341,3,32,1160
6111005205,8259,4465,2036,229,14,1071,28,39,3794
6111005304,5801,4205,910,69,14,410,0,16,1596
6111005305,5559,3730,783,41,3,595,3,51,1829
6111005306,4730,2974,895,44,7,445,26,39,1756
6111005307,6648,3403,1508,132,18,1105,11,37,3245
6111005308,2898,1578,708,40,5,382,2,14,1320
6111005401,3955,2209,1142,54,7,330,2,19,1746
6111005403,2651,906,1477,36,0,121,0,19,1745
6111005404,3849,1858,1422,55,8,273,2,16,1991
6111005502,5241,2142,2037,153,14,584,14,22,3099
6111005503,4014,1889,1109,320,2,380,27,28,2125
6111005504,4430,2264,1422,52,6,391,7,30,2166
6111005601,6831,3136,2004,171,15,1081,19,38,3695
6111005602,4849,2764,1331,106,15,381,6,39,2085
6111005700,2931,1357,868,122,6,372,6,43,1574
6111005801,5214,3549,571,37,5,652,6,56,1665
6111005803,3512,2472,386,32,3,359,1,10,1040
6111005804,5390,3366,510,69,10,1065,1,52,2024
6111005901,6525,4735,934,40,16,354,6,43,1790
6111005906,6630,4784,767,115,20,572,8,28,1846
6111005907,3464,2835,257,18,10,183,1,34,629
6111005908,2945,1789,540,44,5,352,0,22,1156
6111005909,3482,2203,692,41,5,353,2,18,1279
6111005910,1727,1341,156,13,1,94,0,28,386
6111005911,3912,2652,687,61,0,259,4,23,1260
6111006000,4795,2859,1259,28,11,340,12,23,1936
6111006101,3866,2150,498,93,4,920,0,23,1716
6111006102,4727,981,2978,33,6,621,13,27,3746
6111006200,2967,2203,274,36,2,232,1,16,764
6111006301,6472,4525,1067,77,6,437,17,33,1947
6111006302,3807,2281,880,96,4,351,14,26,1526
6111006400,7190,4783,1357,69,19,550,8,28,2407
6111006500,3531,1610,1588,45,7,132,1,17,1921
6111006600,4018,2810,642,25,16,259,5,45,1208
6111006700,3153,2228,369,39,4,300,0,8,925
6111006800,3786,2304,1046,35,9,161,7,31,1482
6111006900,4002,2181,1278,66,13,314,2,20,1821
6111007000,4183,1615,1778,104,12,472,9,31,2568
6111007100,6638,2848,2832,172,8,400,25,41,3790
6111007201,3504,2574,441,36,3,202,2,26,930
6111007202,4175,3044,459,31,10,357,4,15,1131
6111007300,2097,1575,277,21,3,126,0,6,522
6111007402,6058,4647,478,60,7,531,0,42,1411
6111007403,5728,3655,440,84,5,1253,1,14,2073
6111007405,5822,3989,468,66,0,980,5,43,1833
6111007406,2349,1556,210,17,6,443,1,18,793
6111007505,3327,1887,997,20,6,227,12,15,1440
6111007506,7514,4918,1492,79,14,599,9,51,2596
6111007507,6808,4630,822,96,11,852,13,40,2178
6111007508,3696,2331,747,69,11,303,2,22,1365
6111007509,4418,2765,636,85,7,672,10,9,1653
6111007510,6208,4107,493,90,9,1150,2,26,2101
6111007511,2676,1889,280,58,4,233,0,8,787
6111007512,6264,3495,1353,108,3,906,8,50,2769
6111007513,1765,1251,314,24,1,74,0,10,514
6111007515,3444,1973,784,87,12,363,8,33,1471
6111007516,3371,2174,626,78,5,290,8,21,1197
6111007607,5832,3824,1028,106,13,480,5,37,2008
6111007609,2455,1666,408,42,0,187,4,14,789
6111007610,4926,3237,956,45,4,354,0,34,1689
6111007611,4604,566,3704,28,2,208,1,13,4038
6111007612,5184,2158,2148,151,6,409,9,27,3026
6111007613,4992,2712,1278,70,10,607,4,34,2280
6111007614,7185,3712,2452,99,9,533,9,30,3473
6111007700,6456,2903,2554,71,12,638,2,25,3553
6111007800,4403,1472,2042,111,13,564,1,26,2931
6111007901,5354,2161,2458,55,9,444,4,13,3193
6111007903,4893,2586,988,79,8,869,15,34,2307
6111007904,5730,2897,1942,98,7,486,9,47,2833
6111008001,3258,1624,1127,60,11,284,4,5,1634
6111008002,4712,2240,1948,30,19,264,2,19,2472
6111008004,5141,2459,2089,53,7,291,11,28,2682
6111008005,2733,1188,1225,34,5,151,6,5,1545
6111008101,3379,1862,967,42,13,308,2,18,1517
6111008201,4640,2286,1372,78,17,604,7,29,2354
6111008202,4331,2092,1512,53,17,444,7,22,2239
6111008302,5458,3029,1551,88,8,502,14,21,2429
6111008303,3887,2069,1120,76,15,421,4,18,1818
6111008304,5487,3176,1333,71,25,594,10,39,2311
6111008307,3248,1469,974,91,5,521,5,19,1779
6111008308,4455,2476,764,64,12,907,1,14,1979
6111008401,5332,3087,1488,75,13,368,3,27,2245
6111008402,5302,3458,982,49,16,495,7,36,1844
6111008501,4751,3081,865,58,12,473,4,36,1670
6111008502,3647,2156,733,72,11,445,4,28,1491
6111008601,4395,392,3638,93,4,184,8,11,4003
6111008602,3348,267,2796,119,2,107,9,7,3081
6111008700,6150,837,4936,108,23,102,18,29,5313
6111008800,5513,721,4241,144,12,239,18,34,4792
6111008900,3457,267,3007,28,11,77,14,5,3190
6111009100,6270,338,5482,137,20,174,9,13,5932
6111009200,6128,742,4475,167,10,570,26,35,5386
6111009300,6058,2749,2326,170,14,546,2,36,3309
6111009400,2084,1049,693,34,0,157,5,10,1035
6111009500,3486,2341,845,26,19,48,1,24,1145
6111009600,3112,2366,408,14,3,148,2,21,746
6111009700,3410,751,2557,6,14,21,0,18,2659
6111980000,0,0,0,0,0,0,0,0,0
6111990100,0,0,0,0,0,0,0,0,0
6113010102,1401,740,483,30,11,52,15,12,661
6113010103,5882,2139,2658,135,32,547,116,40,3743
6113010104,5045,1682,2269,291,37,405,28,23,3363
6113010105,2008,801,539,184,20,253,7,16,1207
6113010201,3985,1839,1161,154,20,463,14,32,2146
6113010203,5722,1792,2553,354,56,541,60,29,3930
6113010204,5186,2132,2171,190,57,282,77,26,3054
6113010310,5956,2435,1398,367,17,1114,72,56,3521
6113010312,5320,2819,1155,183,17,713,25,46,2501
6113010313,5406,2358,1049,200,12,1196,79,37,3048
6113010314,2322,1066,509,44,10,474,23,10,1256
6113010315,1442,643,469,61,10,140,16,2,799
6113010401,4678,2484,1136,85,10,662,12,20,2194
6113010402,4379,1760,900,313,7,967,49,52,2619
6113010501,8696,4135,1423,339,102,2130,155,31,4561
6113010505,5968,3049,874,138,8,1434,11,40,2919
6113010508,2569,1502,394,52,0,459,6,19,1067
6113010509,3578,1876,758,73,3,624,4,18,1702
6113010510,4908,2514,716,81,8,1207,2,36,2394
6113010511,3333,1892,388,52,5,732,2,20,1441
6113010512,3322,1598,623,115,3,777,2,3,1724
6113010513,2964,1593,566,69,4,530,5,19,1371
6113010602,5597,2563,1360,174,19,1066,13,52,3034
6113010605,3627,1622,464,110,2,1097,0,28,2005
6113010607,4395,2516,542,86,8,912,16,22,1879
6113010608,5675,2028,1216,125,11,1927,8,55,3647
6113010609,2575,1739,355,35,7,190,0,31,836
6113010610,3721,1963,619,68,3,796,3,28,1758
6113010611,1673,921,363,25,10,215,5,5,752
6113010701,4779,2737,780,111,13,766,8,53,2042
6113010703,5438,2713,943,131,4,1268,5,29,2725
6113010704,2275,1386,330,56,1,302,4,20,889
6113010800,3824,1315,2123,54,34,147,11,12,2509
6113010901,5595,1700,3266,103,49,230,7,12,3895
6113010902,6385,2050,3613,127,39,330,17,20,4335
6113011001,6744,2287,3661,119,48,336,27,38,4457
6113011002,3244,2087,866,39,7,69,6,26,1157
6113011101,2922,1201,1475,27,17,72,0,12,1721
6113011102,5123,926,3517,53,23,466,13,13,4197
6113011103,3271,947,1802,47,16,312,11,22,2324
6113011203,2657,1676,758,11,8,56,6,16,981
6113011204,5707,2670,2252,78,26,383,22,33,3037
6113011207,2754,1634,813,21,13,138,3,10,1120
6113011208,7643,2968,2583,140,31,1450,22,30,4675
6113011209,4037,1067,1839,168,12,712,35,41,2970
6113011210,2738,721,1406,22,11,452,17,7,2017
6113011211,1653,568,719,24,3,211,10,8,1085
6113011301,2079,796,1107,36,0,39,3,13,1283
6113011302,3634,1483,1949,10,12,31,10,8,2151
6113011303,1446,658,667,6,5,20,3,9,788
6113011304,1361,416,863,5,4,18,2,6,945
6113011400,4052,1468,2260,90,27,45,7,9,2584
6113011500,5709,2236,2997,111,36,114,5,23,3473
6115040100,5029,2466,1593,297,108,217,20,22,2563
6115040201,3827,2091,1137,99,46,134,9,9,1736
6115040202,4346,2384,1137,191,51,169,26,21,1962
6115040301,3600,1427,1232,109,59,480,13,9,2173
6115040302,2479,835,1146,128,21,176,5,14,1644
6115040304,6587,2393,2386,334,91,810,36,30,4194
6115040305,2755,1306,639,186,19,379,27,11,1449
6115040400,5938,2482,2112,187,93,571,39,49,3456
6115040500,4002,1568,1809,74,73,209,2,21,2434
6115040600,6396,2517,2861,123,75,391,7,32,3879
6115040701,8299,4284,2018,392,40,684,57,55,4015
6115040702,6231,2709,2040,327,74,539,60,30,3522
6115040800,4405,2829,944,60,44,166,12,17,1576
6115040901,3047,1818,619,39,48,282,2,11,1229
6115040902,2412,1370,430,201,6,98,25,18,1042
6115041001,3594,2506,626,26,34,119,12,29,1088
6115041002,3935,3104,387,21,59,85,4,43,831
6115041101,3187,2476,254,31,61,51,15,36,711
6115041102,1506,1185,150,6,32,23,1,2,321
8001007801,3936,598,1681,636,18,896,0,19,3338
8001007802,3893,488,2176,702,33,315,31,30,3405
8001007900,5490,1262,3006,813,25,134,19,42,4228
8001008000,6775,1880,3419,863,23,280,21,41,4895
8001008100,1378,783,180,146,9,201,10,2,595
8001008200,6521,1488,3431,907,32,387,21,40,5033
8001008308,6714,1274,4081,944,28,171,50,24,5440
8001008309,4278,619,3163,290,12,120,19,4,3659
8001008354,4022,1052,1272,1139,9,256,26,44,2970
8001008355,4820,1443,2479,528,22,127,30,20,3377
8001008401,5537,3848,1238,78,44,25,16,15,1689
8001008402,5325,4089,882,35,27,49,10,20,1236
8001008505,7126,3859,2703,90,52,146,8,28,3267
8001008506,6460,3250,2414,176,58,220,17,17,3210
8001008507,6290,3428,2274,72,50,142,13,36,2862
8001008508,5558,3189,1726,82,25,193,10,51,2369
8001008524,9374,5779,2132,144,40,758,16,40,3595
8001008526,7509,4993,1497,105,29,434,1,25,2516
8001008533,7706,3870,2779,181,40,468,15,20,3836
8001008534,4344,2332,1527,63,27,138,9,34,2012
8001008535,4389,1915,1935,111,35,177,3,10,2474
8001008536,4353,2394,1412,120,15,233,4,9,1959
8001008538,11712,6562,3284,690,39,456,28,75,5150
8001008540,10376,6188,2458,170,32,1043,10,42,4188
8001008544,6242,3998,1136,90,25,623,10,15,2244
8001008545,6731,4672,1225,103,29,305,2,21,2059
8001008546,3517,2065,1022,65,17,209,0,8,1452
8001008547,3468,1961,1112,61,17,152,3,20,1507
8001008548,1713,944,439,40,3,183,2,20,769
8001008549,4581,2545,1422,61,25,305,1,17,2036
8001008550,8319,4818,2495,94,39,523,8,25,3501
8001008551,1788,1091,441,10,0,155,1,17,697
8001008552,5185,2697,2024,71,32,141,10,12,2488
8001008553,5596,3637,1453,94,16,132,3,17,1959
8001008554,2507,1656,592,31,21,94,0,9,851
8001008555,5848,3334,1725,163,44,235,13,39,2514
8001008556,6076,3022,2415,114,11,265,8,22,3054
8001008557,852,462,315,4,7,30,0,2,390
8001008558,4220,1990,1668,154,18,167,7,14,2230
8001008559,8672,3692,3644,489,35,376,24,47,4980
8001008560,2203,1713,300,15,14,63,2,1,490
8001008561,4824,3838,600,31,6,133,0,20,986
8001008562,5787,3513,1671,88,25,189,4,29,2274
8001008563,4429,2685,1367,38,19,82,4,30,1744
8001008564,1192,715,397,15,3,24,0,1,477
8001008565,7013,3685,2884,69,27,108,8,21,3328
8001008603,2118,597,1356,26,10,25,6,23,1521
8001008604,4551,1789,2416,146,24,41,6,28,2762
8001008605,4103,2076,1714,30,14,68,16,30,2027
8001008606,6101,2408,3273,64,36,58,20,51,3693
8001008705,5399,1270,3840,126,34,16,3,13,4129
8001008706,5572,1173,4072,131,33,28,7,10,4399
8001008709,8139,1664,5831,366,42,42,0,35,6475
8001008801,5138,1193,3700,61,31,27,0,36,3945
8001008802,4375,1080,3086,59,33,23,1,10,3295
8001008901,2478,638,1721,16,21,12,5,5,1840
8001009001,4770,1587,2644,158,49,122,4,39,3183
8001009003,4405,1386,2640,79,35,142,3,32,3019
8001009004,5040,1636,3007,113,34,84,0,11,3404
8001009101,4220,1451,2467,66,28,83,2,20,2769
8001009103,4383,996,3182,33,20,33,0,25,3387
8001009104,6470,2290,3485,157,40,280,1,38,4180
8001009202,4386,1557,2479,84,53,51,4,20,2829
8001009203,4594,1264,2706,156,43,237,6,19,3330
8001009204,6918,2852,2829,200,37,678,14,37,4066
8001009206,2630,1190,982,73,17,288,0,5,1440
8001009207,4560,1615,2535,67,18,153,1,17,2945
8001009304,5809,2730,2415,160,54,188,9,29,3079
8001009306,3863,1311,2263,39,14,120,4,25,2552
8001009307,3828,1208,2335,47,20,78,16,13,2620
8001009308,4372,1243,2893,45,20,49,6,31,3129
8001009309,3782,1504,1672,75,23,350,11,20,2278
8001009310,6201,1793,3857,104,35,232,2,29,4408
8001009316,8150,2157,5706,43,35,73,1,10,5993
8001009318,6414,1673,4080,195,53,245,6,36,4741
8001009319,3026,787,2076,20,20,42,3,14,2239
8001009320,3202,1016,1801,90,35,137,6,19,2186
8001009321,4383,1507,2467,36,30,207,3,11,2876
8001009322,5241,1675,2957,95,24,306,4,12,3566
8001009323,3704,1738,1423,110,23,241,0,26,1966
8001009325,5721,3971,986,147,33,312,3,23,1750
8001009326,2619,1866,393,24,6,203,0,9,753
8001009327,4248,2434,1349,66,29,191,0,17,1814
8001009401,5060,2448,2105,33,26,224,2,17,2612
8001009406,4493,2510,1461,66,21,215,3,19,1983
8001009407,5352,2541,2183,96,32,286,3,20,2811
8001009408,4802,3509,514,63,15,409,5,11,1293
8001009409,5807,4362,721,51,22,380,9,26,1445
8001009410,3381,2596,445,37,18,146,4,9,785
8001009411,3014,2064,648,62,7,69,3,13,950
8001009501,3215,1072,1841,37,15,160,0,19,2143
8001009502,5764,2214,3036,47,33,251,3,13,3550
8001009553,3528,1323,1851,70,28,109,16,5,2205
8001009603,6246,3206,2333,120,40,238,6,35,3040
8001009604,4724,2258,1911,121,28,193,0,21,2466
8001009606,3442,959,2170,117,40,73,0,9,2483
8001009607,4884,2105,1965,88,35,513,2,16,2779
8001009608,2892,1601,905,31,22,219,0,9,1291
8001009751,4048,1477,2260,53,48,55,7,20,2571
8001009752,3014,982,1817,24,26,67,5,32,2032
8001015000,3112,1126,1730,70,41,20,1,24,1986
8001060001,2581,1829,403,36,7,140,6,16,752
8001060002,4287,2963,635,51,11,386,0,35,1324
8001060100,7318,4545,1770,91,25,541,3,16,2773
8001060200,5227,3435,1091,121,55,266,3,43,1792
8001061200,3819,2529,720,77,11,295,2,18,1290
8001988700,0,0,0,0,0,0,0,0,0
8003960000,1696,1074,469,3,24,2,2,20,622
8003960100,2637,1651,837,5,15,7,0,30,986
8003960201,2693,1280,1232,27,33,25,0,13,1413
8003960202,4173,1991,1764,138,55,79,17,24,2182
8003960300,5177,1494,3399,38,88,29,0,17,3683
8005004951,1599,939,374,102,12,58,0,9,660
8005004952,3014,1851,750,155,8,115,4,16,1163
8005005551,3171,1128,1554,202,34,145,2,12,2043
8005005552,2782,1310,1074,120,30,97,4,16,1472
8005005553,3909,2084,1353,82,38,172,0,13,1825
8005005611,5012,4111,480,36,20,117,13,20,901
8005005612,3661,2710,639,57,27,47,5,22,951
8005005614,3215,2696,257,22,6,86,6,18,519
8005005619,4700,3572,706,34,18,72,0,22,1128
8005005620,2613,2062,363,25,7,48,0,14,551
8005005621,3026,2625,218,9,2,50,1,11,401
8005005622,3491,2914,322,31,9,90,0,8,577
8005005623,4066,3489,267,26,8,79,0,31,577
8005005624,2203,1835,184,14,3,43,4,11,368
8005005625,4079,3114,532,55,16,137,0,22,965
8005005626,3546,2792,354,55,14,115,1,32,754
8005005627,4613,4030,290,34,7,83,0,11,583
8005005628,5837,4723,575,58,13,174,3,26,1114
8005005629,2308,2042,82,13,0,75,1,12,266
8005005630,5314,4417,423,70,12,124,1,16,897
8005005631,3182,2647,246,35,5,82,3,17,535
8005005632,3311,2642,295,59,8,108,0,20,669
8005005633,3120,2630,215,20,7,96,1,11,490
8005005634,3061,2704,181,21,8,56,0,5,357
8005005635,4824,4149,328,46,7,79,7,15,675
8005005636,1873,1611,104,15,0,65,0,5,262
8005005701,1739,1118,436,48,19,32,0,4,621
8005005702,2619,1573,769,101,24,62,2,5,1046
8005005800,2591,2132,251,25,5,32,0,20,459
8005005951,4362,3247,591,132,44,76,17,25,1115
8005005952,3848,2805,528,113,27,182,3,15,1043
8005006000,2708,1974,456,70,17,27,2,26,734
8005006100,3308,2368,533,139,13,38,5,22,940
8005006200,3096,2322,465,38,12,53,0,20,774
8005006300,2655,2024,373,21,12,42,6,19,631
8005006400,2995,2003,656,86,18,64,0,15,992
8005006501,2133,1620,302,19,16,50,5,5,513
8005006502,3302,2636,405,37,21,40,0,22,666
8005006601,5531,3227,1638,195,62,113,6,24,2304
8005006603,3200,2627,308,31,17,48,4,10,573
8005006604,3766,2584,795,68,20,95,9,7,1182
8005006704,4596,3993,187,40,8,176,0,15,603
8005006705,1846,1602,80,18,4,51,0,1,244
8005006706,5003,3953,400,57,2,358,2,24,1050
8005006707,4705,3702,382,98,13,268,6,15,1003
8005006708,5155,4223,321,62,7,263,1,25,932
8005006709,5822,4555,378,79,19,469,6,21,1267
8005006711,4315,3498,356,41,2,222,5,9,817
8005006712,1498,1301,53,11,0,79,0,4,197
8005006713,1754,977,175,44,2,478,0,11,777
8005006808,5650,4417,279,47,6,545,0,34,1233
8005006815,4617,2639,742,212,25,701,1,44,1978
8005006854,3194,1786,367,217,6,628,5,25,1408
8005006857,2233,1762,105,18,5,236,0,24,471
8005006859,3561,2120,383,185,14,692,5,16,1441
8005006860,1742,1205,185,73,3,208,3,15,537
8005006861,4220,2827,269,75,13,795,8,18,1393
8005006862,1810,1135,115,11,2,444,0,8,675
8005006863,6669,3581,1118,628,26,809,3,55,3088
8005006864,3203,2076,300,358,15,358,0,4,1127
8005007101,6272,4842,995,63,36,40,1,25,1430
8005007103,1715,1226,341,26,3,13,6,4,489
8005007106,6492,3822,976,584,17,628,6,27,2670
8005007108,3226,1767,672,327,12,178,14,15,1459
8005007109,2355,1158,490,342,21,211,2,14,1197
8005007110,7369,3551,1883,1036,26,398,12,43,3818
8005007111,1790,467,1229,45,17,2,1,3,1323
8005007112,7916,4579,1188,717,32,801,4,28,3337
8005007113,7952,5327,913,444,20,741,5,56,2625
8005007201,3817,947,1847,615,22,171,46,30,2870
8005007202,3899,894,2198,461,19,147,3,23,3005
8005007301,3215,770,1300,654,19,280,36,16,2445
8005007302,5365,785,2910,1050,36,370,20,36,4580
8005007400,5333,1222,3290,340,23,227,14,42,4111
8005007500,2625,730,1401,308,9,78,8,13,1895
8005007600,3584,863,1802,550,10,168,40,31,2721
8005007702,4424,1379,1717,796,38,178,60,28,3045
8005007703,4701,1353,1747,1139,26,202,19,27,3348
8005007704,4793,1214,1656,1559,20,92,35,26,3579
8005015100,2683,2164,221,58,6,98,0,7,519
8005080000,3780,1195,1370,749,16,200,74,19,2585
8005080100,4632,1592,1393,1146,14,250,11,18,3040
8005080200,6104,2882,1278,1126,13,462,18,23,3222
8005080300,6162,3057,1070,1073,34,520,8,59,3105
8005080400,4996,2928,624,769,28,314,0,28,2068
8005080500,3854,2133,507,738,19,259,8,19,1721
8005080600,3674,1729,937,601,25,180,8,17,1945
8005080700,5604,1992,1789,1203,13,318,18,24,3612
8005080800,3307,783,1549,540,38,212,11,4,2524
8005080900,4396,1514,1866,593,17,179,25,17,2882
8005081001,2026,598,529,661,10,77,16,18,1428
8005081002,3686,817,1648,897,21,145,32,17,2869
8005081101,3490,872,957,1299,13,168,14,14,2618
8005081102,2357,748,756,568,14,106,38,21,1609
8005081200,4849,1564,1301,1362,14,276,28,23,3285
8005081300,3412,988,1245,715,8,238,40,3,2424
8005081400,5588,2820,1253,828,22,369,10,37,2768
8005081500,3152,2739,118,155,9,68,2,4,413
8005081600,5074,2818,1274,478,17,171,18,29,2256
8005081700,2864,1875,287,195,4,307,8,7,989
8005081800,5533,836,3539,608,10,374,16,13,4697
8005081900,7123,1777,3112,1536,53,333,56,42,5346
8005082000,4325,1106,1625,1038,14,191,107,46,3219
8005082100,7124,1915,2774,1533,33,354,52,62,5209
8005082200,6177,2312,1825,1299,20,330,37,44,3865
8005082300,3752,1456,1293,543,23,205,24,22,2296
8005082400,4533,1933,1443,664,24,192,3,19,2600
8005082500,2378,1243,622,221,8,98,10,13,1135
8005082600,5968,1805,1947,1507,50,244,61,31,4163
8005082700,3586,1383,951,693,17,278,6,17,2203
8005082800,5352,2284,1578,878,20,264,35,26,3068
8005082900,5094,2225,1448,741,23,321,17,23,2869
8005083000,4040,1932,709,532,8,619,1,15,2108
8005083100,7649,2939,1658,1537,56,931,18,38,4710
8005083201,6292,3410,986,675,16,714,13,64,2882
8005083202,3334,1832,597,412,15,218,3,16,1502
8005083300,4705,2504,889,723,8,301,5,26,2201
8005083400,7265,3794,1499,935,29,491,32,44,3471
8005083500,5541,2244,1450,987,16,447,12,47,3297
8005083600,3692,2065,746,373,13,232,4,27,1627
8005083700,4399,2993,407,314,19,405,2,30,1406
8005083800,3102,1602,501,550,4,237,2,26,1500
8005083900,3220,1936,482,365,10,194,7,23,1284
8005084000,2454,1386,580,185,24,118,0,12,1068
8005084100,4713,2441,946,693,9,215,18,66,2272
8005084200,3835,1959,1069,399,26,127,1,24,1876
8005084300,3636,1874,825,447,4,199,5,22,1762
8005084400,3213,1537,912,334,18,134,3,22,1676
8005084500,2914,1438,751,384,29,118,9,24,1476
8005084600,5508,3120,1129,524,29,318,15,50,2388
8005084700,4940,2825,1018,471,22,252,3,36,2115
8005084800,3519,2215,550,273,9,220,11,18,1304
8005084900,3243,2217,252,245,2,301,8,20,1026
8005085000,2704,1440,430,223,4,453,5,14,1264
8005085100,6770,3981,599,367,17,1377,5,32,2789
8005085200,3131,2237,233,82,22,338,2,24,894
8005085300,2576,1521,311,224,9,347,5,6,1055
8005085400,4444,2886,557,333,14,313,9,25,1558
8005085500,5286,3637,588,338,20,353,5,35,1649
8005085600,3257,2192,354,162,3,406,0,8,1065
8005085700,4878,2614,1239,446,18,231,17,21,2264
8005085800,1712,1013,325,169,3,95,5,5,699
8005085900,9218,4622,1504,1197,20,1257,12,54,4596
8005086001,4012,2375,652,341,14,348,11,29,1637
8005086002,3850,2119,671,457,6,315,10,8,1731
8005086100,4986,3055,840,422,10,368,5,21,1931
8005086200,6484,3977,895,485,22,663,9,26,2507
8005086300,4468,2556,656,347,15,566,13,27,1912
8005086400,2018,1644,120,48,5,98,0,16,374
8005086500,5351,3316,620,476,10,585,6,34,2035
8005086600,6842,5092,617,327,26,406,8,26,1750
8005086700,6707,4638,715,348,12,544,2,24,2069
8005086801,4342,1909,709,1240,30,220,6,24,2433
8005086802,2909,1226,392,863,9,267,3,26,1683
8005086900,3251,1157,613,1018,20,232,4,19,2094
8005087000,5117,1876,1288,1307,24,314,0,39,3241
8005087100,2589,1215,532,575,8,118,2,15,1374
8005087200,4739,2618,708,713,15,387,0,21,2121
8005087301,4977,1955,1421,1060,52,174,14,29,3022
8005087302,2654,1409,618,356,6,109,0,13,1245
8005980000,130,86,15,6,0,7,1,3,44
8007940400,1431,1097,205,3,43,12,1,8,334
8007974201,1876,1529,195,1,14,2,4,16,347
8007974202,4308,3246,739,8,35,58,0,27,1062
8007974300,3731,2703,738,20,65,20,1,10,1028
8007974400,2013,1600,282,9,13,9,0,16,413
8009964600,1588,1340,136,6,16,1,0,20,248
8009964700,1918,1576,210,13,22,7,0,17,342
8011966701,2081,1010,731,224,63,23,0,2,1071
8011966702,3569,2305,1029,31,27,16,0,6,1264
8013012101,4793,4215,219,19,8,97,0,12,578
8013012103,3810,3042,384,31,7,123,1,36,768
8013012104,2666,2209,216,21,2,75,0,9,457
8013012105,6635,4025,1896,56,12,330,9,38,2610
8013012106,2800,2248,289,27,11,69,2,20,552
8013012107,4200,3218,568,42,2,132,2,16,982
8013012201,3482,3019,155,23,12,96,4,14,463
8013012204,3462,2898,268,33,11,85,3,11,564
8013012205,2938,2393,212,30,5,150,3,15,545
8013012206,3319,2426,306,69,18,286,2,41,893
8013012207,5467,3235,1548,57,9,354,0,24,2232
8013012208,2501,1947,230,21,10,154,1,19,554
8013012300,7059,4873,675,189,95,1161,32,2,2186
8013012401,5878,4857,533,67,3,154,3,19,1021
8013012501,2472,1915,238,25,6,144,4,26,557
8013012505,4251,3493,209,18,5,243,2,31,758
8013012507,4404,3435,397,51,18,257,3,49,969
8013012508,2952,2341,283,31,8,116,1,14,611
8013012509,3322,2686,166,22,3,220,2,19,636
8013012510,4318,3673,186,18,10,212,2,19,645
8013012511,6805,4946,757,202,64,620,32,20,1859
8013012603,3399,2779,186,26,6,172,6,40,620
8013012605,1681,1128,100,20,12,348,4,6,553
8013012608,2247,1682,289,15,10,126,0,12,565
8013012609,1404,1029,131,15,2,135,0,12,375
8013012610,5042,3476,480,65,33,701,5,30,1566
8013012701,6449,5383,381,47,10,270,4,32,1066
8013012705,4508,3592,324,46,10,266,0,15,916
8013012707,2070,1402,540,24,3,39,2,11,668
8013012708,5101,4349,271,45,12,128,0,25,752
8013012709,1823,1549,115,21,0,33,0,23,274
8013012710,3752,3080,286,27,16,147,0,24,672
8013012801,8718,6681,750,94,9,679,2,24,2037
8013012802,6432,5276,577,43,6,216,4,24,1156
8013012903,2304,1895,153,14,2,104,3,11,409
8013012904,5864,4843,439,57,12,234,0,22,1021
8013012905,2632,1887,505,47,11,36,2,8,745
8013012907,3594,2746,482,27,13,151,0,8,848
8013013003,7724,6418,501,48,22,301,4,34,1306
8013013004,3463,2639,457,26,6,136,0,15,824
8013013005,3538,2870,330,24,14,87,3,21,668
8013013006,5515,4618,353,36,12,236,3,20,897
8013013201,2428,1717,504,32,11,35,0,16,711
8013013202,1379,1221,60,14,0,14,0,16,158
8013013205,5331,4547,272,36,12,200,7,52,784
8013013207,4565,3678,485,26,27,84,3,15,887
8013013208,5832,4598,815,38,26,88,11,17,1234
8013013210,5605,3117,1972,81,17,174,2,20,2488
8013013211,7042,4661,1751,33,17,289,0,21,2381
8013013212,4615,3582,426,42,21,330,1,32,1033
8013013214,5508,4042,435,50,14,671,8,46,1466
8013013215,5788,3785,1100,85,39,444,4,38,2003
8013013302,5166,4094,704,23,21,54,2,38,1072
8013013305,5045,3474,1114,45,25,97,3,33,1571
8013013306,4580,2694,1602,18,16,75,4,17,1886
8013013307,3803,2486,1008,50,24,64,0,13,1317
8013013308,3535,2494,720,28,18,62,0,39,1041
8013013401,3791,2112,1381,44,29,57,2,37,1679
8013013402,8046,4726,2683,79,38,225,1,47,3320
8013013503,5432,2459,2615,62,23,68,10,14,2973
8013013505,3950,1855,1824,37,17,57,0,26,2095
8013013506,4885,3502,929,37,21,170,6,18,1383
8013013507,3684,2257,1072,33,24,77,3,32,1427
8013013508,7976,5843,1293,53,21,393,1,36,2133
8013013601,3925,3467,223,9,9,43,1,21,458
8013013602,968,875,29,0,7,8,0,4,93
8013013703,1213,1068,32,4,5,6,1,22,145
8013013704,5222,4495,246,40,6,134,0,31,727
8013013705,1923,1715,76,2,4,21,0,2,208
8013013706,3863,3419,179,7,13,36,1,37,444
8013060601,4571,3129,426,64,3,640,2,32,1442
8013060602,1320,1007,110,11,9,123,4,11,313
8013060700,3055,2463,193,20,2,202,4,21,592
8013060801,3905,2337,1057,61,16,217,4,32,1568
8013060802,5100,2417,2309,54,30,99,1,27,2683
8013060900,5441,4092,597,60,4,389,4,50,1349
8013061300,3341,2480,242,21,1,403,1,15,861
8013061400,4131,2879,299,31,2,619,0,21,1252
8014030000,3402,2371,551,50,13,188,9,34,1031
8014030100,2261,1667,366,12,13,62,2,19,594
8014030200,2134,1457,405,31,2,116,3,15,677
8014030300,3759,2752,579,65,17,174,8,16,1007
8014030400,3807,3109,353,19,4,145,1,17,698
8014030500,5794,4262,526,52,9,626,8,28,1532
8014030600,6745,4008,2096,56,36,203,14,42,2737
8014030700,3120,2252,458,37,5,169,0,4,868
8014030800,5777,3978,983,52,16,410,5,31,1799
8014030900,5964,4789,444,53,13,334,0,14,1175
8014031000,5886,4188,604,80,8,687,6,22,1698
8014031101,3219,2249,414,116,13,208,4,18,970
8014031102,2008,1420,201,44,0,237,0,10,588
8014031103,1983,1643,175,15,5,71,0,7,340
8014031104,1505,1037,202,40,8,120,5,12,468
8014031201,2576,1873,314,65,11,172,5,9,703
8014031202,2762,2000,393,48,13,127,4,27,762
8014031300,2578,2116,159,15,8,149,2,6,462
8014031401,2199,2106,28,4,0,30,0,0,93
8014031402,2016,1237,258,43,2,353,1,3,779
8014031403,4617,3390,410,30,1,515,3,17,1227
8014980100,0,0,0,0,0,0,0,0,0
8014980200,0,0,0,0,0,0,0,0,0
8014980300,0,0,0,0,0,0,0,0,0
8015000100,2555,2047,308,13,12,14,3,17,508
8015000200,4854,4151,436,13,11,29,0,26,703
8015000300,3341,2933,223,6,16,29,1,21,408
8015000402,3771,2705,569,254,69,29,3,18,1066
8015000403,1674,1509,88,2,6,4,1,7,165
8015000404,3281,2850,217,7,18,28,3,11,431
8017960600,1748,1470,206,1,5,3,0,3,278
8019014701,2565,2318,126,5,8,14,0,14,247
8019014702,2494,2149,158,12,13,33,0,6,345
8019014800,1694,1481,106,16,5,18,0,6,213
8019014900,2644,2201,258,16,15,17,7,12,443
8021974800,3357,1191,2085,12,14,5,0,15,2166
8021974900,4104,2274,1694,2,30,16,2,9,1830
8023972600,1754,828,747,23,25,33,0,7,926
8023972700,1745,406,1241,10,9,22,0,6,1339
8025969601,2906,1645,760,310,84,40,0,5,1261
8025969602,3016,1793,848,200,67,29,2,0,1223
8027970101,2422,2188,85,3,21,14,0,21,234
8027970102,2282,2024,93,7,21,8,0,24,258
8029964600,4134,3586,282,8,15,14,1,38,548
8029964700,4125,3539,366,6,9,15,1,31,586
8029964800,3704,2548,856,63,25,67,0,26,1156
8029964900,6293,4563,1358,13,22,46,3,27,1730
8029965001,2246,1932,197,1,5,6,1,13,314
8029965002,2413,2028,213,6,4,9,0,21,385
8029965100,3760,2746,745,15,22,62,0,8,1014
8029965201,2281,1965,199,9,7,8,3,8,316
8029965202,2240,2000,113,0,12,9,0,20,240
8031000102,3622,2668,669,22,23,52,0,13,954
8031000201,3913,1669,2055,53,20,22,2,9,2244
8031000202,4042,1809,1741,243,28,57,3,20,2233
8031000301,5779,4451,906,46,13,108,0,17,1328
8031000302,4412,3372,665,68,15,87,2,11,1040
8031000303,5479,4360,676,48,16,131,4,28,1119
8031000401,3174,2011,910,54,19,52,3,10,1163
8031000403,3682,2644,772,50,14,65,1,12,1038
8031000404,2956,2269,361,87,9,72,1,15,687
8031000501,2014,1552,294,20,16,37,1,14,462
8031000503,2269,1285,656,83,28,124,0,17,984
8031000504,3648,2582,651,80,23,96,0,14,1066
8031000600,4742,3385,879,93,13,151,6,10,1357
8031000703,2603,1591,724,108,11,47,0,20,1012
8031000704,2715,1410,1007,113,38,56,3,13,1305
8031000705,3134,1407,1171,304,32,74,4,12,1727
8031000706,2872,1291,1072,195,46,117,5,9,1581
8031000800,1127,149,501,351,21,37,7,2,978
8031000902,5345,1351,3658,77,37,86,4,32,3994
8031000903,5780,1406,3998,71,63,69,0,42,4374
8031000904,4711,1134,3161,194,58,46,0,19,3577
8031000905,3269,1034,2069,48,24,18,0,11,2235
8031001000,3683,717,2573,146,39,85,3,18,2966
8031001101,2743,1272,1119,160,24,47,2,19,1471
8031001102,5274,3940,791,96,13,168,3,27,1334
8031001301,4834,1249,3048,71,36,271,5,26,3585
8031001302,3759,1065,2399,49,61,72,4,14,2694
8031001401,5935,1309,3857,190,39,388,0,32,4626
8031001402,4048,988,2492,161,46,221,1,42,3060
8031001403,3374,2213,753,116,27,80,3,18,1161
8031001500,4580,1616,2336,393,49,52,0,38,2964
8031001601,2995,1984,567,222,4,86,0,5,1011
8031001602,5167,3920,619,156,15,185,2,22,1247
8031001603,6613,4313,1156,571,67,139,18,37,2300
8031001703,3487,2901,263,46,11,109,3,13,586
8031001704,2383,1668,235,98,14,233,1,15,715
8031001705,4401,3434,380,85,7,207,3,97,967
8031001706,2449,1669,332,163,27,114,6,16,780
8031001707,2478,1763,338,99,13,143,0,17,715
8031001800,3306,1876,929,185,34,112,1,19,1430
8031001901,3903,1445,1474,592,52,119,9,19,2458
8031002000,4053,2700,625,396,33,144,3,18,1353
8031002101,3078,2058,668,83,21,68,5,25,1020
8031002102,3114,2241,422,161,18,100,2,18,873
8031002300,4975,2778,907,920,16,77,0,15,2197
8031002402,1971,1162,381,264,3,47,3,8,809
8031002404,1415,790,304,187,8,48,0,8,625
8031002405,4526,2441,823,800,44,136,3,30,2085
8031002602,2835,2077,343,188,23,80,3,12,758
8031002603,3250,2353,412,160,20,117,0,18,897
8031002604,2097,1304,311,229,26,98,7,20,793
8031002704,2423,1670,409,123,32,60,0,9,753
8031002705,2675,1992,357,118,7,63,1,15,683
8031002706,3286,2516,356,107,14,125,0,18,770
8031002707,2996,2385,308,76,12,69,0,11,611
8031002708,3011,2196,408,137,27,72,5,20,815
8031002709,2284,1741,252,94,7,47,0,19,543
8031002801,3217,2574,327,65,7,87,6,13,643
8031002802,4708,3627,578,120,16,130,0,36,1081
8031002804,2209,1833,193,34,9,56,2,6,376
8031002805,3784,3092,290,84,12,107,7,10,692
8031002901,3839,3155,318,58,12,94,6,23,684
8031002902,4211,3632,279,21,8,79,0,25,579
8031003002,2749,2224,285,29,11,54,0,8,525
8031003003,3188,2425,304,94,12,170,1,16,763
8031003004,6308,4896,536,170,10,322,0,29,1412
8031003005,3144,2604,243,47,15,58,0,13,540
8031003006,3644,3068,248,20,2,86,0,13,576
8031003101,1701,1137,207,208,4,46,3,3,564
8031003102,4082,2719,564,438,33,99,0,34,1363
8031003202,3429,2768,274,123,8,85,0,18,661
8031003203,3100,2753,168,17,3,51,1,12,347
8031003204,2159,1567,281,116,9,61,3,7,592
8031003205,3196,2629,276,61,8,58,3,25,567
8031003300,3329,2839,201,38,9,80,0,5,490
8031003401,2998,2649,159,16,5,49,0,5,349
8031003402,4860,4199,258,20,6,122,2,26,661
8031003501,3238,438,2299,357,50,10,3,17,2800
8031003502,2727,337,2246,68,22,2,0,14,2390
8031003601,4236,1813,1718,431,13,53,4,20,2423
8031003602,4337,1427,1726,874,34,58,5,22,2910
8031003603,3583,1798,573,921,19,62,6,22,1785
8031003701,3746,2809,374,264,33,85,3,18,937
8031003702,4759,3660,472,197,12,120,5,25,1099
8031003703,3276,2516,318,101,7,109,5,19,760
8031003801,3666,3075,252,54,4,129,0,21,591
8031003802,3970,3242,318,100,5,148,1,12,728
8031003901,5266,4435,380,58,7,176,0,37,831
8031003902,4606,3749,398,30,4,143,9,11,857
8031004002,3448,3001,162,26,10,89,1,21,447
8031004003,4408,3416,521,103,19,119,5,23,992
8031004004,1968,1563,177,60,3,61,0,10,405
8031004005,3751,2797,423,101,26,218,9,29,954
8031004006,5373,4286,379,94,6,371,0,15,1087
8031004101,4802,1421,1274,1730,35,74,4,39,3381
8031004102,4081,1188,1130,1464,32,32,3,37,2893
8031004103,5494,3502,562,977,15,104,4,17,1992
8031004104,4519,2205,734,1162,13,73,0,40,2314
8031004108,7604,5651,718,316,9,360,2,41,1953
8031004109,3284,2154,426,135,6,279,3,21,1130
8031004110,5541,3515,869,592,86,181,0,13,2026
8031004111,6848,4396,947,443,24,548,8,32,2452
8031004112,6127,4236,756,465,9,289,2,41,1891
8031004113,1756,1289,207,68,8,91,0,6,467
8031004201,4906,3982,357,156,11,135,2,17,924
8031004202,4467,3211,476,399,32,101,3,22,1256
8031004302,2699,2137,275,75,2,63,0,22,562
8031004303,4341,3741,194,33,3,105,1,24,600
8031004306,6092,4408,701,461,14,150,6,55,1684
8031004307,1988,1376,292,130,5,46,0,12,612
8031004308,4132,2941,551,232,18,153,0,24,1191
8031004309,3633,2798,348,183,16,82,1,12,835
8031004310,2347,1821,224,94,9,73,0,10,526
8031004403,4274,1968,1356,594,31,73,3,31,2306
8031004404,5887,1792,1394,1582,42,803,5,13,4095
8031004406,3965,2729,452,383,19,158,0,27,1236
8031004407,4941,3053,734,628,16,198,5,36,1888
8031004503,4303,519,3419,131,32,102,8,5,3784
8031004504,3881,596,3022,47,43,76,2,21,3285
8031004505,4549,516,3593,152,27,133,16,22,4033
8031004506,3610,490,2477,249,38,258,0,25,3120
8031004601,5666,1573,3632,78,56,167,2,27,4093
8031004602,6688,1358,4601,166,43,361,5,36,5330
8031004603,5324,1889,2951,46,36,230,2,6,3435
8031004700,6172,2134,3420,92,62,276,5,37,4038
8031004801,3077,1321,1438,33,21,134,3,16,1756
8031005001,2869,1820,451,332,15,84,2,19,1049
8031005003,2744,1640,387,448,14,79,4,42,1104
8031005004,4687,2443,791,951,25,223,5,12,2244
8031005102,3506,2570,526,95,10,85,0,23,936
8031005104,3470,2039,666,366,20,190,4,19,1431
8031005200,3338,2452,421,141,5,99,2,26,886
8031005300,1859,1378,208,89,5,90,1,8,481
8031005502,1868,899,657,79,5,161,1,6,969
8031005503,5071,2973,1516,119,21,230,5,13,2098
8031006701,4282,3092,485,157,11,293,6,20,1190
8031006804,3776,2847,359,180,15,214,1,18,929
8031006810,5928,3396,893,933,22,303,2,57,2532
8031006812,3932,2992,404,144,6,166,6,30,940
8031006813,4550,2161,815,1067,38,185,4,37,2389
8031006814,5409,2608,1713,641,20,172,23,21,2801
8031006815,2017,1581,133,83,9,70,5,13,436
8031006816,5511,3700,756,526,26,178,3,43,1811
8031006817,2048,1497,227,134,4,84,1,20,551
8031006818,4221,2608,746,409,16,219,8,30,1613
8031006902,3638,1939,833,502,15,121,7,28,1699
8031006903,2475,1494,472,275,6,86,1,16,981
8031007006,4431,1216,1419,856,25,584,47,35,3215
8031007013,3730,2498,490,336,20,180,0,19,1232
8031007037,4128,1180,1402,1180,13,182,10,20,2948
8031007088,4921,2469,1094,803,20,206,4,26,2452
8031007090,1542,585,186,638,12,50,1,4,957
8031007091,3497,2782,214,349,11,56,0,6,715
8031008304,3846,302,2580,775,15,44,7,17,3544
8031008305,4253,316,3123,609,10,41,38,16,3937
8031008306,6005,458,3574,1491,10,107,147,30,5547
8031008312,8133,639,4889,1994,46,207,135,27,7494
8031008386,4664,318,3304,822,9,91,4,14,4346
8031008387,6220,430,4216,1230,30,164,16,9,5790
8031008388,14773,3207,6766,2763,55,1052,293,39,11566
8031008389,13336,2740,5032,3476,43,1382,41,85,10596
8031008390,9000,1404,3684,2535,36,784,81,37,7596
8031008391,7855,1224,3416,2065,32,720,57,57,6631
8031011902,6682,3151,2779,132,71,237,8,43,3531
8031011903,2304,1305,745,31,19,114,0,18,999
8031012001,2047,1428,447,24,18,70,8,8,619
8031012010,5121,3699,755,94,15,357,2,17,1422
8031012015,4014,2644,874,83,28,171,8,19,1370
8031012016,2659,1822,543,28,11,107,3,6,837
8031015300,3697,2469,556,232,15,158,0,34,1228
8031015400,4487,2914,1156,86,16,118,3,14,1573
8031015500,3399,1998,813,282,30,69,2,22,1401
8031015600,6618,1131,4414,332,36,512,11,32,5487
8031015700,5907,2249,2840,167,42,417,5,20,3658
8031015800,2893,634,847,1046,2,130,46,12,2259
8031980001,0,0,0,0,0,0,0,0,0
8031980100,9,1,4,0,0,0,0,0,8
8031980200,252,184,41,4,0,15,0,1,68
8033000100,2326,1950,176,18,36,6,4,5,376
8035013904,4198,3103,557,118,6,160,8,21,1095
8035013905,5468,4164,673,151,13,138,8,22,1304
8035013907,6177,4787,656,93,22,232,8,47,1390
8035013909,6407,5447,462,60,21,101,5,21,960
8035013910,8222,6571,740,97,16,255,13,26,1651
8035013911,6693,5485,586,67,23,161,8,36,1208
8035013912,7399,5993,694,151,15,193,4,25,1406
8035013913,2660,2193,196,35,11,115,0,10,467
8035013914,3757,3293,207,24,6,59,0,16,464
8035013915,3177,2736,226,18,9,64,2,19,441
8035014005,4761,3642,497,61,4,312,2,31,1119
8035014006,7394,5637,640,95,13,602,2,18,1757
8035014007,3425,2073,410,145,10,594,3,14,1352
8035014008,11741,8397,996,184,26,1515,7,45,3344
8035014009,4741,3311,564,90,28,476,1,15,1430
8035014010,6009,4359,670,142,19,510,11,20,1650
8035014011,7059,4947,537,87,9,1122,0,21,2112
8035014013,11075,8976,1027,146,20,271,12,57,2099
8035014014,4916,3115,584,169,18,720,0,27,1801
8035014015,4074,2971,622,96,18,153,10,16,1103
8035014016,5719,4427,578,77,12,318,6,16,1292
8035014017,3287,2694,293,45,16,89,3,4,593
8035014107,3812,3030,326,36,14,133,5,45,782
8035014108,4823,3971,397,38,12,124,3,23,852
8035014109,2920,2525,164,27,4,100,0,2,395
8035014110,5341,4020,579,84,31,368,3,27,1321
8035014112,3811,3095,292,53,12,177,2,6,716
8035014113,2953,2188,287,35,5,229,0,23,765
8035014114,3370,2529,476,37,21,104,4,11,841
8035014115,4075,3187,323,42,14,295,4,10,888
8035014116,6184,3969,632,180,18,1058,12,27,2215
8035014123,4012,3042,563,111,11,74,4,15,970
8035014124,5276,4156,562,77,11,174,3,16,1120
8035014125,5998,4548,562,89,15,426,0,35,1450
8035014126,1887,1314,170,19,4,279,2,20,573
8035014127,5437,4555,370,45,15,215,2,14,882
8035014128,4581,3617,449,50,7,200,8,15,964
8035014129,3604,2892,303,34,10,171,0,9,712
8035014130,7352,5807,715,58,19,390,6,30,1545
8035014131,6142,5016,489,68,19,324,4,24,1126
8035014132,6161,4868,421,42,14,510,1,20,1293
8035014133,6300,5056,515,42,11,294,3,42,1244
8035014134,5849,4392,496,73,8,512,2,26,1457
8035014135,5818,4786,383,22,11,310,0,8,1032
8035014138,2961,1941,294,46,13,546,0,9,1020
8035014139,4142,3220,354,64,3,303,6,8,922
8035014140,5433,4234,382,77,14,410,4,31,1199
8035014141,5447,4547,368,55,16,167,15,19,900
8035014142,1884,1680,73,18,2,50,0,4,204
8035014143,3153,2382,200,32,2,372,0,12,771
8035014144,6089,4315,446,79,13,980,1,19,1774
8035014145,3684,2633,464,75,5,246,0,25,1051
8035014146,4896,3467,662,55,11,394,5,17,1429
8035014203,6556,5455,559,32,16,128,7,19,1101
8035014205,2913,2390,251,17,8,109,1,8,523
8035014206,788,662,62,0,0,10,0,9,126
8035014207,1794,1390,218,10,16,36,2,8,404
8035014208,1509,1186,178,7,9,44,0,13,323
8035014300,781,692,32,0,6,9,0,0,89
8035014404,2669,2315,154,11,14,34,0,17,354
8035014405,7923,6363,887,65,16,126,10,42,1560
8035014407,3595,2834,499,42,9,56,8,17,761
8035014408,2553,2226,161,13,2,38,5,8,327
8035014409,3918,3229,301,36,4,112,1,38,689
8035014410,12675,9985,1346,221,35,368,5,25,2690
8035014503,6166,4814,718,73,20,146,3,52,1352
8035014504,5656,4305,876,65,42,46,2,40,1351
8035014505,5630,4497,601,68,19,132,0,22,1133
8035014506,6865,5631,664,91,15,101,12,44,1234
8035014602,2616,2307,149,8,7,14,0,10,309
8035014603,7165,5567,903,68,19,138,4,30,1598
8035014604,4452,3619,419,47,13,65,18,30,833
8037000100,1664,722,894,5,0,7,0,2,942
8037000200,8385,4021,4007,20,34,73,2,31,4364
8037000301,6420,3754,2352,19,13,92,9,30,2666
8037000302,2150,1650,396,5,8,12,2,6,500
8037000401,5956,3813,1871,41,10,75,5,22,2143
8037000402,5052,2952,1896,20,6,66,0,7,2100
8037000404,2411,1610,727,13,1,6,0,4,801
8037000405,6876,5651,957,21,10,45,0,8,1225
8037000501,1222,905,241,6,4,36,0,13,317
8037000502,3587,2724,609,58,3,65,3,12,863
8037000504,2944,1233,1540,38,6,79,0,9,1711
8037000505,2603,1885,555,13,3,62,5,9,718
8037000600,1347,1003,293,3,12,4,0,0,344
8037000701,1201,1055,78,3,0,21,0,10,146
8037000702,1389,1187,133,1,2,18,1,11,202
8037000703,2524,2037,309,30,6,51,0,13,487
8039961100,2019,1745,173,5,10,0,1,6,274
8039961204,7999,6682,689,61,37,92,9,25,1317
8039961205,2107,1736,216,10,4,8,2,12,371
8039961206,3521,3010,267,15,9,31,0,28,511
8039961207,4045,3495,282,15,23,18,4,13,550
8039961208,3985,3393,306,10,15,27,3,29,592
8039961209,2386,2124,134,7,18,8,2,10,262
8041000102,3413,2465,584,83,23,33,1,3,948
8041000103,3025,1950,536,215,19,88,13,13,1075
8041000104,3484,2503,502,161,20,80,5,18,981
8041000202,4472,3144,753,171,19,64,7,24,1328
8041000203,4425,3212,672,144,44,94,9,21,1213
8041000301,3262,2141,776,101,25,40,7,18,1121
8041000302,4360,2652,1066,242,23,76,5,33,1708
8041000400,2486,1971,303,62,6,15,3,11,515
8041000500,2016,1637,207,36,4,28,0,9,379
8041000600,3227,2310,545,98,16,28,8,31,917
8041000700,3325,2179,594,260,13,45,0,19,1146
8041000800,2606,1908,400,94,16,24,0,14,698
8041000900,2269,1884,197,28,8,18,1,13,385
8041001000,2301,1973,158,19,3,16,0,22,328
8041001101,1347,901,272,53,17,16,3,10,446
8041001104,3349,2317,592,125,29,57,0,21,1032
8041001301,2203,1698,268,33,26,29,0,13,505
8041001302,5392,3908,878,167,32,49,14,36,1484
8041001400,3365,2637,440,38,13,43,4,15,728
8041001500,2453,1748,423,84,15,24,0,14,705
8041001600,3648,2652,349,139,11,244,3,0,996
8041001700,1733,1228,237,84,11,31,0,12,505
8041001800,1967,1578,226,27,6,24,5,10,389
8041001901,2126,1451,387,86,32,19,3,20,675
8041001902,2276,1197,631,219,16,36,4,16,1079
8041002000,6759,3920,1591,479,63,135,15,58,2839
8041002101,3972,2249,896,387,55,62,9,14,1723
8041002102,4989,2381,1744,417,47,82,25,15,2608
8041002200,2719,1678,571,225,19,44,4,21,1041
8041002300,2139,1447,309,189,25,39,5,8,692
8041002401,2807,2215,354,43,10,33,11,2,592
8041002402,3512,2633,513,61,11,127,5,18,879
8041002501,3550,3016,222,15,7,102,5,25,534
8041002502,3754,2773,477,142,6,84,7,24,981
8041002700,3172,1961,617,300,22,24,9,27,1211
8041002801,3072,1369,1035,364,36,44,4,32,1703
8041002802,4474,2177,1108,592,32,234,17,33,2297
8041002901,4532,2241,1376,383,51,98,37,28,2291
8041002902,1420,684,461,114,18,18,12,8,736
8041003001,1878,1287,316,79,11,31,2,24,591
8041003002,2655,1905,387,89,20,60,7,22,750
8041003100,4706,4043,291,32,16,108,5,10,663
8041003303,5522,3171,1281,487,30,165,10,27,2351
8041003305,7325,5709,697,146,24,330,14,27,1616
8041003306,3248,2440,395,50,8,120,5,26,808
8041003307,3660,2375,638,187,25,171,13,12,1285
8041003308,6111,3106,1493,659,41,302,76,38,3005
8041003401,2310,1993,137,23,17,22,1,4,317
8041003402,1446,1253,92,9,5,16,0,5,193
8041003702,5251,4301,403,66,18,149,4,38,950
8041003705,6494,5110,674,152,26,169,4,45,1384
8041003706,4714,3771,392,98,9,116,8,39,943
8041003707,3458,2708,353,79,23,80,0,19,750
8041003708,2984,2397,226,67,9,114,0,26,587
8041003710,3205,2407,387,52,2,146,0,17,798
8041003711,3154,2448,346,85,6,83,0,14,706
8041003712,5422,4351,563,63,21,98,0,38,1071
8041003713,4505,3796,343,30,16,56,1,32,709
8041003801,3750,2487,559,247,24,176,23,24,1263
8041003802,2865,1879,379,249,14,218,22,3,986
8041003905,4326,2969,677,177,26,142,20,27,1357
8041003906,6306,4619,785,161,9,327,13,39,1687
8041003910,2591,2174,206,15,17,11,2,4,417
8041003911,4423,3644,322,33,39,33,4,33,779
8041003912,8255,5762,1265,304,30,182,21,43,2493
8041003913,1566,1344,96,19,5,13,0,12,222
8041003914,7703,5605,875,393,29,160,24,73,2098
8041004008,3020,1836,506,247,12,129,23,12,1184
8041004009,1460,518,512,239,11,48,1,11,942
8041004100,5247,3101,1184,361,29,80,35,44,2146
8041004200,4066,2458,844,315,21,78,15,24,1608
8041004300,6642,3885,1423,532,40,164,48,31,2757
8041004402,6641,3598,1223,1118,3,236,33,69,3043
8041004403,2204,1073,481,355,0,68,46,19,1131
8041004404,3277,1844,655,287,29,134,44,39,1433
8041004405,3663,1955,924,359,39,42,40,23,1708
8041004406,2567,1186,746,305,29,66,46,15,1381
8041004501,5938,2729,2196,545,50,91,17,34,3209
8041004502,6921,3639,1481,757,32,334,84,37,3282
8041004506,4963,3017,991,346,47,93,41,39,1946
8041004507,3150,1821,635,305,18,62,37,16,1329
8041004512,2635,1473,616,221,13,51,20,18,1162
8041004513,3723,2149,896,302,22,58,18,19,1574
8041004514,6060,3326,1385,557,29,132,77,29,2734
8041004515,6520,3298,1553,758,58,180,120,40,3222
8041004516,3528,2206,804,206,25,48,11,19,1322
8041004517,5122,2984,1156,391,32,81,51,34,2138
8041004518,6598,3661,1283,669,43,251,101,56,2937
8041004519,5482,2872,1297,544,28,179,97,46,2610
8041004520,2360,1358,556,178,10,60,17,28,1002
8041004601,4324,3414,554,39,28,22,0,28,910
8041004602,4669,3533,701,55,17,28,3,30,1136
8041004603,9811,5676,2145,802,61,231,103,110,4135
8041004701,4948,3535,659,198,25,123,5,32,1413
8041004702,2188,1559,351,77,7,37,1,2,629
8041004703,6287,4513,879,249,33,132,8,39,1774
8041004706,5524,3825,817,223,30,264,14,29,1699
8041004707,3389,2385,513,146,19,100,10,8,1004
8041004708,5176,3559,748,286,21,172,24,21,1617
8041004800,4904,3232,970,224,30,83,4,24,1672
8041004901,3771,2434,816,164,28,51,3,25,1337
8041004902,5385,4067,614,180,15,156,7,36,1318
8041005000,5445,3117,1294,410,40,116,14,37,2328
8041005110,4224,2475,966,262,39,103,26,30,1749
8041005112,3932,2250,834,326,14,141,22,30,1682
8041005113,3362,2163,596,199,26,131,11,20,1199
8041005114,1804,863,659,74,19,64,1,6,941
8041005115,6577,3654,1500,499,14,277,36,41,2923
8041005116,4437,2863,656,287,22,199,19,29,1574
8041005117,4026,2709,603,183,13,199,14,23,1317
8041005118,4913,3092,914,317,22,171,12,53,1821
8041005119,4867,2968,911,326,22,201,16,19,1899
8041005120,5636,3629,935,267,54,263,15,63,2007
8041005121,6150,3992,1079,281,21,281,18,27,2158
8041005122,11238,7425,1845,579,64,459,10,81,3813
8041005123,3014,2345,401,24,16,45,0,5,669
8041005124,3855,2365,730,218,17,223,18,34,1490
8041005125,5394,3530,751,333,16,355,35,33,1864
8041005201,4079,1577,1536,538,25,84,25,27,2502
8041005202,2731,1259,689,464,16,104,10,17,1472
8041005300,4566,2049,1458,577,36,134,36,24,2517
8041005400,5918,2053,2357,832,32,165,40,37,3865
8041005501,6953,4874,1015,346,14,191,16,37,2079
8041005502,4567,2702,986,313,38,97,29,21,1865
8041005601,3503,2396,598,165,19,74,10,14,1107
8041005602,2964,2106,452,136,13,64,4,17,858
8041005700,5861,4027,989,295,15,141,27,32,1834
8041005800,3047,2277,412,101,10,44,7,19,770
8041005900,6930,4489,1276,388,40,153,24,51,2441
8041006000,6804,3378,2366,516,44,131,25,33,3426
8041006100,4069,1675,1764,336,32,61,12,14,2394
8041006200,5354,2188,2131,509,30,114,49,36,3166
8041006301,4946,2153,1619,547,20,175,44,55,2793
8041006302,5363,2075,1796,872,29,172,36,26,3288
8041006400,7445,2730,2644,1155,76,219,56,58,4715
8041006501,4062,1172,2214,283,21,98,15,11,2890
8041006502,7873,2895,3083,893,41,357,69,42,4978
8041006600,2427,2009,211,26,7,27,1,21,418
8041006701,2500,2097,189,27,6,28,0,14,403
8041006702,3013,2569,194,24,16,37,3,27,444
8041006801,4228,3016,613,131,29,127,7,22,1212
8041006802,3940,2885,450,120,16,139,12,27,1055
8041006901,5344,3926,679,138,28,212,7,26,1418
8041006902,5019,3666,624,197,26,167,9,23,1353
8041007000,4764,3616,432,102,14,316,4,23,1148
8041007103,5207,3885,504,162,27,241,6,36,1322
8041007104,4316,3294,363,76,6,322,11,47,1022
8041007105,8338,5736,1034,364,31,521,22,30,2602
8041007106,6720,4741,747,240,26,464,7,30,1979
8041007203,4188,3323,357,109,18,142,2,9,865
8041007204,5504,4372,426,85,13,253,4,42,1132
8041007205,5899,4025,632,228,19,599,10,28,1874
8041007206,7441,5658,618,175,14,483,20,52,1783
8041007301,7203,5899,535,101,22,173,0,44,1304
8041007302,6043,4924,521,88,12,161,8,44,1119
8041007401,6828,5814,393,75,30,113,3,53,1014
8041007402,2749,2301,140,37,0,54,1,56,448
8041007501,1227,1060,74,16,6,22,2,8,167
8041007502,9264,7525,747,161,22,299,6,75,1739
8041007602,3868,3229,294,29,17,41,3,46,639
8041007603,10167,7071,1536,383,38,272,34,57,3096
8041007604,3684,2708,486,115,10,111,8,25,976
8041007700,6437,4735,843,279,41,172,7,30,1702
8041007801,1720,1308,212,51,10,48,1,2,412
8041007802,2110,1590,221,53,1,103,2,20,520
8041007900,2610,2217,186,41,5,70,1,15,393
8041008000,4331,3009,702,204,33,97,5,29,1322
8043978100,4436,3740,399,17,37,33,5,32,696
8043978200,3922,2925,541,21,38,15,0,40,997
8043978300,5994,4930,643,19,42,41,6,26,1064
8043978400,2221,1865,212,16,23,13,3,3,356
8043978500,6443,5343,683,25,37,30,2,24,1100
8043978600,3594,2794,435,89,40,26,0,37,800
8043978800,2557,2160,238,13,18,5,2,1,397
8043979001,2675,2360,139,8,13,6,4,13,315
8043979002,1687,1499,78,4,29,4,0,15,188
8043979100,3661,3112,280,14,21,11,3,19,549
8043979200,1880,1635,122,11,11,21,2,7,245
8043979400,2772,2313,237,16,24,23,3,17,459
8043980100,564,304,116,115,22,7,0,0,260
8043980200,2532,867,663,766,186,50,0,0,1665
8043980300,4001,1866,1263,675,150,47,0,0,2135
8045951600,4064,2083,1798,12,8,24,2,14,1981
8045951701,4513,2731,1523,15,10,50,1,28,1782
8045951702,3407,2218,982,11,11,51,1,20,1189
8045951802,4180,2918,1057,11,12,15,4,24,1262
8045951803,5985,3835,1870,18,14,49,3,37,2150
8045951804,4621,3408,962,14,12,50,2,29,1213
8045951901,5555,3584,1666,14,23,12,0,26,1971
8045951902,7590,4916,2253,28,29,54,2,32,2674
8045952001,5713,2660,2792,13,33,20,3,24,3053
8045952003,2371,1511,670,41,29,8,3,12,860
8045952004,6402,3820,2224,46,57,33,4,23,2582
8045952100,7284,4952,1767,54,62,31,9,40,2332
8047013801,2160,1886,120,6,7,26,2,12,274
8047013802,3648,3066,260,26,29,59,2,25,582
8049000100,3226,2575,492,10,11,3,10,16,651
8049000203,2041,1788,162,14,0,19,3,8,253
8049000204,1734,1567,86,6,5,16,2,1,167
8049000205,3543,3135,233,10,16,25,0,24,408
8049000206,1678,1509,89,1,5,7,2,12,169
8049000207,3495,2861,471,18,19,13,0,12,634
8051963601,2134,1853,168,2,8,4,0,4,281
8051963602,1915,1616,196,5,4,6,0,14,299
8051963701,3898,3036,598,23,26,21,0,15,862
8051963702,2888,2252,404,40,11,42,3,49,636
8051963800,5116,4627,198,5,16,48,3,21,489
8051963900,967,870,40,2,5,0,1,8,97
8053973100,788,693,30,8,6,2,1,6,95
8055960600,3248,1427,1589,34,48,12,0,27,1821
8055960901,1753,1277,336,8,17,9,0,18,476
8055960902,1819,1527,205,11,12,3,0,4,292
8057955600,1379,1161,138,0,12,2,2,5,218
8059009806,4266,3644,259,31,13,108,0,20,622
8059009807,1727,1391,190,11,10,29,0,26,336
8059009815,5182,4253,502,23,10,136,4,13,929
8059009823,4495,3464,622,46,13,92,2,37,1031
8059009824,5044,3794,676,33,18,204,3,32,1250
8059009827,6305,4515,891,101,17,428,4,16,1790
8059009828,5315,4178,639,38,23,194,5,14,1137
8059009829,1780,1382,212,16,2,57,0,12,398
8059009830,2155,1577,361,41,11,51,0,19,578
8059009831,2768,1709,644,81,30,123,5,21,1059
8059009832,2567,1730,569,35,9,83,3,14,837
8059009833,5601,3943,1155,118,30,97,0,15,1658
8059009834,4499,3315,773,50,17,124,1,24,1184
8059009835,3584,3024,325,19,1,53,3,16,560
8059009836,4106,3433,406,12,11,86,0,14,673
8059009837,7944,6557,749,37,8,276,0,15,1387
8059009838,5428,4563,376,22,10,201,0,16,865
8059009839,2353,1974,235,7,3,44,0,13,379
8059009840,3705,3071,371,27,9,69,2,14,634
8059009841,2337,1890,289,9,3,46,0,5,447
8059009842,3434,2875,261,18,4,129,0,6,559
8059009845,4014,3584,166,10,11,98,0,9,430
8059009846,5060,4510,227,13,20,72,3,36,550
8059009847,3323,2977,159,9,11,24,0,14,346
8059009848,2614,2383,87,2,5,27,0,19,231
8059009850,2633,2328,114,11,8,39,0,18,305
8059009851,3958,3329,333,19,22,97,2,19,629
8059009852,4524,3908,312,11,10,77,3,34,616
8059009853,2758,2340,152,7,6,88,0,10,418
8059009854,5599,4881,315,13,4,102,0,24,718
8059009855,3430,2807,208,27,10,205,5,21,623
8059009856,2983,2160,554,22,29,65,0,14,823
8059009857,2946,2445,196,19,0,109,1,15,501
8059009858,3358,2921,180,10,7,37,2,25,437
8059009901,3121,2588,205,36,20,145,1,13,533
8059010001,4096,3016,589,144,23,192,0,5,1080
8059010100,4736,3588,656,67,30,148,2,23,1148
8059010205,2572,2212,192,6,2,52,2,8,360
8059010206,4053,3178,604,24,15,64,4,22,875
8059010208,5804,3968,1249,66,27,191,3,9,1836
8059010209,6637,4361,1520,110,46,244,4,37,2276
8059010210,3739,2870,565,28,19,67,0,17,869
8059010211,3214,2279,622,76,8,57,1,18,935
8059010212,4512,3095,986,82,25,56,7,20,1417
8059010213,4751,3151,1231,48,35,93,1,31,1600
8059010303,5634,4605,576,61,29,74,5,19,1029
8059010304,2764,2189,349,24,19,40,2,5,575
8059010305,3565,2608,636,40,34,50,2,19,957
8059010306,2714,2091,362,29,13,43,0,22,623
8059010307,4656,3392,882,66,24,53,5,12,1264
8059010308,6507,5201,793,49,28,132,6,20,1306
8059010402,6187,4012,1537,84,62,126,8,89,2175
8059010403,5434,3464,1394,95,61,122,4,28,1970
8059010405,2715,1867,571,61,17,50,0,15,848
8059010406,3080,1505,1362,31,17,43,9,8,1575
8059010502,5436,3891,1089,59,24,89,4,29,1545
8059010503,4806,3659,725,44,24,121,10,14,1147
8059010504,3003,2556,248,9,4,60,0,12,447
8059010603,3607,2477,794,65,32,78,4,18,1130
8059010604,2497,1586,673,32,26,65,2,10,911
8059010701,4159,3037,794,50,15,71,3,13,1122
8059010702,5187,2735,1973,121,33,85,16,23,2452
8059010801,2512,2073,259,18,15,30,6,18,439
8059010901,5207,3910,712,123,44,95,23,29,1297
8059010902,3165,1925,780,106,48,112,0,13,1240
8059011000,5707,3915,1201,112,67,105,25,44,1792
8059011101,3380,2202,763,88,24,91,17,29,1178
8059011102,3242,1565,1250,152,42,50,26,22,1677
8059011202,5424,4070,940,60,30,79,2,40,1354
8059011300,3011,2135,639,20,20,53,0,15,876
8059011401,2753,1297,1133,108,31,60,8,16,1456
8059011402,3906,2109,1349,118,48,73,13,19,1797
8059011551,4054,2335,1245,180,36,68,11,15,1719
8059011552,2962,1436,1146,105,52,53,0,21,1526
8059011601,3728,1623,1797,67,39,77,0,25,2105
8059011602,4245,1972,1871,84,28,128,3,32,2273
8059011701,4653,3299,946,45,25,167,0,24,1354
8059011702,5730,3759,1337,43,29,345,2,16,1971
8059011708,4199,3151,666,28,21,81,5,19,1048
8059011709,3449,2436,685,24,16,110,8,10,1013
8059011710,4113,2928,749,55,25,141,5,21,1185
8059011711,4281,3136,683,71,20,141,6,12,1145
8059011712,4188,3417,427,23,9,80,2,22,771
8059011720,5147,4187,433,46,6,205,3,26,960
8059011721,2719,2242,197,24,3,119,1,8,477
8059011723,3310,2395,551,60,25,136,0,16,915
8059011724,7559,6181,614,34,16,354,0,13,1378
8059011725,1740,1473,141,8,11,38,1,10,267
8059011726,5767,4576,549,23,16,379,0,21,1191
8059011727,3735,2826,581,31,10,121,2,26,909
8059011728,2713,2025,395,28,13,128,5,14,688
8059011729,3815,2575,843,68,42,89,7,18,1240
8059011730,3706,2458,893,50,22,106,6,21,1248
8059011731,4364,3238,598,71,18,220,0,10,1126
8059011732,4466,3091,820,111,43,134,4,28,1375
8059011733,2339,1642,401,61,11,102,0,7,697
8059011803,5275,2386,2184,60,53,397,10,12,2889
8059011804,4111,2194,1366,38,33,279,3,30,1917
8059011806,5320,2467,2251,118,49,201,0,30,2853
8059011807,2558,1654,548,49,12,160,3,15,904
8059011808,2682,1481,875,73,46,80,2,18,1201
8059011904,3126,2027,733,77,13,120,6,12,1099
8059011951,4472,2661,1122,81,23,423,3,15,1811
8059012022,5540,4547,523,42,22,133,2,22,993
8059012023,3453,2664,364,18,12,165,3,22,789
8059012024,5750,4752,528,28,13,140,4,15,998
8059012026,3495,3132,156,4,10,32,0,11,363
8059012027,3114,2783,152,6,7,28,0,22,331
8059012030,3842,3407,167,11,19,28,0,16,435
8059012031,3779,3339,185,19,10,14,2,17,440
8059012032,2647,2372,122,2,4,30,0,10,275
8059012033,2821,2510,138,23,7,20,0,17,311
8059012034,3999,3561,161,10,13,69,0,12,438
8059012035,5161,4514,241,17,8,83,6,26,647
8059012036,3729,3223,221,7,14,80,1,13,506
8059012037,3466,3071,195,2,12,25,2,19,395
8059012038,3605,2752,552,27,10,70,5,22,853
8059012039,5272,4062,725,51,21,106,1,49,1210
8059012041,5682,4121,791,42,20,444,6,13,1561
8059012042,3935,3002,476,31,15,155,3,38,933
8059012043,5878,4635,727,43,20,170,4,22,1243
8059012044,4057,3077,520,35,14,165,2,22,980
8059012045,6017,4693,706,58,24,272,3,40,1324
8059012046,2327,1738,377,22,4,59,1,13,589
8059012047,4180,3063,713,56,18,101,0,11,1117
8059012048,2479,1975,310,4,2,49,0,11,504
8059012049,3840,3070,378,22,13,183,0,31,770
8059012050,4127,3040,442,45,8,407,1,30,1087
8059012051,3616,3103,275,29,6,62,4,20,513
8059012052,5558,4316,728,68,25,102,1,42,1242
8059012053,3877,3087,451,39,13,71,0,11,790
8059012054,4139,3364,417,17,14,143,0,9,775
8059012055,3877,3130,440,24,21,101,2,11,747
8059012057,5783,4616,655,37,21,173,3,21,1167
8059012058,3955,3480,186,11,17,41,9,24,475
8059012059,3428,2730,417,21,3,62,6,25,698
8059012060,3350,2559,433,39,11,43,4,30,791
8059015800,4384,3192,675,65,21,200,6,25,1192
8059015900,3477,2120,881,116,11,181,7,28,1357
8059060300,4512,3162,593,26,13,479,0,18,1350
8059060400,5420,3816,891,69,19,313,1,8,1604
8059060501,10399,8234,1070,71,39,470,4,28,2165
8059980000,0,0,0,0,0,0,0,0,0
8059980400,1109,717,172,100,101,14,0,1,392
8059980700,0,0,0,0,0,0,0,0,0
8059980800,17,8,2,0,2,0,0,0,9
8061960100,1446,1247,104,3,0,9,1,1,199
8063962100,4478,3089,1136,10,16,24,5,26,1389
8063962400,2609,2217,273,11,8,6,0,6,392
8065961701,2024,1259,618,7,12,19,4,12,765
8065961702,3257,2211,827,12,22,26,3,28,1046
8065961900,2155,823,1217,12,12,18,1,5,1332
8067940300,5385,2843,1123,6,1142,17,0,23,2542
8067940400,5485,4304,687,11,192,19,6,37,1181
8067970601,3877,3224,368,8,69,14,0,14,653
8067970602,6340,5064,733,14,148,33,7,39,1276
8067970701,4560,3840,353,6,79,38,5,37,720
8067970703,6766,5245,908,21,232,61,3,36,1521
8067970705,2702,2192,341,6,49,9,1,11,510
8067970706,1321,1168,64,3,21,6,0,11,153
8067970800,7368,5531,925,36,329,80,4,112,1837
8067970900,4175,3266,465,17,150,39,0,26,909
8067971000,3217,2535,361,10,113,24,3,10,682
8067971100,4442,3180,680,44,285,41,4,21,1262
8069000100,3200,2623,289,29,18,50,1,32,577
8069000201,2669,2251,222,13,16,49,0,4,418
8069000202,2515,2019,322,10,7,29,0,8,496
8069000300,2834,2363,255,17,8,21,0,27,471
8069000401,1926,1483,263,41,6,19,0,19,443
8069000402,2658,2022,421,30,6,18,1,11,636
8069000503,6019,4071,719,146,18,711,9,54,1948
8069000504,2933,2259,350,50,10,94,7,15,674
8069000505,3094,2290,462,67,8,97,2,8,804
8069000506,2911,2279,344,48,23,38,8,7,632
8069000600,8151,5790,1192,271,60,438,15,25,2361
8069000700,2660,2244,202,19,9,57,2,13,416
8069000801,1608,1328,152,21,6,27,3,5,280
8069000802,1264,1019,150,12,0,11,1,12,245
8069000901,5676,4557,608,67,23,119,3,49,1119
8069000902,3528,2799,382,37,7,76,2,20,729
8069001003,5961,4501,801,72,43,204,0,30,1460
8069001004,3615,3037,256,39,17,75,0,31,578
8069001007,3006,2374,339,20,32,70,5,10,632
8069001008,1871,1508,186,9,3,60,0,12,363
8069001009,6372,5218,569,61,25,205,7,25,1154
8069001010,2961,2501,263,6,0,86,1,4,460
8069001104,5714,4525,702,69,11,83,5,20,1189
8069001106,5312,4160,690,74,33,93,2,11,1152
8069001107,5786,4482,737,72,18,127,8,23,1304
8069001109,5121,3947,669,76,29,120,6,33,1174
8069001110,5042,3856,675,99,18,116,5,29,1186
8069001111,2729,2083,256,31,8,212,5,6,646
8069001112,4713,3283,1097,35,9,51,2,20,1430
8069001113,3545,2923,305,11,14,86,2,15,622
8069001114,2432,2074,136,13,0,81,0,8,358
8069001301,3732,3143,310,11,22,41,3,27,589
8069001304,2838,931,1781,11,13,27,9,4,1907
8069001305,3130,2086,717,51,33,67,0,26,1044
8069001306,4596,2842,1277,82,51,116,8,33,1754
8069001307,4781,3640,739,48,25,77,1,19,1141
8069001308,6098,4970,577,30,20,126,5,37,1128
8069001601,1668,1163,367,9,21,22,0,9,505
8069001602,5780,4612,565,63,7,276,6,18,1168
8069001603,5753,3815,1459,47,32,110,0,29,1938
8069001605,7775,5725,891,151,51,529,11,46,2050
8069001606,3537,2776,323,43,13,150,4,10,761
8069001607,4144,3203,491,65,3,164,0,16,941
8069001608,7666,5821,603,62,15,718,1,41,1845
8069001706,6476,4876,1089,68,35,82,4,27,1600
8069001707,5472,4054,1002,55,38,48,1,12,1418
8069001708,4109,3077,604,73,16,142,0,18,1032
8069001710,6888,5099,1216,64,31,72,0,38,1789
8069001711,3655,2821,513,25,25,59,5,16,834
8069001712,4053,3442,370,21,7,37,0,26,611
8069001713,4965,3902,659,41,20,93,0,17,1063
8069001714,7436,6264,629,60,19,143,0,18,1172
8069001715,5029,3956,619,35,16,97,4,39,1073
8069001804,3646,2839,541,14,19,25,1,22,807
8069001807,5829,4732,717,26,24,69,12,29,1097
8069001808,5146,4484,307,21,28,58,8,25,662
8069001810,5298,4303,623,44,32,57,5,7,995
8069001811,2499,2140,198,22,6,19,1,20,359
8069001812,6633,5681,500,31,14,72,8,36,952
8069001813,5436,4350,594,64,13,139,8,33,1086
8069001901,3890,3122,524,28,17,23,1,9,768
8069001902,4591,3724,576,31,22,49,5,15,867
8069001904,2130,1914,83,6,1,16,0,10,216
8069001905,1801,1618,94,3,8,7,2,0,183
8069002005,5078,3846,855,31,17,36,4,52,1232
8069002007,3730,2994,436,51,28,39,0,44,736
8069002008,4007,3170,513,39,28,43,5,29,837
8069002010,2452,2186,122,3,12,24,3,22,266
8069002011,5506,4776,402,19,23,50,2,19,730
8069002300,3593,3070,245,23,9,63,1,10,523
8069002401,1394,1248,69,9,5,2,3,14,146
8069002403,1666,1430,107,2,15,11,0,6,236
8069002404,1454,1296,68,15,5,7,0,9,158
8069002503,2836,2430,231,12,2,12,2,12,406
8069002504,2501,1592,760,17,3,20,0,19,909
8069002505,7983,6556,582,49,15,339,2,49,1427
8069002506,3592,3134,237,25,12,61,1,10,458
8069002507,4947,3916,690,19,23,28,0,38,1031
8069002508,7999,6150,1161,72,21,48,11,37,1849
8069002601,2263,1987,114,0,6,29,0,15,276
8069002602,7054,5929,633,28,6,90,8,49,1125
8069002700,7356,6147,756,16,45,56,4,42,1209
8069002801,3161,2694,285,28,14,45,2,6,467
8069002803,122,96,19,0,3,1,0,1,26
8069002804,3096,2506,413,15,18,54,0,10,590
8069002805,2970,2434,392,5,3,54,2,8,536
8071000100,3759,1904,1603,37,37,24,2,25,1855
8071000200,1957,1141,672,18,20,18,5,5,816
8071000300,2184,1504,580,8,23,6,0,20,680
8071000400,2130,1002,1005,18,10,25,1,4,1128
8071000500,1972,854,995,17,19,17,4,13,1118
8071000800,2553,1560,777,85,36,18,0,20,993
8073961700,3495,2318,695,270,48,35,22,9,1177
8073961800,2180,1934,114,5,13,5,0,12,246
8075965900,1101,957,106,2,6,4,0,4,144
8075966000,2150,1877,220,4,0,3,2,7,273
8075966101,2854,2427,302,12,7,13,0,5,427
8075966102,4114,2959,883,72,18,20,10,6,1155
8075966200,3167,2252,618,111,21,10,4,8,915
8075966300,4063,3360,483,39,19,42,1,16,703
8075966400,4079,2505,899,513,90,27,0,6,1574
8077000200,2009,1557,291,16,17,14,0,9,452
8077000300,1381,1047,212,16,10,17,4,9,334
8077000400,3465,2548,643,32,26,51,0,15,917
8077000500,3115,1988,720,93,64,74,31,68,1127
8077000601,4444,3447,646,42,28,79,4,23,997
8077000602,5062,3629,970,65,34,78,11,38,1433
8077000700,4350,2813,1193,47,29,26,13,24,1537
8077000801,3907,2844,710,39,33,48,3,28,1063
8077000802,5114,3523,1189,24,24,46,15,36,1591
8077000900,4417,3077,923,46,21,159,12,23,1340
8077001001,4973,4158,513,30,12,32,4,21,815
8077001002,6912,5770,624,29,19,122,6,45,1142
8077001102,4954,3886,683,38,24,52,9,17,1068
8077001103,3390,2624,515,22,23,24,5,9,766
8077001104,5267,3460,1329,37,49,66,13,28,1807
8077001200,2083,1738,232,2,6,18,0,15,345
8077001302,5652,4536,690,18,23,90,7,49,1116
8077001303,2798,2107,465,16,19,36,0,23,691
8077001304,6219,4602,1121,38,57,31,0,39,1617
8077001402,6419,5566,419,21,13,76,3,12,853
8077001403,3638,3024,328,14,16,41,1,23,614
8077001404,5199,4575,270,16,16,64,1,27,624
8077001502,8100,6965,620,16,43,35,12,33,1135
8077001503,6251,5239,598,45,29,33,11,25,1012
8077001504,7184,5687,1001,28,37,49,7,26,1497
8077001600,3997,3421,324,8,7,41,2,25,576
8077001702,4296,3607,407,9,23,33,4,26,689
8077001703,4614,3551,728,27,20,45,0,26,1063
8077001705,5820,4126,1300,49,55,34,5,19,1694
8077001706,6072,3951,1653,49,64,28,1,34,2121
8077001707,6333,4515,1399,56,41,31,4,37,1818
8077001800,3110,2728,194,14,18,13,0,22,382
8077001900,5158,4440,368,18,33,27,0,35,718
8079973600,865,775,47,0,4,3,0,0,90
8081000300,3173,2723,209,15,23,15,1,24,450
8081000400,4460,3157,1068,18,26,19,0,20,1303
8081000500,4183,3139,763,42,34,18,1,15,1044
8081000600,1476,1294,84,2,15,0,0,1,182
8083941100,1551,71,40,4,1401,0,4,3,1480
8083969000,3459,2856,277,5,142,7,0,23,603
8083969100,3266,2636,339,11,70,11,5,17,630
8083969200,2818,2390,204,2,63,11,0,13,428
8083969301,3265,2335,529,12,213,16,1,19,930
8083969302,3298,2380,478,15,225,29,7,3,918
8083969400,3963,2251,680,13,765,40,6,15,1712
8083969600,4229,3116,562,10,287,14,1,14,1113
8085966100,2178,1923,110,5,8,2,0,5,255
8085966201,2753,2231,350,9,15,11,0,12,522
8085966202,4460,2634,1622,18,29,11,4,14,1826
8085966301,2306,1536,620,10,14,36,2,9,770
8085966302,3812,2232,1378,22,27,28,4,15,1580
8085966401,1175,983,142,4,11,8,0,4,192
8085966402,5099,3815,982,29,25,47,3,17,1284
8085966501,3019,2565,265,6,20,28,3,23,454
8085966502,4280,3431,570,27,26,63,2,21,849
8085966503,3543,2520,815,9,22,21,0,6,1023
8085966601,5362,3191,1828,8,56,47,7,37,2171
8085966602,4692,4065,345,12,9,32,1,20,627
8087000100,2636,2243,308,2,9,5,3,3,393
8087000200,3420,2576,661,22,14,14,0,13,844
8087000300,1805,956,753,28,10,2,1,5,849
8087000400,4522,2225,1935,199,20,28,1,13,2297
8087000500,2636,998,1235,289,15,15,3,3,1638
8087000600,6374,2688,3148,329,23,41,1,17,3686
8087000700,5882,3388,2225,65,14,41,2,14,2494
8087000800,1836,1472,301,1,5,7,0,9,364
8089968000,1653,1294,293,3,12,0,0,7,359
8089968100,2529,830,1585,20,10,11,2,12,1699
8089968200,2743,1560,1043,12,18,22,2,7,1183
8089968300,3966,2307,1427,34,14,39,6,24,1659
8089968400,1013,664,302,1,10,0,6,10,349
8089968500,1763,1310,386,1,15,3,0,0,453
8089968600,5023,2048,2666,63,33,23,12,43,2975
8091967601,1339,1202,76,4,6,2,2,6,137
8091967602,3535,3106,216,12,10,26,0,18,429
8093000101,1642,1379,140,2,18,7,0,12,263
8093000102,4432,3864,290,21,20,20,5,23,568
8093000200,3688,3100,265,21,25,20,0,18,588
8093000300,2770,2347,238,18,10,23,3,12,423
8093000400,2375,2033,177,12,16,17,0,6,342
8093000500,2483,2179,125,15,29,12,1,23,304
8095967600,3074,1932,1063,6,7,18,0,5,1142
8095967700,1456,1314,92,4,5,4,1,0,142
8097000101,3989,3416,341,26,7,54,2,9,573
8097000102,3795,3010,604,15,14,34,0,16,785
8097000402,2582,2033,369,22,7,57,1,21,549
8097000403,2332,2020,170,11,3,42,3,14,312
8097000404,2059,1747,171,13,4,46,1,11,312
8097000500,2601,2207,237,7,1,47,0,11,394
8099000100,1425,1094,278,4,1,1,0,8,331
8099000200,2448,920,1375,13,37,10,2,14,1528
8099000300,4789,2803,1722,61,36,12,4,14,1986
8099000600,1406,794,525,2,17,8,0,4,612
8099000700,1931,1075,780,3,27,0,0,10,856
8101000100,2820,1481,1129,50,15,24,4,16,1339
8101000200,1906,654,1088,41,18,7,2,15,1252
8101000300,1495,778,419,238,36,19,0,3,717
8101000400,2664,1272,1194,42,19,8,7,16,1392
8101000500,2321,1243,850,60,19,23,0,19,1078
8101000600,2089,800,1092,53,16,9,5,17,1289
8101000800,3156,1029,1925,61,32,11,0,13,2127
8101000902,6075,2546,3107,100,53,56,7,35,3529
8101000903,226,93,62,24,6,9,2,0,133
8101000904,4410,2214,1911,63,26,40,3,22,2196
8101000905,2441,1033,1147,83,21,62,3,14,1408
8101001000,4768,1319,3093,97,63,16,3,32,3449
8101001100,2822,760,1890,41,31,1,5,20,2062
8101001200,2169,467,1586,28,34,5,2,11,1702
8101001400,1461,682,666,38,14,5,1,11,779
8101001500,2188,1274,761,29,8,9,0,9,914
8101001600,1753,1146,506,13,12,18,2,14,607
8101001700,4457,2394,1783,96,31,28,0,23,2063
8101001800,2308,1186,967,34,13,11,1,22,1122
8101001900,1423,685,618,16,17,9,6,1,738
8101002000,3071,1034,1768,93,37,17,0,7,2037
8101002100,1517,420,945,43,14,7,4,18,1097
8101002200,1668,548,979,29,17,10,0,16,1120
8101002300,3802,1448,2064,93,38,30,3,17,2354
8101002400,1937,774,999,41,29,14,0,14,1163
8101002500,2777,1117,1417,66,26,11,0,22,1660
8101002600,3921,1349,2290,120,31,4,5,15,2572
8101002700,5699,2295,3032,113,33,16,5,21,3404
8101002801,5366,2149,2924,95,26,12,8,37,3217
8101002802,3732,2001,1482,75,27,17,3,33,1731
8101002804,4626,3787,555,18,32,21,0,26,839
8101002806,3885,2595,1088,41,6,29,3,12,1290
8101002807,4833,2348,2162,59,25,68,3,24,2485
8101002808,3044,1660,1210,35,7,36,0,18,1384
8101002901,3395,1318,1828,55,21,38,0,30,2077
8101002906,4643,3453,876,31,22,59,6,8,1190
8101002911,3067,2167,669,16,25,39,1,6,900
8101002912,1732,942,593,58,9,24,0,6,790
8101002913,3553,2464,821,34,3,71,1,17,1089
8101002914,3412,2005,1133,54,13,37,1,16,1407
8101002915,2598,1591,814,25,9,25,0,18,1007
8101002916,3071,1979,830,30,22,25,3,14,1092
8101002917,3116,2062,827,16,23,41,3,22,1054
8101002919,4809,2283,2065,121,24,115,12,37,2526
8101002920,2966,1452,1120,93,22,146,7,13,1514
8101002921,3111,1951,879,56,26,33,0,20,1160
8101002922,3252,2311,669,45,13,37,7,19,941
8101002923,1905,1350,386,14,23,20,0,27,555
8101003001,1527,759,667,14,10,6,1,13,768
8101003004,2946,1781,831,72,20,112,5,9,1165
8101003103,1750,745,929,10,13,1,0,5,1005
8101003104,2280,1494,660,7,18,5,1,10,786
8101003105,3227,2144,898,17,7,12,0,18,1083
8101003106,1220,666,502,1,9,2,0,1,554
8101003200,3449,2227,1017,17,18,21,2,20,1222
8101003500,2172,927,1051,62,33,18,1,8,1245
8101003600,2131,875,1147,19,31,13,0,14,1256
8101980100,0,0,0,0,0,0,0,0,0
8103951100,3840,3260,342,13,26,7,2,18,580
8103951200,2689,2249,280,16,25,15,0,11,440
8105976700,5228,1993,2924,27,88,20,1,20,3235
8105976800,1622,788,752,6,16,0,2,15,834
8105977001,2173,1706,327,13,16,14,1,14,467
8105977002,2516,1774,606,5,17,2,0,7,742
8107000100,2122,1953,83,5,7,0,5,3,169
8107000200,2026,1686,208,7,6,10,8,8,340
8107000300,2319,2030,164,3,1,0,0,16,289
8107000400,3960,2906,888,16,11,20,3,16,1054
8107000500,4026,3590,185,35,11,47,11,14,436
8107000600,3412,2941,303,8,15,24,2,13,471
8107000701,2169,1878,128,29,6,21,4,6,291
8107000702,1561,1300,108,43,5,38,1,8,261
8107000703,1190,1103,37,3,2,5,0,0,87
8107000800,2044,1855,96,4,3,4,1,8,189
8109977600,3601,2858,455,17,31,56,2,31,743
8109977700,2767,720,1939,2,50,7,0,11,2047
8111972600,705,575,90,1,6,2,0,1,130
8113968101,2616,2165,341,3,6,26,0,6,451
8113968102,1605,1257,240,6,7,24,0,13,348
8113968103,2334,2061,154,6,2,5,0,15,273
8113968200,1517,1274,147,5,32,0,0,10,243
8115968300,2404,1934,363,3,10,12,0,8,470
8117000101,1416,1026,288,15,6,20,0,13,390
8117000102,5283,3634,1313,74,13,77,2,10,1649
8117000103,1354,1102,193,8,5,6,0,3,252
8117000201,1536,1211,194,7,10,51,3,10,325
8117000202,2780,1411,1203,41,0,31,2,12,1369
8117000203,4028,2994,828,19,6,20,4,27,1034
8117000301,1977,1713,158,0,2,37,0,6,264
8117000302,2207,1908,157,13,12,21,5,15,299
8117000403,1850,1593,121,5,0,16,2,9,257
8117000404,1861,1675,89,8,3,30,0,7,186
8117000405,3809,3255,274,18,0,54,0,21,554
8117000406,2954,2260,517,24,10,44,2,17,694
8119010104,2315,1960,159,25,8,24,0,16,355
8119010107,3603,3089,273,17,10,40,0,5,514
8119010108,4354,3719,321,26,16,36,0,14,635
8119010109,2655,2326,147,5,20,9,1,18,329
8119010110,2329,1975,170,14,13,13,1,13,354
8119010111,2957,2525,192,20,15,32,7,26,432
8119010112,3200,2674,247,6,16,30,1,39,526
8119010203,3297,2749,207,19,24,17,2,17,548
8121924100,2082,1799,175,4,5,8,4,13,283
8121924200,2735,2258,341,20,3,7,6,7,477
8123000100,2653,1166,1076,124,25,175,5,8,1487
8123000200,3193,1919,819,130,21,107,6,19,1274
8123000300,1547,1046,278,91,12,42,6,7,501
8123000401,3562,2406,870,76,10,51,7,5,1156
8123000402,3605,1760,1332,243,18,115,2,24,1845
8123000501,3330,452,2732,45,11,39,2,6,2878
8123000502,3577,949,2374,75,29,49,0,10,2628
8123000600,1784,650,1044,53,10,5,2,1,1134
8123000701,1663,371,1205,21,1,13,5,8,1292
8123000703,7245,1633,5095,295,32,41,5,28,5612
8123000704,1069,355,659,14,0,16,0,4,714
8123000705,1481,906,514,2,2,14,0,2,575
8123000800,3267,1517,1297,171,24,161,10,16,1750
8123000900,3057,1650,1118,57,18,71,2,18,1407
8123001003,4778,1115,2887,503,15,143,2,18,3663
8123001004,4646,1616,2384,183,19,243,36,25,3030
8123001005,7975,3432,4086,63,26,82,12,27,4543
8123001006,4934,2223,2375,47,30,93,0,17,2711
8123001100,5033,2862,1716,136,23,93,0,28,2171
8123001201,4584,2187,1993,106,31,117,6,14,2397
8123001202,3052,1846,964,53,16,30,0,9,1206
8123001300,7376,2396,4485,104,56,119,12,23,4980
8123001404,2965,1693,1136,5,15,15,0,13,1272
8123001405,5229,3050,1809,73,15,77,6,18,2179
8123001406,7472,4604,2403,66,29,96,10,29,2868
8123001407,4320,2862,1159,38,17,83,6,13,1458
8123001408,1991,1528,390,12,3,16,0,7,463
8123001409,3757,2197,1238,64,21,47,2,21,1560
8123001410,3352,2596,532,29,13,46,1,19,756
8123001411,2690,1967,560,33,9,24,2,12,723
8123001412,3430,2448,714,37,19,69,7,25,982
8123001413,2859,1688,969,33,17,45,2,3,1171
8123001414,2272,1463,674,5,7,35,1,2,809
8123001415,3589,2433,863,22,9,79,2,2,1156
8123001416,3282,2468,579,36,8,47,3,8,814
8123001417,3163,1630,1360,14,21,29,0,14,1533
8123001500,8197,6285,1441,28,17,63,15,30,1912
8123001600,4486,3131,1174,2,28,7,0,11,1355
8123001700,5049,2922,1853,24,27,18,0,16,2127
8123001800,4955,2938,1710,8,25,38,4,6,2017
8123001905,4712,1715,2827,14,18,13,0,17,2997
8123001906,1578,749,763,18,5,4,0,15,829
8123001909,495,206,261,6,0,4,1,6,289
8123001910,2059,962,994,14,9,9,0,13,1097
8123001911,1055,543,468,0,2,7,0,7,512
8123001912,1976,1050,774,22,11,17,0,9,926
8123001913,8927,4325,3957,113,54,129,14,54,4602
8123001914,1812,1046,685,6,10,7,0,11,766
8123002004,4953,2661,1916,49,34,104,8,12,2292
8123002005,1478,1025,298,9,0,83,0,2,453
8123002006,406,322,66,1,3,1,0,1,84
8123002007,6712,5220,798,39,25,288,3,25,1492
8123002008,6148,4856,618,48,7,261,13,42,1292
8123002009,5954,4686,635,34,12,270,5,35,1268
8123002010,2170,1128,868,20,0,45,0,18,1042
8123002011,2277,1654,291,10,4,229,1,6,623
8123002012,1306,1014,159,6,10,65,1,7,292
8123002013,3437,2529,617,23,4,103,0,17,908
8123002014,2424,1680,537,15,5,45,5,14,744
8123002015,1375,1055,212,4,3,16,3,3,320
8123002016,3864,2535,1107,19,15,24,2,13,1329
8123002017,753,638,75,0,7,9,0,0,115
8123002018,1954,1558,264,19,2,26,1,14,396
8123002019,7063,4979,1460,43,23,158,6,13,2084
8123002020,6136,4425,1200,54,26,158,4,36,1711
8123002021,796,631,110,2,1,10,0,6,165
8123002101,12329,8082,3438,85,46,123,6,51,4247
8123002104,1689,1472,124,2,9,18,0,15,217
8123002105,5543,3987,1091,37,17,130,11,28,1556
8123002106,4844,3966,597,16,21,49,0,8,878
8123002107,6570,5286,876,28,13,84,5,21,1284
8123002108,6698,4945,1342,28,23,73,4,33,1753
8123002203,3340,2817,316,16,15,26,2,14,523
8123002204,2069,1772,178,15,12,21,0,13,297
8123002205,4812,3701,809,35,15,31,0,16,1111
8123002206,3680,3076,384,17,13,49,1,14,604
8123002207,4084,3377,457,19,5,71,3,3,707
8123002208,10618,8535,1359,67,37,128,5,32,2083
8123002209,3676,3137,314,21,5,44,3,9,539
8123002210,2593,2192,254,6,7,34,4,13,401
8123002300,5867,4374,1150,3,27,23,1,19,1493
8123002501,5889,4797,694,5,25,13,10,17,1092
8123002502,6391,4813,1252,45,18,27,0,37,1578
8125963100,4698,3570,983,17,12,17,1,14,1128
8125963200,5290,3378,1788,4,4,9,1,13,1912
9001010101,4401,3649,313,63,0,223,2,14,752
9001010102,4276,3424,276,49,0,317,3,31,852
9001010201,3395,2620,366,17,9,184,0,28,775
9001010202,5904,4307,628,65,2,509,0,38,1597
9001010300,4370,3596,269,38,0,258,3,31,774
9001010400,5716,4114,782,86,3,394,2,78,1602
9001010500,6570,3289,1870,372,6,547,1,133,3281
9001010600,1884,1317,245,52,2,163,1,13,567
9001010700,3573,2406,592,154,1,262,0,19,1167
9001010800,3135,2408,273,33,3,236,0,39,727
9001010900,5279,3555,573,114,3,770,2,29,1724
9001011000,5477,4378,359,26,0,355,0,60,1099
9001011100,5049,4020,481,17,4,284,0,17,1029
9001011200,1703,1425,114,8,0,77,0,6,278
9001011300,2786,1369,994,63,0,147,1,70,1417
9001020101,2862,1376,570,426,1,407,0,14,1486
9001020102,3988,2021,742,595,1,471,0,15,1967
9001020200,3754,2996,280,111,0,207,0,22,758
9001020301,3829,2960,290,123,0,273,0,30,869
9001020302,3379,2621,270,124,0,211,0,10,758
9001020400,3611,2743,400,110,0,236,2,13,868
9001020500,4813,3701,411,172,8,334,0,38,1112
9001020600,4842,3135,743,256,9,491,1,30,1707
9001020700,4170,3269,398,140,6,230,0,15,901
9001020800,2873,2121,282,105,0,239,0,27,752
9001020900,5257,2933,1275,492,3,322,0,49,2324
9001021000,3559,2282,712,206,5,230,0,31,1277
9001021100,6414,3234,1917,547,1,499,0,56,3180
9001021200,4319,2938,532,247,7,440,0,21,1381
9001021300,4781,1950,1459,694,6,498,1,43,2831
9001021401,3079,278,2000,579,6,117,2,41,2801
9001021402,3947,1034,1379,1172,4,201,3,48,2913
9001021501,3955,308,2143,1202,4,192,1,28,3647
9001021502,2821,193,1556,836,8,165,0,18,2628
9001021601,3559,1530,869,494,11,508,5,36,2029
9001021602,4536,1754,730,497,10,1402,0,37,2782
9001021701,3268,1123,1036,580,7,438,0,16,2145
9001021702,4732,2317,740,676,2,811,2,42,2415
9001021801,4720,1874,1538,599,11,513,0,54,2846
9001021802,5156,1642,2060,987,6,307,0,33,3514
9001021900,6341,2565,2611,607,5,315,0,44,3776
9001022000,3058,1023,1199,524,1,189,0,39,2035
9001022101,3586,357,2472,483,5,200,2,28,3229
9001022102,3943,1393,1788,444,2,208,0,19,2550
9001022201,3060,1246,1143,376,2,184,2,23,1814
9001022202,4581,2227,1438,489,5,269,1,24,2354
9001022300,6311,1796,2741,1258,4,278,0,67,4515
9001022400,2366,1936,234,50,0,68,0,7,430
9001030100,3733,3226,205,17,1,173,4,15,507
9001030200,3316,2831,169,18,1,154,0,7,485
9001030300,4425,3851,218,14,6,146,0,16,574
9001030400,4060,3152,307,41,7,371,0,16,908
9001030500,5965,4956,335,58,2,353,0,34,1009
9001035101,3663,2700,368,140,2,298,0,15,963
9001035102,4259,3695,161,28,0,187,1,13,564
9001035200,3306,2915,128,7,1,119,2,9,391
9001035300,4114,3464,166,33,1,246,0,30,650
9001035400,5280,4395,298,36,2,309,1,21,885
9001042500,3678,2921,317,119,5,174,0,25,757
9001042600,4053,2781,639,260,3,233,1,30,1272
9001042700,5585,3263,1112,487,1,514,0,46,2322
9001042800,4761,2919,1018,426,2,244,0,27,1842
9001042900,1593,1300,145,35,0,43,0,10,293
9001043000,3233,2179,560,240,2,117,0,23,1054
9001043100,4545,2898,767,343,0,311,1,57,1647
9001043200,3081,1209,1086,537,7,118,0,30,1872
9001043300,3389,1387,1243,468,3,196,0,19,2002
9001043400,4980,1402,2234,898,11,259,0,52,3578
9001043500,2713,1584,679,213,0,151,0,13,1129
9001043600,3187,1889,766,247,1,182,1,18,1298
9001043700,3602,1479,1182,537,4,243,1,29,2123
9001043800,8083,2388,3303,1252,22,815,1,66,5695
9001043900,5456,2872,1547,593,6,235,0,30,2584
9001044000,6241,1381,3237,1137,24,231,1,53,4860
9001044100,3479,1309,1287,549,0,206,1,27,2170
9001044200,4092,1787,1588,400,0,165,3,29,2305
9001044300,4264,2846,814,297,2,161,1,17,1418
9001044400,3536,910,1525,925,1,68,1,22,2626
9001044500,4056,340,2472,1069,6,75,1,20,3716
9001044600,3577,3270,108,42,2,31,1,9,307
9001045101,4094,3423,159,13,1,280,1,22,671
9001045102,5885,4708,346,60,0,471,0,28,1177
9001045200,2720,2132,135,62,1,255,3,8,588
9001045300,2513,2068,116,22,1,208,0,4,445
9001045400,3291,2545,160,44,0,398,0,16,746
9001050100,4070,3390,218,32,1,266,0,15,680
9001050200,4096,3296,251,41,0,305,0,19,800
9001050301,3977,3157,273,94,5,272,0,15,820
9001050302,4425,3645,247,34,1,294,0,34,780
9001050400,2444,1950,171,65,1,140,0,16,494
9001050500,4751,3943,285,59,6,235,0,21,808
9001050600,3378,2788,147,50,1,191,0,32,590
9001055100,5837,4667,397,80,3,361,2,38,1170
9001055200,4517,3776,234,63,0,214,1,37,741
9001060100,4551,3581,401,130,5,253,0,19,970
9001060200,4211,3580,256,39,3,187,0,31,631
9001060300,3986,3389,184,40,0,181,0,17,597
9001060400,4494,3964,180,55,0,140,0,15,530
9001060500,3092,2714,110,31,2,130,0,19,378
9001060600,2235,1891,146,20,0,112,0,0,344
9001060700,8087,6998,655,26,4,170,1,37,1089
9001060800,2089,1757,102,39,0,98,0,8,332
9001060900,2546,2240,94,11,0,101,0,12,306
9001061000,4060,3059,356,132,1,301,2,48,1001
9001061100,3826,3127,301,58,3,122,2,44,699
9001061200,2342,1504,365,90,0,218,0,45,838
9001061300,3031,1990,434,121,0,285,0,39,1041
9001061400,3004,1684,703,193,0,249,0,43,1320
9001061500,4936,4132,305,97,0,169,0,20,804
9001061600,5022,4425,214,28,5,190,0,21,597
9001070100,5178,3358,1107,355,1,116,0,51,1820
9001070200,3984,830,1800,1138,5,52,0,38,3154
9001070300,1359,40,808,442,1,6,0,19,1319
9001070400,1712,463,462,502,19,168,0,41,1249
9001070500,1684,221,675,538,2,147,0,29,1463
9001070600,2795,498,1105,967,6,92,2,19,2297
9001070900,2792,134,1516,981,5,62,1,16,2658
9001071000,3850,200,2072,1349,1,112,1,27,3650
9001071100,4623,311,2157,1755,5,239,0,26,4312
9001071200,5302,336,2625,1896,11,249,6,58,4966
9001071300,3547,224,1851,1173,2,97,0,69,3323
9001071400,3876,334,2336,751,2,85,0,174,3542
9001071600,2514,98,1377,943,0,24,0,10,2416
9001071900,4714,661,1849,1625,1,36,0,248,4053
9001072000,3699,525,1398,1220,12,137,1,180,3174
9001072100,6399,1726,2046,1775,9,386,8,161,4673
9001072200,3944,1281,1288,840,2,94,0,201,2663
9001072300,5404,1007,2097,1571,6,147,1,271,4397
9001072400,2833,400,1065,1013,8,117,0,89,2433
9001072500,5843,1910,1908,1251,7,212,1,241,3933
9001072600,7746,3984,1643,1250,18,263,2,160,3762
9001072700,3849,820,1372,1262,7,115,0,97,3029
9001072800,5722,277,2309,2825,9,74,2,51,5445
9001072900,4849,490,1722,2303,13,85,0,74,4359
9001073000,1998,292,886,675,2,44,0,30,1706
9001073100,4666,819,1864,1659,6,82,2,84,3847
9001073200,3765,757,1428,1124,4,316,0,34,3008
9001073300,3430,280,1406,1589,6,50,2,21,3150
9001073400,3882,414,1686,1564,0,72,1,34,3468
9001073500,3613,138,2184,1115,2,34,0,63,3475
9001073600,2318,78,1418,754,0,18,0,3,2240
9001073700,5173,415,2354,2203,7,27,0,45,4758
9001073800,2375,99,1505,663,1,46,0,20,2276
9001073900,3542,124,2132,1154,7,9,0,34,3418
9001074000,2262,80,1296,799,14,19,0,11,2182
9001074300,4652,176,2210,2019,8,63,1,53,4476
9001074400,4673,170,2136,2186,9,41,0,22,4503
9001080100,4998,1640,1722,1203,7,189,0,36,3358
9001080200,4446,1184,1512,1391,7,111,0,52,3262
9001080400,6073,1080,1968,2556,10,154,6,69,4993
9001080500,3107,2693,188,78,1,40,0,11,414
9001080600,2533,1357,512,420,4,87,0,42,1176
9001080700,1980,1224,311,292,4,64,0,9,756
9001080800,4929,3350,731,488,3,118,0,32,1579
9001080900,4897,2648,1215,674,7,126,1,40,2249
9001081000,4359,2529,920,593,3,129,0,25,1830
9001081100,4767,3140,797,558,4,82,0,27,1627
9001081200,5247,3684,772,453,0,119,4,38,1563
9001081300,5019,3878,459,430,3,91,0,31,1141
9001090100,3305,2653,227,80,0,239,0,18,652
9001090200,8152,6388,703,237,4,514,0,63,1764
9001090300,4681,3553,486,170,1,286,1,33,1128
9001090400,6714,4247,1024,582,4,545,0,58,2467
9001090500,4814,3565,508,267,3,253,0,47,1249
9001090600,3578,2881,223,127,8,192,0,21,697
9001090700,5583,4365,334,179,2,480,0,37,1218
9001100100,5583,4480,446,136,8,272,0,26,1103
9001100200,6749,5696,477,127,12,200,0,22,1053
9001100300,6493,5372,547,137,0,188,0,41,1121
9001105100,4220,3623,198,42,2,195,0,16,597
9001105200,3385,2785,246,64,4,133,1,18,600
9001110100,2682,1534,532,318,5,153,2,48,1148
9001110201,4763,3235,722,338,7,267,0,43,1528
9001110202,5078,4017,455,193,7,218,2,25,1061
9001110301,6428,4849,690,302,2,368,3,51,1579
9001110302,3355,2625,241,150,1,194,0,12,730
9001110400,5051,4240,416,114,2,117,1,28,811
9001110500,5561,4738,371,118,1,171,1,36,823
9001110601,2907,2485,164,87,5,95,1,18,422
9001110602,5044,3978,489,192,0,217,1,26,1066
9001200100,4039,2503,679,131,2,284,0,128,1536
9001200200,5788,3639,906,213,11,490,0,161,2149
9001200301,5263,3950,578,149,4,301,0,67,1313
9001200302,5268,4317,459,72,2,138,1,50,951
9001205100,4413,3486,382,76,1,212,3,38,927
9001205200,7015,5751,508,114,5,242,0,66,1264
9001205300,6100,4548,580,109,5,492,0,75,1552
9001210101,2773,627,1392,207,3,196,0,112,2146
9001210102,3246,736,1541,183,4,183,1,233,2510
9001210201,3533,786,1769,159,6,83,0,305,2747
9001210202,3437,543,2147,171,3,97,2,230,2894
9001210300,6114,1954,2364,408,6,486,0,323,4160
9001210401,4594,1702,1601,391,4,359,0,185,2892
9001210402,4433,1778,1341,316,2,487,0,165,2655
9001210501,3207,1853,859,138,0,79,0,70,1354
9001210502,6528,4335,843,505,5,578,0,67,2193
9001210600,6623,2031,3049,422,7,310,0,319,4592
9001210701,5877,1126,3677,251,0,221,2,251,4751
9001210702,3880,1158,1810,143,1,175,3,195,2722
9001210800,6099,3479,1398,450,1,346,11,81,2620
9001210900,5921,3904,935,364,0,335,3,122,2017
9001211000,4051,2182,1001,253,6,313,3,60,1869
9001211100,1190,543,266,344,4,26,0,2,647
9001211201,3630,1825,802,259,11,423,0,97,1805
9001211202,2769,1668,597,156,0,149,0,35,1101
9001211300,3549,2456,523,189,5,133,0,66,1093
9001211400,5064,3277,775,321,2,360,0,62,1787
9001220100,4912,4086,510,51,7,68,3,39,826
9001220200,4873,4149,391,51,4,77,0,46,724
9001220300,3794,3203,300,51,0,85,0,13,591
9001230100,7351,6285,451,73,5,220,0,40,1066
9001230200,1914,1662,125,8,0,49,0,10,252
9001230300,3490,3046,201,34,0,71,2,18,444
9001230400,5579,4775,344,80,4,138,1,20,804
9001230501,3942,3341,236,73,1,116,2,34,601
9001230502,4897,3841,400,324,2,140,5,14,1056
9001240100,4294,3676,249,41,6,142,0,30,618
9001240200,4471,3904,216,34,5,101,2,29,567
9001245100,2879,2473,162,20,2,103,0,15,406
9001245200,4463,3668,281,57,4,249,2,35,795
9001245300,5362,4393,384,42,8,344,1,43,969
9001245400,3404,2888,210,23,2,121,0,23,516
9001245500,2952,2568,134,19,0,101,0,17,384
9001245600,5973,4966,335,53,6,343,0,23,1007
9001257100,3527,3149,159,25,1,51,0,6,378
9001257200,4087,434,1760,1461,10,88,0,134,3653
9001990000,0,0,0,0,0,0,0,0,0
9003330100,1901,1744,35,14,7,13,0,8,157
9003400101,2928,2463,184,76,2,95,0,11,465
9003400102,4299,3587,279,68,2,215,0,18,712
9003400200,5997,5276,281,58,0,213,0,18,721
9003400300,6951,6143,371,49,5,146,1,17,808
9003405100,3164,2235,514,168,1,80,1,2,929
9003405200,4225,3145,504,177,6,184,0,16,1080
9003405300,6105,4710,749,264,4,133,1,17,1395
9003405401,3421,2740,297,90,3,94,3,24,681
9003405402,4257,2754,793,296,8,183,0,15,1503
9003405500,5266,3613,1036,289,7,85,0,31,1653
9003405600,7398,4743,1660,433,11,138,0,50,2655
9003405700,2061,1274,549,127,0,26,1,8,787
9003405801,3176,2322,452,166,10,81,0,16,854
9003405802,4172,3534,290,104,3,94,1,17,638
9003405900,4647,3703,440,131,4,124,0,28,944
9003406001,4113,2393,1073,337,0,93,1,11,1720
9003406002,4754,3975,308,141,0,166,0,20,779
9003406100,4074,2155,1270,386,7,61,3,17,1919
9003410101,5285,4718,217,25,4,84,0,27,567
9003410102,4234,3731,161,34,0,86,0,23,503
9003415300,2521,501,1556,351,0,21,0,15,2020
9003415400,6179,1848,3041,879,0,120,6,46,4331
9003415500,3094,805,1667,435,8,41,0,12,2289
9003415600,4198,1141,2236,632,1,41,0,32,3057
9003415700,3256,1246,1349,457,3,41,3,20,2010
9003415800,2873,1135,1089,455,5,69,6,24,1738
9003415900,1647,561,906,124,2,19,0,3,1086
9003416000,4537,2076,1810,439,8,60,2,24,2461
9003416100,4955,1156,3007,554,9,75,0,12,3799
9003416200,3025,435,2113,362,0,26,0,13,2590
9003416300,3810,1151,1937,539,1,50,4,17,2659
9003416400,3152,2003,682,287,8,54,0,26,1149
9003416500,4833,1813,2127,589,11,129,0,25,3020
9003416600,3150,877,1800,361,2,20,0,23,2273
9003416700,6877,2691,2908,816,4,256,0,16,4186
9003416800,3079,1515,1069,282,1,99,0,11,1564
9003417100,1857,424,1045,288,0,30,0,14,1433
9003417200,1702,755,516,256,2,85,1,8,947
9003417300,2045,1194,290,395,2,52,0,106,851
9003417400,3012,1536,489,408,1,463,0,12,1476
9003417500,4333,2672,983,385,6,133,5,19,1661
9003420400,3021,2573,193,59,8,98,0,6,448
9003420500,5321,3946,773,186,5,152,3,35,1375
9003420601,2596,1977,343,77,4,74,1,11,619
9003420602,3224,2531,367,100,2,101,0,6,693
9003420700,3363,2884,222,67,6,65,0,11,479
9003430100,4141,3539,321,46,0,85,2,20,602
9003430201,3373,2794,194,50,3,221,1,1,579
9003430202,4616,4129,197,41,2,104,0,14,487
9003430203,4024,3667,160,37,1,64,0,6,357
9003430301,3855,3333,178,63,2,138,0,11,522
9003430302,2878,2530,152,37,0,68,0,10,348
9003430400,5092,4381,283,84,5,169,1,4,711
9003430501,1705,1438,106,35,0,49,0,3,267
9003430502,5157,4615,209,57,5,106,0,19,542
9003430602,3451,2909,229,42,4,119,1,19,542
9003430603,2170,1635,250,80,2,101,1,9,535
9003430604,3039,2579,138,37,2,162,0,7,460
9003460100,3441,2487,170,110,1,547,3,15,954
9003460202,4820,3493,311,196,3,633,0,21,1327
9003460203,3313,2230,171,102,5,660,0,10,1083
9003460204,6190,4180,331,186,6,1238,1,29,2010
9003460301,5025,4022,311,137,0,372,0,14,1003
9003460302,3923,3013,233,91,1,405,0,10,910
9003462101,6151,4918,322,120,7,494,2,13,1233
9003462102,4391,3101,191,99,0,788,1,25,1290
9003462201,5439,4333,283,103,2,492,0,26,1106
9003462202,2951,2079,120,74,15,544,0,20,872
9003464101,5185,4622,212,81,7,69,0,23,563
9003464102,4939,4358,201,61,7,128,0,7,581
9003466101,5675,4782,303,73,1,290,2,19,893
9003466102,5496,4495,312,101,2,336,0,23,1001
9003466201,2685,2065,148,152,2,181,0,12,620
9003466202,3678,3286,136,33,4,103,0,15,392
9003466300,4608,3806,266,68,4,278,0,14,802
9003466400,2375,1907,170,89,0,96,1,11,468
9003468101,6912,6190,279,70,19,74,10,22,722
9003468102,3991,3529,145,37,5,84,0,3,462
9003470100,5214,4320,280,145,9,266,0,10,894
9003471100,3554,208,331,2810,6,27,0,24,3346
9003471200,3171,368,261,2331,26,34,0,29,2803
9003471300,5161,1886,362,2520,3,168,0,41,3275
9003471400,5665,3191,411,1696,4,108,3,26,2474
9003471500,3984,1274,332,2077,2,139,0,24,2710
9003473100,6162,1901,834,2896,6,207,1,41,4261
9003473400,2050,1259,251,360,0,72,0,4,791
9003473501,4638,2524,360,1140,6,314,0,47,2114
9003473502,3397,1893,337,842,1,185,0,17,1504
9003473601,3286,2071,284,621,3,134,0,18,1215
9003473602,2374,908,308,693,0,350,3,12,1466
9003473700,5748,1818,814,2591,5,182,0,74,3930
9003473800,1837,168,282,1201,0,84,0,25,1669
9003476100,4734,3260,493,411,3,311,0,28,1474
9003476200,2723,2277,163,81,1,73,1,18,446
9003476300,5156,3742,462,316,4,423,1,32,1414
9003477101,4144,3703,134,65,0,77,0,13,441
9003477103,5657,3740,694,939,8,147,1,2,1917
9003477104,2959,2442,184,102,2,126,0,9,517
9003477200,2992,2698,101,19,3,28,0,0,294
9003480300,2173,1775,188,72,0,32,0,9,398
9003480400,3466,2899,231,94,0,87,0,4,567
9003480500,3256,2420,387,149,10,111,4,7,836
9003480600,4938,2758,1142,564,29,144,0,32,2180
9003480700,2175,1638,237,153,4,37,0,17,537
9003480800,4177,3503,263,136,2,109,3,18,674
9003480900,2989,2038,353,445,6,46,0,20,951
9003481000,3411,2934,180,83,3,52,2,19,477
9003481100,3686,3105,252,88,4,73,0,6,581
9003481200,3734,3028,229,154,3,155,0,11,706
9003481300,2807,2422,159,71,0,46,0,6,385
9003484100,5665,3982,470,302,12,591,0,25,1683
9003484200,5525,4163,540,388,4,157,0,43,1362
9003487100,7158,4932,421,309,5,1153,6,36,2226
9003487201,4581,3631,267,155,0,327,1,17,950
9003487202,3517,2533,162,110,5,580,1,10,984
9003487300,1434,1120,104,62,1,85,0,7,314
9003487400,2621,1637,183,118,4,567,0,8,984
9003487500,7607,4292,441,383,10,2229,5,22,3315
9003490100,5577,3860,529,272,16,715,0,19,1717
9003490303,4579,2073,227,139,11,1996,0,22,2506
9003490304,4031,3258,142,41,1,496,0,8,773
9003492100,3354,2719,292,92,3,119,0,29,635
9003492200,4263,3112,708,148,4,140,5,16,1151
9003492300,6118,3776,1336,401,16,370,1,48,2342
9003492400,3007,2428,299,75,0,120,0,16,579
9003492500,3436,2999,227,30,0,96,0,9,437
9003492600,7120,5955,541,198,1,255,2,22,1165
9003494100,6293,4255,850,390,0,555,2,42,2038
9003494201,4687,3592,456,192,1,302,0,19,1095
9003494202,2792,2111,223,115,1,222,3,13,681
9003494300,4034,3044,475,130,9,225,0,18,990
9003494400,4747,3718,585,131,0,161,0,37,1029
9003494500,4366,3022,610,200,2,342,0,37,1344
9003494600,3617,2448,386,211,5,429,0,17,1169
9003496100,2683,692,897,501,10,417,0,44,1991
9003496200,4747,2868,638,245,3,795,1,32,1879
9003496300,3650,2487,510,198,0,247,0,54,1163
9003496400,2939,2253,197,93,0,293,0,17,686
9003496500,2801,2376,139,60,0,112,0,19,425
9003496600,2781,2296,142,84,0,142,0,13,485
9003496700,3674,1773,825,394,3,415,0,73,1901
9003496800,3616,1350,1014,438,7,501,1,101,2266
9003496900,6179,4046,923,518,2,404,0,47,2133
9003497000,4279,3586,237,105,0,162,0,17,693
9003497100,4041,2951,346,272,4,260,0,28,1090
9003497200,2478,1856,166,152,3,228,0,13,622
9003497300,5478,3776,398,478,6,571,0,77,1702
9003497400,4068,3232,236,118,5,263,0,32,836
9003497500,3972,2781,252,230,2,498,0,28,1191
9003497600,2246,1907,119,27,0,85,0,5,339
9003497700,4451,3602,197,148,1,300,1,39,849
9003500100,3720,164,2601,680,11,125,0,47,3556
9003500200,2179,149,1361,511,2,78,0,39,2030
9003500300,1937,210,1191,427,6,47,0,8,1727
9003500400,1862,199,990,565,4,33,0,22,1663
9003500500,1533,278,446,329,6,438,0,2,1255
9003500900,2027,31,1188,772,0,3,0,15,1996
9003501200,2552,45,853,1571,6,13,0,12,2507
9003501300,1707,26,688,936,0,11,1,4,1681
9003501400,2627,37,539,1964,5,6,0,15,2590
9003501500,3783,65,722,2837,3,8,0,26,3718
9003501700,1512,67,735,652,4,7,0,14,1445
9003501800,2898,62,1422,1308,16,3,0,10,2836
9003502100,2832,1218,367,426,1,688,1,25,1614
9003502300,5910,1225,3335,899,15,233,5,41,4685
9003502400,5582,567,3793,904,7,147,0,52,5015
9003502500,1768,356,993,285,0,59,2,20,1412
9003502600,3743,349,2389,777,6,70,0,61,3394
9003502700,5001,1451,2402,745,2,223,2,40,3550
9003502800,2971,97,2172,596,8,15,0,34,2874
9003502900,2776,241,1672,508,2,240,0,33,2535
9003503000,2978,175,2119,575,4,24,0,18,2803
9003503101,1677,121,624,740,1,136,2,16,1556
9003503102,2851,578,790,1173,11,168,0,12,2273
9003503300,2617,111,978,1401,8,26,1,11,2506
9003503500,1616,6,370,1169,0,2,0,13,1610
9003503700,2450,57,228,2060,5,2,0,6,2393
9003503800,2462,1357,333,546,5,104,0,105,1105
9003503900,4772,103,247,4229,11,20,0,8,4669
9003504000,3365,70,187,2974,9,1,1,17,3295
9003504100,1918,139,1116,381,5,81,11,62,1779
9003504200,4713,1259,1705,1278,13,204,0,51,3454
9003504300,2022,315,1108,292,0,64,2,121,1707
9003504500,3478,189,2416,655,5,55,0,58,3289
9003504800,4576,666,2759,773,9,166,3,97,3910
9003504900,4342,391,2861,762,25,90,0,79,3951
9003510100,2224,623,734,607,0,157,0,15,1601
9003510200,2367,586,908,736,2,77,0,9,1781
9003510300,4185,674,1703,1549,0,120,1,38,3511
9003510400,5614,746,2415,2126,20,126,0,44,4868
9003510500,3139,778,1037,927,4,274,1,11,2361
9003510600,5051,970,1945,1733,18,213,0,37,4081
9003510700,4915,1768,1628,1132,12,141,1,39,3147
9003510800,3110,1319,868,640,4,119,0,49,1791
9003510900,3699,1902,938,585,1,106,0,31,1797
9003511000,3581,1866,823,588,8,168,0,16,1715
9003511100,3742,1750,953,585,6,227,0,23,1992
9003511200,3455,769,1354,1044,16,133,0,40,2686
9003511300,3542,637,1256,1299,9,194,0,31,2905
9003511400,2421,1003,552,553,0,227,0,15,1418
9003514101,3160,2173,277,300,7,283,3,22,987
9003514103,4038,1453,433,459,9,1536,0,39,2585
9003514104,4244,1596,617,879,14,993,0,37,2648
9003514200,3382,1723,655,617,3,222,0,23,1659
9003514300,4363,2597,771,581,6,227,4,26,1766
9003514400,4899,2344,1132,931,12,248,0,27,2555
9003514500,4481,2310,910,595,20,442,0,26,2171
9003514600,5258,2519,1232,974,12,217,0,47,2739
9003514700,4403,1909,1134,866,14,220,4,21,2494
9003514800,3577,1429,1002,794,15,139,2,20,2148
9003514900,2987,2081,408,232,3,101,0,24,906
9003515000,2899,2142,292,197,5,119,0,14,757
9003515101,2525,1686,361,250,6,117,2,16,839
9003515102,6054,2820,840,923,8,1231,0,41,3234
9003515200,3443,2672,261,234,10,154,0,8,771
9003520100,5668,4351,294,151,2,666,0,22,1317
9003520201,3883,3006,164,81,5,459,2,25,877
9003520202,4253,3425,217,58,3,351,0,27,828
9003520301,4732,3087,628,294,1,509,0,8,1645
9003520302,4467,3293,361,130,9,509,1,33,1174
9003520400,7794,6454,348,93,6,599,0,33,1340
9003520501,4362,3703,182,35,2,247,0,25,659
9003524100,6133,5451,299,60,6,85,0,30,682
9003524200,6658,4959,442,276,4,790,0,25,1699
9003524300,5329,3741,564,690,12,133,0,13,1588
9003524400,3157,38,775,2219,9,8,0,9,3119
9003524501,3422,752,1445,849,7,80,1,103,2670
9003524502,2229,1053,413,591,0,55,0,22,1176
9003524600,3198,319,767,1579,20,361,0,23,2879
9003524700,3402,514,1924,729,11,105,2,60,2888
9003980001,0,0,0,0,0,0,0,0,0
9003980002,0,0,0,0,0,0,0,0,0
9003980003,0,0,0,0,0,0,0,0,0
9003980100,889,228,291,357,0,9,0,0,661
9005250100,1662,1520,41,14,1,10,0,8,142
9005253100,3473,2572,466,102,8,104,0,39,901
9005253200,7397,5605,904,170,13,253,2,52,1792
9005253400,6216,4848,630,121,0,247,2,69,1368
9005253500,5990,5003,440,100,6,116,0,55,987
9005260200,3211,2747,266,36,6,15,0,10,464
9005261100,4194,3643,197,80,8,78,1,35,551
9005262100,2680,2390,98,35,1,44,0,29,290
9005263200,1567,1433,61,4,1,24,0,5,134
9005265100,1351,1211,56,1,6,14,0,6,140
9005266100,3019,2586,156,31,21,85,0,10,433
9005267100,3646,3217,219,24,5,49,0,24,429
9005268100,2260,2053,70,9,2,29,0,9,207
9005290100,3647,3382,84,11,1,26,0,16,265
9005293100,1361,1257,31,5,1,4,0,8,104
9005296100,3150,2869,120,16,2,32,0,5,281
9005298300,2729,2478,86,15,8,21,0,3,251
9005298400,2755,2567,86,20,0,10,0,10,188
9005300100,2610,2400,87,13,5,30,0,2,210
9005300400,2151,1942,87,20,2,38,0,2,209
9005300500,3431,3121,102,18,6,46,0,8,310
9005303100,2256,2093,67,12,0,14,0,6,163
9005306100,6658,6105,177,18,6,75,3,31,553
9005310100,4253,2929,789,151,7,139,3,15,1324
9005310200,2844,1693,768,139,7,67,1,7,1151
9005310300,1801,1054,502,96,5,52,2,7,747
9005310400,2578,2096,241,79,3,47,0,9,482
9005310500,1806,1497,125,48,2,43,0,2,309
9005310601,3454,2732,293,103,0,188,0,19,722
9005310602,4427,3723,332,92,4,108,2,11,704
9005310700,4379,3585,381,84,8,113,0,23,794
9005310801,2385,1592,521,75,10,44,0,7,793
9005310803,4802,3552,794,135,11,54,6,30,1250
9005310804,2786,1855,687,58,7,36,1,17,931
9005320101,1388,1079,195,27,3,10,1,12,309
9005320102,4551,3893,306,52,3,64,7,17,658
9005320200,4285,3840,183,37,9,50,4,9,445
9005342100,3385,3104,104,31,4,22,0,12,281
9005349100,4792,4294,208,37,5,60,1,26,498
9005349200,2650,2343,132,21,4,31,0,4,307
9005360100,5285,4643,292,72,8,97,0,17,642
9005360200,7720,6920,354,79,0,118,7,38,800
9005360300,3271,2552,339,115,12,103,2,22,719
9005360400,5829,5006,405,133,1,81,1,37,823
9005362101,4136,3631,243,54,8,61,0,16,505
9005362102,5587,4978,211,54,10,80,6,36,609
9005425300,3986,3483,212,52,8,31,0,3,503
9005425400,4429,3845,269,46,7,48,2,13,584
9005425500,3256,2729,258,43,1,66,7,4,527
9005425601,1588,1449,48,8,4,18,0,2,139
9005425602,1080,975,56,15,3,1,0,7,105
9005425700,5039,3487,801,146,5,238,2,67,1552
9007541100,2549,1156,596,536,7,94,1,20,1393
9007541200,5427,3314,579,742,11,454,0,24,2113
9007541301,2047,1355,188,254,10,142,0,10,692
9007541302,4123,2151,558,789,3,365,0,26,1972
9007541401,3333,2567,221,178,2,183,1,21,766
9007541402,5639,3798,627,620,16,276,4,19,1841
9007541500,3324,1985,369,309,11,422,0,19,1339
9007541600,1475,619,359,334,4,67,0,25,856
9007541700,3664,1986,531,722,8,171,6,18,1678
9007542000,4482,3243,439,474,3,113,0,15,1239
9007542100,3571,2198,441,573,3,103,0,10,1373
9007542200,1628,1232,133,147,1,43,0,8,396
9007550100,5759,5088,243,63,7,118,4,27,671
9007550201,3877,3467,169,47,3,48,0,20,410
9007550202,3081,2747,97,44,11,34,6,13,334
9007560100,5789,5120,264,63,8,85,1,22,669
9007560200,3595,2907,317,130,0,48,0,27,688
9007570100,5007,3581,446,315,3,453,0,25,1426
9007570200,3458,2914,201,104,2,119,0,3,544
9007570300,5760,4784,356,204,7,219,0,16,976
9007580100,4217,3783,201,48,1,49,0,15,434
9007585100,7152,6414,262,63,7,112,3,29,738
9007590101,3925,3607,123,28,3,37,1,20,318
9007590102,4527,4046,152,34,1,76,0,12,481
9007595101,3573,3245,138,15,8,24,2,7,328
9007595102,5302,4820,194,40,9,61,1,11,482
9007600100,3749,3424,135,27,0,30,1,16,325
9007610100,2146,1760,284,6,0,30,0,6,386
9007610200,3689,3029,352,84,6,80,0,31,660
9007610300,4150,3492,368,26,5,87,1,36,658
9007610400,3200,2787,228,32,3,49,0,13,413
9007620100,4415,3909,196,44,9,47,0,2,506
9007630101,4185,3774,183,42,4,50,3,3,411
9007630102,2548,2354,90,10,4,36,1,4,194
9007640100,6174,5630,202,22,4,69,2,17,544
9007670100,4725,4156,247,30,5,128,0,22,569
9007670200,5756,5105,292,53,6,128,4,29,651
9007680101,3161,2629,236,105,6,53,0,25,532
9007680102,3608,3040,315,16,7,42,0,63,568
9007680200,6455,4738,596,628,6,178,1,15,1717
9007990100,0,0,0,0,0,0,0,0,0
9009120100,6375,4355,946,601,9,232,2,23,2020
9009120200,5950,3240,1598,772,11,104,1,41,2710
9009125100,4367,3358,601,206,0,61,1,8,1009
9009125200,5888,3101,1472,910,6,123,0,30,2787
9009125300,5167,2422,1489,804,18,139,0,61,2745
9009125400,3496,1807,931,554,3,59,0,14,1689
9009130101,5136,4063,547,247,2,101,5,16,1073
9009130102,3177,2390,395,183,4,53,0,19,787
9009130201,3566,2966,285,101,3,99,0,14,600
9009130202,4869,3879,525,137,4,168,0,25,990
9009140101,1306,659,123,54,2,416,1,2,647
9009140102,2526,1199,311,386,12,493,2,14,1327
9009140200,543,265,88,159,5,5,2,3,278
9009140300,2750,331,1322,775,3,233,4,7,2419
9009140400,3554,608,1845,815,8,144,2,14,2946
9009140500,3775,206,2228,1064,1,146,5,14,3569
9009140600,4747,315,2343,1819,19,101,8,21,4432
9009140700,4275,984,996,1685,10,369,0,32,3291
9009140800,3892,457,1027,2090,21,130,2,36,3435
9009140900,4478,958,912,2232,15,138,5,38,3520
9009141000,3873,2420,424,632,0,146,0,41,1453
9009141100,2805,1134,339,1059,15,115,0,15,1671
9009141200,4678,779,967,2579,11,90,1,36,3899
9009141301,6316,1872,1365,2589,18,189,5,38,4444
9009141400,4989,1108,737,2787,15,91,2,61,3881
9009141500,7614,317,1451,5480,13,53,0,37,7297
9009141600,5139,706,955,2994,13,259,0,35,4433
9009141800,4523,1766,556,1009,16,978,1,33,2757
9009141900,5569,3830,447,204,2,762,2,33,1739
9009142000,3451,2096,308,166,6,697,0,18,1355
9009142100,1189,413,411,259,4,50,3,4,776
9009142200,1671,1167,167,115,7,125,2,5,504
9009142300,5392,530,3723,944,15,41,2,28,4862
9009142400,5916,501,3887,1241,7,106,0,27,5415
9009142500,5938,802,3501,1393,15,46,0,46,5136
9009142601,5890,1214,2305,1832,6,309,4,43,4676
9009142604,2948,770,1309,724,0,42,0,15,2178
9009142605,4149,1110,1499,1289,15,65,1,28,3039
9009142700,6743,1472,3586,1279,12,158,1,59,5271
9009142800,4751,3092,983,346,2,127,0,11,1659
9009150100,4332,3559,303,128,2,147,4,16,773
9009150200,3385,2340,265,103,7,522,2,20,1045
9009150300,3894,2912,463,174,0,168,0,20,982
9009150400,4118,3174,432,174,3,153,3,12,944
9009150500,4165,3362,366,103,4,138,0,38,803
9009150600,6513,4877,498,224,4,645,0,37,1636
9009150700,4331,3522,332,105,0,229,1,14,809
9009150800,3847,3021,286,96,1,285,2,25,826
9009150900,3965,3375,250,105,8,100,5,16,590
9009151000,4090,3467,262,89,16,103,0,27,623
9009151100,6341,5265,476,150,6,223,0,26,1076
9009151200,3063,2543,178,80,0,127,0,15,520
9009154101,3089,846,1056,891,11,165,2,32,2243
9009154102,4918,1420,1156,1895,9,243,3,28,3498
9009154200,6767,1592,1823,2395,11,683,0,37,5175
9009154500,4738,1778,1761,814,9,166,1,36,2960
9009154600,4226,1919,1019,883,13,181,0,32,2307
9009154700,6187,4726,668,326,4,231,1,23,1461
9009154800,4954,3928,509,204,6,130,0,29,1026
9009154900,3805,2186,812,489,6,150,2,19,1619
9009155000,5487,2592,1646,845,6,140,0,39,2895
9009155100,3421,1920,816,437,10,87,0,21,1501
9009157100,2604,2002,146,71,1,289,0,8,602
9009157200,3865,3128,157,42,5,409,0,14,737
9009157300,3524,2833,178,46,1,362,0,17,691
9009157400,4287,3363,234,100,4,398,1,18,924
9009160100,3576,2683,203,79,1,448,1,20,893
9009160200,5511,3942,344,185,4,755,2,53,1569
9009161100,5297,4561,182,101,3,248,0,25,736
9009165100,4067,1737,943,957,8,264,0,19,2330
9009165200,2577,1976,128,158,3,196,0,7,601
9009165300,2257,1827,142,102,0,70,1,4,430
9009165400,5504,3139,532,1276,13,293,4,17,2365
9009165500,4904,666,903,2947,5,163,7,28,4238
9009165600,5935,1858,1260,2340,14,190,1,46,4077
9009165700,4557,1477,849,1901,11,101,5,25,3080
9009165801,5370,2199,621,1644,20,632,0,55,3171
9009165802,4103,2268,507,956,3,182,0,14,1835
9009165900,8178,5773,683,995,32,467,2,20,2405
9009166002,6894,5283,526,583,58,265,1,19,1611
9009166003,2473,1569,279,347,4,184,0,14,904
9009166004,4350,2612,463,628,7,440,4,34,1738
9009167101,3847,3059,259,218,2,195,2,35,788
9009167102,4289,3422,234,139,1,306,4,8,867
9009167201,4183,3392,270,191,3,204,0,21,791
9009167202,4332,3555,283,127,2,242,0,15,777
9009167301,7602,6203,444,214,15,521,2,26,1399
9009170100,1679,245,1043,304,3,17,2,4,1434
9009170200,1900,415,1145,281,2,6,3,8,1485
9009170300,2453,512,1573,256,6,20,1,19,1941
9009170400,1772,809,672,153,10,29,2,7,963
9009170500,5442,3840,962,272,2,123,0,32,1602
9009170600,2516,1439,774,142,1,47,0,12,1077
9009170700,2672,1089,1180,268,5,16,0,10,1583
9009170800,5925,2796,2181,570,5,130,1,34,3129
9009170900,2705,732,1514,336,3,20,5,9,1973
9009171000,2045,456,1206,277,0,24,0,11,1589
9009171100,5597,3125,1556,472,0,190,3,14,2472
9009171201,4709,3310,740,290,3,177,0,29,1399
9009171202,3420,2339,607,246,4,99,0,10,1081
9009171300,3427,1586,1404,213,5,56,0,16,1841
9009171400,2100,518,1291,151,7,65,5,14,1582
9009171500,3634,717,2162,545,4,49,3,30,2917
9009171600,4998,2550,1486,552,6,174,0,43,2448
9009171700,3856,2626,799,237,1,69,0,10,1230
9009175100,3409,2348,657,110,12,150,0,7,1061
9009175200,2481,1672,577,56,1,73,5,18,809
9009175300,4237,3324,515,81,1,149,0,19,913
9009175400,4444,2757,1080,149,5,281,3,18,1687
9009175501,1441,1308,55,10,0,22,0,2,133
9009175502,6158,5212,420,122,5,215,2,17,946
9009175600,5203,4339,361,87,14,190,4,20,864
9009175700,1956,1674,144,17,0,61,0,3,282
9009175800,4200,3444,243,40,0,348,0,16,756
9009175900,4911,4081,446,105,7,131,1,10,830
9009176000,5956,5238,272,65,12,189,3,30,718
9009180101,2117,1755,219,54,2,34,0,8,362
9009180102,4031,3160,513,123,5,70,0,8,871
9009180200,5723,3462,1506,307,6,262,0,24,2261
9009180300,2470,1619,568,114,0,91,0,6,851
9009180400,2613,1658,536,149,0,179,0,17,955
9009180500,4386,2761,906,299,6,274,2,23,1625
9009180601,3049,2472,398,65,1,45,1,10,577
9009180602,3534,2769,408,151,6,111,0,16,765
9009184101,5254,4232,510,152,12,169,0,22,1022
9009184200,4276,2940,415,222,3,511,2,38,1336
9009184300,4265,3635,208,101,2,147,1,11,630
9009184400,3224,2952,123,13,0,30,1,14,272
9009184500,2540,2261,102,22,0,74,0,18,279
9009184600,2740,2525,106,9,3,38,4,9,215
9009184700,5974,4882,398,135,5,342,2,25,1092
9009186100,6813,6082,367,68,5,120,0,15,731
9009186200,6731,6055,303,77,2,114,0,18,676
9009190100,3289,2914,161,25,5,70,0,9,375
9009190200,3421,2962,163,35,3,130,2,3,459
9009190301,6616,5713,293,80,0,264,0,11,903
9009190302,5398,4602,340,30,2,208,0,21,796
9009190303,3349,2894,178,32,0,109,0,18,455
9009194101,2045,1917,48,9,3,26,0,8,128
9009194102,2991,2734,89,23,2,63,0,2,257
9009194201,7520,6588,316,62,7,286,0,31,932
9009194202,5135,4466,188,33,8,187,0,22,669
9009341100,6000,5126,413,124,9,84,0,43,874
9009343101,5128,3449,529,753,8,233,1,12,1679
9009343102,4000,3245,256,87,4,234,0,34,755
9009343200,6022,4855,367,143,0,440,0,18,1167
9009343300,6918,5856,332,102,0,398,1,18,1062
9009343400,6665,5477,334,141,4,483,0,19,1188
9009344100,4656,4095,215,31,0,146,3,27,561
9009344200,2918,2465,117,36,0,231,0,4,453
9009345100,6858,4662,974,528,6,222,3,120,2196
9009345201,7148,4833,1125,475,4,137,0,128,2315
9009345202,4065,2927,508,251,10,133,0,57,1138
9009345300,6330,4111,1142,416,5,118,4,150,2219
9009345400,7118,4833,1122,525,6,139,0,106,2285
9009346101,6722,5986,368,55,7,103,2,9,736
9009346102,5984,5268,313,73,0,115,2,37,716
9009347100,5712,5053,245,131,5,68,2,18,659
9009347200,3689,3278,181,75,5,26,0,15,411
9009348111,2455,2191,98,36,0,51,2,6,264
9009348122,4198,3637,223,46,2,116,0,18,561
9009348123,5686,4934,272,47,0,198,0,30,752
9009348124,2534,2311,88,21,2,44,0,18,223
9009348125,5006,4552,149,50,2,147,0,16,454
9009350101,4697,859,2762,803,8,139,0,20,3838
9009350200,3695,388,2023,1086,12,28,0,43,3307
9009350300,2235,137,1419,565,6,12,0,29,2098
9009350400,2846,204,1719,766,13,5,0,19,2642
9009350500,2693,303,1760,338,6,61,5,122,2390
9009350800,6010,1656,2540,1505,11,29,0,99,4354
9009350900,2180,742,704,555,2,14,0,44,1438
9009351000,4107,1013,1888,908,12,46,1,62,3094
9009351100,4341,1017,1774,1244,10,61,1,58,3324
9009351200,4146,583,2222,1048,11,55,0,75,3563
9009351300,5557,1753,2138,1165,11,179,0,72,3804
9009351400,4087,901,2132,696,13,82,2,122,3186
9009351500,4975,1791,1868,693,15,115,0,182,3184
9009351601,3541,1570,1204,513,14,32,3,60,1971
9009351602,6201,3551,1408,743,15,104,0,112,2650
9009351700,3015,599,1501,686,11,35,2,24,2416
9009351800,4403,2282,1104,650,15,120,0,42,2121
9009351900,2840,1768,464,347,6,122,1,13,1072
9009352000,4996,2701,1247,623,26,128,6,74,2295
9009352100,4359,1828,1318,844,6,87,0,78,2531
9009352200,2582,367,1557,512,2,34,1,28,2215
9009352300,3106,763,1426,706,8,24,0,41,2343
9009352400,3461,979,1456,764,8,85,3,53,2482
9009352500,3084,1180,999,626,18,63,1,70,1904
9009352600,5450,2293,1731,989,11,151,1,71,3157
9009352701,3415,1434,1133,550,9,98,2,28,1981
9009352702,5996,2608,1663,1155,17,180,3,68,3388
9009352800,6385,2490,2121,1189,11,260,0,89,3895
9009361100,6418,5440,443,164,11,116,0,22,978
9009361200,5446,4645,369,155,10,61,3,14,801
9009361300,4278,3693,275,76,6,73,0,36,585
9009361401,4458,2124,469,439,11,1153,3,40,2334
9009361402,4175,1805,484,349,40,1267,3,39,2370
9009361500,7992,3053,1911,2306,33,433,1,53,4939
9009990000,0,0,0,0,0,0,0,0,0
9011650100,2352,2193,56,10,0,20,0,14,159
9011660101,3420,3099,138,21,1,76,3,9,321
9011660103,2766,2459,103,21,1,80,0,17,307
9011660104,1442,1298,73,4,4,16,0,6,144
9011690300,6805,1843,3087,1225,44,148,7,48,4962
9011690400,2186,439,1164,410,11,18,0,21,1747
9011690500,2774,1092,875,553,18,55,4,29,1682
9011690700,1402,460,464,333,7,22,0,13,942
9011690800,3458,1425,1245,520,33,47,1,7,2033
9011690900,4963,3447,639,470,22,106,9,23,1516
9011693300,5672,4774,343,83,16,185,0,29,898
9011693400,4286,3160,511,151,12,227,2,35,1126
9011693500,3460,3008,157,71,1,76,0,12,452
9011693600,2886,2199,286,99,18,105,0,22,687
9011693700,3267,2548,265,119,23,149,0,15,719
9011695201,4975,3938,350,132,69,179,5,26,1037
9011695202,5854,4742,426,182,45,110,3,18,1112
9011696100,5094,3273,835,479,29,107,4,26,1821
9011696200,4768,3461,380,219,28,352,1,36,1307
9011696300,2741,2075,263,115,18,79,0,17,666
9011696401,6168,2467,1857,1164,36,172,7,59,3701
9011696500,2931,1858,400,328,9,122,6,28,1073
9011696600,3861,2164,525,257,32,649,4,16,1697
9011696701,5902,2617,1361,656,38,757,24,44,3285
9011696800,4016,1451,1175,795,32,230,0,67,2565
9011697000,4644,2345,931,547,46,383,2,49,2299
9011700100,4788,4107,204,54,27,116,0,17,681
9011701100,8050,5971,577,251,426,264,6,43,2079
9011701200,7355,5862,557,206,38,233,9,20,1493
9011702100,4504,3432,291,156,27,304,6,22,1072
9011702300,2419,1684,248,144,7,137,7,13,735
9011702400,3352,2252,397,213,18,219,8,27,1100
9011702500,4679,2038,1321,507,35,326,14,50,2641
9011702600,1115,960,66,7,4,16,0,12,155
9011702700,4707,3196,488,298,24,404,3,12,1511
9011702800,4031,2443,613,246,44,329,3,17,1588
9011702900,2352,2146,74,12,4,35,0,7,206
9011703000,3645,3284,135,23,4,51,2,14,361
9011705101,4202,3718,152,45,22,79,2,12,484
9011705102,4193,3643,162,48,20,95,3,14,550
9011705200,3407,3186,80,22,2,30,0,6,221
9011705300,3747,3356,119,44,6,77,2,7,391
9011705400,2786,2462,112,30,3,54,0,9,324
9011707100,5149,4555,180,38,42,55,8,33,594
9011708100,2570,2335,73,6,16,14,0,2,235
9011709100,6004,5250,187,57,56,90,0,22,754
9011709200,5398,4175,412,195,43,169,0,18,1223
9011710100,4195,3650,168,34,24,60,5,9,545
9011711100,2967,2494,152,76,30,50,1,8,473
9011712100,1863,1624,89,23,20,20,0,5,239
9011713100,2429,2145,105,30,5,10,4,14,284
9011714101,3782,3216,207,82,10,68,0,25,566
9011714103,7096,6261,287,72,18,100,4,36,835
9011714104,4677,4028,259,81,16,90,0,19,649
9011715100,4213,3563,227,63,17,110,4,26,650
9011716101,4975,3840,336,275,10,327,0,20,1135
9011716102,5753,4469,298,86,8,597,2,26,1284
9011870100,7142,6337,331,45,44,45,1,35,805
9011870200,5792,3738,849,480,47,233,19,26,2054
9011870300,5779,2729,1852,633,19,248,5,21,3050
9011870501,4315,2513,394,182,183,796,9,34,1802
9011870502,3243,1960,478,557,45,58,3,15,1283
9011870701,2072,1694,132,35,5,106,2,8,378
9011870703,1749,1541,74,12,9,64,1,6,208
9011870704,4144,3729,148,37,5,83,0,19,415
9011980000,1823,1473,177,53,1,1,0,0,350
9011990100,0,0,0,0,0,0,0,0,0
9013526101,4418,4069,137,28,3,32,0,13,349
9013526102,4680,4212,187,26,4,71,0,24,468
9013528100,3151,2799,121,41,3,34,0,19,352
9013529100,4858,4188,277,86,3,83,0,23,670
9013530100,2286,1707,246,120,1,69,0,13,579
9013530200,6259,3701,1146,714,16,249,3,24,2558
9013530301,5532,3664,686,569,5,306,2,20,1868
9013530302,6240,4550,483,257,4,751,1,8,1690
9013530400,4118,2769,425,303,4,437,0,19,1349
9013530500,3236,2640,221,133,5,105,0,6,596
9013530600,2544,2185,138,47,1,61,0,2,359
9013533102,5562,4792,257,76,5,179,0,35,770
9013533103,4026,3552,201,44,14,79,0,10,474
9013533104,4975,4320,185,91,0,177,0,10,655
9013535101,5533,4333,253,151,4,640,0,16,1200
9013535102,4153,3708,164,54,0,63,5,19,445
9013535200,6740,5470,268,165,9,548,1,17,1270
9013538100,1300,457,308,522,0,13,0,0,843
9013538201,5007,4576,156,64,3,69,3,17,431
9013538202,3948,3608,127,24,6,46,0,13,340
9013840100,5566,4640,260,76,8,324,8,30,926
9013850100,5586,4977,224,47,10,63,0,29,609
9013850200,6649,5906,288,44,3,105,0,47,743
9013860100,5272,4763,212,47,17,31,0,18,509
9013881100,4977,3827,237,93,14,571,0,21,1150
9013881200,9522,6195,1018,675,12,1289,2,35,3327
9013881300,5349,3532,466,318,6,819,4,40,1817
9013881500,6044,4027,485,159,7,1101,9,47,2017
9013890100,3696,3082,243,65,3,68,1,16,614
9013890202,4949,4489,160,20,12,33,0,29,460
9013890203,785,711,23,2,0,6,0,8,74
9013890204,2827,2572,97,13,0,16,5,8,255
9015800300,5958,2782,2137,405,18,393,1,16,3176
9015800400,3910,1728,1822,138,4,35,1,19,2182
9015800501,3804,2008,1500,75,15,43,0,25,1796
9015800502,3149,2531,414,41,10,11,0,11,618
9015800600,4187,952,2938,145,3,41,2,21,3235
9015800700,3417,1535,1388,93,0,276,0,15,1882
9015815000,2151,1877,121,25,10,7,0,13,274
9015820000,1728,1563,58,5,13,12,0,14,165
9015825000,1576,1449,60,5,3,0,0,2,127
9015830100,4191,3702,186,55,5,58,1,16,489
9015900100,4422,4061,92,16,10,36,0,18,361
9015900200,4767,4203,207,56,17,41,0,23,564
9015901101,2640,2410,79,20,1,34,1,10,230
9015901102,5581,5122,140,26,12,55,0,17,459
9015902200,1649,1496,61,8,4,16,0,9,153
9015902500,4266,3786,179,50,5,101,0,23,480
9015903101,3302,2811,214,53,17,30,2,6,491
9015903102,3527,2830,276,72,16,67,2,27,697
9015903200,2395,2161,58,19,1,18,0,14,234
9015904101,4761,4206,194,55,13,65,0,16,555
9015904102,2797,2529,58,12,8,18,0,9,268
9015904400,4112,3592,155,66,8,81,0,20,520
9015904500,6082,4971,430,102,8,162,1,33,1111
9015905101,4751,4062,304,46,7,89,0,18,689
9015905102,3699,3123,233,150,16,34,4,13,576
9015906100,5045,4454,210,64,18,25,0,38,591
9015907100,4217,3633,207,61,16,65,2,22,584
9015907200,5302,4554,286,84,23,42,0,19,748
9015907300,5454,4603,332,83,27,85,0,11,851
9015908100,3578,3110,120,34,18,20,0,8,468
10001040100,7315,5906,337,578,43,49,8,16,1409
10001040201,5446,3294,421,1314,5,47,1,16,2152
10001040203,5182,2736,369,1671,18,75,0,47,2446
10001040204,6451,3532,396,1991,8,131,2,46,2919
10001040205,4699,2374,384,1504,16,123,1,24,2325
10001040206,7643,4004,460,2556,35,191,0,45,3639
10001040501,4605,1779,501,1866,29,155,4,25,2826
10001040502,2645,1236,236,908,15,81,4,10,1409
10001040700,5461,2414,348,1969,30,256,0,81,3047
10001040900,2374,1325,142,633,10,87,3,21,1049
10001041000,7443,2583,1045,3003,44,260,6,34,4860
10001041101,2816,1610,438,429,8,81,19,13,1206
10001041200,4368,1765,520,1463,19,291,0,20,2603
10001041300,2059,842,142,887,9,36,0,7,1217
10001041400,3839,1189,341,1880,13,123,1,22,2650
10001041500,4085,1745,364,1575,13,106,0,23,2340
10001041600,2107,1471,152,272,8,55,0,25,636
10001041701,6164,3593,410,1407,23,237,5,46,2571
10001041702,4472,2494,262,1152,21,213,2,22,1978
10001041802,6720,3551,428,1995,22,320,3,38,3169
10001041803,4384,2376,397,1077,114,87,2,33,2008
10001041804,5980,3570,354,1465,33,155,5,30,2410
10001041900,5289,4357,335,225,29,27,3,25,932
10001042000,3064,2539,102,155,21,25,1,20,525
10001042100,3997,2889,220,519,29,57,0,16,1108
10001042203,5705,3250,480,1237,27,257,11,59,2455
10001042204,4773,2705,385,1146,10,177,0,31,2068
10001042205,3019,1618,300,848,25,33,0,5,1401
10001042206,2822,1966,158,454,22,33,0,9,856
10001042207,2576,1653,211,458,11,59,1,12,923
10001042208,4016,2517,439,722,23,63,3,24,1499
10001042500,3590,1386,654,1273,13,53,0,14,2204
10001042801,2007,1720,70,85,3,7,1,12,287
10001042802,5612,3917,286,988,18,66,1,36,1695
10001042900,5105,3901,284,567,8,44,0,23,1204
10001043000,5414,3554,351,1067,26,36,0,27,1860
10001043100,2573,2247,63,135,2,28,0,7,326
10001043202,3722,2882,268,275,11,24,4,6,840
10001043300,6553,2561,379,3037,28,121,13,33,3992
10001043400,5648,3738,523,944,21,87,3,25,1910
10001980000,108,56,26,7,1,6,0,0,52
10001990000,0,0,0,0,0,0,0,0,0
10003000200,5298,821,272,3899,8,46,4,36,4477
10003000300,3012,397,155,2314,10,18,0,19,2615
10003000400,2957,1161,171,1418,6,24,2,24,1796
10003000500,3453,287,236,2765,11,9,0,23,3166
10003000601,2773,93,165,2387,4,9,0,17,2680
10003000602,2876,194,176,2354,10,21,1,6,2682
10003000900,2267,98,207,1852,0,8,0,17,2169
10003001100,3375,2386,214,557,1,95,0,21,989
10003001200,1605,1327,63,115,0,38,0,4,278
10003001300,3588,3208,103,92,0,55,0,7,380
10003001400,2103,1062,320,600,11,25,2,4,1041
10003001500,2231,864,243,970,3,34,0,21,1367
10003001600,2419,357,245,1675,4,10,0,11,2062
10003001902,2113,380,125,1408,11,97,3,10,1733
10003002100,1809,130,216,1337,2,36,0,14,1679
10003002200,2874,124,1222,1436,5,5,0,8,2750
10003002300,3003,280,1050,1505,2,32,2,4,2723
10003002400,4250,1680,684,1682,3,42,0,13,2570
10003002500,3235,1193,901,989,3,27,7,25,2042
10003002600,3730,481,1295,1815,8,10,0,18,3249
10003002700,2990,769,661,1257,2,156,0,16,2221
10003002800,2378,977,261,913,0,100,0,4,1401
10003002900,3499,196,199,2969,11,7,0,19,3303
10003003002,3060,427,239,2318,1,3,0,1,2633
10003010104,3620,1501,507,1293,17,133,0,12,2119
10003010105,2916,1021,358,1204,6,194,1,20,1895
10003010106,1760,574,88,587,0,438,1,14,1186
10003010200,2034,1277,124,462,5,78,0,0,757
10003010300,4106,1914,404,1015,14,536,3,31,2192
10003010400,4591,3217,228,526,11,435,0,19,1374
10003010502,5779,3955,335,1003,6,188,0,24,1824
10003010703,2036,1109,126,600,3,64,0,22,927
10003010704,3947,1395,276,1962,4,120,0,16,2552
10003010800,4796,3533,242,527,4,314,0,33,1263
10003010900,2773,2364,92,113,0,88,0,7,409
10003011000,3201,2473,158,302,4,123,3,16,728
10003011100,2654,2262,94,122,2,71,0,16,392
10003011201,2421,1537,94,152,6,560,0,10,884
10003011202,4003,3047,134,281,4,384,0,19,956
10003011203,4805,2746,204,1005,8,628,1,55,2059
10003011204,3313,2472,131,405,5,199,3,9,841
10003011205,1968,1556,74,122,7,146,0,6,412
10003011206,4319,3602,131,190,0,252,0,15,717
10003011300,2244,1786,55,175,1,143,3,7,458
10003011400,3456,2947,110,135,3,147,1,4,509
10003011500,2908,2320,160,122,0,156,0,4,588
10003011600,3287,2742,138,134,7,126,2,7,545
10003011700,4260,3712,158,89,8,145,1,12,548
10003011800,4927,4021,161,124,3,431,0,20,906
10003011900,3298,2601,252,90,5,240,0,17,697
10003012000,4334,2652,873,510,2,113,0,15,1682
10003012100,2901,1930,519,264,4,71,0,11,971
10003012200,4676,2330,1462,605,3,73,1,18,2346
10003012300,2739,1326,675,519,8,89,0,22,1413
10003012400,4637,2345,1437,617,8,47,3,12,2292
10003012500,5660,3077,1486,805,4,34,0,18,2583
10003012600,2945,2038,518,206,2,62,0,17,907
10003012700,4392,2765,915,506,5,46,0,21,1627
10003012900,4823,1795,1665,1132,9,27,3,16,3028
10003013000,1927,1324,353,104,4,43,1,11,603
10003013100,2248,1524,415,127,6,56,0,10,724
10003013200,2653,1505,722,261,5,48,0,6,1148
10003013300,1907,1433,266,79,3,58,0,4,474
10003013400,2504,2001,212,108,4,69,0,3,503
10003013501,7213,5858,213,218,0,657,1,20,1355
10003013505,3489,2601,87,97,0,579,1,9,888
10003013506,4567,3792,123,151,2,366,1,5,775
10003013507,1819,1345,90,38,3,266,4,4,474
10003013508,5655,4152,304,208,7,733,0,31,1503
10003013604,4156,3287,275,270,8,154,0,8,869
10003013607,6255,4131,354,454,10,1030,1,20,2124
10003013608,1959,1418,198,201,1,76,0,7,541
10003013610,5460,4200,223,211,2,582,1,37,1260
10003013611,5572,3946,351,688,9,322,0,20,1626
10003013612,6158,4170,256,228,5,1242,1,28,1988
10003013613,5657,4334,349,328,4,411,0,26,1323
10003013614,3258,1743,986,341,3,93,0,5,1515
10003013615,4107,2526,971,296,7,131,0,10,1581
10003013700,4071,1926,847,842,3,237,3,18,2145
10003013800,5901,3024,519,784,10,1340,2,21,2877
10003013901,3492,1803,568,755,3,146,1,10,1689
10003013903,4820,2391,379,1432,11,376,0,25,2429
10003013905,4169,1470,340,1080,15,1047,0,38,2699
10003013906,4648,1760,331,1232,15,1124,0,10,2888
10003014000,5441,2495,832,1413,9,422,2,49,2946
10003014100,4985,2475,925,1151,18,102,0,31,2510
10003014200,1600,1226,93,115,0,87,0,11,374
10003014301,1317,1109,64,45,4,48,0,8,208
10003014302,4908,3263,353,876,0,210,0,3,1645
10003014402,2807,2007,204,165,0,299,3,3,800
10003014403,3611,2234,351,483,10,335,0,13,1377
10003014404,4159,2760,212,340,1,672,1,9,1399
10003014501,2134,1390,170,286,2,217,0,6,744
10003014502,7374,4284,530,1778,1,411,0,3,3090
10003014702,1910,1222,203,312,0,77,0,12,688
10003014703,4827,2516,910,755,15,410,2,14,2311
10003014705,5891,3262,790,1032,11,410,1,16,2629
10003014706,2929,1068,316,1162,0,216,0,10,1861
10003014803,4150,2815,252,461,5,426,3,14,1335
10003014808,6476,2805,761,2128,25,385,0,47,3671
10003014809,8360,4050,587,2726,20,503,2,46,4310
10003014810,7083,4012,579,1792,6,321,4,38,3071
10003014811,6677,3668,292,999,8,1435,0,30,3009
10003014812,4559,2492,260,1109,3,470,0,28,2067
10003014813,4889,2642,384,950,1,675,1,35,2247
10003014814,4361,2305,368,930,12,525,0,17,2056
10003014903,7365,1547,2273,3048,5,220,0,39,5818
10003014904,5003,1971,521,1730,19,561,2,10,3032
10003014906,5339,1568,632,2538,17,340,4,45,3771
10003014907,4921,1583,586,2357,9,143,0,16,3338
10003014908,2425,441,338,1467,8,57,0,11,1984
10003014909,6186,1568,990,3167,13,124,0,50,4618
10003015000,5659,2506,1036,1766,10,138,4,17,3153
10003015100,3594,2028,632,726,4,49,3,12,1566
10003015200,5783,2372,1646,1436,17,90,5,26,3411
10003015400,2932,161,455,2195,8,27,1,22,2771
10003015502,2686,592,475,1507,4,10,0,9,2094
10003015600,2343,455,750,1031,0,6,0,7,1888
10003015802,2276,874,875,415,6,19,0,6,1402
10003015900,3344,1477,690,950,9,40,1,10,1867
10003016000,2999,726,563,1525,11,18,0,27,2273
10003016100,1961,1218,101,557,7,12,0,5,743
10003016200,3051,1974,299,595,5,52,1,10,1077
10003016301,7385,3342,914,2009,13,795,1,27,4043
10003016306,4598,1591,655,1881,6,258,0,10,3007
10003016307,2756,1232,231,1011,3,163,0,11,1524
10003016308,3728,750,351,2182,4,297,0,32,2978
10003016309,4125,1409,464,1959,9,84,2,12,2716
10003016401,6711,3030,431,2110,12,748,4,67,3681
10003016404,3334,2325,222,519,14,38,1,15,1009
10003016608,6561,4361,276,1246,10,304,0,52,2200
10003016609,5595,4489,268,493,5,116,0,17,1106
10003016610,7062,3756,625,2035,10,279,2,31,3306
10003016611,7851,4439,498,1756,14,753,2,23,3412
10003016612,6450,4304,285,1092,0,466,1,10,2146
10003016613,6109,2537,766,2177,3,268,2,48,3572
10003016614,6239,3449,445,1661,4,367,0,39,2790
10003016805,1723,1472,77,65,7,8,0,2,251
10003016806,6347,3515,409,1717,9,282,5,48,2832
10003016807,1901,1338,97,337,0,36,1,3,563
10003016808,7377,4460,424,1864,20,173,2,36,2917
10003016901,2364,2067,100,71,7,16,0,5,297
10003016904,3096,1740,141,1121,6,15,0,9,1356
10003980100,0,0,0,0,0,0,0,0,0
10003990100,0,0,0,0,0,0,0,0,0
10005050101,4013,3136,417,247,5,25,3,31,877
10005050103,5063,3953,336,448,11,111,1,20,1110
10005050104,5031,2884,1002,831,18,60,1,22,2147
10005050105,5939,3033,1167,1380,18,22,2,25,2906
10005050200,3744,2038,654,816,10,14,5,25,1706
10005050302,5521,3279,1294,623,11,44,2,34,2242
10005050303,2935,2154,205,400,0,27,1,9,781
10005050304,4616,3146,489,661,15,65,0,27,1470
10005050401,3606,2765,119,505,14,35,3,9,841
10005050403,3517,1974,671,658,4,20,1,16,1543
10005050405,4378,2677,340,1007,7,100,0,37,1701
10005050406,5475,2386,872,1811,25,110,0,35,3089
10005050407,5238,2758,633,1447,13,110,0,28,2480
10005050408,4534,2642,688,941,7,22,1,11,1892
10005050501,4201,2700,794,459,19,43,5,15,1501
10005050503,5604,1220,3671,564,14,6,0,10,4384
10005050505,2420,1237,372,749,2,19,0,6,1183
10005050506,4112,2376,1080,467,13,17,0,30,1736
10005050601,5391,3658,985,449,24,37,0,17,1733
10005050603,3956,2902,260,447,12,86,1,7,1054
10005050604,4674,2772,613,874,20,138,0,33,1902
10005050701,5068,3615,449,622,86,41,0,20,1453
10005050703,2153,1383,377,193,79,10,0,10,770
10005050706,1772,1632,41,13,5,8,0,3,140
10005050707,2578,2203,83,152,12,29,0,4,375
10005050708,2774,2209,235,139,13,68,0,3,565
10005050709,1956,1801,50,34,1,14,4,6,155
10005050710,1870,1344,206,148,12,11,0,8,526
10005050711,1505,1141,204,66,8,5,0,8,364
10005050801,3979,3029,370,363,14,47,1,11,950
10005050804,4188,3319,234,383,23,46,0,24,869
10005050805,3038,2456,353,117,13,24,0,2,582
10005050806,4454,3552,331,288,11,74,1,24,902
10005050807,1824,1599,79,39,0,42,2,6,225
10005050808,4150,3397,387,138,7,73,0,20,753
10005050903,2161,1887,109,94,2,28,3,5,274
10005050904,2592,2213,102,122,4,17,0,7,379
10005050905,2848,2527,109,49,7,40,0,23,321
10005051008,4100,3482,283,110,10,55,0,19,618
10005051009,2313,1864,108,198,2,55,1,1,449
10005051010,2795,2441,125,60,16,41,1,21,354
10005051011,3580,2924,203,146,8,136,0,14,656
10005051012,1908,1685,54,39,4,39,2,7,223
10005051013,3686,3197,116,141,26,57,3,10,489
10005051014,1881,1722,47,29,1,30,0,4,159
10005051015,1877,1621,124,31,6,23,0,8,256
10005051016,1879,1721,68,18,5,26,0,4,158
10005051017,3804,3260,231,89,10,73,0,19,544
10005051101,629,581,21,4,2,4,0,0,48
10005051102,1029,968,25,7,0,12,3,0,61
10005051103,952,877,20,1,0,4,3,13,75
10005051201,1513,1400,53,5,0,12,0,3,113
10005051202,856,788,23,4,0,7,0,8,68
10005051203,792,753,13,3,0,8,1,6,39
10005051204,652,621,9,0,0,5,0,0,31
10005051205,580,537,8,6,1,11,0,1,43
10005051302,4907,4264,230,174,9,51,0,20,643
10005051307,2975,2739,72,35,2,34,0,10,236
10005051308,4074,3724,138,49,4,23,3,15,350
10005051309,1488,1392,19,21,1,17,0,0,96
10005051310,1933,1803,35,34,2,20,0,12,130
10005051311,1832,1733,46,5,0,10,0,4,99
10005051312,2290,2072,105,24,3,25,1,5,218
10005051313,3144,2802,151,36,0,43,6,10,342
10005051314,2525,2310,87,28,2,23,1,6,215
10005051400,3878,2189,977,473,5,91,0,16,1689
10005051501,2246,1131,628,372,2,24,3,1,1115
10005051502,3228,2341,321,367,15,31,0,10,887
10005051701,4103,3343,280,208,23,45,1,19,760
10005051702,6577,5233,387,568,10,69,1,30,1344
10005051801,5359,3499,735,754,8,99,2,33,1860
10005051802,4354,2205,463,1389,21,35,0,28,2149
10005051900,4760,3522,206,663,7,88,1,30,1238
10005980000,1,0,1,0,0,0,0,0,1
10005990000,0,0,0,0,0,0,0,0,0
11001000101,1406,1054,140,47,4,90,1,3,352
11001000102,3417,2711,316,56,0,176,1,22,706
11001000201,4108,2399,456,339,4,621,6,29,1709
11001000202,4672,3492,357,184,3,396,0,25,1180
11001000300,6161,4533,557,248,11,482,5,26,1628
11001000400,1643,1214,165,82,0,122,0,12,429
11001000501,3829,2624,451,230,9,315,0,25,1205
11001000502,3418,2528,365,105,0,217,0,20,890
11001000600,4676,3492,394,226,5,268,0,31,1184
11001000702,3452,2079,445,276,3,413,1,27,1373
11001000703,3022,2119,285,246,0,229,0,27,903
11001000704,2753,1699,423,234,3,238,0,27,1054
11001000802,3327,2178,330,208,0,386,3,25,1149
11001000803,3174,2169,391,168,0,274,0,9,1005
11001000804,3832,2774,294,197,0,322,3,23,1058
11001000902,2317,1826,173,76,6,93,0,28,491
11001000903,4202,2416,583,415,0,671,0,5,1786
11001000904,3148,2509,187,131,2,126,0,22,639
11001001002,3643,2374,336,344,7,369,0,23,1269
11001001003,3111,2443,240,78,0,130,1,12,668
11001001004,4480,3222,420,228,1,323,1,15,1258
11001001100,5300,3707,451,386,0,398,2,45,1593
11001001200,5371,3722,535,402,4,379,2,25,1649
11001001301,4160,2509,375,590,8,426,0,41,1651
11001001303,3763,2437,338,386,5,371,3,30,1326
11001001304,4018,2897,395,214,5,299,1,14,1121
11001001401,3258,2339,258,213,3,230,0,17,919
11001001402,3514,2355,293,442,3,221,0,6,1159
11001001500,6156,4602,456,549,10,193,0,34,1554
11001001600,4471,1278,334,2447,9,72,0,36,3193
11001001702,3356,1185,380,1449,7,104,2,47,2171
11001001803,4102,266,1457,2195,4,53,0,45,3836
11001001804,5500,408,1929,2944,1,55,0,25,5092
11001001901,4206,800,875,2162,6,124,2,36,3406
11001001902,2117,433,261,1257,3,47,1,14,1684
11001002001,2926,587,1106,1018,4,71,0,14,2339
11001002002,4072,1033,1022,1722,4,83,0,21,3039
11001002101,5687,885,1868,2586,20,115,1,39,4802
11001002102,5099,805,1074,2856,14,83,0,40,4294
11001002201,3485,864,683,1687,3,85,2,14,2621
11001002202,3339,548,1003,1594,8,54,0,22,2791
11001002301,3266,956,551,1437,7,122,0,29,2310
11001002302,1762,639,114,887,7,59,0,2,1123
11001002400,4095,1455,751,1478,9,144,1,13,2640
11001002501,2688,795,613,1090,2,61,0,15,1893
11001002503,3031,1044,712,953,1,157,0,21,1987
11001002504,3349,984,1316,790,2,120,0,22,2365
11001002600,2592,1017,409,823,4,157,1,27,1575
11001002702,5825,3050,1621,602,7,241,4,34,2775
11001002703,2614,1302,672,282,3,171,2,24,1312
11001002704,2993,1174,1008,428,52,196,7,19,1819
11001002801,4398,1182,1393,1446,1,223,5,13,3216
11001002802,4685,1335,1836,1024,7,303,2,27,3350
11001002900,4443,1841,1320,878,3,210,0,17,2602
11001003000,3561,1365,524,1307,6,212,4,17,2196
11001003100,3873,1531,1037,917,18,200,0,19,2342
11001003200,5099,1576,1197,1834,4,209,1,50,3523
11001003301,3824,1903,276,1214,0,172,3,35,1921
11001003302,2434,1245,200,720,6,98,3,27,1189
11001003400,5120,1977,482,1908,7,460,16,12,3143
11001003500,4801,1978,604,1582,4,385,8,24,2823
11001003600,4775,2091,795,1350,10,273,2,21,2684
11001003701,2916,1330,737,526,4,142,0,17,1586
11001003702,2906,918,642,1086,6,135,4,9,1988
11001003801,1800,1146,252,208,0,113,0,4,654
11001003802,3911,1979,816,640,4,295,0,10,1932
11001003901,2598,1564,373,329,3,183,2,17,1034
11001003902,2022,1400,226,155,5,114,1,2,622
11001004001,3941,2962,425,124,7,206,5,12,979
11001004002,3291,2374,319,188,5,195,2,31,917
11001004100,2836,2050,249,120,0,281,2,18,786
11001004201,3548,2597,334,194,3,259,0,9,951
11001004202,2850,2070,279,110,2,242,1,14,780
11001004300,4436,2660,484,824,13,266,4,12,1776
11001004401,3430,2242,308,345,2,342,3,26,1188
11001004402,2755,1671,262,482,0,172,0,7,1084
11001004600,3543,1398,271,1512,6,175,3,24,2145
11001004702,3934,2183,343,769,5,414,8,18,1751
11001004703,3331,1541,358,793,1,478,2,12,1790
11001004704,1945,84,60,1702,3,50,0,2,1861
11001004801,2820,1514,226,756,1,166,1,18,1306
11001004802,3634,1214,342,1524,7,406,0,19,2420
11001004901,3380,1646,435,987,12,156,3,11,1734
11001004902,3449,1653,587,772,0,270,1,24,1796
11001005001,2012,1410,196,198,5,100,4,9,602
11001005003,2143,1251,211,373,8,191,0,10,892
11001005004,3861,1604,1037,773,4,280,0,18,2257
11001005202,3408,2287,338,345,7,267,6,12,1121
11001005203,2979,1844,393,270,2,347,0,15,1135
11001005302,2518,1857,236,117,6,176,0,14,661
11001005303,3215,2047,332,301,4,380,3,17,1168
11001005501,2303,1535,230,119,0,305,1,9,768
11001005502,2968,1977,293,292,1,257,0,19,991
11001005503,2492,1789,189,54,0,326,0,12,703
11001005601,2900,1728,298,119,3,625,0,20,1172
11001005602,4100,2504,390,294,15,724,0,26,1596
11001005801,1672,924,116,82,1,462,0,4,748
11001005802,2145,1282,192,289,0,234,0,33,863
11001005900,2617,1531,238,433,1,298,0,12,1086
11001006400,2481,580,127,1621,8,33,2,15,1901
11001006500,2609,2055,149,109,0,154,8,18,554
11001006600,2164,1734,113,97,8,93,3,18,430
11001006700,3927,2999,212,296,4,157,3,16,928
11001006801,2238,1158,124,755,0,75,1,8,1080
11001006802,2580,1491,164,671,2,74,0,10,1089
11001006804,2429,298,198,1891,0,24,1,0,2131
11001006900,2799,1836,144,533,5,110,1,13,963
11001007000,2697,1872,248,325,8,105,3,12,825
11001007100,3218,1333,189,1426,6,123,4,13,1885
11001007201,2985,1883,254,532,4,150,0,2,1102
11001007202,4303,3133,302,443,7,224,1,12,1170
11001007203,3748,2225,251,875,11,198,8,8,1523
11001007301,3841,2237,612,519,15,133,8,9,1604
11001007304,4410,92,95,4068,3,26,0,22,4318
11001007401,1259,18,43,1150,0,6,0,3,1241
11001007403,2613,31,53,2468,7,0,0,2,2582
11001007404,3637,30,114,3334,11,13,1,33,3607
11001007406,3528,20,119,3283,17,0,1,12,3508
11001007407,3491,117,109,3117,9,22,5,20,3374
11001007408,2867,23,17,2723,5,1,1,10,2844
11001007409,3835,31,80,3576,10,8,0,9,3804
11001007502,4687,62,103,4382,6,15,0,17,4625
11001007503,2528,121,85,2193,4,14,1,6,2407
11001007504,2730,76,82,2435,5,16,0,16,2654
11001007601,4693,247,162,4058,11,21,0,22,4446
11001007603,4185,248,121,3618,6,16,0,26,3937
11001007604,3803,209,126,3251,13,19,1,23,3594
11001007605,3663,76,80,3336,19,28,0,14,3587
11001007703,5227,68,263,4672,16,8,3,26,5159
11001007707,3927,59,159,3577,10,9,1,15,3868
11001007708,2574,27,52,2403,21,10,1,7,2547
11001007709,2072,74,70,1855,6,9,0,7,1998
11001007803,4590,125,271,3975,8,13,1,36,4465
11001007804,3499,65,117,3175,15,14,0,21,3434
11001007806,3457,104,194,3019,22,9,4,6,3353
11001007807,2114,36,120,1888,4,14,0,9,2078
11001007808,3792,64,177,3412,12,14,1,24,3728
11001007809,3155,66,181,2735,9,14,0,17,3089
11001007901,4148,1054,198,2591,26,86,0,20,3094
11001007903,1865,530,90,1107,5,54,0,12,1335
11001008001,3103,1837,207,791,6,83,0,11,1266
11001008002,3366,2175,193,686,5,107,5,22,1191
11001008100,3153,2387,200,234,0,143,1,24,766
11001008200,2695,2079,183,181,3,104,0,10,616
11001008301,3220,2249,219,372,4,188,2,17,971
11001008302,3026,2086,190,434,1,126,2,11,940
11001008402,2447,1374,176,693,0,66,1,20,1073
11001008410,1843,863,117,620,7,123,0,11,980
11001008701,2814,988,210,1308,7,143,0,12,1826
11001008702,3574,1250,340,1543,6,198,6,27,2324
11001008802,4360,1248,374,2380,7,125,1,20,3112
11001008803,4036,1233,451,1945,17,188,13,27,2803
11001008804,2417,391,253,1596,9,42,1,19,2026
11001008903,3062,419,260,2226,2,45,1,16,2643
11001008904,3137,197,292,2506,11,33,0,19,2940
11001009000,4676,256,277,3791,10,131,2,23,4420
11001009102,4608,517,375,3440,10,73,0,16,4091
11001009201,3103,1356,454,941,6,161,8,24,1747
11001009203,2775,798,226,1531,4,98,3,0,1977
11001009204,2889,269,750,1719,10,33,0,7,2620
11001009301,3853,1360,287,1755,14,135,4,26,2493
11001009302,1750,569,267,737,0,64,0,14,1181
11001009400,4424,916,358,2817,9,71,0,15,3508
11001009503,3106,770,198,1876,3,76,3,29,2336
11001009504,3208,884,307,1736,2,101,0,35,2324
11001009505,3796,380,521,2617,6,97,5,24,3416
11001009507,1525,124,271,1068,0,24,0,0,1401
11001009508,4243,511,714,2664,14,144,1,31,3732
11001009509,3194,418,330,2240,10,65,0,19,2776
11001009510,4525,253,1693,2389,8,57,3,24,4272
11001009511,2066,641,647,574,13,98,18,20,1425
11001009601,2086,56,72,1873,2,0,0,11,2030
11001009602,4481,60,145,4088,3,33,3,21,4421
11001009603,3971,87,323,3417,11,15,0,20,3884
11001009604,1996,131,143,1628,4,4,2,25,1865
11001009700,3188,23,68,2989,9,4,0,6,3165
11001009801,1848,17,30,1725,14,5,0,12,1831
11001009802,2064,11,51,1938,2,3,0,12,2053
11001009803,2968,33,84,2675,28,21,0,27,2935
11001009804,2517,37,136,2242,1,17,0,15,2480
11001009807,3523,52,103,3212,2,7,0,13,3471
11001009810,2461,23,50,2287,2,5,0,10,2438
11001009811,4438,22,70,4197,5,4,4,16,4416
11001009901,2364,157,80,1972,6,23,1,10,2207
11001009902,2774,51,69,2546,13,7,3,7,2723
11001009903,2004,49,58,1828,0,3,2,7,1955
11001009904,2886,59,257,2458,3,6,0,29,2827
11001009905,2790,46,108,2536,8,2,1,19,2744
11001009906,1773,55,114,1534,3,8,0,4,1718
11001009907,2259,33,46,2110,7,3,1,12,2226
11001010100,2699,1445,324,384,3,400,4,16,1254
11001010201,3341,1724,342,826,8,231,0,20,1617
11001010202,2631,1399,215,634,7,208,0,19,1232
11001010300,3604,645,873,1822,7,75,4,25,2959
11001010400,4616,107,130,4215,5,3,0,16,4509
11001010500,3712,1417,278,1538,15,240,2,32,2295
11001010601,2130,1092,199,481,3,204,2,16,1038
11001010602,6594,3715,533,1509,4,417,2,47,2879
11001010603,3068,1771,320,536,3,270,3,19,1297
11001010700,2296,1384,273,140,1,385,1,12,912
11001010800,6879,4080,714,630,16,1076,14,31,2799
11001010900,3333,69,106,3024,8,11,0,12,3264
11001011001,2423,1005,182,932,3,139,0,10,1418
11001011002,1859,1198,122,357,0,97,0,9,661
11001011100,5903,646,472,4393,24,81,3,16,5257
11001980000,176,46,5,114,0,2,0,0,130
12001000201,4348,2545,775,589,19,229,0,14,1803
12001000202,4782,3127,717,484,8,232,1,25,1655
12001000301,3384,1808,472,777,7,105,5,23,1576
12001000302,2644,1334,264,759,5,99,0,21,1310
12001000400,5330,1588,471,2880,14,88,1,43,3742
12001000500,5441,3383,579,840,14,270,0,48,2058
12001000600,4544,260,199,3911,2,16,2,27,4284
12001000700,6126,1120,217,4510,16,24,0,30,5006
12001000806,3049,1624,549,425,3,264,2,27,1425
12001000808,4423,1897,654,1099,14,479,0,33,2526
12001000809,1163,616,160,136,4,164,0,22,547
12001000901,3173,2122,416,136,0,405,1,14,1051
12001000902,6362,4578,887,316,0,464,0,0,1784
12001001000,7614,5659,1022,160,0,363,0,50,1955
12001001100,6596,5022,583,462,8,236,2,32,1574
12001001201,2888,1885,323,300,6,226,3,15,1003
12001001202,7443,4514,967,1044,10,442,0,46,2929
12001001203,3881,2170,538,695,10,185,0,40,1711
12001001400,3882,1526,479,1752,4,14,0,9,2356
12001001514,1928,1028,347,208,2,255,0,10,900
12001001515,7427,3251,1384,1224,14,1104,4,47,4176
12001001516,2714,1168,499,441,3,455,0,22,1546
12001001517,5730,2304,958,1300,11,917,1,29,3426
12001001519,2623,838,439,323,3,891,0,15,1785
12001001522,9216,3877,1860,1826,29,1089,11,60,5339
12001001605,10468,5863,2085,1321,11,653,7,80,4605
12001001701,6859,4256,822,1079,13,338,3,55,2603
12001001702,5104,3809,525,308,4,195,3,24,1295
12001001802,2960,1535,258,938,14,20,2,19,1425
12001001803,6285,3561,647,1432,8,251,0,40,2724
12001001811,6294,4212,628,485,5,583,6,26,2082
12001001813,3883,2615,337,255,8,432,0,33,1268
12001001815,1896,1524,161,113,6,20,1,4,372
12001001816,6396,4334,580,1001,11,128,0,46,2062
12001001817,4613,3294,462,491,6,149,0,19,1319
12001001818,5548,4284,455,523,18,21,1,20,1264
12001001819,4633,3134,571,522,23,88,4,25,1499
12001001902,3378,1116,295,1741,3,80,0,15,2262
12001001907,2529,1959,146,230,14,25,0,24,570
12001001908,4718,3020,330,1026,20,53,0,29,1698
12001002001,1528,1240,86,113,4,2,0,13,288
12001002002,3787,2459,181,901,13,31,0,29,1328
12001002101,1905,1420,95,264,10,19,0,5,485
12001002102,939,752,34,88,2,7,0,5,187
12001002201,5676,3810,513,802,24,214,2,20,1866
12001002202,6602,4769,635,658,19,187,2,35,1833
12001002204,12048,7895,1336,857,14,1339,8,87,4153
12001002207,3857,2451,371,265,13,488,0,21,1406
12001002208,2961,2083,326,101,3,288,7,6,878
12001002209,9006,5730,840,970,32,907,7,47,3276
12001002210,5234,3363,649,828,10,53,1,40,1871
12001002217,6539,1941,1030,3115,16,136,7,28,4598
12001002218,2501,742,383,1211,1,34,2,8,1759
12001002219,6717,2739,1240,1713,14,552,1,58,3978
12001002220,2815,1463,436,580,8,147,3,27,1352
12001002221,5281,3491,607,326,5,570,0,28,1790
12001002222,6789,4807,660,184,4,761,0,38,1982
12001110800,2008,1548,131,133,0,104,1,12,460
12003040101,7579,5956,467,721,30,81,3,29,1623
12003040102,7630,5996,244,1070,29,34,3,30,1634
12003040201,7491,5301,149,1774,37,11,8,14,2190
12003040202,5559,4932,113,260,13,31,0,11,627
12005000201,5432,4754,265,74,27,39,7,7,678
12005000203,2765,2404,137,31,12,18,11,2,361
12005000204,3666,3203,108,67,22,31,5,39,463
12005000301,2614,2207,146,15,38,19,0,7,407
12005000302,6858,5584,358,391,49,47,1,17,1274
12005000401,2259,1981,113,23,10,9,0,2,278
12005000402,6115,5349,219,123,15,59,9,25,766
12005000500,7602,5495,553,817,36,192,8,46,2107
12005000600,919,830,35,9,1,6,0,0,89
12005000700,141,66,42,14,0,9,2,0,75
12005000803,4682,2839,493,834,21,142,12,27,1843
12005000804,2117,1407,166,283,12,81,0,16,710
12005000805,4111,2494,357,783,11,154,19,37,1617
12005000806,3260,2177,282,371,8,177,4,16,1083
12005000900,3948,2745,316,491,11,119,0,29,1203
12005001000,1945,1023,222,511,7,62,0,1,922
12005001100,4078,2109,412,1114,17,159,5,12,1969
12005001200,3081,1608,412,806,14,51,6,15,1473
12005001301,5120,3839,303,423,25,190,12,27,1281
12005001302,6156,4230,629,588,25,244,10,16,1926
12005001402,6886,5405,364,564,23,166,6,17,1481
12005001403,1739,1494,62,73,5,17,0,6,245
12005001404,7131,5192,591,675,33,208,10,20,1939
12005001501,5396,4158,372,366,14,186,3,14,1238
12005001502,4792,3610,404,304,24,179,0,18,1182
12005001600,2660,643,308,1567,25,23,1,2,2017
12005001700,2790,831,202,1520,8,42,0,21,1959
12005001800,1413,831,129,323,4,49,0,6,582
12005001900,3796,3289,137,110,20,25,1,21,507
12005002000,1246,833,115,189,6,32,5,13,413
12005002200,4451,2118,952,1036,21,60,4,32,2333
12005002300,3802,2722,436,337,19,60,5,15,1080
12005002400,3952,2409,541,641,15,93,1,24,1543
12005002500,2912,2380,202,84,14,82,0,11,532
12005002604,7441,5843,509,349,43,201,9,37,1598
12005002605,1337,1153,89,18,4,10,2,2,184
12005002606,1827,1566,84,50,12,7,0,8,261
12005002607,1284,1105,72,29,3,5,2,3,179
12005002608,3426,3047,128,31,9,59,5,0,379
12005002609,4911,3656,497,302,22,104,10,20,1255
12005002703,3643,2848,345,119,12,126,2,16,795
12005002706,2728,2131,275,70,16,45,4,14,597
12005002707,2602,2255,181,24,9,26,0,6,347
12005002708,869,701,94,13,10,5,1,8,168
12005002709,2722,2262,183,81,17,57,0,5,460
12005002710,5174,3687,505,413,11,219,11,17,1487
12005002711,3486,2915,225,64,14,78,0,9,571
12005002712,2621,1849,185,378,14,73,1,9,772
12005002713,1310,1071,91,51,7,23,0,5,239
12005990000,0,0,0,0,0,0,0,0,0
12007000100,5697,3674,213,1528,16,38,5,23,2023
12007000201,5171,3219,380,1417,20,10,1,8,1952
12007000202,4010,2817,174,785,8,31,1,13,1193
12007000301,4505,3880,170,258,6,16,2,17,625
12007000302,3314,2963,107,90,1,21,0,11,351
12007000400,5606,3767,306,1349,7,19,3,25,1839
12009060103,2489,2216,97,26,11,22,0,13,273
12009060104,1160,1024,39,13,15,7,2,6,136
12009060105,2808,1907,101,641,11,9,0,7,901
12009060106,1614,1437,60,8,13,7,0,10,177
12009060201,2764,2382,151,83,10,28,1,5,382
12009060202,3115,2372,251,214,17,78,0,13,743
12009060301,2063,1468,168,264,6,18,0,15,595
12009060302,2748,2284,139,154,21,30,2,11,464
12009060400,4276,3101,320,568,11,31,13,14,1175
12009060500,5023,3830,409,445,21,46,2,18,1193
12009060600,5476,3409,542,1133,19,81,2,39,2067
12009060700,3618,1234,332,1790,9,19,1,16,2384
12009061001,5531,3852,588,621,18,140,0,33,1679
12009061002,3390,2500,400,211,10,46,3,10,890
12009061100,6248,4901,544,373,12,104,7,28,1347
12009061201,8439,6174,900,642,24,264,13,32,2265
12009061202,3958,3100,365,189,9,84,1,34,858
12009062106,3396,2750,281,148,5,39,5,18,646
12009062108,6657,5116,633,308,14,93,15,49,1541
12009062109,4774,3511,355,612,21,46,10,3,1263
12009062110,3556,2781,276,205,13,75,0,27,775
12009062111,3583,2836,289,153,14,57,3,17,747
12009062112,1334,1148,74,38,1,5,0,5,186
12009062113,5973,4779,446,315,21,68,6,33,1194
12009062114,2064,1646,157,93,11,15,6,7,418
12009062115,1818,1516,132,45,9,30,3,22,302
12009062301,3973,1265,778,1621,2,46,4,10,2708
12009062302,3456,1635,591,1009,15,24,0,15,1821
12009062401,1885,1405,191,136,1,37,0,4,480
12009062402,5470,2636,1233,1243,11,31,0,27,2834
12009062500,4633,2549,317,1521,14,34,5,13,2084
12009062600,3190,582,853,1574,10,12,3,20,2608
12009062800,3785,3119,258,114,15,60,0,4,666
12009062900,5791,3097,656,1591,11,97,12,16,2694
12009063000,4436,3025,500,481,6,147,8,17,1411
12009063102,9022,6430,1046,714,25,304,5,40,2592
12009063104,3876,2797,400,353,9,94,6,20,1079
12009063105,9005,6324,856,1051,13,185,4,73,2681
12009063106,4176,2985,523,184,7,199,0,23,1191
12009063108,5848,4672,522,161,14,203,2,28,1176
12009063109,4831,3619,522,175,7,178,6,32,1212
12009064102,5524,4240,549,229,10,205,0,13,1284
12009064123,6743,4741,907,477,13,212,7,34,2002
12009064124,4606,3466,516,205,3,119,3,32,1140
12009064126,3994,3169,350,159,8,132,4,25,825
12009064127,7916,6115,744,243,8,372,4,45,1801
12009064128,11426,8860,1091,367,21,479,1,66,2566
12009064129,2151,1669,228,56,3,68,3,18,482
12009064130,3747,2479,620,169,6,185,0,36,1268
12009064201,2453,1976,201,101,6,32,3,16,477
12009064202,3023,2335,337,156,5,30,1,8,688
12009064301,5672,3783,972,368,18,159,2,54,1889
12009064302,6085,3941,823,665,12,211,6,24,2144
12009064400,5137,4096,505,128,26,105,2,25,1041
12009064500,4541,3252,605,193,26,144,5,30,1289
12009064601,7504,5827,683,231,19,331,8,26,1677
12009064602,2946,2058,446,227,7,90,1,12,888
12009064701,2589,1868,351,137,11,56,5,29,721
12009064702,1708,1284,177,111,6,61,0,9,424
12009064800,3144,2127,391,407,11,46,1,26,1017
12009064901,7204,4898,924,558,19,427,2,45,2306
12009064902,3831,1705,402,1486,8,67,0,19,2126
12009065001,3427,2602,354,109,17,141,0,16,825
12009065022,5267,3952,543,207,12,318,5,23,1315
12009065023,4314,2862,571,303,12,317,0,37,1452
12009065024,6450,4484,763,288,16,483,3,40,1966
12009065025,2427,1656,252,138,6,230,1,20,771
12009065123,3782,2660,306,527,17,47,0,24,1122
12009065124,2960,944,317,1466,4,95,0,7,2016
12009065126,3327,2052,526,323,13,216,1,20,1275
12009065127,3447,2179,439,406,5,197,2,39,1268
12009065128,3533,1668,776,771,13,63,4,25,1865
12009065129,4313,2664,715,550,2,94,2,39,1649
12009065130,3272,1805,642,571,5,60,0,29,1467
12009065131,3804,2098,845,540,9,106,0,43,1706
12009065201,6245,4361,829,633,20,93,0,15,1884
12009065202,5491,3399,838,779,13,122,6,33,2092
12009065231,6484,5055,527,417,13,91,6,33,1429
12009065236,1696,1427,118,66,4,23,0,10,269
12009065237,3145,2932,77,27,4,7,0,12,213
12009065238,407,371,12,0,1,5,0,1,36
12009065239,3507,3241,106,20,10,13,1,10,266
12009065240,2564,2401,62,14,7,7,1,3,163
12009066101,4223,3759,246,13,0,36,1,13,464
12009066103,2169,2019,72,4,4,21,1,4,150
12009066104,5133,4668,201,27,6,63,0,12,465
12009066200,2883,2529,168,15,7,48,0,10,354
12009066301,7032,5814,573,60,11,203,0,50,1218
12009066302,4324,3717,261,28,4,89,5,24,607
12009066400,5485,4662,370,61,14,107,1,19,823
12009066500,3738,3190,249,25,14,87,5,8,548
12009066600,4411,3704,319,52,6,69,3,33,707
12009066700,5369,4468,394,52,9,131,5,36,901
12009066800,1670,1214,172,95,7,46,8,5,456
12009066900,6274,5307,411,42,14,148,7,21,967
12009067100,1308,806,218,143,5,37,5,9,502
12009068101,3069,2601,212,43,5,67,1,12,468
12009068102,2289,2011,119,7,2,48,1,11,278
12009068400,2020,1773,88,19,9,25,0,15,247
12009068501,2183,1908,134,24,9,33,2,5,275
12009068502,2495,2115,154,57,11,32,1,20,380
12009068601,2107,1776,146,56,10,29,1,10,331
12009068603,1516,1180,143,58,8,30,0,11,336
12009068604,2188,1934,105,25,5,41,2,4,254
12009069100,4536,3763,323,70,15,126,3,26,773
12009069200,2494,1993,267,55,19,41,0,13,501
12009069300,3043,2511,236,26,21,108,8,15,532
12009069400,6304,5254,392,83,13,216,13,16,1050
12009069700,2571,1712,315,307,5,78,1,7,859
12009069801,3621,2949,294,40,7,123,3,15,672
12009069802,4322,3287,401,176,9,108,41,22,1035
12009069903,2811,2380,188,21,15,43,4,17,431
12009069904,5755,4798,405,69,16,201,2,40,957
12009069905,3,0,1,0,0,0,0,0,3
12009069906,1721,679,220,701,3,28,0,7,1042
12009069907,2964,2415,195,99,0,88,3,2,549
12009071100,4394,4043,113,24,10,15,5,15,351
12009071201,8339,6278,881,320,12,425,9,44,2061
12009071202,1959,1649,126,54,6,23,0,6,310
12009071203,3309,2549,310,172,8,39,9,33,760
12009071204,272,241,8,0,2,4,0,2,31
12009071205,5954,4327,644,280,15,346,2,47,1627
12009071335,5416,3685,758,492,8,142,2,58,1731
12009071337,7703,4264,1495,1242,21,171,7,39,3439
12009071339,7932,4550,1335,1481,27,130,9,49,3382
12009071341,6798,3548,1592,1093,10,96,7,48,3250
12009071342,4462,2339,869,782,10,114,5,55,2123
12009071343,3954,2059,743,841,6,77,4,30,1895
12009071344,5231,3083,954,710,16,130,4,40,2148
12009071345,7744,4226,1309,1564,30,106,6,57,3518
12009071346,7486,4289,1234,1394,21,134,14,48,3197
12009071347,6386,3026,1472,1347,10,93,4,67,3360
12009071348,8691,4567,1457,1785,27,157,2,105,4124
12009071349,3856,1819,762,1018,4,53,1,26,2037
12009071350,5689,3093,1052,1011,10,123,7,26,2596
12009071351,3791,1986,770,670,7,116,0,25,1805
12009071352,3751,2506,583,416,3,58,0,24,1245
12009071353,4970,3367,642,260,5,396,5,22,1603
12009071354,6729,4741,805,383,11,389,0,57,1988
12009071401,1553,1220,119,94,0,45,0,12,333
12009071402,1884,1334,245,160,1,38,0,4,550
12009071500,2555,2024,186,165,11,32,7,9,531
12009071601,2500,1994,203,51,17,77,0,6,506
12009071602,2455,2011,202,49,12,70,0,4,444
12009071700,5717,5080,306,35,11,84,6,21,637
12009980000,43,26,5,4,0,2,0,0,17
12009980100,0,0,0,0,0,0,0,0,0
12009990000,0,0,0,0,0,0,0,0,0
12011010102,3142,2482,356,70,5,51,0,30,660
12011010103,3657,2986,365,59,2,62,2,30,671
12011010104,2283,1910,216,19,0,26,3,34,373
12011010201,3173,1404,771,332,4,62,3,155,1769
12011010202,3585,2054,644,292,3,65,2,162,1531
12011010304,3875,268,400,3033,9,12,1,56,3607
12011010305,5664,1767,1567,1553,4,89,2,198,3897
12011010306,2677,571,375,1458,6,27,3,59,2106
12011010307,4889,817,866,2687,8,81,0,158,4072
12011010308,5176,3325,895,451,2,127,3,60,1851
12011010401,5401,2821,1125,526,6,254,1,156,2580
12011010402,3916,2242,687,370,5,145,2,118,1674
12011010403,4726,3951,471,90,1,44,0,41,775
12011010405,9212,2613,2542,1944,20,220,1,526,6599
12011010406,4553,1792,1197,573,12,116,5,208,2761
12011010407,6285,3519,1246,509,6,133,4,232,2766
12011010502,3765,1807,759,395,9,232,0,119,1958
12011010503,22780,13593,4348,1269,20,2083,5,241,9187
12011010504,6247,3453,1201,451,8,594,8,90,2794
12011010601,8625,5352,1612,601,8,558,1,77,3273
12011010603,5378,2672,1307,647,1,423,1,68,2706
12011010604,4194,2018,1047,638,2,244,0,58,2176
12011010605,6410,3269,1372,878,5,475,3,89,3141
12011010606,6984,2905,1803,1176,8,338,7,181,4079
12011010609,4959,1975,1378,736,3,260,0,113,2984
12011010610,6879,2962,1982,629,8,171,7,295,3917
12011010611,4250,1896,903,679,4,529,2,42,2354
12011010612,6354,2865,1501,887,11,739,8,88,3489
12011010613,2773,953,766,622,1,143,0,71,1820
12011010614,3052,1115,805,605,0,132,0,77,1937
12011010615,4398,1891,1096,646,3,240,7,106,2507
12011010701,6107,1357,1521,2087,15,71,0,352,4750
12011010702,9572,1225,2430,5151,15,48,0,271,8347
12011010800,7624,2629,2585,1416,24,157,0,216,4995
12011010901,2424,1882,316,42,4,66,3,13,542
12011010902,3051,2454,342,48,0,77,1,15,597
12011011000,1987,1755,149,16,2,21,1,7,232
12011020101,8618,3104,2408,2059,6,255,0,196,5514
12011020103,6052,1836,1836,1746,17,194,2,99,4216
12011020104,2636,971,533,759,1,121,0,42,1665
12011020204,6380,2062,1729,1781,1,375,0,94,4318
12011020205,7808,2642,1762,2385,9,488,3,152,5166
12011020206,4791,1479,1363,1412,3,211,0,77,3312
12011020209,2680,752,914,743,8,127,0,40,1928
12011020210,6334,2294,1671,1749,11,248,5,93,4040
12011020211,2419,1012,626,606,4,67,0,19,1407
12011020212,3502,1239,1153,768,2,119,6,52,2263
12011020213,3251,1417,1013,571,3,103,0,36,1834
12011020214,2891,857,714,1051,3,122,4,36,2034
12011020302,8699,2455,2821,2576,11,339,2,155,6244
12011020308,5577,951,1685,2486,7,121,0,101,4626
12011020309,5754,2231,1505,1327,6,285,0,84,3523
12011020311,3678,1534,905,807,3,197,0,68,2144
12011020312,5591,1834,1940,1124,3,330,0,97,3757
12011020313,7530,2099,2387,2370,9,289,0,105,5431
12011020314,5536,1724,1988,1140,3,376,3,65,3812
12011020315,5033,2149,1430,1054,7,155,2,44,2884
12011020316,4269,1420,1317,1138,10,148,0,68,2849
12011020317,3426,1288,1080,780,3,117,2,44,2138
12011020318,10023,3828,2767,1960,17,885,0,105,6195
12011020319,6473,2987,1937,997,12,214,4,68,3486
12011020320,5524,2051,1920,1021,3,245,4,81,3473
12011020321,1961,1090,444,214,4,81,4,17,871
12011020322,3317,1476,904,567,1,161,3,39,1841
12011020323,4276,1072,1794,934,15,226,0,59,3204
12011020324,7291,2146,2629,1788,3,306,0,113,5145
12011020325,3489,1121,1002,1032,0,120,0,49,2368
12011020326,6333,1331,1856,2619,4,214,3,87,5002
12011020404,7846,619,1179,5312,26,336,0,91,7227
12011020405,5356,464,2706,1834,11,172,0,62,4892
12011020406,8122,2133,3098,2248,4,235,3,100,5989
12011020407,7615,809,1684,4583,11,211,4,78,6806
12011020412,4014,161,1030,2622,7,61,0,35,3853
12011020414,5161,1941,1560,1308,7,139,5,32,3220
12011020415,3967,1542,1308,830,5,112,3,38,2425
12011020416,3646,1187,1380,847,2,92,3,27,2459
12011020417,4593,3085,812,523,4,70,0,23,1508
12011020418,3541,1230,999,1005,1,135,0,50,2311
12011020419,3430,1096,1046,1045,1,98,5,28,2334
12011020420,3428,259,469,2429,7,97,2,45,3169
12011020421,4570,535,804,2766,1,217,2,68,4035
12011020501,5095,798,1492,2304,16,221,0,73,4297
12011020502,7933,1252,1596,4501,11,198,1,97,6681
12011030100,3977,3308,417,48,1,38,0,17,669
12011030201,4249,1425,1302,1064,3,52,0,111,2824
12011030202,1581,645,253,574,1,19,0,11,936
12011030203,4450,1738,1428,747,13,68,0,111,2712
12011030301,3667,446,1466,1306,1,31,0,140,3221
12011030302,7769,1394,1667,4328,3,63,6,81,6375
12011030401,3269,55,266,2855,0,6,0,14,3214
12011030402,4241,92,488,3546,1,4,0,11,4149
12011030500,6680,522,2191,3444,4,54,1,176,6158
12011030601,3787,137,1441,2034,3,31,1,64,3650
12011030602,3887,633,701,2379,3,41,1,21,3254
12011030702,3163,1485,746,695,4,39,2,41,1678
12011030703,4851,2228,1408,555,3,165,1,112,2623
12011030704,5190,2765,1098,752,6,147,0,85,2425
12011030705,3641,2792,486,194,1,55,2,32,849
12011030803,4900,1156,2032,1576,9,17,0,23,3744
12011030804,3342,363,1433,1462,2,4,0,20,2979
12011030805,2557,1470,549,170,2,200,0,19,1087
12011030806,4486,2525,1067,379,3,249,0,65,1961
12011030902,3937,2914,589,176,2,66,0,37,1023
12011030903,4306,2365,784,790,6,65,0,52,1941
12011030904,4675,3656,635,96,5,90,3,23,1019
12011031001,2804,1665,520,421,7,30,2,20,1139
12011031002,4291,2799,756,433,7,56,2,40,1492
12011031101,2599,2082,277,51,0,38,4,27,517
12011031102,3769,2808,594,181,6,26,0,34,961
12011031203,1459,1262,120,20,1,19,0,6,197
12011031204,2920,2437,257,52,3,74,1,15,483
12011031205,1536,1262,164,8,0,25,1,14,274
12011031206,2715,2240,283,32,1,48,4,15,475
12011031207,3865,3217,403,69,0,58,2,20,648
12011040101,1256,1019,138,16,0,16,0,16,237
12011040102,2735,2199,349,45,1,41,3,13,536
12011040203,1728,1318,253,27,1,40,1,21,410
12011040204,3418,2423,573,139,5,108,3,27,995
12011040205,4979,3331,971,324,13,92,0,38,1648
12011040206,3303,2245,651,133,17,96,0,22,1058
12011040300,4003,2670,800,254,4,79,12,19,1333
12011040401,2244,1772,284,31,0,65,0,18,472
12011040402,3022,2313,472,51,0,71,3,13,709
12011040502,3760,2985,440,63,0,114,0,32,775
12011040503,1887,1578,200,27,0,33,0,8,309
12011040505,1440,1162,175,32,0,39,0,5,278
12011040506,2201,1777,248,23,5,69,0,13,424
12011040601,4111,3216,503,91,1,115,0,21,895
12011040602,3070,2342,451,74,2,55,0,21,728
12011040701,2761,1951,486,126,15,77,1,12,810
12011040702,4061,2479,875,372,6,119,4,25,1582
12011040801,4640,1214,654,2520,8,61,0,24,3426
12011040802,4544,2065,967,1206,10,79,2,35,2479
12011040901,4607,222,274,3995,9,9,2,17,4385
12011040902,3569,165,297,2960,3,26,0,17,3404
12011041000,2878,20,104,2692,4,1,1,1,2858
12011041100,5407,121,340,4781,20,10,0,36,5286
12011041200,4723,107,229,4236,9,33,0,31,4616
12011041300,7280,200,521,6310,18,22,0,24,7080
12011041400,3378,100,253,2928,11,2,1,20,3278
12011041500,3981,70,207,3636,7,4,0,0,3911
12011041601,3249,405,310,2396,6,29,0,13,2844
12011041602,3158,101,218,2747,5,2,2,11,3057
12011041700,4142,680,616,2653,5,28,0,24,3462
12011041801,1923,1390,324,77,6,66,0,11,533
12011041802,3818,2628,718,179,4,94,2,27,1190
12011041900,4357,3218,707,154,9,109,0,30,1139
12011042000,3366,2801,320,55,0,70,2,14,565
12011042100,3009,2377,343,93,1,66,3,28,632
12011042200,3240,2644,363,43,3,76,0,14,596
12011042301,4574,3420,693,167,6,98,1,35,1154
12011042302,1972,948,566,268,10,82,2,19,1024
12011042400,1332,1074,161,18,1,14,2,9,258
12011042501,5026,3045,1009,533,15,161,4,40,1981
12011042502,6227,3522,1773,449,5,230,0,92,2705
12011042601,3505,2396,569,274,7,79,4,24,1109
12011042602,2250,1123,452,542,1,34,1,30,1127
12011042700,5497,2263,1222,1666,4,70,2,59,3234
12011042801,4793,417,1443,2784,4,29,2,22,4376
12011042802,2238,142,631,1389,5,14,0,13,2096
12011042900,7272,515,962,5431,9,59,0,48,6757
12011043001,1433,1040,273,28,1,26,0,11,393
12011043002,6965,1947,3496,1123,12,157,0,33,5018
12011043100,4975,2243,2069,330,6,115,2,17,2732
12011043301,5040,3306,1088,241,5,143,0,27,1734
12011043302,1971,825,724,283,5,37,1,22,1146
12011050100,4432,1371,2511,290,7,86,0,35,3061
12011050204,6006,2554,1483,1413,9,121,0,75,3452
12011050205,3134,1780,921,178,3,127,1,14,1354
12011050206,4261,1817,1119,1045,7,92,0,36,2444
12011050207,7098,1656,1452,3433,3,175,7,64,5442
12011050208,3846,839,1647,1130,5,75,0,41,3007
12011050301,8437,285,454,7255,15,167,0,52,8152
12011050306,4617,146,274,4027,7,21,0,32,4471
12011050308,3421,42,94,3194,0,26,0,3,3379
12011050309,2787,83,1193,1389,1,55,0,20,2704
12011050311,3635,545,335,2576,1,52,0,23,3090
12011050312,2429,300,275,1756,3,14,1,22,2129
12011050313,4211,157,292,3617,6,29,0,22,4054
12011050314,3234,282,181,2647,4,24,0,18,2952
12011050315,3868,217,184,3261,6,70,0,29,3651
12011050316,2365,784,562,866,0,59,1,17,1581
12011050401,4039,1208,784,1724,2,72,3,40,2831
12011050402,4569,2250,999,983,3,103,5,34,2319
12011050501,3785,1795,1437,305,5,92,0,26,1990
12011050502,4892,1929,1958,573,11,150,10,45,2963
12011050601,3437,2432,593,144,7,91,2,35,1005
12011050602,3864,2008,1036,521,4,108,0,19,1856
12011050701,3542,1161,1119,1065,7,59,3,11,2381
12011050702,6332,1422,2753,1827,8,79,5,34,4910
12011050800,5657,316,761,4345,14,27,0,26,5341
12011050900,5417,3158,999,833,28,153,2,30,2259
12011051001,3258,2372,509,192,5,66,0,25,886
12011051002,2784,2176,328,105,9,71,2,13,608
12011060105,7617,1627,1927,3501,20,217,0,71,5990
12011060107,4324,757,1229,1928,4,200,3,31,3567
12011060109,3885,1028,869,1584,4,189,0,43,2857
12011060111,6912,2148,2412,1747,3,288,0,61,4764
12011060113,7008,1702,2196,2274,1,435,1,79,5306
12011060114,6766,1385,1399,3254,7,312,1,70,5381
12011060115,7329,1745,2819,2010,7,380,4,78,5584
12011060116,8148,1935,2910,2541,8,377,5,121,6213
12011060117,6916,1151,2725,2519,8,214,2,66,5765
12011060118,4743,1948,1792,610,7,143,6,57,2795
12011060119,7255,2502,2782,1275,10,340,5,64,4753
12011060120,8296,2588,3260,1343,7,683,1,94,5708
12011060121,5826,2854,1480,722,5,398,0,67,2972
12011060122,5644,1883,2615,638,11,291,0,63,3761
12011060123,3418,653,592,1878,2,132,3,24,2765
12011060124,6418,956,940,4071,20,139,6,55,5462
12011060125,2332,329,427,1379,8,37,0,45,2003
12011060126,5542,1268,496,3297,6,194,0,88,4274
12011060127,3379,428,740,1978,5,59,0,39,2951
12011060128,6298,1060,1472,3336,10,130,1,65,5238
12011060129,2300,754,700,685,5,37,0,23,1546
12011060130,5204,1133,2124,1540,11,199,2,62,4071
12011060203,6093,354,654,4782,6,68,7,38,5739
12011060206,5198,1131,2153,1497,9,177,3,57,4067
12011060207,4038,928,1373,1421,1,145,0,35,3110
12011060208,6090,427,849,4401,11,124,14,69,5663
12011060209,2864,298,530,1822,1,72,10,41,2566
12011060210,3081,1285,1000,537,3,87,0,35,1796
12011060211,4616,1849,1699,728,4,165,8,41,2767
12011060212,3373,854,1171,1014,8,162,0,19,2519
12011060214,2793,897,1194,502,0,82,1,27,1896
12011060215,2665,852,1245,404,6,68,0,26,1813
12011060302,7425,235,375,6541,11,37,1,50,7190
12011060303,8194,295,529,7058,16,46,2,32,7899
12011060304,3181,65,199,2774,5,30,0,23,3116
12011060305,2749,211,319,2023,0,59,0,43,2538
12011060306,2252,515,504,1065,1,44,1,25,1737
12011060401,5245,410,326,4307,8,30,0,20,4835
12011060402,6517,124,294,5829,2,47,1,51,6393
12011060404,2311,101,129,1953,0,20,2,26,2210
12011060405,3363,142,192,2809,14,114,0,9,3221
12011060501,6730,1878,1908,2295,11,298,1,52,4852
12011060503,5012,2118,1567,759,2,338,0,54,2894
12011060504,4483,2592,1084,434,6,131,2,47,1891
12011060505,4549,2185,1115,892,9,140,0,55,2364
12011060603,4934,2059,1583,698,12,368,1,43,2875
12011060605,4008,1184,1316,1026,3,216,0,63,2824
12011060606,5920,1856,2145,1357,0,303,5,59,4064
12011060607,2894,1464,711,425,18,95,2,26,1430
12011060608,6678,2919,2088,1053,7,274,1,90,3759
12011060609,3441,1261,1102,705,4,171,0,35,2180
12011060700,3105,1454,611,726,4,100,1,25,1651
12011060801,1939,875,596,262,0,104,2,17,1064
12011060802,6735,591,1001,4572,22,150,7,93,6144
12011060900,4405,2316,1038,574,11,165,3,62,2089
12011061001,6340,3774,1518,555,4,194,1,54,2566
12011061003,3500,2127,766,235,3,174,0,32,1373
12011061004,5664,2553,1750,817,4,250,0,66,3111
12011061100,7931,1258,5406,833,8,210,2,63,6673
12011070102,1631,799,557,103,1,89,0,14,832
12011070103,5578,2058,2163,796,15,254,9,53,3520
12011070104,5649,1447,3131,647,10,206,5,27,4202
12011070204,5588,2051,2028,679,10,424,15,81,3537
12011070205,5768,2738,2049,300,11,374,3,56,3030
12011070208,7830,4247,2281,457,4,517,3,55,3583
12011070209,4989,3259,1164,151,6,241,0,13,1730
12011070210,3540,1697,1288,262,7,128,2,29,1843
12011070211,6105,3144,1906,428,12,339,8,43,2961
12011070212,3598,1886,1230,170,3,161,0,26,1712
12011070213,2881,1498,989,152,0,125,1,24,1383
12011070304,7685,3282,3227,471,10,318,4,70,4403
12011070306,8037,3869,2696,529,16,586,4,33,4168
12011070310,3749,1179,2133,150,3,130,1,35,2570
12011070311,5940,2084,3199,200,2,191,0,35,3856
12011070312,7363,2823,3658,253,9,311,3,56,4540
12011070314,4934,1855,2230,322,3,315,0,52,3079
12011070315,5160,2210,2142,251,13,330,1,29,2950
12011070316,5308,2522,1944,299,2,317,0,45,2786
12011070318,6781,2922,2905,156,12,390,4,19,3859
12011070319,4632,1617,2297,130,0,328,0,38,3015
12011070320,6817,2242,3563,226,3,442,0,34,4575
12011070321,3242,756,2161,109,1,121,0,8,2486
12011070323,3344,1597,1350,128,7,147,1,23,1747
12011070324,6840,1875,4186,216,7,336,0,37,4965
12011070325,4273,1372,1938,184,4,588,0,37,2901
12011070326,6538,1968,3179,260,1,694,0,65,4570
12011070327,5552,1056,3959,169,8,186,0,38,4496
12011070328,1976,304,1440,56,0,104,2,15,1672
12011070329,3680,981,2058,131,1,251,0,26,2699
12011070330,3789,867,2034,195,7,473,0,18,2922
12011070331,7617,1810,4544,277,18,586,0,45,5807
12011070401,6190,2977,2228,324,13,420,2,55,3213
12011070402,3451,1940,955,102,4,302,4,30,1511
12011070403,5285,2508,1951,263,8,307,1,45,2777
12011070404,3395,2040,940,75,9,197,1,12,1355
12011070405,5205,2602,1639,274,4,395,1,45,2603
12011070501,5776,3382,1360,305,11,446,1,36,2394
12011070503,7891,2415,3371,932,11,750,1,95,5476
12011070504,4249,478,2578,941,8,113,1,48,3771
12011070601,5167,1793,2220,465,8,482,4,32,3374
12011070602,7831,2960,2804,862,28,713,6,100,4871
12011080102,4299,1937,1288,805,10,72,9,23,2362
12011080103,1537,768,523,151,5,27,2,15,769
12011080104,2313,1371,634,132,0,61,0,35,942
12011080105,2651,1541,753,180,8,45,2,20,1110
12011080200,983,636,248,44,2,27,0,4,347
12011080402,2538,1693,590,110,7,32,0,16,845
12011080403,7895,3243,3038,1015,29,294,3,75,4652
12011080405,3080,1358,1167,335,3,82,4,35,1722
12011080406,5716,3078,1732,422,13,160,6,89,2638
12011080500,7415,544,1196,5430,15,43,11,51,6871
12011090102,1773,1273,351,46,5,35,0,18,500
12011090103,2279,1544,587,59,1,33,2,10,735
12011090104,4402,3041,974,150,1,84,0,32,1361
12011090200,3921,2636,932,94,3,62,0,18,1285
12011090301,2347,794,900,516,10,32,0,26,1553
12011090303,3062,1116,1071,747,1,29,3,28,1946
12011090304,4370,2230,1422,451,9,95,0,36,2140
12011090401,5049,1868,2042,851,4,89,0,46,3181
12011090403,3471,798,1559,894,9,61,2,40,2673
12011090404,5224,1503,2315,1083,5,71,3,52,3721
12011090502,7056,4671,1682,363,2,86,0,60,2385
12011090503,2794,2182,432,26,0,53,0,23,612
12011090504,3324,1241,1526,346,8,90,0,40,2083
12011090601,3123,701,1783,364,1,172,0,14,2422
12011090602,7951,2207,3851,978,345,321,0,42,5744
12011090700,8217,2232,3658,1410,27,541,5,104,5985
12011090801,4256,1657,1817,416,0,161,2,58,2599
12011090802,4245,1994,1634,359,3,91,1,30,2251
12011090900,4948,2547,1751,275,10,139,1,46,2401
12011091000,4101,1933,1493,441,7,99,0,24,2168
12011091100,7021,1113,3869,1548,18,253,6,70,5908
12011091201,5226,935,3100,753,20,261,4,41,4291
12011091202,4972,973,2875,749,10,190,0,65,3999
12011091300,4185,943,2278,620,5,173,0,58,3242
12011091400,6073,565,2827,2367,12,121,6,41,5508
12011091500,5411,439,2044,2649,6,90,0,37,4972
12011091601,4054,1548,1508,742,1,105,0,35,2506
12011091602,3411,1084,1378,729,5,107,2,14,2327
12011091701,3777,951,1673,889,10,108,5,25,2826
12011091702,4737,1424,2073,919,8,148,1,35,3313
12011091802,3031,625,1074,1161,1,45,0,29,2406
12011091803,4184,631,1525,1789,5,49,0,38,3553
12011091804,2438,706,888,682,14,52,4,15,1732
12011091901,3712,1920,1251,276,4,83,0,37,1792
12011091903,3629,1328,1443,588,4,117,2,33,2301
12011091904,1888,508,871,360,4,50,0,41,1380
12011092000,3598,2343,1005,54,3,50,0,18,1255
12011100103,3581,2020,1267,100,0,59,0,25,1561
12011100104,3822,2429,1113,85,5,41,0,53,1393
12011100105,3170,2069,848,80,0,47,1,43,1101
12011100106,2750,1681,807,78,0,76,1,18,1069
12011100107,2618,1781,645,42,1,54,0,7,837
12011100108,2619,1443,943,79,1,49,0,14,1176
12011100201,2051,535,1105,285,4,46,2,15,1516
12011100203,2601,1535,814,133,0,24,5,19,1066
12011100204,2973,1232,1364,207,4,56,0,11,1741
12011100301,3951,707,2010,956,4,127,0,44,3244
12011100302,2336,592,1327,309,6,37,0,18,1744
12011100400,5897,302,1835,3517,4,84,3,37,5595
12011100501,1027,180,594,198,2,25,0,10,847
12011100502,3807,765,2150,740,4,54,0,32,3042
12011100600,5428,760,2551,1825,23,71,1,70,4668
12011100700,5958,224,815,4735,11,40,1,37,5734
12011100801,3579,218,826,2358,4,42,2,34,3361
12011100803,3494,326,1426,1565,4,52,3,33,3168
12011100804,4524,179,855,3280,6,67,0,38,4345
12011110100,6597,1328,2986,1747,12,265,1,89,5269
12011110301,7258,1626,4319,777,4,268,0,81,5632
12011110303,4295,1343,2098,425,0,278,4,42,2952
12011110307,5353,2024,2576,481,2,96,0,30,3329
12011110308,6743,1909,3019,1256,16,328,2,46,4834
12011110309,6335,1549,3407,877,0,235,2,49,4786
12011110311,6810,1618,3630,1081,14,222,0,44,5192
12011110312,7508,1487,4096,1338,7,352,9,65,6021
12011110313,5819,1015,3134,1200,6,274,3,43,4804
12011110319,6212,375,1589,3742,7,240,1,59,5837
12011110321,5375,639,3029,1164,10,325,0,65,4736
12011110323,7478,309,2382,4331,13,149,2,100,7169
12011110326,4681,876,2351,892,0,344,1,36,3805
12011110327,6500,1727,2929,892,21,684,0,41,4773
12011110328,5807,1216,2705,1013,9,626,0,48,4591
12011110330,3477,624,1722,599,4,341,1,23,2853
12011110332,6006,1479,3025,911,6,296,6,66,4527
12011110333,6721,1147,3357,1160,14,686,2,72,5574
12011110334,3580,872,2138,391,1,90,0,28,2708
12011110337,9975,950,4199,4024,12,395,0,107,9025
12011110338,4330,677,2136,1118,3,197,3,61,3653
12011110339,4497,1081,2416,727,0,106,6,38,3416
12011110341,4341,650,1549,1820,3,154,6,55,3691
12011110344,3323,407,1625,836,7,288,0,46,2916
12011110345,5285,441,2619,1436,4,571,3,53,4844
12011110346,4224,359,2150,1399,0,126,0,66,3865
12011110347,5180,1223,2728,683,13,297,0,57,3957
12011110348,5574,548,2628,1912,8,235,2,63,5026
12011110349,4373,277,1478,2138,9,263,0,54,4096
12011110350,2948,322,962,1319,1,193,0,44,2626
12011110351,3671,969,1449,987,5,135,0,28,2702
12011110352,3237,405,1906,587,2,196,0,29,2832
12011110353,6235,691,3045,1881,5,381,2,72,5544
12011110354,4874,966,3215,525,4,75,0,26,3908
12011110355,4297,1174,2513,417,0,67,1,39,3123
12011110356,4653,993,2491,659,4,260,0,35,3660
12011110357,6371,1464,3035,976,14,603,4,67,4907
12011110358,6222,845,3196,1538,2,413,3,51,5377
12011110359,6116,976,3417,775,13,624,2,49,5140
12011110360,5884,445,2310,2008,4,834,0,55,5439
12011110361,9775,1505,4655,2029,5,1118,4,102,8270
12011110362,6698,619,3971,1338,6,555,0,44,6079
12011110363,4828,558,2181,1258,0,581,1,76,4270
12011110364,6858,496,3785,1950,0,379,4,51,6362
12011110365,7115,559,3947,1661,5,704,0,87,6556
12011110366,4541,188,1016,3044,3,113,0,32,4353
12011110367,6667,226,2019,4088,3,114,0,65,6441
12011110368,3421,858,1740,528,2,143,1,35,2563
12011110402,4687,188,1024,3244,9,83,0,40,4499
12011110403,5273,381,1968,2625,3,99,0,50,4892
12011110404,6041,377,2027,3316,7,107,3,67,5664
12011110501,3347,197,1189,1753,2,69,1,34,3150
12011110502,5249,229,1137,3645,9,36,0,36,5020
12011110600,5380,2473,1956,510,3,154,6,58,2907
12011980000,3,0,1,0,0,0,0,0,3
12011990000,0,0,0,0,0,0,0,0,0
12013010100,2497,2221,71,110,13,1,0,0,276
12013010200,3787,3413,99,12,33,4,0,4,374
12013010301,3257,2531,143,270,18,15,0,1,726
12013010302,4107,2325,309,1276,29,26,0,5,1782
12015010100,5555,4067,458,768,12,49,0,24,1488
12015010200,4962,4427,247,69,18,39,0,14,535
12015010301,3974,3592,164,46,11,40,0,16,382
12015010302,4690,3337,643,438,13,40,0,32,1353
12015010401,3264,3022,98,14,9,29,1,16,242
12015010402,2422,2264,73,23,3,21,0,8,158
12015010405,7100,6572,218,43,10,84,3,16,528
12015010503,4185,3572,308,133,13,61,0,13,613
12015010504,1829,1667,71,20,7,22,0,0,162
12015010505,4985,4488,186,62,8,62,0,20,497
12015010506,2743,2433,153,37,7,38,0,7,310
12015020101,7803,5899,687,770,10,108,4,21,1904
12015020103,6347,4880,503,530,15,152,2,44,1467
12015020104,2761,2466,110,74,7,33,0,9,295
12015020203,4250,2987,434,513,23,56,0,36,1263
12015020204,4110,2754,549,501,3,86,0,36,1356
12015020205,4242,3167,442,319,9,74,2,27,1075
12015020206,3500,2530,439,315,13,54,3,20,970
12015020301,6031,4655,633,411,7,111,3,25,1376
12015020302,4288,3019,523,453,7,64,0,25,1269
12015020303,4863,3695,517,354,12,87,0,16,1168
12015020401,3934,3409,195,150,9,47,1,16,525
12015020402,6031,4842,513,275,16,95,5,30,1189
12015020501,5160,4322,308,218,8,74,6,16,838
12015020502,1474,1189,119,15,3,81,0,4,285
12015020601,2967,2305,289,152,4,69,2,15,662
12015020602,3452,2695,396,136,2,53,5,10,757
12015020700,4707,3313,712,321,19,112,2,24,1394
12015020800,4836,3124,936,406,10,68,10,32,1712
12015020900,6297,4413,694,645,7,134,3,49,1884
12015021001,1733,1473,139,34,4,19,0,1,260
12015021002,3128,2723,155,69,3,83,0,17,405
12015021003,3177,2522,275,218,12,40,3,9,655
12015030101,3279,2883,193,32,8,29,0,11,396
12015030102,4015,3486,231,85,4,40,0,14,529
12015030201,5520,4894,278,45,15,61,0,14,626
12015030202,2962,2713,120,6,8,29,0,8,249
12015030301,2877,2702,74,2,6,22,0,9,175
12015030302,3658,3432,120,9,2,17,3,4,226
12015030401,2354,2181,86,3,2,7,2,13,173
12015030402,1999,1918,36,4,3,2,0,4,81
12015030501,6198,5510,295,73,12,73,1,10,688
12015030504,1271,1191,32,5,0,5,0,0,80
12015030505,4846,4435,183,36,1,41,0,19,411
12015030506,3811,3504,140,15,5,33,0,4,307
12015030507,3257,3028,104,23,5,22,2,24,229
12015990000,0,0,0,0,0,0,0,0,0
12017450103,4364,3768,270,121,10,58,1,16,596
12017450104,2841,2356,195,101,7,67,2,15,485
12017450105,2112,1930,81,9,7,11,0,4,182
12017450106,2612,2189,144,140,7,15,0,10,423
12017450201,3974,3095,457,160,11,70,1,22,879
12017450202,5987,4604,665,272,17,109,2,20,1383
12017450305,3107,2603,146,120,4,24,3,3,504
12017450306,3372,2963,146,62,11,49,1,5,409
12017450307,5747,4722,341,219,11,203,0,27,1025
12017450308,5557,4737,270,160,28,125,5,23,820
12017450309,6227,4950,654,222,15,92,0,38,1277
12017450310,3991,3137,490,174,12,28,0,4,854
12017450401,3108,2739,155,64,8,19,2,12,369
12017450402,3954,3503,195,49,16,29,0,17,451
12017450501,1934,1729,73,13,8,40,0,16,205
12017450502,2346,2113,82,40,5,24,1,18,233
12017450601,5214,4648,247,64,21,34,1,10,566
12017450602,5006,4252,225,232,21,62,0,14,754
12017450703,5330,4481,237,125,7,375,0,18,849
12017450704,3208,2800,176,45,6,48,3,2,408
12017450705,5546,4628,323,171,26,183,2,11,918
12017450706,2885,2306,264,136,12,51,0,11,579
12017450800,4506,3920,221,110,17,36,0,16,586
12017450901,2981,2667,128,31,10,15,0,13,314
12017450902,2648,2285,135,69,9,33,2,19,363
12017451001,2466,2029,179,92,14,53,1,4,437
12017451002,3689,3233,183,54,8,33,1,15,456
12017451101,2397,2017,180,43,2,44,0,7,380
12017451103,3142,2612,255,58,11,80,0,16,530
12017451104,3201,2833,159,48,10,17,2,13,368
12017451200,3957,3610,141,40,13,20,5,3,347
12017451300,3379,2987,203,24,7,14,1,4,392
12017451400,4960,4081,350,261,4,63,0,13,879
12017451501,3539,3077,181,91,7,29,5,9,462
12017451502,6501,5724,300,44,39,58,1,19,777
12017451603,2077,1828,96,39,8,37,0,10,249
12017451604,4102,3558,227,90,8,72,1,8,544
12017451605,2296,2007,140,11,13,11,0,3,289
12017451606,5133,4569,232,76,7,63,0,18,564
12017451701,1990,1887,36,0,1,9,0,4,103
12017451702,2457,2300,59,11,8,9,0,7,157
12017990000,0,0,0,0,0,0,0,0,0
12019030103,5611,4755,330,92,40,38,3,7,856
12019030104,3788,3386,130,34,19,15,2,8,402
12019030105,3236,2857,117,50,17,15,3,13,379
12019030106,5420,4494,308,220,17,48,10,30,926
12019030204,8910,6005,968,1068,41,189,15,48,2905
12019030205,16990,6714,2671,5254,37,1066,26,124,10276
12019030206,6983,3138,1190,1790,6,391,11,25,3845
12019030207,7710,3406,1265,1952,22,545,22,41,4304
12019030208,3405,1461,495,985,9,217,4,16,1944
12019030209,4648,2854,735,649,16,107,6,16,1794
12019030210,3966,3029,384,239,21,66,9,16,937
12019030303,2894,1552,380,658,12,115,7,12,1342
12019030304,4900,2524,821,1016,12,189,18,37,2376
12019030305,5166,2696,870,1092,10,121,7,46,2470
12019030306,2615,1652,195,363,15,236,9,23,963
12019030400,2491,1423,460,383,8,56,1,8,1068
12019030500,2921,1818,398,480,14,82,2,14,1103
12019030600,4945,3361,482,637,9,151,14,34,1584
12019030701,7965,6293,636,326,16,275,5,23,1672
12019030704,5455,4457,366,189,10,174,5,25,998
12019030705,6072,4740,521,255,11,248,8,8,1332
12019030706,3297,2170,362,369,17,168,17,37,1127
12019030707,7454,5466,734,470,26,361,7,44,1988
12019030708,4223,2864,505,445,7,114,29,23,1359
12019030801,5212,4032,481,265,11,115,9,20,1180
12019030802,6527,4741,695,476,19,194,7,22,1786
12019030903,4034,2936,406,330,11,110,7,19,1098
12019030904,7435,4691,913,1005,31,321,5,53,2744
12019030905,5845,3840,784,626,19,241,4,28,2005
12019030906,4856,2947,686,775,10,116,21,26,1909
12019031101,3293,2872,158,59,3,31,1,16,421
12019031104,3736,3225,179,67,6,32,1,8,511
12019031105,2117,1881,97,13,8,10,2,5,236
12019031108,1573,1372,68,17,18,15,0,6,201
12019031109,3355,2898,164,85,14,3,3,18,457
12019031110,4098,3597,195,79,22,26,1,6,501
12019031201,3237,2779,106,177,6,18,0,8,458
12019031202,8505,6081,895,775,38,143,16,45,2424
12019031203,5235,4303,357,220,13,39,11,37,932
12019031301,1563,1357,74,46,2,5,1,3,206
12019031302,3897,3000,304,279,6,95,11,19,897
12019031303,3073,2257,341,282,3,40,8,16,816
12019031400,5955,3914,680,996,20,64,14,19,2041
12019031500,3228,2777,208,33,7,21,1,12,451
12019980000,406,371,20,0,1,0,0,0,35
12021000101,1523,1453,36,0,0,16,0,7,70
12021000102,1497,1346,92,13,3,5,0,15,151
12021000200,1898,1613,176,31,3,27,0,12,285
12021000301,2885,2685,85,2,0,43,0,5,200
12021000302,1391,1255,91,11,4,4,0,8,136
12021000401,2698,2591,30,1,3,25,0,8,107
12021000402,1465,1433,22,1,0,3,0,0,32
12021000500,1695,1594,30,1,0,35,0,3,101
12021000600,1226,1128,46,7,3,13,0,8,98
12021000700,1312,525,311,423,0,13,0,6,787
12021010102,6605,5467,625,129,2,170,2,26,1138
12021010107,4090,3355,451,59,0,79,0,25,735
12021010108,2623,2189,318,15,0,40,0,10,434
12021010109,1764,1372,254,34,0,22,0,9,392
12021010110,3645,2553,803,53,10,82,4,35,1092
12021010111,2326,2144,92,15,0,20,0,7,182
12021010112,1833,1355,241,100,1,78,3,8,478
12021010113,2468,2405,28,6,0,19,0,0,63
12021010114,1974,1826,82,7,5,15,0,6,148
12021010205,2482,2222,166,9,0,38,0,6,260
12021010208,3254,3133,51,4,1,17,0,6,121
12021010209,2275,2151,42,0,1,31,0,1,124
12021010210,3462,2974,368,22,0,38,4,9,488
12021010211,1847,1460,271,34,0,39,0,7,387
12021010213,4184,3749,251,35,3,59,1,9,435
12021010215,3271,3148,48,3,2,42,0,1,123
12021010216,3529,2445,772,114,4,73,1,33,1084
12021010217,2729,2351,240,5,0,48,0,22,378
12021010300,4121,2681,1102,124,2,67,0,10,1440
12021010401,3814,2842,623,123,14,105,3,16,972
12021010408,3201,2162,758,106,7,46,1,10,1039
12021010411,7098,1868,4184,881,6,46,2,18,5230
12021010416,6589,5539,680,79,3,100,0,32,1050
12021010419,3511,552,2479,410,0,16,0,21,2959
12021010420,6691,985,4448,1100,7,37,0,30,5706
12021010421,4864,677,3522,542,4,25,0,31,4187
12021010422,3157,431,1916,717,0,12,0,4,2726
12021010423,7885,5505,1574,275,9,275,6,43,2380
12021010424,6269,3402,2295,296,12,74,0,31,2867
12021010425,2495,1453,832,91,5,20,0,19,1042
12021010426,6090,3416,2194,187,15,68,0,37,2674
12021010427,1411,860,444,45,2,14,0,3,551
12021010428,6898,3050,3135,395,11,58,3,46,3848
12021010429,2214,1962,117,21,0,51,0,10,252
12021010430,3932,2589,934,100,12,156,0,26,1343
12021010431,2202,1930,147,27,1,43,0,16,272
12021010432,3755,3051,420,73,3,108,0,21,704
12021010433,2471,1905,370,42,2,62,0,6,566
12021010434,6384,4069,1787,272,6,106,0,25,2315
12021010435,5331,4586,444,44,9,117,1,17,745
12021010436,8596,5236,2161,544,7,291,2,63,3360
12021010437,2488,2088,231,25,5,70,3,8,400
12021010438,4261,2991,837,114,6,162,0,17,1270
12021010508,4508,3079,994,315,3,32,0,5,1429
12021010511,4483,2353,1471,457,7,96,1,12,2130
12021010512,3095,1394,1308,224,5,73,2,9,1701
12021010513,2844,1194,1519,23,1,38,3,8,1650
12021010514,2918,2253,424,88,1,51,0,12,665
12021010515,1527,1351,111,22,0,15,2,0,176
12021010516,1684,1563,85,16,0,8,0,1,121
12021010517,1333,1033,188,46,0,31,0,3,300
12021010518,4565,3936,333,156,4,32,0,19,629
12021010519,2677,1269,1116,154,0,72,0,6,1408
12021010520,2151,1373,568,140,0,27,0,5,778
12021010601,2651,1338,1061,141,12,25,0,16,1313
12021010602,3064,1879,878,210,2,23,0,16,1185
12021010604,3119,2071,663,293,8,25,1,11,1048
12021010605,3066,1853,660,419,6,36,1,5,1213
12021010606,2285,1885,248,60,4,28,0,11,400
12021010701,4529,2369,1635,314,14,59,3,24,2160
12021010702,4238,2418,1333,314,11,38,1,15,1820
12021010801,3772,3104,382,178,5,30,1,7,668
12021010804,5132,309,3645,1086,5,9,0,15,4823
12021010805,1906,1383,331,140,2,10,2,6,523
12021010806,1874,1160,454,213,1,16,0,5,714
12021010807,5667,4167,679,606,5,79,0,15,1500
12021010808,4390,3093,893,239,10,72,0,7,1297
12021010902,3470,2832,487,13,7,45,0,13,638
12021010904,1693,1542,86,4,0,16,0,0,151
12021010905,2848,2622,134,8,7,26,0,4,226
12021010906,1748,1532,135,17,1,21,1,2,216
12021010907,2887,2524,239,4,2,31,0,11,363
12021011003,3441,3248,91,7,3,40,0,2,193
12021011103,2360,1108,714,516,1,3,2,1,1252
12021011107,898,750,100,0,28,1,0,3,148
12021011108,7622,5460,1410,463,13,71,0,31,2162
12021011109,1964,1720,170,19,5,23,0,6,244
12021011110,1747,1140,451,91,4,19,0,2,607
12021011111,2147,1318,554,216,3,15,0,2,829
12021011112,1539,1394,92,13,2,19,0,5,145
12021011113,1022,875,97,22,3,3,0,3,147
12021011114,3216,2248,697,162,8,42,0,6,968
12021011204,4301,48,2933,1282,2,0,0,18,4253
12021011205,2809,44,1566,1068,47,2,0,12,2765
12021011206,6900,2167,3903,527,16,70,1,31,4733
12021011207,2321,2071,157,14,5,29,0,5,250
12021011208,6515,3591,1913,619,21,157,0,48,2924
12021011209,7278,5577,948,251,7,212,0,53,1701
12021011210,3649,3182,312,57,3,35,0,18,467
12021011211,5396,2261,2483,367,18,84,0,24,3135
12021011212,5896,3610,1494,418,7,142,0,36,2286
12021011213,4727,4291,202,41,4,63,0,16,436
12021011214,4487,2018,2020,218,15,64,1,14,2469
12021011303,3800,74,2829,846,6,9,0,1,3726
12021011304,2734,154,2387,145,2,5,1,13,2580
12021011305,2924,75,2256,537,0,7,1,6,2849
12021011306,3680,183,2872,575,3,5,1,14,3497
12021011400,4576,217,3882,413,9,12,0,17,4359
12021990000,0,0,0,0,0,0,0,0,0
12023110201,4320,3125,379,535,10,113,1,34,1195
12023110202,5681,3319,223,1847,15,49,1,36,2362
12023110300,7026,3822,467,2512,16,9,2,15,3204
12023110400,2839,1367,195,1081,11,29,0,20,1472
12023110500,8302,5018,802,1793,33,252,9,54,3284
12023110602,4471,3559,324,305,29,29,0,12,912
12023110603,2246,1778,173,134,1,47,0,10,468
12023110604,7224,5554,429,787,16,163,6,10,1670
12023110700,4648,3160,433,776,3,42,4,25,1488
12023110800,6013,4755,328,646,22,29,0,25,1258
12023110901,5699,4594,481,294,37,44,3,25,1105
12023110903,4469,3718,272,200,19,20,0,23,751
12023110904,6760,5327,557,531,24,41,1,6,1433
12027010101,4316,3159,958,74,12,16,6,2,1157
12027010102,4340,2040,1036,1181,18,15,1,12,2300
12027010200,5306,2330,1910,872,3,44,0,10,2976
12027010301,5836,1854,3382,379,13,59,0,19,3982
12027010302,2274,407,406,1367,4,3,0,6,1867
12027010403,3355,3019,193,38,11,13,0,6,336
12027010404,3341,2027,1122,50,8,13,0,15,1314
12027010405,1775,1560,87,86,11,5,1,4,215
12027010406,3433,2228,917,156,0,21,0,6,1205
12029970101,5339,3390,319,1436,24,19,0,3,1949
12029970103,3930,3567,107,33,17,18,0,8,363
12029970104,3548,3218,117,30,10,11,0,11,330
12029970201,1793,1576,75,39,8,3,0,5,217
12029970202,2149,1999,70,13,2,7,0,6,150
12029990000,0,0,0,0,0,0,0,0,0
12031000101,2539,900,151,1332,10,16,4,3,1639
12031000102,3111,665,100,2181,10,17,1,12,2446
12031000200,2744,126,88,2404,0,7,0,19,2618
12031000300,2231,458,146,1483,3,7,2,7,1773
12031000600,4886,2390,741,1067,13,422,0,22,2496
12031000700,4480,3282,322,470,5,217,1,18,1198
12031000800,3021,2176,239,325,7,138,5,5,845
12031001000,4886,1701,195,2866,4,30,5,15,3185
12031001100,1977,1025,154,660,11,30,4,14,952
12031001200,2066,986,149,808,6,22,0,8,1080
12031001300,3937,355,143,3281,4,9,2,27,3582
12031001401,3723,647,137,2724,16,17,3,18,3076
12031001402,2316,256,79,1858,2,10,0,8,2060
12031001500,4006,156,134,3527,1,11,1,52,3850
12031001600,1710,53,83,1520,1,0,3,10,1657
12031002101,2912,2260,264,165,6,46,7,20,652
12031002102,2469,2061,133,99,1,55,9,10,408
12031002200,4608,3842,333,117,6,75,0,32,766
12031002300,1882,1596,85,44,2,48,0,9,286
12031002400,1944,1772,67,24,6,5,0,7,172
12031002501,3924,1887,292,1435,17,92,3,24,2037
12031002502,3604,2712,268,357,11,54,8,18,892
12031002600,4165,514,241,3162,14,23,10,44,3651
12031002701,3705,365,128,3041,16,28,0,21,3340
12031002702,3888,766,195,2698,3,18,2,41,3122
12031002801,5059,135,106,4645,13,0,0,28,4924
12031002802,5014,209,167,4390,11,22,1,46,4805
12031002901,3729,135,109,3340,5,2,1,11,3594
12031002902,3781,225,147,3254,7,3,0,29,3556
12031010101,9862,5329,812,2789,41,343,9,68,4533
12031010104,5599,3209,540,1279,15,218,2,45,2390
12031010105,2981,1856,300,511,9,105,8,22,1125
12031010106,7193,3572,771,2081,16,288,6,47,3621
12031010107,4682,3903,192,239,18,69,1,38,779
12031010202,3419,2408,267,465,2,71,3,16,1011
12031010203,6799,3578,655,1829,28,275,15,84,3221
12031010204,3846,2317,447,677,10,135,6,28,1529
12031010301,8099,3916,749,2827,30,163,12,52,4183
12031010305,6377,856,324,4862,13,88,5,31,5521
12031010306,1536,382,92,980,2,12,0,15,1154
12031010307,2562,215,154,2107,3,29,1,5,2347
12031010308,4896,337,222,4162,7,42,2,11,4559
12031010401,3300,1019,237,1881,3,32,4,13,2281
12031010402,4646,1451,420,2440,16,51,0,74,3195
12031010501,5237,1313,346,3325,12,72,0,19,3924
12031010502,4654,2147,201,2001,21,45,2,24,2507
12031010503,7257,1083,366,5514,9,53,4,32,6174
12031010601,4545,2575,182,1563,12,21,0,29,1970
12031010602,2766,1755,86,710,16,30,4,49,1011
12031010700,5203,409,137,4478,8,21,0,29,4794
12031010800,5166,368,125,4536,1,2,0,20,4798
12031010900,4213,436,95,3530,14,19,0,20,3777
12031011000,4393,898,163,3153,13,11,0,34,3495
12031011100,3417,518,121,2635,6,26,3,8,2899
12031011200,2976,124,59,2731,4,4,0,11,2852
12031011300,2909,66,60,2679,6,8,0,14,2843
12031011400,2363,71,49,2192,0,0,2,7,2292
12031011500,4103,120,111,3719,3,8,0,15,3983
12031011600,3961,126,96,3619,15,1,2,11,3835
12031011700,3372,1530,180,1414,8,47,1,17,1842
12031011800,2907,1064,195,1429,11,40,1,8,1843
12031011901,8030,5901,587,1018,12,65,10,51,2129
12031011903,5302,3340,401,1098,17,209,2,30,1962
12031011904,4748,2250,348,1720,2,198,1,53,2498
12031011905,6504,3036,925,1891,18,328,2,53,3468
12031012000,5078,2608,437,1599,16,134,3,11,2470
12031012100,1571,811,138,470,7,65,3,4,760
12031012201,3616,1368,365,1578,9,120,0,25,2248
12031012202,4405,1493,391,2122,13,130,2,27,2912
12031012300,3614,2314,295,677,16,74,3,32,1300
12031012400,2780,2034,250,266,6,44,1,19,746
12031012500,4358,1812,536,1588,25,158,0,23,2546
12031012601,3180,1139,310,1509,12,47,3,29,2041
12031012602,6218,1957,553,3216,15,167,8,56,4261
12031012702,6540,2536,802,2595,9,284,2,50,4004
12031012703,5771,2507,614,1990,15,305,5,40,3264
12031012704,6028,1147,871,3423,14,276,9,37,4881
12031012800,7554,2270,1001,3460,13,391,9,47,5284
12031012900,2702,1327,272,726,12,197,0,15,1375
12031013000,2634,2419,113,2,4,18,0,12,215
12031013100,2261,1759,137,219,1,43,1,17,502
12031013200,1755,976,316,273,9,74,8,3,779
12031013301,3276,1593,359,853,13,240,4,17,1683
12031013302,4917,1687,922,1884,10,117,4,42,3230
12031013402,5423,2493,823,1682,8,135,0,21,2930
12031013403,3443,1368,293,1510,8,78,1,14,2075
12031013404,3394,1455,349,1261,10,138,6,10,1939
12031013502,3395,1313,375,1373,15,143,5,25,2082
12031013504,6214,1947,917,2694,10,367,5,33,4267
12031013522,3613,1133,544,1508,10,221,3,18,2480
12031013523,3928,1310,600,1567,7,207,10,33,2618
12031013524,4679,1997,654,1526,7,184,3,38,2682
12031013525,6917,1727,1041,3408,9,346,14,41,5190
12031013526,7392,2174,1385,2855,31,520,22,72,5218
12031013723,10795,4148,1745,3700,47,553,4,84,6647
12031013728,4862,2028,692,1537,8,292,3,42,2834
12031013729,4856,2539,615,1240,12,147,2,28,2317
12031013730,3956,1723,574,1082,7,358,5,35,2233
12031013731,4167,2247,573,863,13,238,6,17,1920
12031013732,5464,1723,804,2435,17,179,3,39,3741
12031013733,6643,2662,617,2680,21,310,6,68,3981
12031013800,4965,2556,872,963,30,208,25,22,2409
12031013901,3937,2426,587,417,7,193,10,17,1511
12031013902,5049,3228,466,835,22,161,4,26,1821
12031013904,5240,3211,584,777,23,157,39,41,2029
12031013905,4354,3928,172,19,7,54,5,23,426
12031013906,4453,3846,230,138,6,67,1,12,607
12031014001,4639,4040,252,46,15,55,2,19,599
12031014002,2578,2262,130,27,4,30,5,10,316
12031014101,4706,4172,214,37,9,36,0,12,534
12031014103,2530,2158,183,27,4,31,1,31,372
12031014104,1901,1586,124,50,6,50,0,4,315
12031014203,4983,4372,248,78,8,86,1,14,611
12031014204,5397,4556,291,176,9,134,0,30,841
12031014205,2741,2061,170,276,4,84,2,21,680
12031014206,1572,1356,87,22,6,46,0,4,216
12031014311,5371,2828,1081,852,30,256,11,38,2543
12031014312,6806,3288,1129,1144,11,797,5,51,3518
12031014328,7376,4232,852,1028,18,735,10,44,3144
12031014329,3125,2083,321,278,9,238,5,4,1042
12031014330,4766,3874,280,201,8,187,0,26,892
12031014331,6081,3468,1827,241,19,199,6,60,2613
12031014333,3440,2068,367,627,5,129,5,29,1372
12031014334,4565,2680,455,911,3,270,6,21,1885
12031014335,8391,5366,860,853,9,719,35,49,3025
12031014336,7009,3848,775,890,12,963,25,39,3161
12031014338,4623,1920,981,715,4,706,20,24,2703
12031014339,4581,2667,527,419,9,711,11,21,1914
12031014340,6495,4103,731,763,16,467,12,54,2392
12031014341,3939,3177,288,141,4,100,1,33,762
12031014342,5268,3565,676,469,9,258,15,19,1703
12031014343,6015,2884,834,838,12,1040,11,36,3131
12031014344,4677,2105,664,679,7,914,12,45,2572
12031014408,4806,3530,386,428,11,147,5,34,1276
12031014413,5440,3122,476,607,10,960,0,41,2318
12031014414,7334,3176,2241,944,47,541,8,62,4158
12031014415,4429,2312,747,999,1,116,1,23,2117
12031014416,5841,3374,790,739,22,556,0,35,2467
12031014417,7362,4194,821,964,9,970,13,46,3168
12031014418,2064,1663,163,60,0,111,1,4,401
12031014419,5851,4318,463,292,2,477,3,29,1533
12031014420,5169,3441,522,336,10,508,7,44,1728
12031014421,5339,4026,483,268,6,258,5,22,1313
12031014422,2936,2309,211,132,4,144,1,20,627
12031014423,15930,9061,1912,1952,21,1938,13,132,6869
12031014424,7674,4933,766,796,11,759,4,39,2741
12031014425,4025,2016,554,566,14,623,0,23,2009
12031014426,4897,2670,650,630,15,598,4,92,2227
12031014427,2286,1355,498,165,2,134,0,18,931
12031014428,6552,3245,854,914,7,1147,2,53,3307
12031014500,4074,2297,705,529,10,281,2,39,1777
12031014601,6227,4791,412,458,10,216,9,24,1436
12031014603,6162,3061,862,1592,12,268,5,47,3101
12031014604,6190,2296,940,2301,7,313,9,36,3894
12031014702,2987,1532,462,751,13,68,0,25,1455
12031014703,1732,919,144,455,2,95,3,5,813
12031014704,6100,1747,703,3214,17,116,5,43,4353
12031014800,6329,2283,853,2710,17,143,8,22,4046
12031014901,5843,2515,1063,1652,13,213,2,49,3328
12031014902,8148,3195,1200,2844,26,376,4,84,4953
12031015001,6233,2587,1174,1745,23,340,3,40,3646
12031015002,3745,1614,442,1257,6,148,7,97,2131
12031015100,4241,1756,937,1253,15,79,2,32,2485
12031015200,3193,1143,587,1199,13,70,8,35,2050
12031015300,3064,1386,408,1000,15,64,2,40,1678
12031015400,2699,1015,516,953,4,65,0,7,1684
12031015501,3621,1602,799,927,9,92,6,3,2019
12031015502,5077,1319,978,2424,23,91,4,48,3758
12031015600,3797,2511,424,591,1,86,3,8,1286
12031015701,2270,693,695,702,1,68,2,15,1577
12031015702,3136,1796,465,588,5,119,0,11,1340
12031015803,3547,2002,801,482,15,66,2,17,1545
12031015804,3815,2502,589,405,14,82,2,28,1313
12031015805,6144,1704,1512,2242,5,326,11,80,4440
12031015806,2902,1390,592,497,9,221,0,19,1512
12031015922,4729,2194,820,1169,17,231,5,53,2535
12031015924,5352,3077,848,884,10,288,3,30,2275
12031015925,5280,1982,1200,1373,18,344,7,73,3298
12031015926,9719,5072,1179,1663,36,1232,36,81,4647
12031015927,3335,1797,476,567,11,294,3,22,1538
12031015928,2268,901,240,570,9,431,2,18,1367
12031015929,5756,3007,588,714,10,1152,0,28,2749
12031016001,3928,2026,732,561,6,440,8,19,1902
12031016002,3201,1369,810,581,0,321,1,15,1832
12031016101,3243,1380,732,596,5,387,2,12,1863
12031016102,4899,1860,1535,707,5,626,0,36,3039
12031016200,2697,1103,809,431,5,234,0,27,1594
12031016300,2642,890,485,880,10,254,6,10,1752
12031016400,5656,4350,447,481,11,125,3,29,1306
12031016500,5319,4267,369,238,9,218,3,15,1052
12031016603,3570,2560,382,335,2,108,0,23,1010
12031016604,4300,2780,711,418,7,151,3,47,1520
12031016605,2531,1196,421,550,2,229,5,16,1335
12031016606,5400,1600,1733,1727,6,131,5,34,3800
12031016711,4630,3816,322,136,2,131,0,44,814
12031016724,4901,2943,687,769,28,149,4,77,1958
12031016725,4289,2151,655,948,6,264,2,46,2138
12031016726,3730,2452,529,318,7,111,0,31,1278
12031016727,3815,2339,686,369,3,123,0,58,1476
12031016728,5471,3603,584,432,8,483,8,57,1868
12031016729,6476,4237,838,555,7,223,4,145,2239
12031016730,3047,1945,315,247,8,391,0,14,1102
12031016731,6239,3339,1088,1120,12,213,12,75,2900
12031016801,2229,1847,202,30,1,53,0,4,382
12031016803,7299,5959,476,317,15,197,1,39,1340
12031016804,8167,6699,526,340,17,231,3,33,1468
12031016807,4370,2979,623,297,2,139,3,53,1391
12031016808,3661,2403,545,371,4,88,4,29,1258
12031016809,5019,3168,429,462,0,701,0,27,1851
12031016810,3159,2101,313,328,4,261,0,19,1058
12031016811,5603,4197,459,311,3,252,5,37,1406
12031016812,4621,3106,497,473,10,282,1,34,1515
12031016813,8801,4906,1266,1104,10,858,9,72,3895
12031017101,3722,2621,288,425,7,136,3,22,1101
12031017102,2839,2026,253,297,9,128,9,13,813
12031017200,2662,904,169,1379,11,67,2,22,1758
12031017300,7844,5401,539,1385,32,47,4,44,2443
12031017400,2825,294,131,2254,8,1,0,19,2531
12031990000,0,0,0,0,0,0,0,0,0
12033000100,2306,1501,126,512,12,50,4,12,805
12033000300,2594,1534,99,763,10,35,0,12,1060
12033000400,3479,562,92,2677,5,15,4,9,2917
12033000500,1480,934,80,393,0,7,0,6,546
12033000600,1954,654,128,1025,7,30,2,16,1300
12033000801,2025,1638,93,173,0,25,0,11,387
12033000802,2990,2053,145,639,11,24,0,19,937
12033000900,2616,2187,114,153,7,39,0,8,429
12033001001,6063,5086,363,159,22,138,2,29,977
12033001002,2941,2450,146,162,11,48,0,9,491
12033001101,5908,4866,291,257,21,177,2,30,1042
12033001103,2789,2245,170,160,11,61,0,11,544
12033001104,6352,4515,430,719,41,240,7,30,1837
12033001201,4741,2835,363,971,19,257,8,32,1906
12033001202,4016,2269,278,979,17,183,10,23,1747
12033001300,4165,1340,216,2313,14,63,9,17,2825
12033001401,5453,3877,467,309,25,497,28,148,1576
12033001402,6743,3234,450,2308,25,272,7,46,3509
12033001500,1232,121,17,1033,2,4,0,2,1111
12033001600,2191,673,46,1434,2,0,0,5,1518
12033001700,3125,864,171,1858,16,23,2,12,2261
12033001800,1872,670,90,968,13,26,4,3,1202
12033001900,2204,806,219,990,11,68,0,16,1398
12033002000,1927,517,109,1122,30,27,0,12,1410
12033002100,4967,2142,447,1847,52,212,0,31,2825
12033002200,3660,2256,231,844,29,60,6,16,1404
12033002300,4861,3802,278,397,30,110,11,21,1059
12033002400,5532,3351,1162,556,18,168,1,60,2181
12033002500,2939,2682,101,13,13,28,0,10,257
12033002601,3278,2319,228,288,25,128,4,16,959
12033002602,1845,1647,65,15,9,13,3,7,198
12033002604,4452,3645,231,128,9,97,0,33,807
12033002605,5061,2995,434,881,29,227,18,29,2066
12033002606,3223,2607,198,113,18,80,2,7,616
12033002607,5100,3829,376,343,27,173,9,23,1271
12033002701,3284,1971,228,466,34,279,6,19,1313
12033002703,3012,1276,215,1242,17,52,5,15,1736
12033002704,6277,3922,496,1080,27,242,15,38,2355
12033002801,2820,1671,203,619,21,78,8,16,1149
12033002802,5243,3123,355,955,17,355,10,36,2120
12033002803,2593,1313,161,863,8,61,4,21,1280
12033002804,3568,1937,535,550,10,223,19,16,1631
12033002900,4199,2521,362,815,30,117,0,45,1678
12033003001,3716,1371,271,1653,17,170,8,30,2345
12033003002,3756,1643,244,1503,41,83,4,20,2113
12033003100,5104,994,277,3421,12,139,7,19,4110
12033003201,5044,2201,276,2063,36,191,4,10,2843
12033003203,4687,1957,231,2209,18,113,5,13,2730
12033003204,2843,1814,197,483,16,152,5,23,1029
12033003301,4486,2947,266,723,48,218,1,14,1539
12033003305,2593,1675,281,420,6,67,7,7,918
12033003307,2180,1152,156,592,10,104,7,6,1028
12033003308,4336,2697,256,801,31,225,8,12,1639
12033003310,4960,2743,294,1316,44,207,3,22,2217
12033003311,3491,1749,232,1084,11,134,7,24,1742
12033003312,3239,1804,200,725,26,213,6,36,1435
12033003313,4113,2615,284,658,33,178,14,25,1498
12033003400,6376,3778,546,1430,92,101,10,37,2598
12033003505,3817,2468,383,622,15,67,0,39,1349
12033003506,4707,3078,347,850,17,134,3,14,1629
12033003507,6419,4062,514,1173,26,239,3,42,2357
12033003509,5294,2635,392,1602,24,336,0,26,2659
12033003510,2878,1559,337,674,12,98,20,16,1319
12033003511,2562,1940,144,234,21,98,0,9,622
12033003512,3879,2627,287,597,17,67,4,24,1252
12033003603,10870,8087,626,885,94,438,11,33,2783
12033003607,2593,1825,219,344,10,78,3,25,768
12033003608,7770,5909,375,760,20,198,1,46,1861
12033003609,3821,2644,256,540,35,81,1,15,1177
12033003610,6762,4994,315,747,47,171,3,23,1768
12033003611,5951,4674,274,464,45,154,9,25,1277
12033003612,6070,4737,307,527,37,126,11,30,1333
12033003613,4168,3539,120,225,28,30,1,18,629
12033003614,6132,4409,219,980,52,63,7,42,1723
12033003700,5644,3667,216,1271,40,120,2,9,1977
12033003800,4961,4177,114,208,108,24,13,24,784
12033003900,4962,4043,93,369,129,27,0,12,919
12033004000,4641,2308,235,1903,25,10,12,24,2333
12033990000,0,0,0,0,0,0,0,0,0
12035060103,2710,2182,266,106,8,49,0,9,528
12035060104,4737,3628,471,293,12,125,0,36,1109
12035060105,4048,3407,292,104,7,100,3,18,641
12035060106,4280,3776,226,32,1,66,0,19,504
12035060107,4682,3495,584,310,23,74,4,26,1187
12035060206,4994,4208,329,206,19,22,0,17,786
12035060207,6978,5160,453,1020,18,71,0,29,1818
12035060208,8577,6119,940,862,23,158,3,54,2458
12035060210,4216,2849,466,556,16,100,1,27,1367
12035060211,6867,4767,852,771,6,159,7,33,2100
12035060212,5759,3763,826,729,9,135,6,57,1996
12035060213,7063,4380,1098,1035,12,152,3,55,2683
12035060214,7906,4987,1069,1107,34,257,4,73,2919
12035060215,5202,3323,754,650,5,179,8,40,1879
12035060216,4103,2704,639,428,8,97,11,23,1399
12035060217,3250,1971,455,470,14,114,4,32,1279
12035060218,5334,4109,508,367,10,99,0,12,1225
12035060219,5158,3381,757,569,22,130,0,49,1777
12035060220,3097,1925,440,404,10,113,1,38,1172
12035060301,7015,5742,501,395,9,133,1,23,1273
12035060302,3714,3342,151,30,14,30,0,10,372
12035060303,2745,2479,81,48,6,55,1,7,266
12035060304,2943,2594,141,45,5,32,2,17,349
12035990000,0,0,0,0,0,0,0,0,0
12037970101,2079,1094,221,699,0,5,0,7,985
12037970102,2198,2025,35,33,10,2,0,18,173
12037970200,3436,3098,123,34,19,5,1,8,338
12037970302,2589,1829,185,427,7,9,1,1,760
12037970304,2149,1752,111,210,5,9,0,7,397
12037990000,0,0,0,0,0,0,0,0,0
12037990100,0,0,0,0,0,0,0,0,0
12039020101,4767,3045,366,1128,18,16,0,19,1722
12039020103,2346,1232,226,803,1,9,0,5,1114
12039020104,3478,1227,99,2043,3,4,0,3,2251
12039020300,4787,679,603,3405,8,13,0,1,4108
12039020400,4715,2073,305,2150,12,22,4,18,2642
12039020500,5535,1527,922,2934,9,18,0,15,4008
12039020600,5070,1112,237,3555,8,29,0,39,3958
12039020701,3246,308,612,2280,2,5,0,7,2938
12039020702,5518,684,731,4006,3,15,0,6,4834
12039020800,4364,2206,992,1022,7,16,0,7,2158
12041950100,5684,4918,445,66,15,14,2,5,766
12041950201,2314,2042,135,7,13,3,0,7,272
12041950202,3164,2497,193,342,7,11,0,10,667
12041950203,3265,2832,196,46,15,15,0,13,433
12041950204,3437,2538,379,327,12,13,0,10,899
12043000100,2125,1880,131,34,17,8,0,6,245
12043000201,2878,1574,1193,21,8,2,0,17,1304
12043000202,3728,2170,1005,443,6,12,0,17,1558
12043000300,3395,1508,721,936,162,12,0,5,1887
12043990000,0,0,0,0,0,0,0,0,0
12045960101,3546,3063,64,229,22,10,0,1,483
12045960102,2842,2044,181,511,12,5,0,11,798
12045960200,3161,2176,79,737,17,14,0,8,985
12045960301,1572,1280,76,141,9,5,0,6,292
12045960302,3071,2659,155,74,6,23,0,8,412
12045990000,0,0,0,0,0,0,0,0,0
12047960101,2689,871,311,1483,6,0,0,3,1818
12047960102,3108,1577,158,1240,12,12,0,11,1531
12047960103,1575,1067,63,368,5,13,0,4,508
12047960201,1630,1303,128,136,4,2,0,4,327
12047960202,3237,1779,756,579,7,14,0,4,1458
12047960300,1765,1036,39,616,9,2,0,0,729
12049970101,3809,1973,1639,54,20,28,0,5,1836
12049970102,3517,2075,1277,42,6,42,0,3,1442
12049970201,3271,1138,1829,237,5,5,0,5,2133
12049970202,981,754,181,2,7,15,0,0,227
12049970301,4677,1843,2556,153,7,30,0,8,2834
12049970302,3070,1239,909,879,5,9,1,7,1831
12049970401,3613,1560,1551,393,0,29,2,4,2053
12049970402,2389,1291,662,351,5,7,0,3,1098
12051000101,3994,1104,2037,660,11,129,0,8,2890
12051000102,3369,1174,1705,321,9,81,1,16,2195
12051000200,7002,1284,3124,2452,18,31,0,0,5718
12051000300,9185,2510,6175,251,25,48,0,25,6675
12051000401,4042,1788,2139,27,2,3,2,23,2254
12051000403,4336,1344,2623,271,11,22,0,6,2992
12051000404,3866,1985,1602,160,7,23,1,19,1881
12051000601,474,150,236,12,57,1,0,3,324
12051000602,3351,750,2471,41,15,1,0,20,2601
12051990000,0,0,0,0,0,0,0,0,0
12053040101,6014,4466,846,306,21,57,0,25,1548
12053040102,2129,1663,274,55,5,21,0,3,466
12053040201,2590,2197,160,92,12,13,0,6,393
12053040202,6525,4904,596,644,36,48,14,28,1621
12053040301,1810,1495,139,80,6,14,0,5,315
12053040302,4410,3758,342,103,28,21,0,30,652
12053040303,2888,2420,223,30,7,38,0,23,468
12053040400,3245,2357,169,595,16,7,0,4,888
12053040501,4407,2698,588,845,21,40,0,11,1709
12053040502,3075,2364,307,235,9,26,0,5,711
12053040601,2441,2014,147,112,4,12,1,1,427
12053040602,3030,2571,243,50,11,25,1,13,459
12053040701,7830,6100,1019,227,17,51,5,22,1730
12053040702,5463,4302,683,138,11,69,5,18,1161
12053040801,3873,3422,288,46,8,24,0,9,451
12053040802,4658,3978,391,110,10,32,1,3,680
12053040901,6155,4185,1324,284,24,126,1,17,1970
12053040906,8090,5532,1604,335,15,238,9,50,2558
12053040907,2976,2000,613,133,8,50,0,20,976
12053040908,8133,5476,1402,568,28,271,2,37,2657
12053040909,5430,4029,725,278,20,169,0,37,1401
12053040910,4252,3146,636,216,17,54,1,9,1106
12053040911,6158,4095,1238,439,5,145,0,25,2063
12053040912,3039,2383,419,85,6,26,0,22,656
12053040913,3517,2959,321,99,2,45,0,12,558
12053041003,3170,2147,628,175,7,45,3,6,1023
12053041004,7007,4438,1670,406,12,96,3,38,2569
12053041005,2557,1587,588,174,15,53,0,21,970
12053041006,6933,4460,1644,364,23,87,2,43,2473
12053041103,4340,3134,803,127,4,33,2,27,1206
12053041104,2786,2080,390,100,4,48,0,18,706
12053041105,4719,3159,1011,277,15,35,0,22,1560
12053041106,4438,2889,1035,186,13,67,4,41,1549
12053041201,4192,2932,783,179,9,57,2,38,1260
12053041203,4378,3107,827,178,11,28,3,26,1271
12053041204,3675,2752,607,113,21,23,5,7,923
12053041302,3329,2223,696,204,7,20,0,19,1106
12053041303,2474,2344,73,13,0,13,0,3,130
12053041304,1751,1619,91,13,2,2,6,0,132
12053041305,1424,1338,62,5,1,0,0,0,86
12053041401,6183,4356,1158,286,13,77,0,36,1827
12053041402,6191,4434,1137,218,9,71,9,37,1757
12053041501,3244,2700,269,82,13,32,4,4,544
12053041502,3915,2864,527,226,12,94,1,30,1051
12053041601,3453,3029,231,65,6,50,2,7,424
12053041602,2218,1954,118,11,9,13,0,10,264
12053990000,0,0,0,0,0,0,0,0,0
12055960101,2710,2340,214,29,8,28,1,16,370
12055960102,1399,609,126,619,0,1,0,2,790
12055960104,2851,1909,557,240,7,54,2,10,942
12055960105,1650,703,356,488,10,36,0,0,947
12055960200,4402,2575,1146,516,14,29,3,11,1827
12055960300,4334,1284,1578,1306,13,21,0,5,3050
12055960401,4044,1802,1343,533,8,230,1,10,2242
12055960402,3098,1760,866,255,14,104,1,15,1338
12055960501,1296,1009,234,25,0,3,0,7,287
12055960503,4298,2543,844,393,10,341,0,23,1755
12055960504,3159,2389,483,99,8,75,0,5,770
12055960601,2945,1724,813,203,8,97,3,14,1221
12055960602,6107,4841,774,210,19,71,5,14,1266
12055960700,4037,2764,818,219,6,59,5,13,1273
12055960800,2617,1519,606,360,9,34,3,12,1098
12055960900,2779,1191,497,990,7,8,2,7,1588
12055961000,4558,3564,713,140,7,23,1,7,994
12055961100,3937,2036,1223,468,14,43,5,16,1901
12055961201,2406,1208,765,307,7,7,0,14,1198
12055961202,2477,1908,342,98,22,25,0,7,569
12055961301,6787,4996,977,274,11,111,6,16,1791
12055961303,1368,1185,108,40,0,10,0,1,183
12055961304,2909,2438,218,94,15,25,6,6,471
12055961401,3278,2693,355,103,8,7,0,10,585
12055961402,2478,2109,256,29,6,15,2,5,369
12055961500,5167,3859,902,186,16,34,2,18,1308
12055961601,1209,934,225,14,0,2,0,4,275
12055961602,1028,824,110,28,8,5,0,2,204
12055961604,2559,1151,1149,157,5,29,0,12,1408
12055961605,4012,2692,780,396,13,46,0,13,1320
12055961701,3158,2074,489,511,4,15,0,5,1084
12055961702,2136,852,1069,154,14,14,0,7,1284
12055980000,42,26,7,0,0,0,1,0,16
12055980100,0,0,0,0,0,0,0,0,0
12055980200,0,0,0,0,0,0,0,0,0
12057000101,5208,2466,1079,1019,11,370,14,68,2742
12057000102,5616,1310,1797,2067,11,174,4,24,4306
12057000201,3656,758,1212,1437,17,54,16,34,2898
12057000202,5221,841,2103,1930,17,116,5,35,4380
12057000301,5054,861,1872,2091,12,47,0,44,4193
12057000302,2522,597,1152,668,9,19,4,24,1925
12057000401,2345,717,1033,455,4,63,2,5,1628
12057000402,2765,921,1317,326,3,96,0,32,1844
12057000500,4034,2207,1341,176,10,94,0,23,1827
12057000601,4696,990,2682,646,3,208,0,44,3706
12057000602,2640,607,1250,536,5,133,0,22,2033
12057000701,3806,395,1062,2179,5,7,0,19,3411
12057000702,3055,513,836,1549,9,14,3,21,2542
12057000800,3506,711,1051,1513,11,72,0,22,2795
12057000901,2746,632,786,1137,7,59,6,33,2114
12057000902,4702,814,955,2590,8,106,1,27,3888
12057001001,3536,368,1044,2012,12,21,0,14,3168
12057001002,5516,304,843,4197,7,16,0,28,5212
12057001100,2347,1225,485,439,5,42,0,11,1122
12057001200,2886,989,954,756,4,32,1,24,1897
12057001300,6044,1774,3423,440,10,202,0,32,4270
12057001400,4620,1163,2856,369,0,109,0,22,3457
12057001500,2541,1779,508,80,7,33,0,7,762
12057001600,2296,1308,490,360,7,29,0,15,988
12057001700,4216,2016,1059,882,7,51,8,22,2200
12057001800,4754,247,962,3349,9,16,1,21,4507
12057001900,3017,125,403,2396,2,0,0,13,2892
12057002000,2781,389,580,1674,6,18,0,6,2392
12057002100,2537,988,589,812,5,8,2,35,1549
12057002200,1699,974,400,214,4,19,0,9,725
12057002300,2853,1702,656,275,6,51,2,22,1151
12057002400,3918,1397,1894,435,2,44,4,20,2521
12057002500,6743,1239,4276,733,7,302,10,38,5504
12057002600,1706,323,1032,211,12,42,0,28,1383
12057002701,3805,893,2508,259,3,64,0,7,2912
12057002702,3110,532,2405,98,6,37,0,8,2578
12057002800,2924,1636,862,254,15,38,3,9,1288
12057002900,1832,806,518,400,0,23,0,8,1026
12057003000,2801,553,475,1623,3,17,0,18,2248
12057003100,2803,294,788,1607,7,7,0,32,2509
12057003200,2367,440,959,870,7,15,3,14,1927
12057003300,2496,344,593,1425,18,6,1,23,2152
12057003400,3156,159,311,2578,6,12,0,25,2997
12057003500,2684,251,265,2052,4,4,1,20,2433
12057003600,4497,449,770,3071,11,21,6,16,4048
12057003700,1894,652,418,723,4,25,0,3,1242
12057003800,1025,309,144,497,8,13,2,5,716
12057004100,1612,347,459,742,0,10,0,10,1265
12057004200,1664,775,294,481,6,41,3,11,889
12057004300,821,85,138,561,0,17,0,4,736
12057004400,2205,342,683,1040,6,22,5,9,1863
12057004500,4102,577,2956,426,0,67,2,11,3525
12057004601,3904,1798,832,653,6,394,0,50,2106
12057004602,1841,637,381,625,0,114,0,12,1204
12057004700,2584,1232,848,200,3,172,4,13,1352
12057004800,4121,1631,1743,404,3,190,0,17,2490
12057004901,2144,944,473,632,1,35,0,16,1200
12057004902,2852,2149,324,113,0,136,1,20,703
12057005000,7602,4654,1011,1342,14,215,2,63,2948
12057005101,3777,2249,820,318,7,209,0,24,1528
12057005102,4936,3631,604,141,2,329,4,24,1305
12057005301,4422,3100,622,174,5,296,0,33,1322
12057005302,2017,474,1312,170,3,15,3,6,1543
12057005401,5609,4440,691,71,9,193,1,11,1169
12057005500,2690,2055,301,80,0,129,2,25,635
12057005700,4157,2786,856,145,11,162,0,20,1371
12057005800,4964,3583,788,73,9,277,1,27,1381
12057005900,6443,4909,857,114,8,283,3,15,1534
12057006000,5876,4791,630,72,8,136,1,30,1085
12057006101,3111,2535,339,21,2,77,2,21,576
12057006103,4118,3139,542,96,5,159,2,26,979
12057006200,4281,3313,498,63,5,164,2,37,968
12057006300,4297,3260,594,53,4,146,0,26,1037
12057006400,4146,3164,586,43,4,150,0,13,982
12057006501,3193,1997,626,283,7,113,0,26,1196
12057006503,1441,1027,168,77,1,50,0,16,414
12057006504,794,640,84,26,3,21,0,5,154
12057006600,4002,2646,759,202,4,163,0,20,1356
12057006700,5730,4425,765,69,0,207,1,31,1305
12057006801,4834,3214,703,333,15,268,0,31,1620
12057006802,3444,2603,457,93,4,101,2,41,841
12057006900,5573,3668,845,390,9,266,22,35,1905
12057007001,4583,2580,936,428,8,290,1,28,2003
12057007002,3060,1093,921,639,10,165,6,27,1967
12057007102,3704,2386,631,305,6,155,25,15,1318
12057007103,3688,2209,746,283,19,191,2,16,1479
12057007200,5107,2964,812,674,19,244,22,33,2143
12057007300,1878,1153,293,217,7,46,6,7,725
12057010105,4751,3101,1346,52,10,63,1,21,1650
12057010106,5007,3579,1147,79,5,51,2,4,1428
12057010107,3860,2754,894,36,17,45,0,5,1106
12057010108,2307,1758,370,62,2,41,0,3,549
12057010203,2479,1220,427,615,10,79,1,25,1259
12057010204,5587,1994,1719,1396,10,210,8,45,3593
12057010210,4617,1390,1040,829,12,1099,0,30,3227
12057010211,5220,2677,1082,880,4,315,1,37,2543
12057010212,5005,2404,726,592,9,1012,0,47,2601
12057010213,1937,1086,337,383,8,46,0,7,851
12057010215,7762,2931,1205,1478,13,1683,1,88,4831
12057010216,5961,2119,1142,822,14,1465,13,48,3842
12057010217,4046,1257,967,746,11,846,1,38,2789
12057010218,5543,3047,1061,678,6,423,2,55,2496
12057010303,3438,2309,653,179,33,14,0,40,1129
12057010304,3990,2767,592,301,14,156,3,22,1223
12057010305,4744,2312,878,1030,19,277,0,25,2432
12057010401,5866,2186,1221,1860,13,261,1,32,3680
12057010402,6547,1487,1353,2989,12,441,5,26,5060
12057010501,6134,726,1079,3989,20,53,9,45,5408
12057010502,2542,461,543,1381,3,38,2,9,2081
12057010600,3386,1541,681,883,8,79,1,22,1845
12057010701,5694,3034,1086,1080,10,213,7,25,2660
12057010702,3380,2053,661,436,4,72,1,18,1327
12057010805,5852,623,2945,2035,7,59,3,28,5229
12057010808,3433,724,1168,1261,9,127,3,27,2709
12057010809,2603,1341,434,429,4,251,2,14,1262
12057010810,3978,1629,593,912,7,610,6,37,2349
12057010811,7331,3124,1210,1875,14,696,4,79,4207
12057010814,3420,1361,559,741,1,537,12,6,2059
12057010815,2163,175,1077,789,6,18,6,33,1988
12057010816,4286,630,1492,1926,13,56,1,29,3656
12057010817,4747,813,2910,847,5,46,1,17,3934
12057010819,2590,1002,428,541,0,443,18,44,1588
12057010820,2917,1009,567,905,3,274,9,25,1908
12057010821,3151,353,1639,1025,5,5,4,31,2798
12057010822,2265,571,971,600,2,41,1,8,1694
12057010823,2662,695,411,882,11,533,0,11,1967
12057010824,3741,2182,557,371,20,387,6,37,1559
12057010900,5853,3307,1068,696,9,472,8,287,2546
12057011003,5244,2249,1689,905,10,146,7,24,2995
12057011005,3015,2224,441,119,5,81,1,11,791
12057011006,5938,3872,1086,272,21,350,1,54,2066
12057011007,3197,2258,570,101,6,94,0,21,939
12057011008,7052,3413,1016,789,11,1473,2,38,3639
12057011010,6118,2970,1457,949,7,401,0,60,3148
12057011013,4469,1727,837,581,8,1075,0,46,2742
12057011016,4993,1745,666,661,18,1754,0,26,3248
12057011017,2322,1335,391,209,5,251,2,16,987
12057011018,5115,2004,1070,1204,12,507,6,44,3111
12057011019,9337,4415,1656,1294,16,1383,3,78,4922
12057011103,3489,2584,582,102,4,72,0,12,905
12057011106,2100,907,756,195,1,118,6,14,1193
12057011107,6999,3771,2092,491,7,321,4,45,3228
12057011108,1750,1214,356,76,0,54,0,4,536
12057011109,4756,3156,884,164,6,348,0,22,1600
12057011203,3290,1814,1026,209,4,94,0,8,1476
12057011204,6274,3125,2070,600,5,186,0,28,3149
12057011205,2935,1849,726,142,8,79,0,14,1086
12057011206,2964,1178,1149,460,9,62,4,14,1786
12057011301,3486,2091,853,168,11,182,1,55,1395
12057011303,2989,1709,908,197,0,66,0,11,1280
12057011304,5302,3369,1283,245,9,198,1,33,1933
12057011407,2393,1694,464,109,2,40,0,21,699
12057011408,2762,1447,907,119,0,158,7,13,1315
12057011409,2897,1881,654,175,3,58,0,24,1016
12057011410,6899,4021,1584,509,6,427,5,48,2878
12057011411,1807,677,771,114,0,184,4,2,1130
12057011412,3422,1547,1246,220,0,236,0,38,1875
12057011413,6579,2793,2474,392,6,598,5,40,3786
12057011414,8491,2681,4449,627,9,392,0,98,5810
12057011415,5176,1802,2238,460,5,418,0,43,3374
12057011416,7089,2028,3753,676,8,331,0,45,5061
12057011417,4914,1970,2059,428,4,223,0,30,2944
12057011418,3818,2378,996,190,1,130,0,31,1440
12057011504,2234,1791,266,42,4,46,1,1,443
12057011506,9515,5108,1944,498,13,1443,3,94,4407
12057011509,6624,4730,1019,238,3,317,0,29,1894
12057011510,4933,3038,816,227,7,570,0,21,1895
12057011512,4217,2857,786,131,5,251,0,14,1360
12057011514,5739,3042,1803,340,6,227,0,65,2697
12057011515,3651,1995,1132,179,3,160,1,17,1656
12057011516,3209,1687,1013,194,4,159,4,10,1522
12057011518,4163,3073,634,94,2,174,0,22,1090
12057011519,2101,1501,332,61,4,92,0,17,600
12057011520,5574,3870,826,223,5,337,5,65,1704
12057011521,4762,2670,1259,428,8,184,4,14,2092
12057011522,4963,2855,891,187,8,749,1,52,2108
12057011523,1709,1063,438,69,0,78,0,3,646
12057011524,4936,2073,1966,549,6,137,1,38,2863
12057011525,4308,2930,518,127,5,531,0,29,1378
12057011526,4454,2047,1077,323,5,720,0,41,2407
12057011527,3881,2746,429,148,0,391,8,15,1135
12057011528,6068,4008,716,204,0,817,5,31,2060
12057011603,4367,1304,2347,315,8,196,1,55,3063
12057011605,6313,989,4722,335,7,116,1,44,5324
12057011610,5779,1481,3652,280,8,210,3,32,4298
12057011611,4493,878,2696,333,1,412,0,44,3615
12057011612,6883,1892,4134,405,5,145,8,59,4991
12057011613,5979,1540,3828,343,6,61,6,49,4439
12057011614,7266,1205,4987,543,4,264,8,66,6061
12057011615,4602,947,2865,306,3,254,3,66,3655
12057011616,9609,4023,3936,526,15,663,4,72,5586
12057011617,4349,1776,1629,289,6,403,0,44,2573
12057011708,5075,3000,1226,311,25,254,3,27,2075
12057011712,5738,2913,2056,359,11,159,6,31,2825
12057011713,4975,2390,1299,455,11,505,4,71,2585
12057011714,1834,1015,466,121,0,142,0,8,819
12057011715,2566,495,1699,129,7,117,0,28,2071
12057011716,5371,1520,2505,618,11,452,4,58,3851
12057011802,6810,854,5611,118,0,151,0,18,5956
12057011804,5727,626,4386,150,4,469,2,16,5101
12057011805,3322,953,1483,462,0,258,0,23,2369
12057011806,3608,475,2634,324,3,90,0,19,3133
12057011905,1468,287,1058,86,2,18,0,0,1181
12057011907,3164,998,1445,315,6,260,0,29,2166
12057011908,2202,416,1312,350,3,39,0,20,1786
12057011909,3647,906,2275,200,10,148,0,18,2741
12057011910,4405,764,3280,183,8,62,0,18,3641
12057011911,5818,1327,3394,777,10,131,0,32,4491
12057012001,2778,873,632,1122,9,52,0,12,1905
12057012002,4014,1034,1196,1529,6,38,0,31,2980
12057012103,7276,2169,2101,1797,4,839,8,62,5107
12057012106,5327,3191,932,700,6,249,0,25,2136
12057012107,4886,2329,1347,900,20,71,5,22,2557
12057012108,3487,1684,1034,499,6,126,0,19,1803
12057012109,3130,1161,983,721,12,52,0,33,1969
12057012110,5305,1940,2261,763,25,74,3,39,3365
12057012206,6320,3204,1468,975,13,315,18,43,3116
12057012207,7173,3911,1831,844,14,250,2,38,3262
12057012208,6820,3862,1412,794,11,397,3,43,2958
12057012209,5150,2671,1169,591,9,465,0,22,2479
12057012210,5297,2635,1557,624,17,243,1,18,2662
12057012211,2002,926,329,729,5,6,2,0,1076
12057012212,4677,1308,1595,1379,4,149,1,28,3369
12057012213,4965,2523,1238,714,7,233,9,22,2442
12057012301,6611,3233,1843,825,20,368,11,44,3378
12057012303,3419,1656,1085,465,9,47,0,6,1763
12057012304,5117,2065,1978,680,15,175,0,25,3052
12057012401,5378,2219,2853,75,22,68,0,4,3159
12057012402,2667,1097,1444,44,0,17,0,6,1570
12057012403,6481,3054,2862,318,17,53,0,27,3427
12057012501,3953,2051,1555,163,16,38,1,17,1902
12057012503,4550,3041,827,350,8,156,2,19,1509
12057012504,3156,2305,518,128,5,78,0,16,851
12057012600,5697,2176,1992,1232,13,74,9,12,3521
12057012701,6502,1954,3754,496,18,74,1,25,4548
12057012702,3668,2045,1247,198,8,29,4,15,1623
12057012800,4178,2249,1507,254,2,19,2,13,1929
12057012900,3215,455,1123,1551,1,9,1,5,2760
12057013001,4065,2389,1264,226,2,46,0,1,1676
12057013002,5514,2678,2059,433,16,120,1,20,2836
12057013003,4461,2167,1548,477,12,101,3,15,2294
12057013004,4158,1552,1625,806,0,29,6,16,2606
12057013100,2781,1835,681,115,2,11,4,8,946
12057013203,3345,2031,770,271,3,114,5,21,1314
12057013204,3779,2499,778,276,4,85,0,24,1280
12057013205,8547,4996,1850,852,40,401,2,37,3551
12057013206,5213,3151,1002,508,18,235,0,29,2062
12057013207,4660,3208,822,257,7,149,2,35,1452
12057013208,4998,3786,585,163,4,188,5,29,1212
12057013305,5027,3372,875,283,10,263,4,18,1655
12057013307,3977,1763,994,843,6,167,2,27,2214
12057013310,2745,1305,731,483,0,94,1,13,1440
12057013311,3197,1661,886,343,8,100,5,18,1536
12057013312,5371,2466,1472,648,17,513,2,27,2905
12057013313,4916,2986,1153,394,12,172,0,28,1930
12057013314,2976,1707,696,376,7,64,0,12,1269
12057013315,5677,2362,1296,1238,10,436,0,51,3315
12057013316,2674,685,1030,780,5,49,0,16,1989
12057013317,2611,1115,618,593,4,136,0,19,1496
12057013319,5614,2382,1312,1094,11,444,11,38,3232
12057013320,4675,1865,1255,865,23,394,3,51,2810
12057013322,7190,3135,1925,1332,9,327,0,74,4055
12057013323,10885,3674,3315,2354,44,934,11,104,7211
12057013406,1339,787,385,70,4,19,3,6,552
12057013407,7040,4510,1215,638,18,224,7,63,2530
12057013409,4785,3202,758,351,35,215,4,16,1583
12057013410,4872,1938,1655,929,9,91,1,36,2934
12057013411,2920,1916,633,156,8,69,4,7,1004
12057013412,4156,2428,907,466,8,132,4,23,1728
12057013413,3489,2436,489,279,13,97,0,24,1053
12057013414,6115,3973,1039,496,7,177,0,63,2142
12057013415,3668,2438,630,308,10,106,1,10,1230
12057013501,3699,886,1557,1079,9,41,0,33,2813
12057013503,3757,716,2199,704,6,42,5,12,3041
12057013504,3818,656,2273,766,4,36,0,17,3162
12057013505,3324,525,1556,1089,6,15,0,12,2799
12057013602,2905,991,1354,339,13,97,3,12,1914
12057013604,1215,722,375,48,2,3,2,1,493
12057013702,12191,3776,3165,3966,32,570,2,122,8415
12057013703,8571,2506,2996,2137,5,455,2,67,6065
12057013705,7217,2951,1932,1670,11,212,5,63,4266
12057013706,1515,471,546,405,4,34,0,10,1044
12057013801,2523,964,1280,181,5,27,2,7,1559
12057013802,3527,1838,1203,257,7,65,3,16,1689
12057013803,1618,885,582,69,5,3,0,3,733
12057013804,10972,3204,3680,3166,32,275,10,87,7768
12057013806,4424,1496,1410,962,15,243,11,48,2928
12057013807,10982,3729,3501,2825,29,368,19,73,7253
12057013903,3390,2734,433,34,8,12,1,29,656
12057013907,2063,1358,562,21,2,50,3,10,705
12057013912,7011,3501,2150,760,31,215,5,31,3510
12057013913,14160,5062,5815,2469,17,318,8,90,9098
12057013914,6948,1893,3859,864,9,111,7,48,5055
12057013915,11725,4648,3087,2588,27,536,13,105,7077
12057013916,18273,6463,4785,5065,34,864,16,145,11810
12057013917,7344,3119,1883,1593,26,279,8,64,4225
12057013918,1947,1185,574,50,6,38,0,9,762
12057013919,8010,4125,1873,1032,24,401,7,95,3885
12057013922,7225,4968,1114,307,12,358,4,28,2257
12057013923,11022,7172,1831,481,16,880,8,62,3850
12057013924,4423,1757,1287,896,13,235,4,37,2666
12057013925,5969,2979,1507,934,19,208,5,43,2990
12057013926,9252,6164,1984,333,9,321,2,31,3088
12057014002,2969,1867,1004,18,1,17,3,11,1102
12057014003,1553,1277,180,3,2,22,0,0,276
12057014007,11002,3543,3328,3084,23,317,11,117,7459
12057014008,3684,3428,100,53,7,36,0,0,256
12057014009,2761,2435,157,82,6,31,0,11,326
12057014010,2630,2326,143,55,11,42,2,10,304
12057014011,3707,3357,179,66,5,38,0,7,350
12057014012,3197,3028,63,18,2,42,0,3,169
12057014013,1287,627,578,24,1,6,5,1,660
12057014014,2333,2152,65,45,4,22,0,8,181
12057014017,2994,2732,92,63,0,64,2,13,262
12057014104,1996,1644,275,10,0,12,1,3,352
12057014106,3478,2433,730,106,6,49,1,20,1045
12057014108,6180,2368,2996,551,26,75,3,19,3812
12057014109,8312,2611,3683,1611,25,99,13,44,5701
12057014117,3374,2697,351,88,8,94,2,14,677
12057014118,4172,3522,317,77,12,89,1,12,650
12057014119,9651,5731,1812,1110,15,396,11,62,3920
12057014121,5812,3388,1128,821,8,195,1,43,2424
12057014122,8512,2414,2908,2533,24,164,10,82,6098
12057014200,3838,1144,1027,1437,7,55,4,34,2694
12057014300,4809,3673,730,87,16,53,0,27,1136
12057014400,4853,2601,1126,343,11,463,3,31,2252
12057980100,0,0,0,0,0,0,0,0,0
12057980200,0,0,0,0,0,0,0,0,0
12057980300,0,0,0,0,0,0,0,0,0
12057980400,73,58,2,0,0,7,0,0,15
12057980500,5,0,3,0,0,1,0,0,5
12057980600,25,7,10,1,0,5,0,0,18
12057980700,6,4,1,0,0,0,0,0,2
12057990000,0,0,0,0,0,0,0,0,0
12057990100,0,0,0,0,0,0,0,0,0
12059960100,3813,3451,94,89,29,4,7,12,362
12059960201,3090,2873,58,14,38,8,0,1,217
12059960202,2079,1911,69,9,9,11,1,1,168
12059960300,3233,2966,84,31,15,8,3,3,267
12059960401,1653,723,208,719,0,2,0,0,930
12059960402,3417,2862,78,204,15,26,2,7,555
12059960403,2368,1980,97,145,14,22,0,3,388
12061050101,3317,2218,589,264,12,84,0,22,1099
12061050102,3367,2396,511,221,5,72,2,32,971
12061050201,1642,1260,230,52,0,31,3,5,382
12061050202,2736,1909,353,246,8,126,0,9,827
12061050303,3423,216,176,2901,5,6,0,15,3207
12061050304,1896,407,331,1073,3,9,0,10,1489
12061050305,2885,1920,260,577,3,33,0,10,965
12061050306,2172,2066,58,5,0,15,0,2,106
12061050401,3589,2236,647,457,7,71,3,34,1353
12061050402,2557,2096,258,67,9,30,1,9,461
12061050504,1588,1476,66,1,0,5,0,2,112
12061050505,3437,3204,116,15,0,31,0,13,233
12061050506,4246,3981,105,10,6,43,0,6,265
12061050507,1823,1750,32,5,0,11,0,4,73
12061050508,2960,2680,170,2,6,24,2,14,280
12061050509,2054,1913,77,4,0,14,0,12,141
12061050601,2808,2105,244,290,10,54,1,12,703
12061050602,4836,3587,635,227,5,126,0,53,1249
12061050603,6790,4517,1044,754,15,117,9,42,2273
12061050604,1518,1397,72,19,0,14,0,3,121
12061050605,1895,1767,66,11,8,7,2,0,128
12061050607,6984,3637,1288,1544,14,115,3,67,3347
12061050608,5415,3282,954,760,24,111,5,30,2133
12061050702,5193,4152,594,107,9,116,0,29,1041
12061050704,3244,2641,320,92,2,78,0,22,603
12061050706,6742,5551,664,176,11,128,0,27,1191
12061050707,4028,3084,483,190,2,72,4,7,944
12061050708,3868,3190,315,143,2,90,0,17,678
12061050709,2065,1921,65,19,4,6,0,3,144
12061050805,4065,3151,296,434,7,18,2,18,914
12061050806,4895,4044,426,197,14,57,1,13,851
12061050807,5152,4308,426,134,10,54,1,17,844
12061050808,4612,3944,342,100,5,48,1,10,668
12061050809,6214,4998,567,334,7,96,2,12,1216
12061050810,3564,2883,315,156,4,81,0,3,681
12061050811,6737,5360,657,384,13,125,3,15,1377
12061050812,3104,2444,238,253,2,55,0,27,660
12061050903,7209,4859,1685,282,21,62,2,38,2350
12061050905,3477,2951,244,103,5,53,0,18,526
12061050906,2416,2083,215,35,5,12,0,5,333
12061050907,1488,1205,151,47,0,11,1,15,283
12061050908,4299,1706,2082,367,7,27,3,16,2593
12061050909,3478,927,2465,21,3,3,1,12,2551
12061980000,0,0,0,0,0,0,0,0,0
12061990000,0,0,0,0,0,0,0,0,0
12063210100,3694,1877,369,1357,11,0,0,10,1817
12063210200,1284,358,28,833,6,4,0,10,926
12063210301,4214,2815,215,1068,13,10,5,5,1399
12063210302,2052,1280,45,626,3,4,0,9,772
12063210400,3710,2500,145,778,31,9,0,9,1210
12063210500,3659,2302,204,852,13,112,5,17,1357
12063210600,4771,2249,164,2135,18,13,2,11,2522
12063210700,4111,3071,196,585,16,63,2,14,1040
12063210800,4196,2269,143,1571,20,4,0,17,1927
12063210901,1872,1272,73,414,6,10,1,7,600
12063210902,4068,2525,320,1082,13,12,1,14,1543
12063211000,5179,4246,146,534,24,27,1,5,933
12063211100,4509,3865,167,207,22,24,1,16,644
12065250103,2610,923,138,1479,1,4,2,5,1687
12065250104,3151,2170,133,712,7,11,1,2,981
12065250105,1555,807,53,644,9,3,0,8,748
12065250106,2784,1922,159,607,5,5,0,15,862
12065250200,4410,2898,175,1158,14,11,0,24,1512
12065990000,0,0,0,0,0,0,0,0,0
12067960100,2648,1641,291,696,6,0,0,9,1007
12067960201,3522,2826,331,259,7,7,1,2,696
12067960202,2056,1607,316,69,3,3,0,7,449
12069030102,3775,3279,337,15,14,7,1,2,496
12069030104,1815,1659,49,37,2,0,4,3,156
12069030106,1683,1409,186,13,0,8,1,3,274
12069030108,4734,3765,508,143,20,42,3,15,969
12069030109,4363,3691,331,113,21,33,0,16,672
12069030110,4708,3638,567,269,11,18,2,14,1070
12069030111,2112,1841,134,17,5,5,0,14,271
12069030112,4271,3584,445,40,23,10,0,5,687
12069030203,10004,7648,1047,690,19,233,3,19,2356
12069030204,4195,2906,609,448,6,51,4,21,1289
12069030206,4764,2010,838,1680,14,25,4,8,2754
12069030208,4390,2939,707,426,2,97,0,13,1451
12069030209,3711,1956,979,569,5,32,3,23,1755
12069030210,2154,1651,235,144,7,20,0,5,503
12069030211,4943,3552,652,450,10,71,5,27,1391
12069030302,4239,3383,291,323,13,83,2,8,856
12069030305,2546,2269,165,13,8,17,3,3,277
12069030306,4625,3839,403,180,15,28,0,10,786
12069030307,4891,4020,461,206,11,29,0,12,871
12069030308,4086,3355,343,165,10,114,0,12,731
12069030405,6113,4716,605,491,26,50,19,19,1397
12069030406,4727,3798,381,266,9,66,16,12,929
12069030407,3367,2109,587,378,16,88,2,19,1258
12069030408,4457,3993,187,111,8,66,5,14,464
12069030409,5051,4822,94,31,7,28,0,9,229
12069030410,3496,2839,305,113,3,112,0,15,657
12069030411,6455,5042,671,399,10,81,1,33,1413
12069030505,4537,1469,836,1985,9,16,9,46,3068
12069030506,5691,4900,184,373,6,106,2,27,791
12069030507,8026,4076,1609,1770,27,40,9,71,3950
12069030601,5517,3368,671,962,15,201,63,40,2149
12069030602,2670,1155,329,994,3,41,0,11,1515
12069030701,2565,2100,180,197,4,18,0,6,465
12069030702,6167,3249,935,1383,13,239,16,43,2918
12069030803,5705,4208,492,650,26,100,2,38,1497
12069030804,1422,985,213,160,3,10,1,6,437
12069030805,4688,2981,674,669,13,135,1,32,1707
12069030806,3759,2781,382,399,10,48,2,10,978
12069030807,4663,2940,567,484,16,441,2,28,1723
12069030914,5382,2845,1056,1193,21,72,0,27,2537
12069030915,8252,5520,1561,669,14,100,18,26,2732
12069030916,5148,3980,662,156,13,58,2,27,1168
12069030917,9054,6005,1653,747,16,214,3,64,3049
12069030918,2719,1930,539,107,5,21,1,11,789
12069031001,2018,1297,594,31,4,14,2,5,721
12069031002,6000,4807,669,223,14,73,3,21,1193
12069031103,2333,1767,351,111,13,17,0,9,566
12069031104,1965,1874,19,6,2,13,0,3,91
12069031105,6102,5031,442,286,23,138,0,20,1071
12069031106,2642,2418,92,70,1,17,0,3,224
12069031107,3322,2775,317,119,0,15,2,0,547
12069031108,3022,2586,172,119,9,29,3,20,436
12069031202,7397,4710,1542,600,26,126,2,88,2687
12069031203,6338,3878,1525,571,18,84,6,55,2460
12069031205,3605,1207,1814,406,4,40,0,25,2398
12069031206,4658,2273,1374,576,25,123,4,85,2385
12069031207,13434,6530,3544,2029,49,424,5,193,6904
12069031208,3765,2619,338,669,10,43,0,6,1146
12069031301,6843,5157,956,237,22,125,4,60,1686
12069031306,10384,6161,1975,1032,19,511,7,181,4223
12069031308,7264,4767,1055,763,4,285,0,110,2497
12069031309,13632,7474,3380,1361,31,551,13,156,6158
12069031312,5287,2031,1753,1027,32,110,3,97,3256
12069031313,3187,2289,410,154,15,40,0,34,898
12069031314,10252,5113,3064,1154,40,270,0,105,5139
12069031315,7762,4047,1932,812,14,395,3,180,3715
12069031316,10932,6216,2531,1172,32,403,6,114,4716
12069031317,4314,1435,2152,443,12,91,7,29,2879
12069031318,6924,3893,2183,380,17,127,6,34,3031
12069031319,4319,2838,782,353,9,164,0,35,1481
12069031320,7919,3565,1910,1231,22,491,23,229,4354
12069031321,4326,2523,964,432,13,136,4,64,1803
12069031322,3366,2253,591,266,9,69,1,28,1113
12069031323,4688,3341,757,261,9,73,0,42,1347
12069031324,4316,2134,1527,361,9,91,4,18,2182
12071000303,3884,847,2574,346,4,24,0,18,3037
12071000304,1314,919,213,109,2,25,0,2,395
12071000305,2048,285,1232,492,0,6,0,8,1763
12071000306,3164,344,2562,224,4,2,0,7,2820
12071000401,2818,864,1734,119,1,24,0,21,1954
12071000402,2433,1482,808,58,9,23,1,8,951
12071000502,3873,282,866,2578,3,5,0,12,3591
12071000503,3972,331,1921,1628,5,6,1,22,3641
12071000504,2748,540,1700,422,3,20,0,18,2208
12071000600,3999,180,483,3179,5,17,1,24,3819
12071000700,2488,603,444,1321,0,13,1,19,1885
12071000800,1838,1457,196,91,2,41,0,5,381
12071000900,2913,2477,213,31,2,58,1,7,436
12071001001,3129,2074,490,287,14,50,3,49,1055
12071001002,3289,1956,763,345,6,40,0,21,1333
12071001101,3922,732,918,2004,16,63,0,40,3190
12071001103,2234,1287,415,319,9,43,0,31,947
12071001104,2955,705,815,1258,16,34,2,20,2250
12071001203,4089,1065,1646,752,0,70,0,119,3024
12071001204,4147,2431,630,787,6,119,3,43,1716
12071001205,3566,1418,1240,562,5,117,0,22,2148
12071001206,2821,2036,424,133,0,96,0,11,785
12071001207,2165,1615,236,43,4,150,0,29,550
12071001208,3340,2839,221,33,4,146,2,15,501
12071001209,3087,1727,797,296,3,110,0,25,1360
12071001300,3110,1581,1176,166,7,54,2,34,1529
12071001401,5865,2178,1917,1245,10,131,2,81,3687
12071001402,2748,2287,210,58,1,68,0,10,461
12071001501,2547,2243,140,33,5,28,0,11,304
12071001502,6390,2151,3268,657,12,60,4,37,4239
12071001601,4627,3211,810,222,8,113,1,53,1416
12071001602,3372,3051,130,47,8,64,0,12,321
12071001701,3471,2565,409,99,1,286,2,9,906
12071001705,4048,3434,344,64,10,65,0,19,614
12071001706,3547,2850,404,101,1,70,1,19,697
12071001708,2630,2231,253,35,5,31,0,12,399
12071001709,3198,2592,260,61,7,152,0,18,606
12071001710,2305,2056,122,34,3,20,0,11,249
12071001711,2909,2367,279,79,1,58,1,19,542
12071001801,4642,3717,486,124,2,107,0,38,925
12071001802,2610,2418,89,11,4,48,0,1,192
12071001903,3261,3030,94,14,1,45,0,9,231
12071001908,1093,1040,17,0,6,5,0,2,53
12071001910,1554,1451,75,5,1,3,0,0,103
12071001911,1010,965,15,0,4,2,0,5,45
12071001912,1961,1838,50,11,2,14,0,6,123
12071001913,1861,1759,52,7,1,16,1,0,102
12071001915,3436,3310,15,0,0,20,0,39,126
12071001916,2324,1801,402,24,5,31,0,15,523
12071001917,3655,1544,1440,503,3,58,3,16,2111
12071001918,2300,1711,267,74,5,141,0,13,589
12071001919,2511,2037,187,84,0,111,1,17,474
12071001920,3175,2589,234,82,4,169,2,14,586
12071001921,3313,3060,115,24,1,44,0,6,253
12071001922,2600,2320,178,28,1,18,0,0,280
12071001923,2500,2216,141,24,0,35,2,4,284
12071010104,1966,1870,52,0,1,10,0,6,96
12071010106,4975,2897,1453,299,3,107,0,21,2078
12071010107,3620,2019,1205,195,5,41,0,28,1601
12071010108,3370,2003,1008,190,6,52,0,16,1367
12071010109,4037,3148,611,93,12,58,6,17,889
12071010110,2674,2117,373,53,4,31,0,3,557
12071010111,5355,3368,1411,261,11,65,0,15,1987
12071010112,2135,2027,53,8,0,5,2,5,108
12071010113,2803,1856,628,179,6,22,0,11,947
12071010203,7510,3740,2841,454,14,139,7,39,3770
12071010205,5081,2521,1992,326,1,68,2,15,2560
12071010206,8084,4361,2877,397,4,95,5,37,3723
12071010207,5455,3198,1655,324,7,47,2,38,2257
12071010208,3302,2169,699,179,10,88,0,21,1133
12071010209,1827,1765,32,3,0,5,0,0,62
12071010210,3309,2662,402,82,3,48,0,11,647
12071010302,6889,3918,2117,460,9,113,1,39,2971
12071010303,5900,3795,1424,235,30,125,0,45,2105
12071010305,4100,3049,714,124,9,48,0,19,1051
12071010306,7100,4063,2273,343,17,131,2,45,3037
12071010307,7064,4167,2041,406,14,127,4,47,2897
12071010308,5864,3664,1503,312,11,122,6,33,2200
12071010309,4265,2909,900,133,9,116,10,25,1356
12071010404,9757,5886,2774,406,25,224,0,78,3871
12071010411,4732,3176,1158,129,9,56,1,35,1556
12071010412,5061,3526,1065,150,9,101,2,33,1535
12071010413,5739,3807,1378,233,1,116,1,27,1932
12071010414,3103,2045,763,75,2,77,1,12,1058
12071010415,3592,2917,443,64,9,44,0,22,675
12071010416,3284,2720,375,67,11,38,1,10,564
12071010417,2273,1978,186,16,5,21,0,6,295
12071010418,5211,3865,885,210,8,72,0,11,1346
12071010419,5850,3770,1486,234,11,96,0,39,2080
12071010420,8131,6109,1359,201,15,128,10,36,2022
12071010421,6941,4474,1712,262,8,159,0,39,2467
12071010422,4572,3493,717,120,7,61,1,19,1079
12071010423,3240,2435,536,105,5,64,0,9,805
12071010501,3766,2610,813,105,3,66,6,16,1156
12071010503,3138,2605,362,44,7,34,4,14,533
12071010504,2310,1687,454,73,4,21,2,8,623
12071010601,4278,3129,787,93,8,64,3,25,1149
12071010602,2698,2030,463,71,3,38,1,3,668
12071010701,3915,3198,482,46,10,49,1,11,717
12071010702,2893,2524,205,29,9,33,6,3,369
12071010801,2158,1801,237,22,3,27,1,4,357
12071010802,3408,2605,569,74,6,32,0,12,803
12071010803,1783,1566,130,7,0,24,2,4,217
12071020102,4398,3576,624,69,8,23,0,6,822
12071020103,2253,2116,69,14,3,6,0,8,137
12071020104,2660,2538,54,0,2,30,0,5,122
12071020201,1151,944,171,1,4,2,0,4,207
12071020202,2582,2258,159,13,2,30,0,10,324
12071020301,2788,2317,321,16,10,24,0,8,471
12071020302,2345,1791,398,16,15,2,0,14,554
12071020400,3119,2758,182,18,9,47,2,7,361
12071020501,3125,2818,174,23,10,4,0,3,307
12071020502,4021,3365,427,75,4,18,0,14,656
12071020600,3736,2761,717,85,10,36,0,16,975
12071020700,4441,3546,559,93,4,68,2,20,895
12071020801,1775,1611,102,7,4,4,0,2,164
12071020802,2289,1670,468,39,12,8,1,24,619
12071030100,2466,2183,174,11,0,20,0,6,283
12071030201,1875,1732,69,26,5,15,0,2,143
12071030202,5594,3274,1795,281,6,76,0,25,2320
12071030205,2818,2083,447,77,2,67,0,22,735
12071030300,2966,2444,244,150,13,11,0,11,522
12071040108,3637,2945,306,95,2,134,2,29,692
12071040109,5415,1338,2374,1461,10,62,2,38,4077
12071040110,3533,1963,820,329,4,289,0,19,1570
12071040111,2986,2841,62,7,4,22,0,1,145
12071040113,1559,1310,125,17,7,23,0,21,249
12071040117,3860,3282,269,57,4,142,0,8,578
12071040118,2315,1990,151,36,6,66,1,5,325
12071040120,1867,805,667,268,7,49,3,8,1062
12071040121,3603,792,1486,996,11,173,0,25,2811
12071040122,5819,724,3031,1832,6,19,0,22,5095
12071040123,5310,3693,881,362,5,150,0,36,1617
12071040124,6840,1849,2774,1660,4,183,0,105,4991
12071040125,2424,692,1095,515,9,28,2,22,1732
12071040126,3405,744,1695,756,4,72,0,40,2661
12071040127,3565,1255,1463,679,7,43,0,24,2310
12071040128,2419,2281,56,5,0,46,0,1,138
12071040129,2264,1994,156,32,2,42,0,4,270
12071040130,3251,2653,321,69,4,66,0,15,598
12071040131,1339,1238,28,22,2,25,0,3,101
12071040132,1768,1657,53,11,0,24,0,4,111
12071040133,3030,2145,372,153,12,220,1,12,885
12071040134,690,446,121,51,0,28,1,11,244
12071040135,2515,2051,220,38,2,111,0,11,464
12071040136,5660,3987,844,335,8,192,0,52,1673
12071040137,2124,1554,297,91,0,74,1,7,570
12071040138,5485,3996,864,289,21,94,0,25,1489
12071040139,3659,2631,563,243,8,51,0,22,1028
12071040205,6031,2695,2179,864,13,27,0,29,3336
12071040206,3382,2528,465,216,5,32,2,15,854
12071040207,4780,2462,1497,615,14,36,5,11,2318
12071040208,2522,965,939,486,0,27,2,18,1557
12071040209,3174,1837,841,292,11,12,0,24,1337
12071040210,2471,1163,851,333,10,21,0,8,1308
12071040211,5090,2421,1837,525,14,84,5,38,2669
12071040212,6353,2237,2779,1016,18,83,0,38,4116
12071040301,7901,1836,3927,1795,10,62,1,45,6065
12071040302,4306,975,2172,909,13,82,6,25,3331
12071040303,6394,1474,3281,1348,17,49,1,58,4920
12071040304,5491,1777,2940,572,6,33,1,48,3714
12071040305,3468,1236,1738,330,8,34,5,20,2232
12071040308,4114,1183,2143,651,9,28,0,8,2931
12071040310,2560,782,1181,476,5,34,0,24,1778
12071040311,4558,1627,2054,684,6,35,2,20,2931
12071040312,1879,514,917,351,0,22,0,14,1365
12071040313,1789,536,811,352,4,19,3,14,1253
12071040314,2874,1046,1334,351,6,29,0,18,1828
12071040315,3055,1122,1127,631,2,46,2,20,1933
12071040316,3841,1455,1705,429,11,53,4,42,2386
12071050103,1611,1193,317,10,0,44,0,7,418
12071050104,2823,2476,275,17,0,5,0,6,347
12071050105,2615,2221,180,60,7,71,0,8,394
12071050106,4916,4214,382,49,12,107,0,16,702
12071050204,3610,2633,587,85,5,175,0,13,977
12071050205,1947,1086,714,47,5,25,1,0,861
12071050206,3299,1927,1068,108,10,69,1,12,1372
12071050207,2814,2411,178,48,0,116,0,4,403
12071050208,6142,4048,1544,183,8,92,2,37,2094
12071050210,3116,2519,304,58,5,108,1,26,597
12071050211,1945,1802,73,18,5,20,3,5,143
12071050212,4149,2499,1341,81,2,67,0,19,1650
12071050213,6399,4082,1700,268,9,113,6,19,2317
12071050305,3774,3603,38,20,0,54,1,4,171
12071050306,2652,2303,180,29,0,63,1,3,349
12071050311,7529,6374,661,68,7,165,0,25,1155
12071050312,3829,2795,828,46,5,45,0,31,1034
12071050315,1850,1771,29,11,1,16,0,3,79
12071050316,2763,2648,65,9,0,22,1,3,115
12071050317,3192,2467,619,27,1,18,0,0,725
12071050318,6003,4872,723,55,3,146,0,14,1131
12071050319,1901,1670,129,9,0,36,0,3,231
12071050320,4270,3488,564,47,2,62,1,14,782
12071050321,2211,1970,93,25,0,57,3,14,241
12071050322,2600,2501,43,0,0,20,0,2,99
12071050323,1207,1142,32,4,0,14,0,2,65
12071050324,3642,3397,129,31,2,28,0,4,245
12071050325,3422,3139,151,25,2,51,1,7,283
12071050401,4544,2363,1957,39,4,52,10,21,2181
12071050402,5950,3014,2633,75,13,104,2,18,2936
12071050501,2954,1494,1309,41,5,31,8,17,1460
12071050502,3856,2335,1348,41,2,40,0,38,1521
12071050601,2970,2504,290,18,4,39,0,9,466
12071050603,3605,2008,1344,34,7,63,6,29,1597
12071050604,2204,1808,247,28,7,64,0,2,396
12071060101,889,826,29,3,2,5,8,4,63
12071060102,2057,1894,83,11,5,5,0,8,163
12071060201,748,728,15,0,0,1,0,0,20
12071060202,1429,1373,17,1,2,2,0,3,56
12071060203,1348,1277,45,1,3,4,0,3,71
12071060300,1116,1057,37,0,1,4,1,3,59
12071070101,1969,1480,406,0,2,10,0,13,489
12071070102,2977,2650,218,9,5,25,0,8,327
12071070201,2083,1949,55,3,1,8,0,3,134
12071070202,1740,1587,86,8,4,7,0,10,153
12071080100,446,419,18,2,0,2,1,0,27
12071080202,2513,2384,52,9,5,18,0,9,129
12071080203,1500,1431,32,6,2,6,0,0,69
12071080204,2369,2215,71,12,1,20,2,7,154
12071080300,2247,1633,221,298,2,21,0,15,614
12071090100,973,943,12,7,0,5,0,1,30
12071980000,0,0,0,0,0,0,0,0,0
12071990000,0,0,0,0,0,0,0,0,0
12073000200,4060,3166,298,308,2,91,2,24,894
12073000301,1574,1034,104,304,0,60,0,11,540
12073000302,2401,1604,185,452,6,29,4,9,797
12073000303,4153,1002,296,2419,6,199,0,39,3151
12073000400,2688,284,104,2226,25,16,0,1,2404
12073000501,2465,1845,310,141,0,75,0,23,620
12073000502,2939,1460,307,908,12,110,0,15,1479
12073000600,3201,931,261,1872,2,41,1,8,2270
12073000700,1985,1293,151,400,0,33,0,8,692
12073000800,2886,2104,197,345,4,102,3,12,782
12073000903,2356,1154,197,821,0,66,0,8,1202
12073000904,3354,1791,248,1025,7,94,3,20,1563
12073000905,2663,1192,216,958,11,127,3,13,1471
12073000906,3082,1905,211,641,5,174,0,22,1177
12073000907,4839,2969,355,1026,6,225,9,21,1870
12073001001,2620,290,118,2089,1,11,3,7,2330
12073001002,2164,140,126,1842,6,7,0,5,2024
12073001101,2815,66,104,2548,7,11,0,9,2749
12073001102,2369,61,100,2165,2,3,2,3,2308
12073001200,2324,955,209,1104,1,7,1,11,1369
12073001300,6655,4325,1141,583,14,238,0,31,2330
12073001401,2942,824,232,1656,7,63,3,28,2118
12073001402,5570,1343,672,3079,2,236,0,20,4227
12073001500,4620,2392,327,1533,13,129,6,17,2228
12073001601,4836,1974,418,2005,11,165,3,21,2862
12073001602,3174,2515,163,281,4,50,8,17,659
12073001701,2692,2333,124,55,4,67,1,13,359
12073001702,5264,3777,315,758,9,166,0,47,1487
12073001801,4174,540,251,3205,7,20,0,18,3634
12073001803,811,357,103,254,7,60,0,3,454
12073001804,5439,1459,336,3162,6,242,6,21,3980
12073001901,2292,276,182,1739,3,21,2,17,2016
12073001902,3763,1059,317,2201,11,11,2,18,2704
12073002003,2611,971,136,1366,15,15,0,12,1640
12073002005,4643,2767,729,614,20,212,0,13,1876
12073002006,3601,1906,395,944,6,149,0,14,1695
12073002007,4097,1534,539,1698,5,130,0,14,2563
12073002008,3836,1415,535,1620,13,120,7,5,2421
12073002101,4691,2036,308,2047,6,76,4,23,2655
12073002103,3465,1253,417,1236,2,393,2,22,2212
12073002105,3599,1350,355,1648,12,62,0,31,2249
12073002106,3224,1000,392,1554,12,126,3,7,2224
12073002201,6334,2187,743,3032,19,117,5,20,4147
12073002205,6138,2267,415,2988,3,168,3,33,3871
12073002206,3452,2014,274,933,4,67,4,10,1438
12073002207,2195,1490,136,394,7,40,2,15,705
12073002208,4612,3102,300,908,7,77,1,25,1510
12073002302,3156,2112,128,741,10,18,0,16,1044
12073002303,4214,2096,258,1599,18,37,0,17,2118
12073002304,2739,1210,395,951,12,62,0,16,1529
12073002403,2671,1532,188,758,1,64,0,16,1139
12073002410,5886,3936,428,964,6,272,1,20,1950
12073002411,1576,1251,85,174,6,10,0,8,325
12073002413,3097,2527,156,224,4,58,0,5,570
12073002414,4366,3459,276,307,8,118,1,21,907
12073002415,4398,3449,292,275,11,148,0,24,949
12073002416,2978,2452,141,147,4,127,2,0,526
12073002418,4687,3728,312,284,8,110,0,17,959
12073002419,4560,3318,297,373,2,370,5,8,1242
12073002420,3269,2669,181,184,7,67,0,13,600
12073002421,4465,3561,272,357,6,113,1,10,904
12073002422,3527,2567,155,308,0,351,0,11,960
12073002423,5364,3731,274,363,8,803,4,19,1633
12073002505,6782,4033,439,1629,21,371,12,25,2749
12073002507,2335,1657,91,454,0,21,7,6,678
12073002509,3887,1608,476,1501,30,99,0,19,2279
12073002511,2165,1562,131,313,0,65,2,5,603
12073002512,3489,2441,188,473,0,243,1,23,1048
12073002513,4214,2837,278,407,14,497,0,18,1377
12073002514,3479,2363,215,611,1,124,2,3,1116
12073002515,5796,4060,234,1206,13,31,0,26,1736
12073002516,3779,1924,285,1321,4,105,7,13,1855
12073002517,3245,1631,193,888,5,387,0,7,1614
12073002603,4878,2093,210,2287,13,10,2,13,2785
12073002604,2904,2096,162,447,16,13,8,8,808
12073002605,5872,3393,473,691,8,992,0,50,2479
12073002606,3261,2326,212,534,14,17,5,9,935
12073002701,4727,2341,719,1407,19,37,0,13,2386
12073002702,4764,3783,418,238,30,24,2,18,981
12075970101,2409,1508,398,367,5,8,0,10,901
12075970103,3367,2549,396,208,22,17,3,23,818
12075970104,5422,3757,743,550,12,20,4,26,1665
12075970200,4334,3082,265,674,29,72,0,15,1252
12075970301,1410,1292,54,11,3,4,0,7,118
12075970303,3832,3413,160,64,6,14,0,10,419
12075970304,2758,2286,252,62,7,22,0,2,472
12075970400,2757,2518,96,31,10,8,0,8,239
12075970501,4129,3174,649,98,12,25,3,13,955
12075970502,4336,3505,395,206,7,15,0,33,831
12075970600,4430,2369,541,1299,0,70,1,14,2061
12075970700,3731,3421,131,27,9,17,0,9,310
12075990000,0,0,0,0,0,0,0,0,0
12077950100,1965,1818,62,13,5,0,0,1,147
12077950201,2770,2364,163,82,32,14,0,4,406
12077950202,1487,886,109,409,15,3,1,10,601
12077980000,1752,661,228,849,0,1,0,11,1091
12079110100,3016,2271,128,519,9,8,0,13,745
12079110200,3177,1824,82,1101,13,12,0,6,1353
12079110301,2355,1490,86,700,6,5,0,0,865
12079110302,5530,1552,326,3520,10,13,0,14,3978
12079110400,3890,2995,259,441,15,7,0,30,895
12081000101,2368,1923,176,138,5,42,4,16,445
12081000103,4782,1162,1785,1580,10,28,6,34,3620
12081000105,4783,1391,2360,873,3,33,2,12,3392
12081000106,4284,905,2405,852,4,12,0,14,3379
12081000201,4143,3094,539,259,24,68,3,27,1049
12081000203,1956,1192,580,95,0,11,3,8,764
12081000204,1985,1745,156,11,1,17,0,5,240
12081000304,3196,1871,825,338,11,29,1,16,1325
12081000305,6727,1202,4534,760,36,31,0,18,5525
12081000307,3621,1528,1402,446,6,52,7,29,2093
12081000309,4206,2005,1420,545,13,55,8,15,2201
12081000310,4669,2205,1832,412,9,27,0,10,2464
12081000311,2658,1619,568,318,6,42,3,10,1039
12081000312,2007,1586,264,62,0,32,0,6,421
12081000313,2765,771,1537,345,8,9,1,13,1994
12081000314,3402,1672,1387,266,4,5,1,4,1730
12081000403,1566,1365,78,17,0,43,0,7,201
12081000405,2614,2209,207,49,6,29,12,6,405
12081000406,3904,3308,312,99,8,57,0,2,596
12081000407,4302,3842,178,105,9,48,0,3,460
12081000409,2348,1994,153,97,3,27,3,4,354
12081000410,3147,2622,240,124,9,61,4,10,525
12081000501,3027,2260,423,142,8,36,5,17,767
12081000503,3863,2991,513,112,7,72,4,8,872
12081000504,3111,2211,517,130,6,61,2,10,900
12081000601,3168,2015,646,291,10,20,5,13,1153
12081000603,3815,2156,1193,254,2,56,0,13,1659
12081000604,5261,2705,1480,843,23,41,5,29,2556
12081000703,3130,929,968,1059,14,35,0,13,2201
12081000704,5906,1441,2636,1639,5,29,9,27,4465
12081000705,4692,1348,1654,1530,1,40,1,11,3344
12081000804,3728,2966,394,97,9,110,3,10,762
12081000805,7858,5185,1353,706,11,304,4,27,2673
12081000808,6199,5050,522,188,9,236,0,19,1149
12081000809,5186,4056,630,163,10,113,3,18,1130
12081000810,6171,5254,372,200,7,164,0,21,917
12081000811,3572,1312,1364,675,10,40,3,28,2260
12081000812,4988,2638,1477,504,16,164,11,18,2350
12081000813,3420,2458,384,159,3,245,6,18,962
12081000814,3821,2978,328,123,7,274,3,2,843
12081000901,5170,2977,1474,380,5,95,2,29,2193
12081000902,5499,3300,1221,595,10,103,1,19,2199
12081001001,2654,1986,442,105,11,22,0,5,668
12081001002,2484,1860,448,58,1,31,1,12,624
12081001104,4429,3184,513,295,2,220,3,40,1245
12081001105,3725,2690,429,336,8,96,12,26,1035
12081001106,4352,2538,830,720,11,78,0,18,1814
12081001107,3370,2737,311,157,10,27,2,14,633
12081001108,2501,2231,142,19,1,22,5,2,270
12081001202,4150,3592,251,45,7,56,9,6,558
12081001203,4336,3680,317,93,3,89,0,7,656
12081001204,6298,5732,243,49,14,62,3,10,566
12081001300,3459,2484,682,113,8,10,0,26,975
12081001402,1862,1553,215,31,5,5,0,5,309
12081001404,3266,2093,782,196,10,33,0,23,1173
12081001405,2493,1307,925,160,2,20,0,7,1186
12081001406,2434,1863,351,115,3,33,4,13,571
12081001501,4863,1119,1764,1808,17,33,9,16,3744
12081001502,6100,1672,2458,1789,10,37,2,28,4428
12081001602,4405,3000,672,561,19,35,1,21,1405
12081001603,1688,1511,77,8,8,30,0,0,177
12081001604,4019,2660,689,452,3,43,0,16,1359
12081001701,1357,1251,46,9,0,9,0,4,106
12081001705,2746,2563,79,9,9,31,1,7,183
12081001801,2314,2127,79,5,4,23,0,2,187
12081001802,1215,1128,40,3,0,11,0,1,87
12081001904,7339,4790,1388,693,17,173,2,32,2549
12081001907,7585,5111,1096,803,11,196,3,34,2474
12081001908,6992,5864,509,282,22,112,3,31,1128
12081001909,3492,2990,216,82,0,54,2,27,502
12081001910,6126,4671,708,289,15,147,2,25,1455
12081001911,7688,5869,820,474,15,215,7,27,1819
12081001913,6021,4903,534,256,9,103,0,10,1118
12081001914,3031,2276,520,46,1,77,0,10,755
12081001915,2858,2041,339,263,3,86,2,6,817
12081001916,5392,4023,589,375,15,139,2,32,1369
12081002003,6786,4901,943,390,11,187,4,37,1885
12081002005,5075,4264,318,112,11,214,3,28,811
12081002008,5920,4645,580,173,16,160,3,42,1275
12081002010,4158,3422,496,17,9,25,1,15,736
12081002011,4103,2943,490,352,11,98,3,30,1160
12081002012,4887,3849,542,114,17,120,10,28,1038
12081002014,7541,5857,810,240,13,276,4,19,1684
12081002016,6257,5477,263,127,2,223,5,28,780
12081002017,4419,3547,429,89,6,142,2,13,872
12081002018,6920,5714,560,131,11,211,0,19,1206
12081002019,7975,6257,826,204,5,347,0,39,1718
12081002020,4322,3644,327,82,10,84,0,20,678
12081002021,6328,5027,609,161,6,297,0,21,1301
12081002022,2023,1733,103,31,3,76,0,3,290
12081002023,8281,6877,654,167,7,271,8,38,1404
12081002024,3776,3278,203,73,3,110,0,13,498
12081002025,6877,5126,835,404,16,238,3,28,1751
12081990000,0,0,0,0,0,0,0,0,0
12083000101,2848,1908,320,495,0,15,0,2,940
12083000102,2461,1795,173,358,4,8,0,18,666
12083000201,2477,1608,255,498,12,2,0,7,869
12083000202,3017,1733,242,929,8,14,2,4,1284
12083000203,1388,1037,104,191,0,7,0,1,351
12083000302,4082,2288,513,1046,12,25,0,25,1794
12083000303,3036,2391,267,261,5,11,0,9,645
12083000304,4887,2907,497,1427,10,4,0,18,1980
12083000401,2531,2161,164,56,12,11,0,0,370
12083000402,4993,4274,273,87,32,17,0,32,719
12083000501,1867,1678,69,7,19,4,0,0,189
12083000502,1414,1279,30,1,5,6,3,6,135
12083000601,4095,3560,195,29,21,15,3,20,535
12083000604,3385,2776,377,16,9,8,0,8,609
12083000605,2849,2543,128,14,20,11,0,7,306
12083000606,3244,2907,126,21,17,8,4,6,337
12083000607,3111,2723,177,32,18,5,0,3,388
12083000703,4029,3084,445,232,24,35,1,31,945
12083000704,1931,1629,109,100,3,7,1,11,302
12083000705,1867,1501,179,78,0,21,0,5,366
12083000706,4607,4068,225,150,11,42,6,12,539
12083000707,2107,1759,174,73,6,2,0,8,348
12083000803,3740,2757,527,188,5,26,3,20,983
12083000804,1590,1337,146,20,4,16,0,0,253
12083000805,5412,4444,531,125,15,100,11,11,968
12083000806,2526,2390,67,25,1,13,0,0,136
12083000807,2337,2081,99,69,4,27,0,5,256
12083000808,3020,2737,143,28,2,41,0,8,283
12083000809,2565,2383,76,21,1,34,1,7,182
12083000810,3345,2925,203,75,11,38,3,2,420
12083000811,4203,3888,119,83,3,28,0,14,315
12083000901,6413,4477,1186,418,34,58,1,42,1936
12083000903,3325,2241,732,178,13,30,3,4,1084
12083000904,6902,4612,1683,277,20,26,0,20,2290
12083001003,1630,1244,289,19,6,10,0,1,386
12083001005,7609,3490,1978,1617,14,105,4,73,4119
12083001007,6345,4606,839,517,7,81,3,53,1739
12083001008,4887,4079,423,156,9,70,1,17,808
12083001009,7799,4149,1786,1029,24,349,8,85,3650
12083001010,3725,2990,388,163,6,78,1,6,735
12083001011,4176,2295,1039,586,4,26,4,45,1881
12083001012,3294,1098,1175,775,2,41,1,21,2196
12083001013,8201,2268,3692,1783,17,109,2,77,5933
12083001102,3124,2239,493,175,3,33,7,8,885
12083001103,7391,4336,1527,1022,12,93,7,35,3055
12083001105,4444,3126,733,277,13,29,3,25,1318
12083001106,2713,2048,361,149,6,34,0,2,665
12083001204,7815,2802,2155,2203,46,113,2,76,5013
12083001205,4150,3262,365,248,8,72,3,23,888
12083001206,1961,949,461,383,12,22,2,25,1012
12083001208,3949,2887,514,317,19,43,0,21,1062
12083001209,3592,1973,878,518,10,55,3,22,1619
12083001210,6205,3280,1240,1112,12,169,4,77,2925
12083001211,3613,1611,737,998,10,53,0,26,2002
12083001301,6714,4603,746,921,13,61,1,19,2111
12083001302,6555,4813,671,655,25,76,3,13,1742
12083001401,5621,2669,819,1801,9,34,3,36,2952
12083001403,5453,3613,700,740,22,161,0,19,1840
12083001404,1096,698,153,167,1,9,0,4,398
12083001500,3765,1276,323,1950,24,8,1,12,2489
12083001600,4098,2132,858,863,9,134,0,17,1966
12083001700,5156,777,1788,2412,3,30,1,15,4379
12083001800,1634,87,259,1214,4,0,1,4,1547
12083001900,2585,1676,460,258,10,47,0,11,909
12083002001,2665,1781,358,373,6,29,2,15,884
12083002002,4283,2337,685,956,3,59,3,14,1946
12083002100,5100,4110,465,186,5,61,0,8,990
12083002201,3769,2695,531,265,8,102,1,14,1074
12083002202,3693,3121,329,110,2,18,1,7,572
12083002203,7089,4859,826,870,15,218,1,39,2230
12083002302,6637,4918,720,544,8,98,3,32,1719
12083002303,1781,1228,250,172,3,14,1,4,553
12083002304,5663,4376,554,295,2,210,2,13,1287
12083002401,5160,3306,774,462,6,394,3,16,1854
12083002402,5760,4149,668,347,22,307,2,30,1611
12083002503,7089,4271,1135,1306,20,52,0,35,2818
12083002504,5788,3449,1001,1030,17,102,3,21,2339
12083002505,6574,4272,983,445,9,580,0,35,2302
12083002506,2430,1385,794,128,7,26,1,10,1045
12083002507,5856,2871,1632,569,6,489,4,47,2985
12083002602,7213,4265,2010,613,18,36,0,33,2948
12083002604,3859,2722,667,238,21,40,0,4,1137
12083002605,6848,6137,319,153,9,74,3,20,711
12083002607,4021,2904,750,151,11,19,2,17,1117
12083002608,3023,2312,397,193,10,10,2,6,711
12083002609,2949,2615,208,49,0,38,0,9,334
12083002610,4165,3704,218,117,11,44,0,27,461
12083002703,2695,2084,198,292,5,23,1,11,611
12083002704,4256,3683,280,96,20,33,6,17,573
12083002705,5422,4322,628,174,18,34,0,20,1100
12083002706,1216,1004,126,25,3,3,0,9,212
12083980000,0,0,0,0,0,0,0,0,0
12083980100,0,0,0,0,0,0,0,0,0
12085000100,2779,2596,115,3,1,11,0,9,183
12085000200,3626,3197,201,67,4,47,0,23,429
12085000300,6033,4858,564,200,10,133,0,26,1175
12085000400,7875,6699,588,122,8,117,0,44,1176
12085000501,4558,3928,306,108,6,44,0,14,630
12085000502,1991,1762,118,15,3,36,0,2,229
12085000603,6450,5134,751,88,10,201,4,17,1316
12085000604,6076,5134,496,44,5,184,0,25,942
12085000606,6615,5485,591,102,16,164,2,25,1130
12085000607,2720,2501,111,13,4,27,2,13,219
12085000610,4022,3549,246,6,0,58,6,10,473
12085000701,1671,1481,112,24,0,18,0,4,190
12085000702,2125,1729,146,187,6,16,0,4,396
12085000800,2280,887,352,915,4,23,0,3,1393
12085000901,2379,2177,115,23,1,18,0,6,202
12085000902,4717,3646,591,253,8,47,2,20,1071
12085001000,6317,3480,1803,675,13,116,0,35,2837
12085001103,2765,2349,232,59,2,43,0,5,416
12085001105,3580,2446,803,148,6,62,0,16,1134
12085001106,5366,3936,866,135,12,160,8,24,1430
12085001107,2221,1677,306,55,1,37,0,14,544
12085001108,4933,4499,224,38,2,65,0,10,434
12085001200,2169,933,953,161,6,18,1,7,1236
12085001301,5966,2846,2761,199,9,26,0,18,3120
12085001302,4075,3662,235,36,6,16,0,10,413
12085001404,6257,4880,705,400,6,61,2,13,1377
12085001406,3297,2826,214,60,2,63,2,7,471
12085001407,2195,1961,116,26,4,15,0,8,234
12085001408,3154,2172,510,292,8,25,3,10,982
12085001409,3033,2588,244,80,0,33,2,0,445
12085001410,5969,4006,1161,575,8,43,0,15,1963
12085001500,3755,3383,182,37,8,41,3,12,372
12085001601,4220,3835,219,21,4,28,1,8,385
12085001602,1269,1103,108,4,0,9,0,0,166
12085001701,4144,3444,412,57,3,58,0,12,700
12085001702,2627,1977,425,80,8,65,1,3,650
12085001703,4619,3741,537,72,14,54,0,23,878
12085001803,2435,346,1973,81,6,6,0,1,2089
12085001804,4508,1025,2646,727,1,32,3,17,3483
12085001805,1227,418,769,5,2,22,0,0,809
12085001806,2413,920,380,1084,1,4,0,12,1493
12085990000,0,0,0,0,0,0,0,0,0
12085990100,0,0,0,0,0,0,0,0,0
12086000107,2924,1330,1133,69,1,30,0,62,1594
12086000109,3782,855,2257,349,12,47,0,45,2927
12086000115,3100,1788,1130,66,0,17,0,19,1312
12086000118,1373,914,306,13,0,40,0,6,459
12086000120,4669,1605,2501,215,5,112,0,38,3064
12086000121,1720,1032,527,53,1,22,0,21,688
12086000122,4108,2166,1602,92,0,77,0,26,1942
12086000123,4194,2565,1337,38,1,73,0,33,1629
12086000124,3260,443,1509,1036,5,74,0,114,2817
12086000125,3774,2284,1148,55,2,66,1,37,1490
12086000126,1930,1054,779,8,0,24,1,7,876
12086000127,3306,1328,1664,79,3,91,2,23,1978
12086000128,4181,1538,2119,156,2,93,0,48,2643
12086000129,2305,1455,640,36,2,38,2,10,850
12086000130,2826,1482,1064,36,4,60,0,33,1344
12086000131,4721,2229,1910,88,2,102,0,51,2492
12086000132,4888,1869,2450,243,4,91,0,58,3019
12086000134,3143,1241,1540,118,0,102,0,28,1902
12086000140,3199,1058,1825,75,5,37,0,60,2141
12086000141,2692,1247,1111,109,1,86,2,18,1445
12086000142,6149,3212,2397,115,5,107,0,50,2937
12086000143,2712,1435,1041,69,0,49,0,9,1277
12086000144,1405,605,585,76,1,29,0,10,800
12086000145,2332,1293,870,21,0,39,4,9,1039
12086000146,4067,2115,1552,81,5,86,0,34,1952
12086000204,4602,247,1208,2914,3,122,0,29,4355
12086000206,5297,235,1482,3297,0,131,0,39,5062
12086000211,3171,578,1874,462,5,106,0,38,2593
12086000212,5234,457,2128,2395,11,111,1,29,4777
12086000213,5318,1909,1142,1771,7,299,0,87,3409
12086000215,4171,129,649,3202,3,62,2,22,4042
12086000216,3965,221,894,2649,1,123,0,9,3744
12086000218,3403,102,738,2469,2,27,0,17,3301
12086000219,4407,389,1600,2189,8,62,4,45,4018
12086000220,4593,314,1432,2599,10,102,0,22,4279
12086000221,2398,287,1440,499,0,97,0,13,2111
12086000222,4379,631,2773,527,1,320,0,28,3748
12086000223,3541,321,882,2223,3,33,0,17,3220
12086000224,4610,386,1345,2661,4,47,0,39,4224
12086000225,4107,455,2211,1087,6,182,0,40,3652
12086000226,2556,1693,373,272,8,101,1,27,863
12086000227,2644,84,741,1690,0,89,0,10,2560
12086000228,2860,96,569,2138,2,17,0,15,2764
12086000302,2274,181,745,1217,4,66,2,10,2093
12086000306,5017,405,1356,3041,7,74,0,22,4612
12086000307,4391,218,1531,2517,5,37,0,8,4173
12086000308,5104,386,1486,3020,4,87,0,38,4718
12086000309,3359,119,659,2490,10,19,0,8,3240
12086000310,4046,258,827,2749,2,78,3,29,3788
12086000311,3693,229,705,2578,17,63,4,24,3464
12086000312,3826,270,887,2477,1,104,0,17,3556
12086000402,3670,56,1147,2394,7,5,0,21,3614
12086000405,4433,110,1174,3037,0,40,0,21,4323
12086000408,6376,222,2574,3451,7,7,0,33,6154
12086000409,4464,61,1237,3049,1,16,0,21,4403
12086000410,3861,77,1127,2566,4,27,0,14,3784
12086000411,5445,97,1253,3978,5,17,1,10,5348
12086000413,4709,110,1045,3406,3,33,2,22,4599
12086000414,5016,117,813,3965,2,7,0,29,4899
12086000415,2338,79,1017,1190,0,2,0,17,2259
12086000416,4455,111,2297,1973,4,2,0,29,4344
12086000417,4100,61,1483,2459,6,10,0,27,4039
12086000418,2818,44,653,2071,1,2,0,9,2774
12086000419,2781,54,1092,1565,2,9,0,11,2727
12086000420,3674,68,1208,2320,0,6,0,27,3606
12086000504,4689,118,2820,1668,13,10,0,13,4571
12086000505,5441,231,5053,108,0,9,2,12,5210
12086000506,2655,58,897,1651,1,13,1,14,2597
12086000507,4856,253,3250,1195,3,35,5,72,4603
12086000508,4117,61,1566,2436,0,0,0,8,4056
12086000509,3257,88,1951,1147,4,19,1,15,3169
12086000601,5035,300,4701,5,0,10,0,8,4735
12086000602,5021,316,4673,0,2,4,0,11,4705
12086000603,5132,239,4856,9,4,9,0,8,4893
12086000605,4512,227,4112,120,4,10,0,20,4285
12086000607,4800,196,4562,0,0,11,0,23,4604
12086000609,3429,96,3302,13,0,3,0,6,3333
12086000610,2736,70,2651,1,1,0,0,3,2666
12086000611,2986,134,2826,7,0,4,4,3,2852
12086000612,3036,127,2874,15,0,1,0,6,2909
12086000705,4870,127,4689,27,2,9,0,13,4743
12086000710,5133,162,4924,28,1,0,0,6,4971
12086000711,6309,180,5862,230,0,3,0,14,6129
12086000712,2362,93,2244,7,1,1,0,6,2269
12086000713,2864,75,2765,12,0,5,0,2,2789
12086000714,4528,180,4327,7,1,5,0,0,4348
12086000715,3753,135,3569,9,2,17,0,11,3618
12086000716,2689,90,2561,4,1,15,0,10,2599
12086000717,2745,136,2575,5,2,4,0,14,2609
12086000718,3382,131,3178,30,0,16,0,6,3251
12086000719,1450,47,1391,0,0,3,0,6,1403
12086000720,3922,154,3746,7,0,0,0,6,3768
12086000804,4451,217,4201,12,0,5,0,9,4234
12086000805,5634,271,5319,13,0,8,0,9,5363
12086000806,4557,123,4374,24,0,13,0,7,4434
12086000807,3632,131,3437,42,2,3,0,5,3501
12086000808,4044,161,3819,38,0,4,1,8,3883
12086000903,3469,77,2162,1160,0,4,0,27,3392
12086000904,2384,71,1616,677,2,0,0,2,2313
12086000905,4215,102,3475,570,0,6,2,19,4113
12086000906,1986,65,1558,342,4,0,0,5,1921
12086000907,1938,61,1711,146,6,3,0,1,1877
12086000908,3716,111,3372,185,0,4,0,19,3605
12086001003,5715,93,2379,3146,1,13,2,14,5622
12086001004,7409,149,2262,4822,9,16,1,49,7260
12086001005,2107,35,513,1501,0,7,0,8,2072
12086001006,4575,263,1533,2609,11,42,3,35,4312
12086001007,3472,71,1165,2163,0,3,1,14,3401
12086001008,2941,65,1274,1530,0,11,0,15,2876
12086001101,5106,604,1599,2534,9,131,0,124,4502
12086001102,5809,1024,1823,2688,8,71,1,25,4785
12086001103,3938,473,1469,1862,6,35,0,22,3465
12086001104,4344,1696,1697,621,4,106,2,36,2648
12086001204,5992,1932,3030,664,8,116,0,66,4060
12086001205,3082,1324,1277,227,1,109,2,15,1758
12086001206,4835,2318,1844,367,7,114,1,31,2517
12086001207,1574,496,750,229,4,22,0,15,1078
12086001208,2981,356,1082,1311,0,88,0,28,2625
12086001209,3916,254,1417,2053,7,71,2,18,3662
12086001301,5094,1005,2438,1315,3,125,0,54,4089
12086001302,4992,1666,2205,790,0,61,0,45,3326
12086001401,4713,105,1250,3226,5,22,0,15,4608
12086001402,4717,223,1651,2707,4,39,0,21,4494
12086001501,3022,38,763,2130,12,8,0,17,2984
12086001502,4314,53,1181,3012,0,0,0,20,4261
12086001603,3276,146,3105,6,1,8,0,4,3130
12086001605,3968,123,3764,57,0,7,0,6,3845
12086001606,4429,165,4189,38,5,9,0,11,4264
12086001607,2853,133,2680,20,1,2,0,4,2720
12086001608,3018,139,2844,8,2,6,0,3,2879
12086001701,4363,112,2402,1798,3,0,0,8,4251
12086001702,3814,95,1804,1865,5,4,0,7,3719
12086001704,3119,124,2891,81,0,4,0,10,2995
12086001705,2109,67,1975,41,2,2,0,9,2042
12086001801,3924,81,1321,2472,7,5,1,9,3843
12086001802,4144,89,1931,2031,2,13,0,22,4055
12086001803,3307,53,1349,1837,0,3,1,20,3254
12086001901,4950,66,1491,3291,9,5,1,4,4884
12086001903,3313,49,931,2260,0,10,4,9,3264
12086001904,4596,95,1502,2894,4,2,0,21,4501
12086002001,3647,105,667,2765,3,13,0,7,3542
12086002003,3453,73,1133,2142,2,19,0,10,3380
12086002004,2497,113,864,1468,1,6,0,15,2384
12086002100,2910,1134,1294,257,5,80,0,25,1776
12086002201,3125,505,1596,880,0,56,3,21,2620
12086002202,4725,307,1739,2489,7,21,0,15,4418
12086002300,5287,99,2244,2842,5,11,0,21,5188
12086002402,5554,148,5055,280,2,5,0,35,5406
12086002403,4192,117,3957,87,1,4,1,8,4075
12086002404,5394,149,4830,356,1,8,0,24,5245
12086002501,5459,156,4506,732,3,16,0,21,5303
12086002502,3388,101,2524,710,3,18,0,10,3287
12086002600,6169,1300,3892,614,2,94,4,42,4869
12086002702,4537,1132,2728,396,4,82,0,50,3405
12086002705,4325,1474,2175,259,1,111,0,49,2851
12086002707,2987,1066,1411,152,2,117,2,51,1921
12086002708,3043,844,1852,127,3,79,0,17,2199
12086002709,5273,2107,2277,305,8,253,0,56,3166
12086002710,1766,847,703,72,4,46,0,18,919
12086002800,1269,223,701,277,1,21,2,12,1046
12086002900,5450,254,4686,436,3,15,0,30,5196
12086003001,3155,420,1844,619,5,168,0,27,2735
12086003004,5030,336,3703,850,3,56,1,33,4694
12086003005,1673,78,1540,25,0,12,0,6,1595
12086003006,4611,216,4111,203,0,33,0,9,4395
12086003100,4654,154,1261,3120,6,21,0,17,4500
12086003400,3042,112,1343,1507,0,8,0,18,2930
12086003603,2041,133,1741,84,3,43,0,15,1908
12086003604,2520,373,2029,39,0,24,0,9,2147
12086003605,3433,254,2967,108,2,24,0,16,3179
12086003606,2007,174,1523,255,0,17,0,5,1833
12086003607,2206,56,1422,667,0,9,0,20,2150
12086003703,2919,1159,1234,167,2,161,1,48,1760
12086003704,1759,407,1059,123,2,73,0,26,1352
12086003705,2483,749,1406,99,2,88,0,37,1734
12086003706,1425,294,583,547,0,0,0,0,1131
12086003707,2228,800,1042,141,0,75,1,33,1428
12086003708,1486,668,633,22,0,75,0,17,818
12086003709,1642,280,1105,120,1,41,0,22,1362
12086003710,6562,2002,3469,426,2,279,0,102,4560
12086003801,6006,2794,2759,111,0,72,0,55,3212
12086003803,3093,2036,829,32,1,46,0,29,1057
12086003804,5689,2717,2512,59,2,79,3,69,2972
12086003906,2746,1805,753,24,0,25,2,20,941
12086003909,1573,424,978,84,0,24,0,22,1149
12086003911,4076,838,2959,133,2,51,3,24,3238
12086003912,3903,946,2589,148,5,79,1,45,2957
12086003913,3981,766,2877,119,9,66,0,30,3215
12086003914,4243,1184,2659,110,2,67,2,30,3059
12086003915,4709,1065,3285,119,9,50,0,31,3644
12086003916,3684,996,2307,156,3,66,1,39,2688
12086003917,4948,1263,3063,254,3,116,0,49,3685
12086003918,3211,1116,1731,134,0,93,0,41,2095
12086003919,2443,1209,1019,40,3,39,1,18,1234
12086003921,3082,1096,1718,34,0,80,0,39,1986
12086003922,1846,783,923,17,1,27,0,14,1063
12086004000,5007,3298,1374,75,1,71,0,60,1709
12086004102,2881,1848,809,33,0,58,2,12,1033
12086004103,1924,534,1257,41,0,27,0,18,1390
12086004105,2376,1073,1089,44,4,52,1,19,1303
12086004106,3220,2064,846,54,4,83,1,31,1156
12086004204,2080,740,1124,85,0,50,3,17,1340
12086004205,2246,962,1028,78,2,53,0,32,1284
12086004206,1362,535,663,64,0,34,0,14,827
12086004207,2190,1112,828,83,3,64,0,23,1078
12086004208,1449,669,651,28,0,28,0,15,780
12086004301,2490,1307,906,75,2,58,1,33,1183
12086004303,2427,764,1396,102,0,69,0,29,1663
12086004304,2203,868,1123,67,2,56,0,27,1335
12086004403,2671,872,1498,96,7,64,2,24,1799
12086004404,1868,672,1024,62,8,40,0,23,1196
12086004405,3030,825,1932,73,4,50,2,62,2205
12086004406,2755,1447,983,91,3,68,0,31,1308
12086004500,4986,2995,1454,73,2,126,0,67,1991
12086004602,4301,1100,3001,8,0,30,0,27,3201
12086004605,4265,1188,2803,5,0,27,0,26,3077
12086004607,4306,1206,2786,6,2,34,0,22,3100
12086004608,1973,507,1309,8,1,15,0,13,1466
12086004701,5431,1247,4012,30,4,53,2,16,4184
12086004703,4869,648,4067,53,9,41,0,10,4221
12086004704,2364,289,2008,14,3,15,0,13,2075
12086004705,3559,631,2812,24,0,37,0,16,2928
12086004901,3291,110,3114,37,0,7,0,9,3181
12086004903,3828,162,3606,17,0,12,0,11,3666
12086004904,2488,144,2301,8,3,16,0,5,2344
12086005002,5335,209,5036,20,0,23,0,23,5126
12086005003,2975,139,2791,23,0,7,0,11,2836
12086005004,3707,183,3471,5,0,7,0,17,3524
12086005102,4127,342,3515,150,0,33,1,24,3785
12086005103,2521,65,2394,18,3,20,0,7,2456
12086005104,4250,258,3813,83,1,45,0,20,3992
12086005201,5580,246,5177,97,6,4,0,30,5334
12086005202,5245,192,4929,78,1,11,0,19,5053
12086005303,3647,117,3352,138,0,6,0,12,3530
12086005304,4321,162,4060,52,2,6,0,18,4159
12086005305,3283,118,3036,65,0,18,0,26,3165
12086005306,3977,171,3647,80,1,21,0,24,3806
12086005403,1570,43,1515,2,0,5,0,2,1527
12086005405,3496,204,3215,44,2,13,0,7,3292
12086005406,3961,229,3635,57,0,2,0,24,3732
12086005407,2535,135,2370,2,1,9,0,3,2400
12086005409,3738,112,3554,42,0,6,0,13,3626
12086005410,3318,103,3172,12,0,4,0,11,3215
12086005503,3331,140,3154,11,0,10,0,4,3191
12086005504,3652,173,3424,14,4,19,0,4,3479
12086005505,2984,123,2806,9,1,31,0,7,2861
12086005506,2864,102,2712,14,3,7,0,16,2762
12086005600,4576,341,4098,29,0,46,1,18,4235
12086005701,5947,198,5705,6,0,9,0,4,5749
12086005705,3680,126,3497,16,0,8,0,23,3554
12086005706,4213,198,3915,31,1,29,0,11,4015
12086005707,1795,57,1720,5,3,2,0,5,1738
12086005708,6022,220,5734,4,0,22,0,20,5802
12086005803,5299,230,4983,14,0,32,0,15,5069
12086005804,3662,143,3474,8,0,26,0,2,3519
12086005805,2787,136,2591,11,4,25,0,6,2651
12086005806,3700,154,3505,10,0,19,0,5,3546
12086005901,4462,323,4039,31,0,26,1,10,4139
12086005902,3790,186,3558,16,0,7,0,12,3604
12086005903,5141,272,4797,14,3,25,2,8,4869
12086005904,5653,497,4973,71,1,53,3,16,5156
12086006002,5169,644,4381,36,0,46,1,16,4525
12086006003,3201,275,2853,9,0,34,0,6,2926
12086006004,2959,508,2370,11,1,25,0,8,2451
12086006103,1897,746,1076,7,0,37,0,6,1151
12086006104,4275,1361,2732,30,1,55,0,7,2914
12086006105,2260,626,1494,15,0,63,1,11,1634
12086006106,2743,763,1837,26,8,38,0,9,1980
12086006201,2729,421,2185,35,0,21,0,10,2308
12086006203,2155,663,1363,18,0,47,2,16,1492
12086006205,4313,718,3299,58,4,110,0,19,3595
12086006206,3838,1188,2388,40,0,118,3,14,2650
12086006302,5235,578,4462,40,3,61,0,28,4657
12086006303,3865,207,3579,18,3,17,0,12,3658
12086006304,3045,251,2703,31,1,27,0,16,2794
12086006401,3240,188,2967,16,1,24,0,14,3052
12086006402,3792,350,3290,60,7,29,0,28,3442
12086006403,3202,335,2753,29,0,47,0,11,2867
12086006501,3063,316,2677,13,0,18,0,10,2747
12086006503,2448,298,2039,14,3,53,0,9,2150
12086006504,2120,276,1750,17,0,30,3,13,1844
12086006603,2146,467,1441,64,6,69,0,30,1679
12086006604,2115,341,1520,89,0,61,0,10,1774
12086006605,1601,627,780,51,0,75,0,10,974
12086006606,1748,88,1543,84,0,4,0,12,1660
12086006607,3544,221,3223,36,2,17,0,20,3323
12086006608,3539,540,2775,21,1,67,2,16,2999
12086006705,4532,1189,3015,44,1,67,0,48,3343
12086006706,2404,605,1658,32,2,23,0,15,1799
12086006707,5076,1680,2844,80,2,116,0,27,3396
12086006709,2359,1055,1017,50,1,74,0,20,1304
12086006713,2416,860,1231,65,0,95,0,25,1556
12086006714,2304,777,1334,25,1,55,0,27,1527
12086006715,4378,1012,3016,88,0,76,0,27,3366
12086006716,1386,576,635,42,2,52,0,18,810
12086006717,2309,828,1055,71,1,166,0,37,1481
12086006718,3979,1658,1827,83,0,149,0,30,2321
12086006719,2934,1334,1096,130,3,140,0,51,1600
12086006720,2929,991,1559,71,0,124,1,22,1938
12086006721,2620,1124,1140,95,1,112,2,22,1496
12086006722,1754,481,1031,62,4,45,0,32,1273
12086006801,3547,1959,1265,33,1,74,0,19,1588
12086006802,4037,1787,1963,32,2,66,1,33,2250
12086006901,2818,420,2273,26,5,40,0,14,2398
12086006902,2911,480,2267,51,3,35,0,11,2431
12086007003,4374,395,3742,70,0,91,0,19,3979
12086007004,5141,703,4134,82,0,115,1,24,4438
12086007005,2324,306,1906,31,0,40,1,17,2018
12086007006,3473,361,2998,35,2,26,0,22,3112
12086007007,2410,636,1608,45,1,69,0,14,1774
12086007101,2600,610,1217,611,8,28,1,21,1990
12086007103,1747,890,678,62,3,36,0,9,857
12086007104,3289,1457,1500,104,4,56,0,25,1832
12086007200,2537,385,566,1496,1,13,1,14,2152
12086007300,4248,2363,1561,63,2,66,0,16,1885
12086007401,1660,597,961,1,1,33,0,9,1063
12086007402,2959,933,1850,42,0,39,0,15,2026
12086007403,2775,952,1576,40,3,69,1,24,1823
12086007501,2763,872,1724,18,1,71,0,12,1891
12086007503,882,323,486,8,3,24,0,3,559
12086007601,2601,730,1725,35,2,32,0,7,1871
12086007603,3959,910,1434,1222,4,214,0,50,3049
12086007605,4035,867,2900,96,9,70,1,18,3168
12086007607,2500,629,1754,24,0,28,2,12,1871
12086007608,2547,781,1319,286,0,76,0,11,1766
12086007609,1867,431,951,64,1,348,0,21,1436
12086007610,4734,1568,2620,90,2,268,0,44,3166
12086007704,6394,1246,4299,196,9,424,0,61,5148
12086007705,5670,1020,4238,98,0,169,0,26,4650
12086007706,3569,774,2643,52,0,50,0,11,2795
12086007707,2403,280,2076,4,2,15,1,6,2123
12086007708,3055,244,2742,14,1,20,0,4,2811
12086007709,3222,277,2896,6,1,9,1,6,2945
12086007801,830,389,387,6,0,21,1,4,441
12086007805,4934,1210,3442,81,2,88,0,25,3724
12086007806,3965,1713,1895,43,0,159,1,15,2252
12086007807,4438,1695,2262,67,2,243,0,27,2743
12086007808,4091,904,2541,108,9,366,0,36,3187
12086007809,4283,817,2981,176,2,183,0,13,3466
12086007901,3662,1294,2106,39,0,96,0,27,2368
12086007902,3465,1528,1717,41,0,54,0,15,1937
12086008000,5227,2075,2813,44,6,104,0,26,3152
12086008101,3746,1673,1729,72,0,117,3,18,2073
12086008102,4754,1898,2318,98,0,230,0,47,2856
12086008202,4283,1568,2201,139,0,199,0,16,2715
12086008205,3972,1809,1784,43,0,165,0,21,2163
12086008206,4184,1760,1949,114,4,215,0,25,2424
12086008207,4117,1860,1843,83,1,158,0,34,2257
12086008208,4915,1241,2745,551,5,207,2,20,3674
12086008209,4661,1746,2211,252,6,269,0,24,2915
12086008305,5393,1498,3156,304,1,232,0,47,3895
12086008308,5770,347,3773,1444,4,70,0,42,5423
12086008309,4832,80,1292,3362,4,17,2,11,4752
12086008310,3256,436,1842,755,5,99,1,36,2820
12086008311,4104,361,2403,1097,7,94,0,45,3743
12086008312,3325,98,1465,1693,1,7,0,12,3227
12086008313,4644,120,1549,2861,10,24,2,34,4524
12086008314,2696,158,1565,808,2,66,0,30,2538
12086008315,3442,251,1775,1213,3,67,0,41,3191
12086008409,5526,1533,3290,303,2,171,0,38,3993
12086008415,5047,1592,3165,112,1,92,1,5,3455
12086008416,3804,588,3018,60,0,69,2,6,3216
12086008418,2791,325,2265,50,0,109,0,7,2466
12086008419,5086,775,4044,96,1,80,1,30,4311
12086008420,1669,570,996,48,1,18,0,8,1099
12086008421,4250,804,3148,89,0,83,0,24,3446
12086008422,2790,429,2239,23,0,53,4,5,2361
12086008423,4472,863,3437,37,3,65,0,10,3609
12086008424,3622,359,3051,89,2,49,5,18,3263
12086008425,2048,304,1593,46,0,46,0,9,1744
12086008426,4603,1130,2933,287,0,113,0,25,3473
12086008427,2415,517,1694,87,0,67,3,6,1898
12086008428,2846,680,1995,90,4,45,0,3,2166
12086008429,3547,815,2521,54,1,90,0,20,2732
12086008430,5346,504,4518,190,0,74,1,12,4842
12086008431,2606,798,1644,64,2,44,0,11,1808
12086008502,4448,574,3666,34,0,106,0,13,3874
12086008503,3459,345,3060,8,1,24,0,3,3114
12086008504,2939,384,2499,18,1,16,1,8,2555
12086008601,4888,397,4401,21,2,27,0,15,4491
12086008603,4293,499,3672,22,3,44,1,7,3794
12086008604,1885,184,1605,11,0,58,0,0,1701
12086008702,5505,566,4808,19,1,64,0,10,4939
12086008703,2581,181,2352,6,0,30,0,6,2400
12086008704,3287,385,2865,9,0,9,1,1,2902
12086008805,4999,249,4677,3,1,22,0,12,4750
12086008806,3887,245,3609,7,0,5,0,8,3642
12086008807,3478,207,3223,1,1,16,0,9,3271
12086008808,3916,187,3673,18,0,13,0,6,3729
12086008809,2772,178,2512,6,0,58,1,0,2594
12086008810,3886,219,3589,15,0,37,0,5,3667
12086008904,3285,592,1301,1077,7,193,7,59,2693
12086008906,5464,327,4999,22,0,90,0,9,5137
12086008907,4583,363,3936,73,4,165,0,12,4220
12086008908,3282,183,3050,6,0,18,0,10,3099
12086008909,3984,217,3727,4,0,7,0,4,3767
12086008910,3316,207,3058,6,0,32,0,5,3109
12086008911,3255,310,2884,6,0,39,0,5,2945
12086009010,8427,1066,6595,185,6,284,0,53,7361
12086009014,4341,283,3873,42,6,104,0,6,4058
12086009015,6856,282,6373,27,1,73,1,32,6574
12086009020,2957,117,2696,45,0,54,0,12,2840
12086009021,4459,180,4159,24,2,67,0,12,4279
12086009022,2255,84,2122,11,0,22,0,5,2171
12086009024,5967,387,4913,95,6,431,1,45,5580
12086009026,2349,140,2149,25,0,14,0,4,2209
12086009027,4410,298,3927,39,2,93,2,18,4112
12086009028,5819,301,5293,36,2,108,1,24,5518
12086009029,4090,307,3586,15,0,136,0,11,3783
12086009030,5157,274,4757,32,0,46,1,23,4883
12086009031,4102,189,3733,33,0,109,0,16,3913
12086009039,6282,578,5207,93,5,177,1,44,5704
12086009040,7103,626,5979,59,5,191,2,72,6477
12086009043,5266,535,4368,57,8,120,0,33,4731
12086009044,3424,269,3002,26,0,59,0,14,3155
12086009048,3661,483,2898,32,2,111,0,17,3178
12086009049,5045,437,4333,19,2,112,0,44,4608
12086009050,4807,344,4253,22,0,60,0,38,4463
12086009051,2471,180,2247,10,0,14,0,9,2291
12086009052,3580,164,3370,7,3,8,0,4,3416
12086009053,3972,239,3530,27,1,109,0,15,3733
12086009054,1703,74,1610,2,1,7,0,4,1629
12086009055,2293,123,2137,6,3,11,0,2,2170
12086009056,2827,386,2139,26,2,128,0,17,2441
12086009057,5623,446,4794,67,1,148,4,39,5177
12086009058,4866,561,3948,26,1,175,0,21,4305
12086009059,3538,268,3002,56,1,116,0,25,3270
12086009060,5452,521,4550,78,5,144,0,22,4931
12086009061,3250,85,3139,6,0,0,0,11,3165
12086009062,3221,173,2936,17,2,62,0,11,3048
12086009063,2853,99,2694,6,3,30,0,8,2754
12086009064,2961,153,2715,31,7,20,0,14,2808
12086009065,2942,293,2463,46,0,71,0,10,2649
12086009066,6910,647,5679,91,4,284,1,50,6263
12086009101,2803,125,2635,11,1,4,0,13,2678
12086009102,3842,324,3042,451,0,5,0,8,3518
12086009200,3406,207,3164,2,0,9,0,11,3199
12086009305,5108,768,4183,38,1,50,0,18,4340
12086009312,5795,699,4641,251,2,115,0,16,5096
12086009314,3845,141,3663,10,0,17,0,5,3704
12086009315,3507,169,3305,7,2,8,0,5,3338
12086009316,2873,203,2631,7,0,8,0,16,2670
12086009317,4431,277,4087,24,0,7,0,16,4154
12086009318,1922,161,1676,33,0,28,0,14,1761
12086009319,3567,445,2968,63,2,40,2,18,3122
12086009320,4265,163,4054,16,2,7,0,11,4102
12086009321,2553,114,2408,0,1,17,0,1,2439
12086009322,3557,146,3377,15,0,6,0,4,3411
12086009323,2963,157,2783,3,5,3,0,4,2806
12086009324,4620,208,4312,75,3,4,0,9,4412
12086009325,1852,91,1729,19,0,5,0,3,1761
12086009326,3121,128,2944,12,0,17,0,4,2993
12086009327,3156,199,2943,2,1,2,0,4,2957
12086009401,2454,88,1009,1302,5,7,0,5,2366
12086009402,3690,81,1799,1759,0,2,0,11,3609
12086009503,4560,86,1068,3321,5,5,0,15,4474
12086009504,4658,77,871,3610,2,33,0,12,4581
12086009505,1434,25,160,1222,0,3,1,3,1409
12086009506,4126,75,740,3156,0,16,0,43,4051
12086009601,3451,250,777,2308,0,40,1,14,3201
12086009602,3569,129,495,2854,3,9,0,18,3440
12086009703,3719,1996,1406,127,0,63,0,22,1723
12086009704,6259,2717,2776,402,3,130,0,56,3542
12086009705,4827,1003,3068,480,5,79,0,52,3824
12086009706,4058,1056,2364,343,1,95,0,32,3002
12086009803,7564,682,2537,3911,14,149,0,86,6882
12086009804,3450,535,1158,1452,1,105,7,50,2915
12086009806,3042,587,1158,1036,1,70,1,39,2455
12086009809,3151,245,773,1936,8,97,0,18,2906
12086009810,3879,454,1157,2035,0,78,0,28,3425
12086009811,2656,186,1022,1221,2,144,0,10,2470
12086009812,5311,1162,2247,1408,5,134,4,98,4149
12086009903,5208,76,758,4246,0,12,0,28,5132
12086009904,3914,77,652,3101,4,35,0,3,3837
12086009905,5336,145,693,4333,6,16,0,47,5191
12086009906,5569,150,1125,4095,11,32,2,41,5419
12086009907,3798,150,367,3041,0,150,0,23,3648
12086009908,4280,54,660,3407,8,33,0,39,4226
12086009909,2240,43,343,1745,0,34,1,13,2197
12086010010,4794,100,2866,1731,3,18,0,37,4694
12086010012,5333,92,1476,3515,5,49,0,42,5241
12086010013,4164,174,3153,721,0,53,0,14,3990
12086010015,4321,204,3822,61,2,199,0,14,4117
12086010016,4733,261,3929,473,3,28,0,18,4472
12086010017,3958,171,3015,685,2,18,2,26,3787
12086010018,3577,192,2939,393,0,18,0,13,3385
12086010019,3921,81,2527,1263,12,6,0,8,3840
12086010020,3763,113,2539,1060,0,6,0,18,3650
12086010021,4328,120,2051,2080,0,3,0,20,4208
12086010022,3408,127,2175,1048,1,13,0,21,3281
12086010023,2247,39,561,1562,3,8,0,21,2208
12086010024,4770,77,1537,3082,0,2,0,23,4693
12086010025,3992,68,985,2839,4,21,1,13,3924
12086010026,2618,36,1411,1138,0,2,0,16,2582
12086010193,4517,519,3503,155,0,221,0,23,3998
12086010198,3336,411,2480,269,6,80,0,23,2925
12086010201,4952,563,3772,398,19,96,0,31,4389
12086010205,4819,266,3823,591,4,48,0,41,4553
12086010207,4467,186,3330,837,1,44,0,15,4281
12086010208,4768,184,3576,871,8,57,0,22,4584
12086010209,5542,319,4152,897,3,67,0,35,5223
12086010211,4479,292,3779,310,0,50,0,21,4187
12086010212,2594,269,1806,332,5,93,2,44,2325
12086010213,4606,227,3209,1044,0,46,0,19,4379
12086010214,2307,117,1484,585,8,44,0,30,2190
12086010301,2860,877,1720,151,4,35,0,27,1983
12086010302,3005,414,2488,50,0,13,0,11,2591
12086010303,3442,1077,2145,75,17,65,1,3,2365
12086010400,5331,441,3786,890,6,54,1,34,4890
12086010501,6216,233,3161,2632,4,60,0,34,5983
12086010502,9647,778,6893,1525,4,198,1,57,8869
12086010604,5110,1798,2696,283,2,103,2,36,3312
12086010608,5402,1049,3644,420,2,118,0,35,4353
12086010609,5636,426,4427,630,2,54,0,37,5210
12086010610,4909,1547,2710,406,0,104,0,35,3362
12086010613,5984,1031,3988,665,5,95,1,43,4953
12086010618,4442,668,3062,490,3,77,1,26,3774
12086010619,2686,464,1751,263,0,130,1,21,2222
12086010620,3068,612,1965,322,0,59,5,17,2456
12086010621,4764,261,3583,721,0,92,0,35,4503
12086010622,4253,135,2140,1885,5,10,0,7,4118
12086010623,3182,619,2143,248,1,98,0,11,2563
12086010624,3543,854,2255,259,0,38,0,43,2689
12086010625,4778,660,3313,535,6,108,2,40,4118
12086010626,3381,246,2470,563,1,31,1,20,3135
12086010705,5486,357,4057,906,2,86,0,26,5129
12086010706,2830,178,2080,496,1,31,0,11,2652
12086010707,3758,270,2330,1016,0,39,0,15,3488
12086010708,6465,471,4090,1712,2,96,1,30,5994
12086010709,5395,404,4068,706,6,89,1,44,4991
12086010710,6741,450,5275,861,4,31,0,21,6291
12086010803,3785,157,2258,1227,0,62,0,17,3628
12086010804,7337,406,4437,2176,12,142,0,60,6931
12086010805,5237,306,3961,821,8,68,0,19,4931
12086010806,3989,266,2471,1144,3,25,2,25,3723
12086010900,6783,353,5348,939,4,40,0,33,6430
12086011003,4791,271,3913,535,2,21,0,18,4520
12086011008,4837,465,3462,696,0,73,13,34,4372
12086011009,6674,697,4510,1082,7,150,0,55,5977
12086011010,5509,266,3955,1157,7,30,0,15,5243
12086011011,4675,275,3782,545,0,24,1,10,4400
12086011012,2710,220,2160,269,0,29,0,4,2490
12086011013,3229,230,2653,277,0,39,0,8,2999
12086011014,4936,852,3241,618,1,75,0,38,4084
12086011015,10065,1300,6554,1646,6,192,12,92,8765
12086011103,3303,215,2552,463,0,15,1,21,3088
12086011104,5654,334,4732,499,9,30,4,20,5320
12086011105,3644,1129,2088,250,4,58,0,17,2515
12086011106,3468,798,2298,247,6,40,4,22,2670
12086011203,5950,387,5285,232,6,5,3,8,5563
12086011204,2529,752,1585,132,0,11,0,6,1777
12086011205,4112,299,2482,1207,3,28,3,22,3813
12086011206,3256,951,1997,151,0,56,2,19,2305
12086011301,3805,99,1873,1749,8,11,0,7,3706
12086011302,6362,129,3645,2454,4,8,3,27,6233
12086011405,3330,94,1995,1188,4,7,0,20,3236
12086011406,4380,578,2942,786,9,10,0,7,3802
12086011407,3453,346,2200,839,0,10,0,11,3107
12086011408,4479,893,2398,1159,0,14,0,7,3586
12086011409,5642,1228,3206,955,4,81,1,39,4414
12086011410,4677,881,2557,980,11,60,2,74,3796
12086011411,2771,426,1739,483,4,43,3,4,2345
12086011412,7311,630,3816,2612,1,72,1,47,6681
12086011500,7660,1494,5652,208,5,162,0,27,6166
12086011601,3995,294,3156,387,3,95,0,21,3701
12086011602,3816,232,3187,297,1,42,0,10,3584
12086011701,1873,112,1588,108,4,29,0,9,1761
12086011702,4974,205,4371,308,5,40,0,13,4769
12086011800,3523,256,2654,461,2,90,0,13,3267
12086011900,5694,559,4626,374,0,75,0,28,5135
12086012001,3143,142,2702,179,0,53,0,27,3001
12086012002,5842,236,5351,130,0,68,0,21,5606
12086012101,2834,143,2570,50,0,40,0,16,2691
12086012102,4508,185,3923,296,2,34,0,16,4323
12086012103,2948,121,2676,109,0,12,0,10,2827
12086012104,1469,91,1301,47,0,13,0,7,1378
12086012105,3339,169,3009,97,2,36,0,17,3170
12086012200,5030,689,4246,48,1,8,0,9,4341
12086012301,2507,164,2038,184,0,78,0,18,2343
12086012302,4187,228,3715,139,0,56,0,27,3959
12086012401,3954,239,3354,216,2,92,3,14,3715
12086012402,3571,231,3187,92,2,45,0,6,3340
12086012403,1881,164,1575,81,0,16,2,29,1717
12086012501,1960,93,1827,5,0,25,0,3,1867
12086012502,4152,226,3860,8,0,29,0,22,3926
12086012601,3592,134,3400,10,0,26,2,7,3458
12086012602,2967,135,2778,0,0,29,0,9,2832
12086012701,10996,919,9149,313,0,383,1,77,10077
12086012702,4875,398,4233,114,0,73,1,9,4477
12086012801,4433,264,4026,41,0,55,0,31,4169
12086012802,3581,481,2884,83,0,64,0,22,3100
12086012900,4347,142,4112,12,4,48,0,16,4205
12086013000,4359,170,4106,6,3,46,1,8,4189
12086013100,4982,196,4719,19,3,14,1,9,4786
12086013201,2294,77,2192,6,0,9,0,2,2217
12086013202,3107,137,2929,2,6,8,1,11,2970
12086013301,2783,122,2624,5,0,14,0,5,2661
12086013302,3153,144,2971,8,0,11,0,9,3009
12086013400,4970,242,4652,17,0,20,0,15,4728
12086013500,4998,173,4756,10,0,28,0,27,4825
12086013600,5614,215,5341,11,1,16,0,12,5399
12086013700,6678,306,6326,13,0,7,0,12,6372
12086013801,2373,125,2218,4,0,16,0,3,2248
12086013802,3901,139,3729,16,5,0,0,6,3762
12086013900,4390,226,4114,12,3,16,1,6,4164
12086014100,1373,374,373,619,5,1,0,0,999
12086014200,4626,267,4263,28,1,34,0,18,4359
12086014300,3493,270,3147,10,0,34,0,14,3223
12086014400,4595,237,4230,34,5,51,0,17,4358
12086014500,4474,349,4061,5,0,30,0,8,4125
12086014601,3088,115,2907,20,1,22,1,6,2973
12086014602,3678,159,3462,14,0,15,0,12,3519
12086014701,2321,98,2175,10,0,9,3,5,2223
12086014702,4476,260,4148,21,0,21,0,12,4216
12086014800,6253,305,5887,14,1,8,2,13,5948
12086014900,5264,305,4867,10,0,23,0,17,4959
12086015001,5100,255,4784,8,9,18,0,9,4845
12086015002,4444,308,3982,26,4,79,0,16,4136
12086015101,4076,300,3568,28,6,126,0,18,3776
12086015102,2758,199,2416,23,1,68,0,22,2559
12086015103,3098,172,2803,27,2,65,0,10,2926
12086015201,3316,266,2942,36,7,20,0,6,3050
12086015202,3667,196,3350,18,1,68,0,4,3471
12086015300,6296,370,5821,18,1,46,0,13,5926
12086015400,5785,337,5353,6,0,58,0,13,5448
12086015501,2851,235,2577,7,0,15,0,7,2616
12086015502,3308,273,3002,12,0,5,0,4,3035
12086015600,4517,588,3714,68,0,41,0,33,3929
12086015700,2621,258,2245,48,1,46,0,3,2363
12086015800,4891,322,4519,15,1,10,3,5,4569
12086015900,3498,217,3211,16,0,38,0,1,3281
12086016000,4583,308,4158,34,0,33,0,10,4275
12086016100,4532,221,4201,19,0,69,0,3,4311
12086016200,3373,253,2962,47,3,54,0,10,3120
12086016300,4724,400,4121,69,3,71,2,11,4324
12086016401,4645,324,4108,29,2,117,0,35,4321
12086016402,2490,198,2165,40,0,64,0,6,2292
12086016501,3537,248,3007,39,1,193,0,11,3289
12086016502,4891,360,4054,103,0,295,1,28,4531
12086016600,3715,228,3347,47,4,47,0,21,3487
12086016700,4667,292,4253,30,1,45,0,15,4375
12086016800,3942,370,3421,33,0,42,3,37,3572
12086016900,4610,340,4115,72,1,31,0,16,4270
12086017000,5067,320,4621,32,0,51,0,18,4747
12086017101,4383,227,4071,12,0,34,0,12,4156
12086017102,2419,177,2133,33,2,30,0,10,2242
12086017200,3617,393,3077,30,1,70,0,14,3224
12086017300,4470,360,3859,93,1,96,0,18,4110
12086017401,1552,267,1225,11,0,22,0,6,1285
12086017402,5461,583,4666,89,0,61,0,18,4878
12086017500,3745,172,3463,47,0,26,1,8,3573
12086017600,6617,416,5900,104,0,117,0,22,6201
12086017700,4689,247,4266,46,0,55,0,22,4442
12086017800,6063,270,5600,76,0,43,0,19,5793
12086017901,4503,349,3865,99,1,111,2,26,4154
12086017902,4568,349,3902,117,0,128,2,22,4219
12086018001,2262,220,1836,67,0,67,0,10,2042
12086018002,3102,231,2614,95,7,99,0,21,2871
12086018003,7014,710,5808,214,12,162,0,21,6304
12086018100,4829,466,4011,119,2,108,0,40,4363
12086018200,2623,221,2177,86,2,60,0,13,2402
12086018300,5703,469,4670,215,0,224,0,33,5234
12086018400,3697,311,3120,132,2,64,2,10,3386
12086018500,4901,541,3862,209,7,156,0,37,4360
12086018601,3515,292,3007,105,0,51,0,23,3223
12086018602,4310,341,3572,171,3,104,0,41,3969
12086018700,4405,449,3521,170,3,173,4,24,3956
12086018801,2911,481,2153,101,3,100,2,10,2430
12086018802,2788,274,2325,86,0,59,0,19,2514
12086018803,3044,328,2438,115,0,71,0,18,2716
12086018901,3353,688,2378,123,2,39,0,24,2665
12086018902,3273,648,2261,126,7,108,3,19,2625
12086019000,5768,789,4611,143,0,99,0,38,4979
12086019100,5799,714,4678,166,3,137,0,35,5085
12086019200,5083,758,3822,169,0,159,0,36,4325
12086019301,3157,425,2177,311,1,115,0,20,2732
12086019302,4649,544,3381,392,6,185,2,30,4105
12086019401,3172,474,2285,133,2,135,2,29,2698
12086019402,5562,749,4124,214,4,282,0,52,4813
12086019501,4118,654,3082,239,0,39,4,24,3464
12086019502,3963,350,3258,172,6,81,1,30,3613
12086019600,5898,580,4481,442,1,239,0,30,5318
12086019700,3792,592,2721,285,0,71,0,30,3200
12086019801,5487,511,4456,229,2,175,0,16,4976
12086019802,4497,399,3723,190,0,93,0,29,4098
12086019901,3995,253,3460,151,0,71,1,25,3742
12086019902,7024,435,5970,361,11,103,0,52,6589
12086020001,2478,185,2165,68,0,18,0,12,2293
12086020002,4686,491,3866,162,3,67,0,37,4195
12086020100,4341,304,3639,226,0,101,0,25,4037
12086020200,5489,483,4364,527,4,56,2,9,5006
12086020300,3385,236,2856,229,0,11,0,9,3149
12086490100,1459,64,1361,9,1,19,0,0,1395
12086980100,0,0,0,0,0,0,0,0,0
12086980200,0,0,0,0,0,0,0,0,0
12086980300,4511,764,1553,1698,0,282,32,129,3747
12086980400,2,0,1,0,0,0,0,0,2
12086980500,466,55,337,40,2,15,0,0,411
12086980600,0,0,0,0,0,0,0,0,0
12086980700,999,93,361,528,0,0,0,4,906
12086980800,1,0,0,0,0,1,0,0,1
12086980900,0,0,0,0,0,0,0,0,0
12086981000,2,2,0,0,0,0,0,0,0
12086981100,935,266,304,358,0,0,0,2,669
12086981200,0,0,0,0,0,0,0,0,0
12086981300,2900,654,1027,1164,4,24,0,22,2246
12086990000,0,0,0,0,0,0,0,0,0
12087970400,4412,2523,1588,140,6,27,1,9,1889
12087970500,3108,2122,798,24,7,40,4,15,986
12087970600,1970,1495,382,16,4,22,3,5,475
12087970700,2931,1919,882,25,11,22,0,6,1012
12087970800,4665,3818,643,30,9,30,0,20,847
12087970900,2092,1653,355,9,5,14,0,5,439
12087971001,1531,1218,237,24,2,14,1,7,313
12087971002,1884,1492,300,47,0,5,0,2,392
12087971100,3618,2155,1175,122,8,40,1,18,1463
12087971200,2654,1746,756,87,3,8,0,3,908
12087971300,1998,1034,742,135,3,28,5,3,964
12087971401,3148,2463,466,41,9,36,2,21,685
12087971402,1515,1268,172,11,0,11,0,9,247
12087971501,2019,1694,193,23,8,18,6,15,325
12087971502,3078,2513,361,49,6,31,0,20,565
12087971600,2274,1784,324,42,0,22,0,15,490
12087971700,3203,2027,816,181,4,55,3,13,1176
12087971800,5783,2449,2218,905,9,56,0,21,3334
12087971900,7028,3527,1954,1067,17,178,8,49,3501
12087972000,4311,2892,985,135,8,110,9,34,1419
12087972100,4253,2461,987,437,17,97,9,36,1792
12087972200,3174,1877,905,192,4,71,6,23,1297
12087972400,3156,1898,450,575,7,97,0,17,1258
12087972500,1110,910,100,44,0,16,0,6,200
12087972700,4453,3182,1057,37,6,38,0,14,1271
12087972800,3415,2596,551,111,6,38,3,21,819
12087980000,80,14,30,8,9,13,0,0,66
12087980100,11,1,5,0,1,0,0,0,10
12087990000,0,0,0,0,0,0,0,0,0
12089050102,2985,2650,104,119,7,14,3,10,335
12089050103,3599,2269,442,708,1,34,6,13,1330
12089050104,3209,2908,118,25,6,29,5,10,301
12089050201,2169,2085,20,25,1,9,0,4,84
12089050203,3898,3533,138,77,5,39,0,11,365
12089050204,3412,2837,211,193,1,33,6,5,575
12089050205,3705,3364,137,44,6,42,2,5,341
12089050304,6447,5333,313,334,23,46,4,22,1114
12089050305,1221,1064,32,52,5,13,0,0,157
12089050306,8152,6219,651,734,23,138,5,28,1933
12089050307,5322,3919,449,537,17,65,1,31,1403
12089050308,6179,5231,292,364,16,45,4,24,948
12089050309,6162,5159,304,276,10,77,1,25,1003
12089050310,5902,4689,442,346,18,108,4,14,1213
12089050401,3354,2944,91,153,10,16,3,5,410
12089050402,2430,2102,61,143,6,13,0,6,328
12089050403,3223,2903,64,113,3,6,0,10,320
12089050504,4093,3729,101,61,6,22,0,15,364
12089050505,4974,4344,190,89,24,49,4,19,630
12089050506,3292,2844,109,151,13,32,0,11,448
12089050507,2095,1761,45,205,4,4,2,5,334
12089050508,1911,1745,36,26,8,8,0,8,166
12089050509,2618,2185,99,170,9,21,2,12,433
12089990000,0,0,0,0,0,0,0,0,0
12091020101,4424,3799,157,107,35,20,0,13,625
12091020102,4660,4022,190,113,49,22,11,24,638
12091020200,2064,1728,69,135,10,5,0,9,336
12091020303,5487,4296,397,267,26,118,13,43,1191
12091020304,4667,3431,438,313,21,87,10,22,1236
12091020305,4054,3362,208,133,15,39,5,18,692
12091020306,2737,1633,256,682,14,14,3,2,1104
12091020400,7609,5336,564,940,20,124,23,33,2273
12091020500,8721,5776,774,1241,59,135,20,39,2945
12091020601,7618,4055,907,1727,28,231,7,61,3563
12091020602,4186,2547,578,484,31,149,11,33,1639
12091020701,3956,2429,473,575,13,129,11,18,1527
12091020702,8540,5498,907,1075,26,283,38,55,3042
12091020800,4341,2947,587,323,12,127,14,20,1394
12091020900,7235,5716,496,234,31,236,8,46,1519
12091021001,6099,4856,453,168,20,159,2,20,1243
12091021002,5766,4709,385,152,5,118,11,38,1057
12091021101,3458,2583,281,169,12,146,7,10,875
12091021102,8510,6486,723,321,15,295,15,36,2024
12091021200,6158,4444,535,348,16,195,29,35,1714
12091021400,2979,1607,631,380,7,75,13,18,1372
12091021501,4179,2881,465,344,12,165,12,17,1298
12091021502,3786,2719,376,263,13,165,19,16,1067
12091021600,2479,2074,137,66,10,64,1,6,405
12091021700,2655,2180,172,79,10,63,0,10,475
12091021801,5536,3101,917,697,16,271,10,39,2435
12091021802,6004,3388,1110,738,27,212,28,40,2616
12091021901,1552,373,254,762,6,49,1,14,1179
12091021902,7540,4512,999,896,25,476,24,63,3028
12091022001,4280,1900,1250,661,9,176,4,20,2380
12091022002,3616,2206,699,305,19,121,5,19,1410
12091022100,3549,2211,605,296,6,152,6,20,1338
12091022300,2548,1672,303,253,9,97,7,20,876
12091022400,4000,3068,411,129,9,98,3,8,932
12091022500,4225,2812,464,412,7,187,7,26,1413
12091022600,3651,2017,509,687,14,147,0,27,1634
12091022700,3724,2520,444,309,17,185,4,29,1204
12091022800,2252,1161,415,396,6,106,3,13,1091
12091022900,4075,2725,467,300,12,222,9,10,1350
12091023100,8354,5347,877,858,51,399,33,55,3007
12091023200,1977,1630,140,64,4,36,8,14,347
12091023303,1517,1353,66,14,3,17,1,3,164
12091023304,3959,3039,301,155,17,139,0,34,920
12091023305,4748,3625,439,130,24,173,4,41,1123
12091023306,2953,2417,221,41,6,43,1,23,536
12091023307,1914,1353,271,75,1,31,0,30,561
12091023308,3326,2727,257,79,1,77,7,16,599
12091990100,0,0,0,0,0,0,0,0,0
12091990200,0,0,0,0,0,0,0,0,0
12093910101,5905,3140,1121,1449,32,18,0,29,2765
12093910102,2835,2145,503,53,19,16,7,14,690
12093910201,4535,1758,2114,495,29,16,3,10,2777
12093910202,3916,1436,2138,225,20,10,0,11,2480
12093910300,1951,862,393,616,11,7,1,10,1089
12093910401,3512,2860,430,38,15,19,0,10,652
12093910402,2412,1261,966,68,15,36,0,9,1151
12093910403,3590,2885,441,87,22,35,1,5,705
12093910500,4410,3140,831,178,30,87,0,29,1270
12093910601,4635,3580,738,83,25,73,2,18,1055
12093910602,1943,1604,182,26,45,15,0,1,339
12093990000,0,0,0,0,0,0,0,0,0
12095010201,1829,1296,293,80,6,68,1,18,533
12095010202,3861,2660,641,150,2,196,4,34,1201
12095010300,3469,2211,739,237,0,114,0,25,1258
12095010400,1545,65,323,1093,0,11,1,12,1480
12095010500,1371,64,110,1141,4,0,2,1,1307
12095010802,3292,2339,485,79,3,179,1,20,953
12095011000,3132,1898,751,233,13,107,1,12,1234
12095011100,3122,1973,728,182,4,71,0,37,1149
12095011200,3293,2500,490,74,12,65,1,11,793
12095011300,5440,4036,752,210,7,158,0,28,1404
12095011600,4817,828,814,2889,12,81,0,35,3989
12095011701,4229,144,405,3531,9,25,1,21,4085
12095011702,4365,99,428,3678,9,7,0,13,4266
12095012000,7003,457,1060,5025,17,184,5,83,6546
12095012100,6591,548,1101,4582,20,118,0,48,6043
12095012201,5054,415,577,3677,11,133,1,55,4639
12095012202,5083,486,731,3443,9,140,4,62,4597
12095012303,7081,843,799,4504,10,489,9,131,6238
12095012304,6294,445,1071,4354,0,166,1,81,5849
12095012305,7319,679,1960,4067,7,336,3,84,6640
12095012306,3384,476,552,2120,5,67,1,58,2908
12095012307,6797,616,1005,4719,13,112,1,97,6181
12095012402,5741,892,1434,3103,6,85,4,48,4849
12095012403,5358,708,852,3427,17,100,0,45,4650
12095012404,4655,591,639,3158,9,92,0,31,4064
12095012405,4125,600,548,2752,9,54,0,18,3525
12095012500,2463,1870,296,108,4,56,0,11,593
12095012600,5325,4329,546,135,7,104,0,20,996
12095012701,5278,3983,675,145,1,159,4,42,1295
12095012800,3918,3248,320,50,1,99,1,27,670
12095012900,3875,2670,663,140,6,177,4,13,1205
12095013201,4456,937,3041,182,2,151,0,41,3519
12095013202,6435,1350,3873,575,10,425,5,53,5085
12095013300,6872,2603,3519,385,4,119,12,37,4269
12095013402,3196,705,2113,211,9,57,1,28,2491
12095013403,3584,684,2569,194,3,54,3,16,2900
12095013405,2529,410,1714,270,2,41,4,27,2119
12095013406,4039,611,2846,382,0,68,0,32,3428
12095013503,2441,384,1525,411,2,28,0,16,2057
12095013505,4553,1106,2818,380,9,111,3,24,3447
12095013507,9054,1561,5754,1082,9,284,0,104,7493
12095013510,2562,480,1658,300,3,29,0,25,2082
12095013511,6500,1415,4495,297,7,113,1,41,5085
12095013512,5280,669,3820,551,1,85,0,43,4611
12095013513,4431,801,2994,433,10,51,0,24,3630
12095013603,5198,2058,2403,359,6,145,1,35,3140
12095013604,6371,2417,2939,539,7,222,3,54,3954
12095013605,4011,1487,1754,457,17,87,8,61,2524
12095013606,3857,765,2566,293,6,102,0,35,3092
12095013607,5394,2578,2102,331,3,109,4,38,2816
12095013701,4339,1870,1671,447,13,125,1,30,2469
12095013702,5263,2478,1866,515,9,145,1,34,2785
12095013801,2271,1472,569,100,4,47,0,6,799
12095013802,2645,2046,372,76,5,38,4,9,599
12095013803,2809,1776,670,120,9,77,4,18,1033
12095013900,4220,3031,667,209,8,117,6,16,1189
12095014000,6336,5056,759,144,3,81,1,24,1280
12095014100,6599,4214,1602,272,5,209,4,30,2385
12095014201,5769,900,3668,787,4,198,17,52,4869
12095014202,4982,593,3016,951,8,266,10,45,4389
12095014301,5317,1825,1737,1108,12,378,8,39,3492
12095014302,5257,751,3458,812,1,148,0,21,4506
12095014400,3409,1693,700,752,7,72,4,32,1716
12095014502,5934,462,1749,3443,15,56,7,33,5472
12095014503,6423,1378,1558,3280,10,49,2,22,5045
12095014504,6970,1763,2502,1624,18,314,11,164,5207
12095014601,8419,262,1043,6755,10,70,2,50,8157
12095014605,4564,76,391,3975,7,23,3,3,4488
12095014606,8295,1461,3997,1748,13,179,16,304,6834
12095014607,7057,1708,2764,1080,13,460,5,219,5349
12095014608,4540,391,882,2938,11,55,4,58,4149
12095014609,5388,708,1623,2521,6,89,2,140,4680
12095014701,5613,898,1647,2223,14,264,11,228,4715
12095014702,6130,1409,1946,1720,12,251,8,201,4721
12095014703,2627,488,931,678,1,92,0,140,2139
12095014705,8097,2237,2458,1179,4,534,6,316,5860
12095014706,5459,1749,1749,764,8,211,4,210,3710
12095014804,6434,2444,1745,1370,7,443,2,92,3990
12095014805,5155,1056,1096,2173,17,321,6,203,4099
12095014806,4635,2223,889,601,10,424,4,103,2412
12095014807,7128,2816,1481,1176,2,784,4,255,4312
12095014809,2953,2165,271,77,3,238,8,40,788
12095014810,5681,3524,875,277,7,544,4,96,2157
12095014811,5656,3504,936,226,10,422,37,65,2152
12095014812,6172,2259,1891,601,16,629,0,180,3913
12095014813,4765,2506,869,219,11,654,0,116,2259
12095014814,6754,4004,1041,609,8,517,7,110,2750
12095014815,5169,3282,648,255,0,608,8,48,1887
12095014904,6070,430,786,4504,13,127,6,44,5640
12095014906,6955,2665,1452,1901,9,391,3,149,4290
12095014908,6504,531,1031,4368,16,277,1,96,5973
12095014909,2895,503,474,1477,16,187,1,85,2392
12095015001,1754,452,1112,147,1,10,0,5,1302
12095015002,6505,2302,2635,967,19,254,1,79,4203
12095015003,6748,2707,2756,699,25,226,1,73,4041
12095015005,3547,1194,693,1084,11,307,9,87,2353
12095015006,4852,1667,742,1796,20,280,7,85,3185
12095015103,6546,2731,1641,1434,14,357,4,27,3815
12095015104,5362,1867,1634,1429,6,133,1,28,3495
12095015105,3723,1205,925,1279,6,86,0,38,2518
12095015106,7425,1193,1304,4347,17,205,3,86,6232
12095015202,6058,2093,1579,1911,17,216,3,30,3965
12095015203,3088,1103,660,911,11,237,0,49,1985
12095015204,5375,2253,1292,1161,0,320,0,90,3122
12095015300,4068,2688,574,429,13,171,8,19,1380
12095015501,6127,3994,885,665,10,202,4,85,2133
12095015601,3042,2197,453,153,0,88,0,9,845
12095015602,2394,2086,176,10,3,36,0,15,308
12095015701,2217,1820,208,40,0,75,0,15,397
12095015702,1798,1417,202,38,6,55,2,11,381
12095015801,1712,1404,140,50,0,54,0,1,308
12095015802,2595,2122,220,33,5,89,0,15,473
12095015901,2428,1214,340,685,4,49,0,15,1214
12095016001,2085,1656,211,81,1,63,0,16,429
12095016002,2537,2063,237,36,0,115,1,7,474
12095016100,4742,3869,438,59,6,203,2,12,873
12095016200,7062,4629,1303,491,14,270,4,46,2433
12095016301,5569,3163,1459,459,12,184,1,44,2406
12095016302,3899,1466,1496,500,6,222,0,51,2433
12095016402,2729,766,1323,317,0,206,0,13,1963
12095016406,2045,814,705,246,3,135,0,23,1231
12095016407,6604,2552,2371,856,2,446,13,42,4052
12095016408,2296,1263,566,199,3,127,0,27,1033
12095016409,3289,2135,606,139,10,237,1,23,1154
12095016411,3557,1375,1367,426,6,179,5,12,2182
12095016412,4882,1968,1905,323,12,459,8,26,2914
12095016413,4297,1243,2402,300,14,170,1,25,3054
12095016414,4378,1569,1553,462,10,551,2,45,2809
12095016503,9397,5186,2165,804,8,785,2,113,4211
12095016504,5031,1925,1998,466,1,399,10,36,3106
12095016505,3151,1150,1278,361,2,183,1,32,2001
12095016509,4845,2682,1500,280,10,165,4,16,2163
12095016510,8424,4359,1754,1013,14,700,1,143,4065
12095016511,6338,3117,1619,647,3,514,5,61,3221
12095016512,7464,3799,1859,771,31,600,0,75,3665
12095016513,5408,1859,2794,400,11,111,0,35,3549
12095016514,6503,3247,1788,690,8,414,9,58,3256
12095016515,8246,4807,1577,842,8,552,6,67,3439
12095016603,7516,3707,2126,794,11,508,4,54,3809
12095016604,5178,3243,1150,334,12,173,10,40,1935
12095016605,1601,969,484,41,10,22,3,0,632
12095016606,2690,1501,663,227,2,142,1,19,1189
12095016607,6251,3190,1870,562,7,283,9,53,3061
12095016709,6907,1076,5049,411,10,185,3,45,5831
12095016710,4211,1188,2164,351,8,321,2,27,3023
12095016713,8645,1900,5261,736,22,399,6,86,6745
12095016714,3121,877,1672,340,11,121,0,15,2244
12095016715,6891,1699,4194,492,5,299,11,28,5192
12095016716,5670,2812,1954,281,14,370,0,33,2858
12095016717,3670,1088,1671,388,11,330,1,49,2582
12095016723,5085,1602,2632,372,9,248,6,48,3483
12095016724,6464,1365,3890,661,2,313,1,66,5099
12095016728,5198,2689,1643,302,5,265,0,70,2509
12095016731,7553,3004,2331,1723,3,246,1,55,4549
12095016733,5844,1929,2943,410,10,381,0,36,3915
12095016735,12745,3776,6602,850,18,804,6,114,8969
12095016736,13392,4935,5522,953,2,1149,16,132,8457
12095016737,9685,3809,3818,723,10,675,11,125,5876
12095016738,3812,931,1981,409,6,311,0,40,2881
12095016739,6753,1020,4532,878,5,130,7,42,5733
12095016740,3592,1218,1517,378,3,272,1,35,2374
12095016741,3464,1208,1381,450,4,223,4,27,2256
12095016742,4411,1235,2156,645,5,176,4,28,3176
12095016743,6040,2002,2571,749,6,426,13,49,4038
12095016744,5168,1577,2571,479,0,272,6,59,3591
12095016745,5361,1977,1884,705,8,513,0,50,3384
12095016746,4276,2190,1160,333,8,301,0,45,2086
12095016747,5601,3121,1202,332,12,579,13,48,2480
12095016748,6010,2077,2201,814,0,503,5,54,3933
12095016749,6277,2490,2228,621,10,518,1,85,3787
12095016750,12194,5288,4227,1012,9,956,10,118,6906
12095016751,6423,2065,2577,536,7,937,15,43,4358
12095016752,4454,2004,1442,312,5,472,0,34,2450
12095016753,7673,2053,3903,910,15,488,4,95,5620
12095016754,4118,901,2580,319,6,179,13,25,3217
12095016755,6722,1825,3376,646,8,518,7,59,4897
12095016756,2700,750,1205,254,8,333,0,22,1950
12095016802,18656,7970,6915,988,26,1599,6,166,10686
12095016803,2860,644,1458,416,6,215,1,27,2216
12095016804,6333,1359,3427,768,18,503,7,41,4974
12095016808,1992,432,808,318,1,269,10,37,1560
12095016809,7969,1111,5405,892,6,258,17,108,6858
12095016810,11406,1746,7194,1132,11,811,10,178,9660
12095016811,11616,1754,7170,1261,10,861,14,161,9862
12095016812,6331,787,4301,719,10,263,5,58,5544
12095016813,3203,252,2509,187,0,111,4,24,2951
12095016814,5295,519,3765,535,1,251,5,82,4776
12095016902,5845,754,3646,1115,4,167,5,44,5091
12095016904,4722,257,2059,1989,10,295,1,26,4465
12095016906,4632,332,1505,2575,7,54,7,25,4300
12095016907,7296,426,3164,3445,3,67,2,41,6870
12095016908,2829,479,1304,610,3,219,4,37,2350
12095016909,5171,350,2795,1782,7,81,21,38,4821
12095016910,1429,158,771,323,3,104,5,24,1271
12095016911,8349,1161,3530,2992,9,217,5,103,7188
12095017001,4966,1311,1252,1946,1,172,4,68,3655
12095017004,5904,2580,2345,285,13,334,48,35,3324
12095017006,4513,1036,1985,222,4,755,10,93,3477
12095017011,5884,1227,2849,818,20,596,13,101,4657
12095017012,2992,1013,1073,285,4,426,3,41,1979
12095017013,7512,1850,3997,652,8,657,21,107,5662
12095017015,8347,3030,3299,461,9,847,1,138,5317
12095017018,6605,1209,4057,568,6,406,12,93,5396
12095017019,4297,855,2728,361,11,158,11,57,3442
12095017020,7005,1947,3797,412,8,360,3,73,5058
12095017021,6191,1465,3260,466,15,584,16,104,4726
12095017022,10303,3260,5427,640,15,446,9,125,7043
12095017023,2309,1016,905,123,12,126,11,9,1293
12095017024,2929,1540,960,160,8,125,4,13,1389
12095017025,4080,1501,1506,186,4,514,2,76,2579
12095017026,3941,2320,893,147,1,372,10,35,1621
12095017108,10418,5640,2107,470,19,1113,6,189,4778
12095017109,6170,4148,734,156,5,735,2,53,2022
12095017110,7170,3319,2232,234,25,757,3,68,3851
12095017111,18071,10163,4126,823,11,1106,7,299,7908
12095017112,16383,8054,4180,826,16,1288,9,331,8329
12095017113,14094,8463,2590,715,9,971,9,175,5631
12095017114,11635,6318,2335,691,24,1056,1,171,5317
12095017115,4801,2932,573,289,6,649,3,30,1869
12095017116,9265,4815,1701,1218,11,716,6,114,4450
12095017117,7861,4054,1579,755,12,703,8,150,3807
12095017118,5459,2745,890,797,1,561,2,84,2714
12095017119,2863,1962,316,184,6,185,0,49,901
12095017120,6406,3698,914,535,4,749,4,106,2708
12095017121,2820,1411,550,89,0,550,0,18,1409
12095017122,3484,1773,627,205,2,638,1,37,1711
12095017123,4958,2121,861,270,3,1187,6,108,2837
12095017200,4957,3036,935,600,8,61,0,71,1921
12095017301,2935,1909,653,184,0,63,0,9,1026
12095017302,7356,3379,2677,783,13,153,5,51,3977
12095017401,7586,4696,1075,991,11,298,5,93,2890
12095017402,5235,1194,1957,1621,27,147,0,94,4041
12095017503,6068,2087,2851,797,2,96,1,37,3981
12095017504,8525,2947,2739,2194,17,214,11,50,5578
12095017505,5020,780,1175,2693,14,96,0,64,4240
12095017506,12043,4006,2367,3810,41,937,21,215,8037
12095017600,4921,643,1464,2643,5,17,4,31,4278
12095017701,5622,1817,2046,1289,10,186,3,52,3805
12095017702,2433,1477,452,277,8,88,0,20,956
12095017703,4967,1772,2328,583,18,77,0,26,3195
12095017805,3067,1791,737,317,8,59,1,14,1276
12095017806,5103,3126,1008,539,14,143,4,36,1977
12095017807,4119,1435,2042,439,0,67,0,9,2684
12095017808,3799,2495,688,273,4,154,1,32,1304
12095017809,3474,1207,1488,495,5,117,0,25,2267
12095017810,6244,2059,1584,2036,13,218,3,77,4185
12095017811,4881,2207,1019,1265,3,170,1,35,2674
12095017812,8137,3780,2108,1614,14,236,2,64,4357
12095017813,2328,1250,523,401,4,42,1,7,1078
12095017814,6387,3512,1304,1035,6,217,5,39,2875
12095017901,4403,2171,985,953,14,116,2,14,2232
12095017902,7349,4447,1360,1000,23,220,3,31,2902
12095018000,3659,1178,543,1717,8,99,0,22,2481
12095018100,3244,1719,627,515,3,141,0,53,1525
12095018201,4952,3392,750,96,4,394,1,46,1560
12095018202,4341,2925,707,123,8,301,8,31,1416
12095018203,1937,589,859,258,0,113,5,15,1348
12095018204,2296,994,827,152,7,216,0,3,1302
12095018300,3149,594,475,1844,6,101,0,18,2555
12095018400,2381,1203,767,161,5,113,1,26,1178
12095018500,3684,790,745,1939,0,58,0,20,2894
12095018700,5749,1314,700,3530,13,50,0,41,4435
12095018800,4676,3009,790,282,8,302,0,30,1667
12095018901,5730,1568,1092,2570,14,238,7,25,4162
12095018902,4922,2785,1103,446,7,297,5,48,2137
12095019000,3621,2553,552,181,6,139,0,27,1068
12095990000,0,0,0,0,0,0,0,0,0
12097040801,1464,814,408,79,3,71,0,8,650
12097040805,2065,985,737,147,2,83,0,14,1080
12097040806,2193,1220,659,80,8,56,0,45,973
12097040807,5249,3416,1024,135,8,218,2,49,1833
12097040808,7279,5110,1153,102,10,329,1,76,2169
12097040809,3841,1220,1935,141,2,283,0,67,2621
12097040810,3112,1401,1402,104,10,56,0,25,1711
12097040811,7565,3075,3252,478,10,159,7,120,4490
12097040812,6510,3250,2107,514,8,237,4,45,3260
12097040901,6123,1684,3126,525,10,397,3,90,4439
12097040903,4069,1271,2240,202,0,145,2,61,2798
12097040904,8909,2096,5219,536,13,471,19,210,6813
12097041003,8297,1786,4878,1010,7,243,6,91,6511
12097041004,8454,1563,5338,953,17,223,18,107,6891
12097041005,3051,1665,1123,140,6,43,2,24,1386
12097041006,8457,1525,4577,1494,10,340,3,187,6932
12097041101,10277,1317,6296,2039,17,151,6,154,8960
12097041102,9367,988,5238,2534,15,168,3,146,8379
12097041301,7936,792,4839,1826,9,128,4,125,7144
12097041302,7348,794,4717,1385,9,135,1,90,6554
12097041501,7721,1868,3805,1193,8,429,3,140,5853
12097041502,11309,2413,5984,1869,21,503,1,141,8896
12097041600,4351,1143,2399,527,8,114,2,27,3208
12097041700,6092,1297,4242,297,1,110,2,53,4795
12097041800,3373,675,2075,360,6,121,4,36,2698
12097041900,6859,813,5216,522,5,143,1,54,6046
12097042000,12505,1730,8755,988,7,520,0,141,10775
12097042100,12839,2279,8277,862,13,837,3,186,10560
12097042201,6905,1323,4752,405,5,209,2,54,5582
12097042202,4942,518,3806,392,10,101,0,35,4424
12097042300,7922,1200,4952,1314,8,209,7,81,6722
12097042400,7139,1931,4345,442,8,139,6,63,5208
12097042500,7320,950,5237,711,17,148,3,108,6370
12097042601,3388,299,2492,388,2,97,0,36,3089
12097042603,8132,721,6181,840,8,161,7,83,7411
12097042604,4973,612,3697,403,7,90,5,53,4361
12097042701,8224,589,6600,641,7,142,0,93,7635
12097042702,6438,570,5123,521,9,61,7,51,5868
12097042800,15058,3593,8894,1110,28,754,9,176,11465
12097042901,5647,1181,3654,447,5,149,10,40,4466
12097042902,5042,962,3505,365,3,62,0,29,4080
12097042903,4010,898,2359,430,4,165,0,39,3112
12097042904,4515,866,3018,364,10,94,0,59,3649
12097042905,2692,376,1892,339,3,42,0,11,2316
12097043100,6750,2490,3447,348,14,161,5,56,4260
12097043203,5082,1878,2690,237,0,74,1,33,3204
12097043205,2002,1464,393,15,0,20,0,44,538
12097043207,10201,3343,5383,846,8,190,8,90,6858
12097043208,11791,4364,6037,677,19,258,8,85,7427
12097043209,1171,962,151,7,6,16,0,1,209
12097043301,2659,1721,676,98,8,63,3,14,938
12097043303,7918,3570,3330,487,21,141,17,42,4348
12097043304,8872,3927,4101,345,12,136,6,61,4945
12097043400,5102,3046,1553,158,21,59,5,35,2056
12097043500,5233,3344,1406,145,9,52,5,21,1889
12097043600,10813,5379,3848,682,13,407,7,69,5434
12097043700,12096,5604,4931,717,24,353,10,74,6492
12097043801,6303,4510,1172,189,17,86,5,38,1793
12097043802,3701,2981,443,40,13,18,7,32,720
12099000102,3268,2824,250,47,1,40,0,16,444
12099000103,2350,2120,136,7,0,19,0,4,230
12099000104,4654,3936,409,30,8,63,1,13,718
12099000202,6070,3225,2575,49,6,76,1,21,2845
12099000204,3870,2787,779,65,7,94,3,5,1083
12099000208,4157,3348,446,48,6,125,0,17,809
12099000210,6380,4068,1164,561,21,263,10,39,2312
12099000211,3962,3452,304,9,3,37,0,14,510
12099000213,3014,1705,934,247,0,50,0,10,1309
12099000214,6323,4715,815,122,3,384,7,26,1608
12099000216,2789,2053,472,59,3,106,0,7,736
12099000217,4548,3560,647,48,3,118,5,5,988
12099000218,3256,2368,444,104,0,174,0,19,888
12099000219,7971,5996,980,260,6,375,5,43,1975
12099000220,5371,4266,609,51,5,233,0,21,1105
12099000221,6238,4665,750,149,2,356,2,32,1573
12099000222,2532,793,1584,50,1,38,1,17,1739
12099000223,2846,2350,252,48,0,76,0,8,496
12099000301,4181,3868,178,11,0,39,0,14,313
12099000303,5106,4525,322,50,5,75,0,6,581
12099000304,6198,4125,1132,402,4,290,0,32,2073
12099000405,2534,2367,98,10,6,16,0,2,167
12099000406,2415,2223,111,7,0,18,0,5,192
12099000407,1543,1463,35,6,0,13,0,3,80
12099000408,3525,3253,172,12,1,17,0,9,272
12099000410,4101,3659,242,24,3,82,0,1,442
12099000505,3120,2830,152,36,4,37,1,17,290
12099000507,1326,1172,50,59,1,17,0,3,154
12099000509,2603,2313,124,31,0,67,0,8,290
12099000512,1512,1332,82,34,1,23,0,2,180
12099000513,1506,1318,79,31,0,23,0,1,188
12099000600,1693,1162,405,36,5,23,0,5,531
12099000702,2936,2369,298,84,0,50,7,15,567
12099000703,4031,3189,454,118,5,80,2,5,842
12099000803,3305,2731,296,90,0,89,0,20,574
12099000805,5464,3848,783,285,9,324,3,25,1616
12099000902,2697,1892,337,196,0,158,0,5,805
12099000903,5357,2993,1060,713,1,314,0,68,2364
12099000904,4406,3068,665,287,1,235,0,26,1338
12099000905,3914,2625,637,215,0,327,2,19,1289
12099001002,6996,746,735,4925,4,328,0,41,6250
12099001003,4607,2605,654,741,7,409,0,24,2002
12099001004,5675,2544,1706,991,3,226,1,25,3131
12099001101,6695,1701,685,3867,3,186,0,35,4994
12099001102,2637,2179,232,78,2,49,0,16,458
12099001200,4839,1011,713,2922,10,42,1,29,3828
12099001301,6774,788,867,4580,5,271,0,55,5986
12099001302,5212,125,228,4663,14,8,3,16,5087
12099001402,2777,239,275,2173,3,2,2,6,2538
12099001403,2870,59,156,2552,8,1,0,5,2811
12099001404,4148,144,310,3568,2,15,3,14,4004
12099001500,3077,486,262,2230,0,20,0,3,2591
12099001600,4230,981,1636,1413,11,44,0,26,3249
12099001700,5278,1952,2179,981,6,43,1,21,3326
12099001801,5472,552,1187,3508,13,28,0,23,4920
12099001802,5097,1845,782,2165,3,124,0,19,3252
12099001904,3285,1084,627,1323,0,109,0,23,2201
12099001907,3708,1415,700,1330,3,131,0,26,2293
12099001909,2830,497,1382,824,3,62,1,11,2333
12099001910,1859,1196,330,257,0,25,0,10,663
12099001911,1045,757,156,78,0,20,3,7,288
12099001912,2172,1411,378,275,1,40,0,17,761
12099001913,2187,1622,290,189,2,36,2,17,565
12099001916,4188,1714,740,1394,13,137,3,29,2474
12099001917,4947,1642,1118,1781,7,192,0,26,3305
12099001918,3206,1778,575,580,3,128,3,28,1428
12099001919,5745,1383,1031,2657,8,390,4,56,4362
12099001920,3265,1037,768,1153,5,162,1,34,2228
12099001921,4239,1596,608,1695,2,173,0,30,2643
12099002005,4627,987,669,2680,7,82,5,36,3640
12099002006,4283,1567,868,1601,6,117,2,24,2716
12099002100,4110,294,380,3217,12,31,0,49,3816
12099002200,2726,204,396,2002,7,0,1,7,2522
12099002300,4157,1642,542,1752,9,91,0,13,2515
12099002400,2158,168,264,1629,3,7,0,9,1990
12099002600,3224,2216,563,170,6,149,1,14,1008
12099002701,1519,1147,240,61,0,39,0,2,372
12099002702,1933,1537,276,52,0,28,1,7,396
12099002703,2815,2146,336,100,4,104,0,25,669
12099002800,3234,1612,1131,293,9,45,0,24,1622
12099002900,6079,408,3765,1661,8,86,5,33,5671
12099003000,5953,1050,3757,877,3,62,0,57,4903
12099003101,7089,1770,3231,1761,8,111,0,41,5319
12099003102,6661,1060,2368,2909,7,99,0,61,5601
12099003201,5313,1019,2457,1415,2,237,2,47,4294
12099003202,6146,1024,2006,2667,3,195,7,68,5122
12099003300,4161,831,2810,389,7,33,0,16,3330
12099003400,3985,2402,1251,144,6,51,4,28,1583
12099003507,2495,2266,148,7,0,18,2,12,229
12099003512,1275,1185,49,3,0,18,0,1,90
12099003513,1714,1604,62,4,0,20,0,4,110
12099003514,2500,2280,100,26,0,48,0,9,220
12099003600,5388,3011,1924,212,2,82,1,38,2377
12099003700,5837,1442,3965,197,2,82,0,32,4395
12099003801,2949,883,1804,178,3,26,0,7,2066
12099003802,4744,1098,2354,1126,3,56,1,13,3646
12099003901,4511,1360,2300,602,4,95,5,37,3151
12099003902,6274,1335,3190,1430,10,112,0,33,4939
12099004005,4359,964,1575,1449,0,212,1,19,3395
12099004007,6118,728,4448,756,3,83,0,20,5390
12099004008,6262,842,3280,1789,5,145,7,44,5420
12099004009,4184,418,3278,326,1,84,0,19,3766
12099004010,3439,608,2279,359,2,121,0,12,2831
12099004011,6031,966,3985,868,7,76,0,24,5065
12099004012,4452,1838,1905,493,6,104,1,17,2614
12099004013,3565,1372,1800,211,1,47,65,11,2193
12099004101,5580,1529,3329,491,10,72,0,32,4051
12099004102,3608,628,2455,336,1,85,7,24,2980
12099004203,3735,1544,1813,239,3,46,0,16,2191
12099004204,3261,644,1840,593,3,92,0,19,2617
12099004205,5475,1202,3746,359,8,77,1,18,4273
12099004206,2540,578,1414,412,0,51,0,24,1962
12099004207,2450,825,1337,193,1,19,2,14,1625
12099004300,6658,3363,2664,296,2,96,7,42,3295
12099004401,3959,1176,1828,707,9,80,8,15,2783
12099004402,5536,1039,3332,969,5,61,3,46,4497
12099004500,7652,1188,4568,1644,9,104,3,37,6464
12099004601,4284,925,2725,378,13,150,1,17,3359
12099004602,5318,838,3431,810,15,64,4,48,4480
12099004702,7317,1366,4587,1029,3,152,0,37,5951
12099004704,7266,1105,5003,870,6,135,0,39,6161
12099004705,5878,1121,3770,732,9,133,0,41,4757
12099004706,2701,950,903,643,3,103,0,26,1751
12099004810,4947,3041,1246,366,3,91,0,27,1906
12099004813,6655,1588,1699,2543,1,493,5,66,5067
12099004815,8011,2302,2816,2180,16,368,0,81,5709
12099004816,3526,2082,965,301,6,78,0,18,1444
12099004817,4388,2413,1516,285,6,63,0,20,1975
12099004818,2980,1626,773,457,0,55,0,9,1354
12099004819,4577,1076,2380,863,11,115,0,17,3501
12099004820,3851,324,795,2585,11,34,2,15,3527
12099004821,3667,545,1047,1881,2,61,7,26,3122
12099004822,2834,1750,681,250,3,72,0,11,1084
12099004823,2993,1784,731,250,2,72,1,14,1209
12099004902,2147,1777,209,44,0,57,0,12,370
12099004903,5266,625,2781,1718,5,35,3,20,4641
12099004904,6496,1168,3839,1132,15,127,2,63,5328
12099005000,5234,2504,2028,464,1,87,0,20,2730
12099005101,3548,481,2465,530,17,3,2,11,3067
12099005102,6613,765,3200,2460,14,24,4,29,5848
12099005202,4802,1345,2209,1036,9,40,0,54,3457
12099005203,2580,1177,1045,243,5,20,0,14,1403
12099005204,4158,1728,1763,442,7,36,4,20,2430
12099005300,4869,3582,711,300,7,61,0,29,1287
12099005411,3345,3092,147,5,0,36,7,9,253
12099005412,3001,2617,206,37,1,56,0,16,384
12099005413,1261,1128,68,5,0,31,0,4,133
12099005501,3977,2122,749,880,8,82,6,11,1855
12099005502,6371,2574,1543,1858,10,91,0,70,3797
12099005601,5444,1082,1821,2357,1,34,0,19,4362
12099005602,2173,1728,231,78,4,25,0,15,445
12099005702,7121,1746,909,4139,9,54,2,43,5375
12099005703,2161,363,384,1325,1,14,3,17,1798
12099005704,2013,717,348,846,5,32,1,14,1296
12099005807,5608,2777,1409,1002,5,183,2,64,2831
12099005810,1639,1400,132,42,1,16,1,5,239
12099005811,3537,1927,515,738,3,193,3,31,1610
12099005812,4255,1681,1570,626,6,176,0,26,2574
12099005813,5818,2675,1358,1243,8,244,1,45,3143
12099005814,4546,897,2752,734,4,61,1,18,3649
12099005815,4320,1651,1086,1278,1,136,0,22,2669
12099005818,4239,2102,933,803,4,138,0,83,2137
12099005819,3620,1002,579,1653,4,216,7,34,2618
12099005820,6723,2591,1871,1631,10,264,3,76,4132
12099005821,5940,2995,1232,1106,6,282,1,50,2945
12099005916,7928,2929,1957,2050,9,575,0,52,4999
12099005917,4793,2618,955,810,4,211,2,23,2175
12099005918,5497,2747,1305,788,5,337,0,52,2750
12099005921,7576,5080,1203,686,10,255,4,73,2496
12099005922,5588,3668,863,600,6,174,0,28,1920
12099005923,3382,2806,236,170,2,106,0,15,576
12099005926,4505,3538,411,431,2,40,1,15,967
12099005930,3821,2820,472,314,1,79,0,12,1001
12099005931,2920,2414,303,99,0,51,1,6,506
12099005933,2922,2577,178,85,3,20,0,10,345
12099005934,5003,3789,628,262,0,131,0,36,1214
12099005936,3144,2184,426,296,4,136,0,24,960
12099005937,1551,1412,55,11,0,30,0,3,139
12099005938,4116,3421,375,181,0,57,0,20,695
12099005939,1350,1092,143,45,0,14,4,7,258
12099005940,2135,1622,274,111,0,15,1,21,513
12099005942,2515,2135,173,29,0,89,0,21,380
12099005943,2281,1854,237,102,0,17,0,8,427
12099005944,2264,1809,276,86,0,29,0,10,455
12099005945,4313,3870,206,100,5,56,0,30,443
12099005946,8087,4760,1525,952,7,464,4,66,3327
12099005947,4253,4092,68,21,1,29,0,11,161
12099005949,3404,2749,293,181,3,86,0,26,655
12099005950,4324,2493,721,647,5,236,3,44,1831
12099005951,4408,1729,741,1689,11,95,0,33,2679
12099005952,1357,1203,99,25,0,10,0,4,154
12099005953,4646,3352,523,583,0,88,1,16,1294
12099005954,4408,3387,434,314,0,122,0,19,1021
12099005955,4413,4011,248,56,5,22,0,7,402
12099005957,3586,2306,646,358,7,102,0,38,1280
12099005958,1822,1266,322,87,1,65,0,15,556
12099005959,4004,3105,480,209,2,60,0,14,899
12099005960,6030,3603,1092,706,6,326,1,39,2427
12099005961,2255,1204,691,144,5,114,1,11,1051
12099006005,4202,2707,503,643,7,164,0,30,1495
12099006006,2768,2282,252,133,4,53,0,7,486
12099006007,4054,1486,431,1922,5,86,0,30,2568
12099006008,2743,2146,203,246,1,75,0,8,597
12099006009,2208,1931,167,47,2,16,0,0,277
12099006010,3724,1583,556,1306,8,69,0,42,2141
12099006011,3353,2180,521,450,0,92,0,11,1173
12099006012,4983,2738,934,950,9,113,2,58,2245
12099006100,4806,1352,408,2861,4,27,2,21,3454
12099006201,5029,1513,909,2387,0,50,0,24,3516
12099006202,3220,2334,467,259,1,36,0,28,886
12099006203,2304,1495,263,423,5,37,1,12,809
12099006301,3315,2328,453,309,5,56,0,20,987
12099006302,3518,2071,440,822,4,37,1,12,1447
12099006401,2123,1778,184,48,7,38,0,10,345
12099006402,3519,3084,221,73,0,39,1,15,435
12099006501,1605,979,235,315,6,8,0,3,626
12099006502,3979,2628,382,775,3,69,5,20,1351
12099006602,3485,2907,319,76,0,39,1,14,578
12099006604,4724,1835,488,2107,4,100,0,18,2889
12099006606,4067,3005,463,407,5,78,0,17,1062
12099006607,5626,3401,473,1377,5,116,5,32,2225
12099006700,2709,550,263,1780,6,27,0,12,2159
12099006801,6409,666,995,4486,6,69,0,30,5743
12099006802,2994,388,339,2170,6,13,0,17,2606
12099006906,5067,3556,625,514,14,95,0,46,1511
12099006907,3903,2713,517,424,8,88,3,24,1190
12099006908,5292,2709,788,1506,5,94,0,37,2583
12099006909,2447,1786,298,238,2,37,1,25,661
12099006910,2151,1495,303,240,0,49,0,11,656
12099006911,3327,2094,578,357,4,88,0,47,1233
12099006912,4795,3422,604,310,1,200,0,45,1373
12099007005,4349,3802,227,52,0,160,0,16,547
12099007006,4239,3208,441,102,4,269,2,29,1031
12099007007,3901,3271,354,41,1,81,0,19,630
12099007008,4847,3446,761,182,5,193,3,38,1401
12099007009,3526,2644,508,77,2,109,1,32,882
12099007010,2124,1890,150,13,0,21,0,4,234
12099007011,2925,2592,238,26,0,19,2,6,333
12099007012,2488,1678,388,102,1,171,0,16,810
12099007013,4091,3206,485,83,0,135,0,32,885
12099007100,4308,1951,735,1286,5,81,4,27,2357
12099007202,4110,2870,617,193,4,145,1,46,1240
12099007204,2498,1220,735,269,1,93,4,44,1278
12099007205,3572,1924,820,402,4,168,0,59,1648
12099007206,2290,1739,314,61,0,38,0,14,551
12099007207,1855,1227,350,74,0,110,1,12,628
12099007208,1974,1300,362,91,0,91,4,26,674
12099007301,4700,3354,714,330,12,104,1,36,1346
12099007302,4935,3380,805,242,11,217,3,42,1555
12099007407,2092,1880,110,7,0,45,2,11,212
12099007410,1783,1661,60,9,0,12,0,7,122
12099007412,1449,1326,77,5,0,9,0,3,123
12099007414,2203,1993,120,13,2,36,2,9,210
12099007420,3243,2790,239,26,4,54,1,20,453
12099007421,4282,3725,320,32,6,66,1,18,557
12099007501,3709,2524,458,474,5,75,0,24,1185
12099007504,3204,2439,443,120,6,68,0,18,765
12099007505,3664,3022,320,59,5,85,0,29,642
12099007603,2349,1754,382,34,0,71,0,17,595
12099007604,6616,5225,898,98,4,87,0,41,1391
12099007605,4268,3290,584,55,6,119,0,31,978
12099007610,4718,3511,674,139,4,114,0,67,1207
12099007612,5495,3316,1304,175,8,248,2,45,2179
12099007613,4298,2403,1092,232,0,206,2,79,1895
12099007614,5143,3727,888,67,6,144,0,71,1416
12099007615,4392,2540,952,319,1,236,4,76,1852
12099007616,3844,3248,339,47,0,94,1,15,596
12099007619,1408,851,301,89,0,62,0,24,557
12099007620,3225,1281,954,483,3,285,1,58,1944
12099007621,2316,1635,384,61,0,80,0,40,681
12099007622,3293,2266,611,89,2,62,0,46,1027
12099007623,3617,2888,352,90,1,55,1,79,729
12099007624,3428,2884,269,58,0,81,0,23,544
12099007705,4142,2616,991,243,5,118,2,26,1526
12099007710,7626,4308,1741,834,4,345,10,96,3318
12099007716,5152,3020,1265,239,4,195,0,82,2132
12099007721,4948,3426,907,207,3,195,0,44,1522
12099007723,2769,1838,600,151,3,69,0,13,931
12099007724,6061,3347,1818,556,8,114,0,17,2714
12099007725,5792,3342,1534,520,3,143,0,39,2450
12099007730,6432,4133,1181,266,6,372,2,45,2299
12099007731,5527,3252,1046,378,4,291,0,114,2275
12099007732,6791,2838,1928,507,13,289,0,352,3953
12099007735,5880,3887,1000,243,9,353,0,75,1993
12099007736,3702,1699,934,436,4,125,1,127,2003
12099007738,4320,2041,1069,348,7,295,0,119,2279
12099007739,3230,1603,862,209,0,133,0,78,1627
12099007740,5885,3725,1116,264,4,168,1,104,2160
12099007741,4601,3248,738,164,2,114,0,41,1353
12099007742,4906,3301,856,260,5,228,4,54,1605
12099007743,5740,3775,1059,264,2,257,0,71,1965
12099007746,1286,898,226,73,1,30,0,4,388
12099007747,2951,2588,207,72,0,30,2,14,363
12099007748,4750,3126,723,180,0,343,2,65,1624
12099007749,5713,3820,1099,303,5,214,2,50,1893
12099007750,4435,1702,1582,787,5,164,1,38,2733
12099007751,3540,2115,884,298,3,85,0,32,1425
12099007752,7504,4389,1542,724,10,474,2,50,3115
12099007754,4915,3850,425,313,6,190,0,26,1065
12099007757,4674,3547,444,338,0,222,0,26,1127
12099007758,5649,2596,1717,918,4,184,2,46,3053
12099007759,1943,1323,431,71,1,46,0,10,620
12099007763,8167,2984,2249,1947,3,578,0,68,5183
12099007764,2061,1472,340,137,0,42,0,7,589
12099007766,4014,1651,1041,330,1,267,0,211,2363
12099007767,4176,1432,1071,593,2,120,0,215,2744
12099007768,1441,952,264,53,0,86,0,10,489
12099007769,1569,1093,303,80,4,21,0,19,476
12099007770,2976,1859,474,300,0,196,3,16,1117
12099007771,3870,2697,492,362,3,177,0,34,1173
12099007772,6056,4360,656,513,10,294,2,33,1696
12099007773,6503,4909,684,340,10,325,0,42,1594
12099007774,8783,6644,1077,208,6,336,0,48,2139
12099007775,8022,3998,1531,1017,8,1130,5,44,4024
12099007776,1366,901,289,92,0,42,4,0,465
12099007777,4795,3100,985,194,5,119,1,73,1695
12099007778,6804,3738,1277,999,8,460,0,43,3066
12099007779,3711,2738,489,214,8,119,0,25,973
12099007780,1515,987,270,86,0,97,1,6,528
12099007805,7440,5956,800,136,11,218,5,36,1484
12099007812,5928,2563,1778,1162,16,142,2,61,3365
12099007813,6915,2325,2253,1658,8,397,3,60,4590
12099007814,2185,1922,128,33,0,49,0,12,263
12099007818,1676,1080,249,248,0,51,0,0,596
12099007820,2755,1601,739,206,4,65,0,28,1154
12099007821,2827,1627,756,251,4,55,3,9,1200
12099007823,4345,3576,483,34,9,69,1,18,769
12099007830,4260,3656,337,74,0,77,0,13,604
12099007831,4294,3234,476,251,0,218,0,12,1060
12099007832,3982,1610,1241,913,5,66,0,37,2372
12099007833,5706,1243,1407,2770,6,92,2,39,4463
12099007834,1821,1658,63,14,0,31,0,4,163
12099007835,4156,3419,396,79,0,131,2,8,737
12099007837,7054,3891,1306,1231,6,316,0,53,3163
12099007838,8029,3571,1974,1587,15,477,0,61,4458
12099007840,2100,1000,553,384,1,54,4,14,1100
12099007841,6253,2628,1617,1425,13,247,3,70,3625
12099007842,2788,1972,347,261,0,113,0,14,816
12099007843,5471,1503,1434,1967,6,272,6,38,3968
12099007844,4488,2351,934,777,7,177,2,60,2137
12099007845,2615,1742,461,178,2,69,2,34,873
12099007846,617,426,91,29,0,48,0,3,191
12099007847,7540,6112,856,123,9,78,1,34,1428
12099007848,3459,2016,780,418,16,54,5,42,1443
12099007849,1032,533,312,60,1,47,1,7,499
12099007850,906,396,259,159,0,44,0,9,510
12099007851,4087,2507,1078,185,5,105,0,26,1580
12099007852,0,0,0,0,0,0,0,0,0
12099007853,2695,1586,625,273,11,56,0,26,1109
12099007909,4558,3671,320,207,5,195,3,17,887
12099007913,2324,1299,507,324,2,76,5,19,1025
12099007914,5220,2934,1044,767,10,172,5,47,2286
12099007915,1487,833,268,222,0,58,0,11,654
12099007916,4436,2589,904,572,20,102,1,32,1847
12099007917,5316,2983,1090,865,16,77,2,57,2333
12099007918,3499,1999,732,435,4,106,0,65,1500
12099007919,5131,2827,1033,715,18,234,3,63,2304
12099008001,3548,423,997,2078,0,10,1,7,3125
12099008002,4366,293,1175,2824,2,13,0,5,4073
12099008101,6110,761,3730,1486,6,35,0,11,5349
12099008102,0,0,0,0,0,0,0,0,0
12099008201,3983,64,397,3420,0,0,0,5,3919
12099008202,3086,46,105,2842,1,17,1,7,3040
12099008203,4467,399,2160,1835,1,29,2,6,4068
12099008301,1625,158,453,999,1,2,0,0,1467
12099008302,6207,733,1772,3602,2,2,1,14,5474
12099980000,0,0,0,0,0,0,0,0,0
12099980100,2,0,1,0,0,0,0,0,2
12099980200,14,7,4,1,0,0,0,0,7
12099980400,0,0,0,0,0,0,0,0,0
12099980500,0,0,0,0,0,0,0,0,0
12099990000,0,0,0,0,0,0,0,0,0
12099990100,0,0,0,0,0,0,0,0,0
12101030101,3468,2543,545,146,6,50,2,23,925
12101030102,2623,2300,141,31,10,23,0,2,323
12101030202,3209,2810,188,37,15,36,3,10,399
12101030203,1561,1342,132,34,0,6,2,1,219
12101030204,1459,1097,197,67,8,21,0,8,362
12101030205,2308,1862,266,58,1,32,0,5,446
12101030303,3341,2855,270,30,6,63,2,13,486
12101030304,5644,4600,555,135,24,79,3,26,1044
12101030404,3031,2448,250,76,12,107,0,20,583
12101030405,2342,1750,331,118,7,36,2,1,592
12101030406,2735,2010,399,144,10,54,1,7,725
12101030407,3243,2320,487,205,5,67,2,28,923
12101030408,3438,2225,592,357,13,55,0,12,1213
12101030409,2972,2104,480,192,0,54,4,14,868
12101030410,2367,1930,259,64,8,19,0,1,437
12101030411,3245,2338,487,175,5,70,1,11,907
12101030412,3063,1970,587,280,17,56,0,13,1093
12101030501,2256,1663,318,126,12,37,1,11,593
12101030502,4859,3575,679,283,18,73,0,33,1284
12101030601,2448,1839,331,101,3,60,3,12,609
12101030602,2736,1891,471,124,12,83,0,23,845
12101030700,4249,2907,819,162,9,94,0,32,1342
12101030800,3259,2252,646,119,8,73,4,18,1007
12101030901,3981,2939,593,182,18,34,1,28,1042
12101030905,3689,2867,484,105,8,45,3,12,822
12101030906,5639,4151,842,239,8,92,5,21,1488
12101031003,6398,4335,1287,321,18,108,0,31,2063
12101031005,4027,2571,897,240,17,54,5,7,1456
12101031006,1983,1187,436,225,10,25,4,12,796
12101031007,5695,3655,1350,277,11,86,11,24,2040
12101031008,2491,2097,173,30,3,34,2,4,394
12101031009,3099,2210,534,141,21,44,1,13,889
12101031010,4511,3040,946,214,15,45,4,25,1471
12101031011,2781,2144,376,81,5,48,0,5,637
12101031012,5118,3953,730,143,21,51,2,12,1165
12101031013,3379,2270,689,213,18,29,0,13,1109
12101031014,3521,2332,760,170,14,39,0,17,1189
12101031101,4482,3714,407,110,13,65,4,14,768
12101031103,1405,1234,96,13,1,12,0,3,171
12101031104,4044,3310,477,75,10,32,1,6,734
12101031203,2831,2331,274,54,12,73,2,11,500
12101031204,2904,2378,314,45,7,33,5,16,526
12101031205,3958,3459,271,44,6,41,0,3,499
12101031206,3152,2652,271,40,9,19,0,4,500
12101031207,2907,2327,326,67,9,19,1,12,580
12101031208,5521,3901,891,333,13,152,0,35,1620
12101031301,3625,3062,263,89,0,62,1,15,563
12101031302,6400,5144,494,152,9,312,2,20,1256
12101031401,4162,2980,632,233,18,45,2,16,1182
12101031404,4225,2980,720,225,12,112,2,20,1245
12101031406,3171,2561,384,86,16,29,0,5,610
12101031407,3098,2529,324,68,6,24,6,5,569
12101031410,3230,2417,408,154,6,63,6,22,813
12101031411,1679,1349,170,25,2,59,0,11,330
12101031412,4525,3356,679,194,10,58,7,16,1169
12101031503,3244,2417,468,117,7,98,0,4,827
12101031504,2002,1702,139,16,1,87,0,0,300
12101031505,6222,4658,865,237,11,134,5,23,1564
12101031506,4612,3223,830,130,7,138,0,20,1389
12101031507,6787,5538,651,136,14,149,4,33,1249
12101031508,5068,3987,486,135,1,235,1,25,1081
12101031601,7827,6049,732,266,16,425,4,41,1778
12101031602,9280,6069,1646,419,16,590,14,45,3211
12101031603,10457,5597,2888,717,8,630,3,66,4860
12101031604,7086,4663,1263,353,21,463,10,48,2423
12101031605,6481,4412,1018,196,12,496,3,45,2069
12101031701,9232,6473,1469,327,28,517,7,24,2759
12101031703,4888,4047,372,92,25,38,0,11,841
12101031704,6050,4984,635,82,6,108,2,33,1066
12101031705,4445,3616,428,86,6,129,3,22,829
12101031706,4097,3459,326,68,1,51,1,12,638
12101031707,3308,2916,178,46,5,47,0,17,392
12101031708,5557,4735,461,97,8,84,0,21,822
12101031804,4274,3777,246,47,18,38,3,11,497
12101031805,4129,3532,321,24,18,34,0,12,597
12101031806,4944,4009,567,38,16,42,7,15,935
12101031807,3560,2944,340,70,27,35,1,7,616
12101031808,3581,2645,561,109,10,57,0,11,936
12101031809,2754,2215,297,70,8,29,0,4,539
12101031901,3816,2817,687,118,6,43,1,18,999
12101031902,9909,7222,1431,577,17,241,4,43,2687
12101031903,7953,4353,1943,902,25,300,2,59,3600
12101032001,6527,4344,1154,422,15,231,0,43,2183
12101032005,4174,3472,393,101,5,83,0,4,702
12101032006,7730,4981,1629,520,21,161,4,48,2749
12101032007,2865,2193,410,75,14,38,0,19,672
12101032008,4795,3119,1022,226,7,161,0,34,1676
12101032009,8379,5561,1637,364,16,375,2,45,2818
12101032010,3778,2156,1037,285,6,120,3,25,1622
12101032011,5067,3054,1015,473,7,199,1,63,2013
12101032012,3609,1690,1071,419,5,168,6,52,1919
12101032013,5538,3700,1127,265,11,126,2,44,1838
12101032014,6678,3697,1741,561,18,310,2,54,2981
12101032103,8130,3863,2180,1114,26,433,6,54,4267
12101032104,4870,2472,1379,556,5,208,5,37,2398
12101032105,8538,3966,2306,1510,10,287,8,79,4572
12101032106,8506,4606,1755,804,7,818,10,85,3900
12101032107,10670,5323,2615,1161,25,859,12,86,5347
12101032108,8090,4920,1682,531,12,454,6,60,3170
12101032109,4934,2132,1242,656,5,612,5,40,2802
12101032110,2869,1766,535,239,6,183,8,8,1103
12101032111,5412,2609,1223,730,8,548,3,43,2803
12101032112,3875,2040,894,382,4,341,2,31,1835
12101032113,3994,1939,1117,507,4,195,1,35,2055
12101032200,6730,4407,875,1035,19,161,0,28,2323
12101032300,2324,1863,266,64,1,18,0,8,461
12101032401,2932,2067,550,179,10,9,0,18,865
12101032402,2789,1526,875,291,8,3,0,12,1263
12101032500,6215,2853,2587,532,12,29,2,12,3362
12101032601,3359,1155,1329,751,15,13,0,10,2204
12101032602,3371,2182,781,229,10,26,0,3,1189
12101032700,3096,2081,484,423,4,13,3,6,1015
12101032802,3175,2562,403,46,16,31,0,12,613
12101032804,2898,2230,370,155,6,46,2,16,668
12101032805,3959,3086,534,121,11,73,4,8,873
12101032901,8109,4756,1769,883,19,249,10,60,3353
12101032902,2074,1665,215,89,7,42,2,10,409
12101032905,5417,4568,445,224,15,26,3,16,849
12101033005,4704,3730,511,170,19,86,0,16,974
12101033006,2558,1770,448,204,4,37,5,9,788
12101033007,1912,1771,68,10,0,9,0,1,141
12101033008,2717,2073,350,114,7,29,0,16,644
12101033009,3195,2234,529,226,0,35,2,19,961
12101033010,4025,3066,578,143,16,29,3,9,959
12101033011,1744,1415,192,56,0,13,2,7,329
12101033012,2529,2066,295,75,17,10,2,6,463
12101033013,3102,2113,591,173,18,41,0,2,989
12101033014,2821,2431,221,26,10,14,0,17,390
12101033101,2348,1760,248,252,7,7,0,4,588
12101033102,1710,1217,303,102,7,19,0,5,493
12101990000,0,0,0,0,0,0,0,0,0
12103020105,5432,4342,347,423,6,119,6,29,1090
12103020106,3839,3409,178,44,6,58,1,11,430
12103020107,1725,1546,60,17,8,53,0,9,179
12103020108,2312,2124,108,18,3,28,0,2,188
12103020109,4025,1139,354,2337,2,27,0,21,2886
12103020110,1402,339,78,891,2,8,1,7,1063
12103020201,4727,1576,251,2576,9,83,3,46,3151
12103020202,3178,1546,164,1268,2,51,3,22,1632
12103020206,4330,1601,260,2216,15,56,3,33,2729
12103020207,2610,1634,185,631,0,62,1,13,976
12103020208,2640,561,139,1780,5,32,1,18,2079
12103020209,4408,1821,269,2030,4,72,2,32,2587
12103020301,3529,1212,194,1882,12,46,2,37,2317
12103020302,3763,2050,319,1145,4,53,0,23,1713
12103020400,2270,1487,153,432,8,70,4,14,783
12103020500,4149,757,210,2947,2,27,1,39,3392
12103020600,3915,415,177,3135,2,25,0,30,3500
12103020700,3661,320,109,3111,7,11,0,12,3341
12103020800,5219,596,255,4121,16,12,1,7,4623
12103021200,3843,436,200,3033,11,13,5,18,3407
12103021501,2772,2357,148,93,3,83,0,11,415
12103021502,1608,1070,143,265,8,33,0,11,538
12103021600,2591,1256,299,834,1,59,0,12,1335
12103021800,2523,1627,182,510,10,34,0,26,896
12103021900,3304,1656,309,1053,6,94,0,31,1648
12103022000,3262,738,217,2124,3,37,0,4,2524
12103022101,2244,1399,210,461,9,41,2,10,845
12103022102,2617,1776,231,371,11,76,0,15,841
12103022200,4090,2554,426,774,9,98,0,25,1536
12103022301,2766,2170,212,212,5,22,3,18,596
12103022302,3743,3096,262,172,8,62,9,18,647
12103022401,3566,3037,210,54,9,76,0,20,529
12103022402,5061,4263,372,92,7,84,0,23,798
12103022501,5211,3801,582,341,17,185,4,23,1410
12103022502,3501,2454,505,224,1,131,6,18,1047
12103022503,5317,3990,565,181,12,290,2,31,1327
12103022601,3407,2531,407,161,7,162,0,7,876
12103022602,4398,3224,498,182,11,232,6,31,1174
12103022700,4115,2791,488,353,0,337,3,15,1324
12103022801,4591,2635,918,406,2,403,6,22,1956
12103022802,3077,1991,476,111,0,362,0,13,1086
12103022901,2990,1890,291,431,11,228,2,16,1100
12103022902,2601,1316,424,290,9,411,2,18,1285
12103023000,2688,1542,322,253,5,421,0,12,1146
12103023100,2755,1847,266,226,9,225,1,13,908
12103023200,2821,2323,205,72,3,80,1,19,498
12103023300,2314,1742,242,138,2,61,0,6,572
12103023400,1879,1337,182,213,2,37,0,10,542
12103023501,2171,1580,195,147,25,64,1,12,591
12103023502,1237,958,131,63,6,21,0,2,279
12103023601,2164,1821,171,55,0,39,5,8,343
12103023602,1543,1241,120,48,0,32,4,14,302
12103023700,2453,2122,153,49,5,33,0,5,331
12103023800,2337,1978,161,47,4,38,2,10,359
12103023900,2064,1724,185,50,0,31,0,3,340
12103024001,3458,2972,225,33,5,91,0,16,486
12103024002,5224,4396,403,59,8,126,3,22,828
12103024004,4890,4197,319,47,9,118,0,15,693
12103024005,3130,2548,257,61,0,76,0,19,582
12103024100,4626,3500,530,215,5,182,4,15,1126
12103024201,2769,1987,300,164,6,162,1,23,782
12103024202,2369,1797,246,100,1,93,0,13,572
12103024301,3853,2835,369,179,7,246,2,21,1018
12103024302,4359,3160,406,210,15,319,1,25,1199
12103024403,4133,2959,505,255,9,158,2,27,1174
12103024406,6048,3841,871,693,17,326,1,40,2207
12103024408,4010,2560,562,490,18,108,1,44,1450
12103024409,3044,2671,173,17,6,79,0,10,373
12103024410,3551,2273,414,498,8,147,2,24,1278
12103024411,4130,3270,395,111,2,134,4,24,860
12103024412,4663,2847,616,498,10,442,2,28,1816
12103024413,4595,3607,349,279,9,148,1,21,988
12103024505,6974,4552,752,541,24,740,1,50,2422
12103024507,3493,2668,377,145,17,130,6,20,825
12103024508,5356,3215,754,684,22,370,5,23,2141
12103024509,3617,2716,299,126,11,303,0,34,901
12103024510,5282,2151,1372,1439,6,200,8,7,3131
12103024512,3006,2178,372,98,10,223,0,15,828
12103024514,4953,2589,1228,528,13,275,11,47,2364
12103024515,1868,1373,175,149,1,84,0,12,495
12103024516,2072,1836,72,52,0,47,0,6,236
12103024517,3154,2088,403,280,7,206,0,12,1066
12103024518,1788,1086,249,262,5,85,0,24,702
12103024519,3488,2106,514,580,11,90,3,26,1382
12103024601,3794,2447,511,352,17,231,4,25,1347
12103024603,2955,1469,555,558,10,168,0,30,1486
12103024604,3130,1891,423,387,7,281,4,17,1239
12103024701,3330,1886,460,361,6,460,0,11,1444
12103024702,2501,1491,475,237,10,177,0,5,1010
12103024703,3038,1686,420,408,6,300,15,13,1352
12103024801,4453,3152,559,164,4,350,2,21,1301
12103024803,2599,1771,300,243,7,127,5,18,828
12103024804,2359,1472,386,208,1,152,3,7,887
12103024805,2769,1822,427,131,3,238,0,16,947
12103024901,5563,3516,747,354,4,605,16,32,2047
12103024904,4096,2541,609,199,7,494,2,34,1555
12103024905,6802,4102,1136,327,29,792,5,57,2700
12103024906,4331,2674,694,282,10,384,5,35,1657
12103024907,3778,2244,635,347,14,362,7,21,1534
12103024908,3205,1818,563,283,5,340,6,25,1387
12103025004,6392,4041,1040,354,13,592,2,34,2351
12103025007,4502,3466,412,181,8,250,2,17,1036
12103025009,3879,2492,556,291,7,273,7,37,1387
12103025011,5077,3968,420,105,24,318,4,35,1109
12103025012,5645,4315,555,170,20,310,0,22,1330
12103025013,4209,3192,394,159,18,188,3,19,1017
12103025014,4885,3242,538,191,5,600,8,25,1643
12103025015,2877,2499,192,50,6,63,0,14,378
12103025016,2110,1630,179,74,4,104,42,5,480
12103025017,3030,2351,241,171,13,106,0,15,679
12103025018,2914,1855,392,318,8,197,4,16,1059
12103025019,2634,1876,395,146,4,74,0,20,758
12103025020,2930,2133,284,200,3,184,0,15,797
12103025021,3192,2505,257,72,3,212,0,13,687
12103025106,2897,2448,167,86,8,74,0,8,449
12103025107,4098,3462,284,76,10,84,3,21,636
12103025108,2466,2179,115,33,5,34,0,11,287
12103025109,4177,3386,335,116,10,140,1,15,791
12103025110,5957,4924,509,107,16,139,8,33,1033
12103025111,3092,2795,122,46,13,50,0,7,297
12103025112,3466,2933,253,58,8,78,0,13,533
12103025113,2913,2455,218,51,3,45,0,16,458
12103025114,3243,2722,224,50,7,83,0,14,521
12103025115,3124,2508,284,125,6,37,2,12,616
12103025116,2049,1662,145,44,6,55,0,10,387
12103025119,5686,4704,435,149,8,121,1,21,982
12103025120,3510,3021,204,25,2,85,0,15,489
12103025121,4846,4096,295,54,9,162,0,8,750
12103025122,5167,4536,290,48,0,81,3,14,631
12103025123,1892,1671,105,18,6,21,0,5,221
12103025204,3414,2858,212,105,9,71,9,16,556
12103025205,3795,3338,194,25,4,64,3,11,457
12103025207,6758,4312,714,1143,6,122,23,36,2446
12103025208,1545,1338,112,27,0,14,1,6,207
12103025209,4280,3326,444,248,8,46,5,27,954
12103025210,2965,2640,152,17,3,49,0,21,325
12103025211,2537,2239,123,40,3,23,0,19,298
12103025303,5090,4007,459,233,13,164,1,11,1083
12103025305,3176,2292,426,288,22,24,3,19,884
12103025307,4389,2229,570,1229,12,99,0,25,2160
12103025309,2276,1864,192,102,3,30,1,9,412
12103025310,1222,1029,98,35,0,17,0,0,193
12103025311,4071,3338,355,92,17,103,10,17,733
12103025401,4603,3482,570,140,11,175,5,31,1121
12103025407,5371,3941,659,294,19,153,6,51,1430
12103025411,1969,1130,344,244,1,93,0,24,839
12103025412,4784,3430,677,264,5,152,17,25,1354
12103025413,3447,2610,404,147,11,106,3,33,837
12103025414,2647,2031,306,97,4,100,0,9,616
12103025415,2838,2137,341,119,3,103,3,12,701
12103025416,3392,2364,513,168,4,103,3,25,1028
12103025417,2693,2306,163,100,0,31,3,13,387
12103025418,2562,1815,275,188,11,149,0,29,747
12103025419,4210,2614,1163,121,4,77,4,23,1596
12103025420,2681,2051,280,133,6,82,3,11,630
12103025421,3633,2640,290,277,2,169,2,55,993
12103025501,4089,3188,455,119,15,123,0,14,901
12103025505,2219,1099,521,400,7,40,1,14,1120
12103025507,3488,2923,290,93,7,96,0,2,565
12103025508,1406,1123,118,61,3,48,0,8,283
12103025509,2515,1702,411,183,7,54,0,20,813
12103025510,3008,2049,546,139,5,111,0,12,959
12103025602,3360,2155,620,273,10,79,25,19,1205
12103025603,2460,1754,326,142,7,54,10,20,706
12103025604,1392,917,253,81,8,42,13,20,475
12103025700,4240,3842,173,38,3,75,1,10,398
12103025800,4353,1884,909,1220,10,72,2,25,2469
12103025901,3664,2011,780,589,11,73,9,21,1653
12103025902,2605,1897,380,167,6,69,0,6,708
12103026001,2885,2603,141,9,2,49,0,10,282
12103026003,1679,1443,95,34,3,53,0,2,236
12103026004,1136,987,71,8,2,36,0,7,149
12103026101,2431,1176,358,713,5,40,1,10,1255
12103026102,1367,1079,103,110,4,16,0,2,288
12103026200,2256,389,358,1380,6,9,4,14,1867
12103026300,7025,3052,1409,1945,12,122,81,43,3973
12103026401,3408,2016,845,270,11,106,5,11,1392
12103026402,3113,1100,1368,495,6,30,0,14,2013
12103026501,2907,2050,493,157,8,65,1,17,857
12103026502,4518,2427,1145,525,9,154,22,11,2091
12103026601,3583,2573,536,165,5,106,0,21,1010
12103026602,4207,2506,1168,186,0,147,2,13,1701
12103026701,4584,2906,785,527,9,137,9,27,1678
12103026703,6523,3539,2029,448,11,173,1,44,2984
12103026704,2873,1946,382,224,9,108,0,17,927
12103026705,3458,2396,576,183,9,104,0,21,1062
12103026804,5424,3593,999,386,4,163,1,30,1831
12103026809,2548,2067,234,67,5,71,2,11,481
12103026811,6224,5138,527,102,12,184,3,42,1086
12103026812,4433,3400,574,134,7,125,8,20,1033
12103026813,3297,2456,493,61,0,148,0,5,841
12103026814,2353,2109,118,21,5,21,1,3,244
12103026815,4724,3916,361,56,12,160,0,15,808
12103026816,5667,4346,543,348,16,110,2,38,1321
12103026817,5187,4033,526,183,10,204,0,10,1154
12103026818,4231,1951,1254,648,12,128,0,27,2280
12103026819,2388,1462,519,231,7,67,0,6,926
12103026820,4365,3660,369,90,8,99,5,17,705
12103026821,2733,2065,356,79,5,71,3,11,668
12103026904,4553,3395,610,156,21,190,3,10,1158
12103026908,4012,3523,208,56,1,75,0,12,489
12103026909,4580,3781,429,90,5,76,1,13,799
12103026911,3993,3431,271,82,6,66,0,16,562
12103026912,4031,3103,499,130,4,160,1,13,928
12103026913,3254,2599,315,136,1,92,0,9,655
12103026914,3670,3129,264,64,7,82,4,15,541
12103026915,2817,2247,269,124,9,49,2,14,570
12103026916,4536,3440,529,171,18,146,8,26,1096
12103026917,1226,1032,95,47,4,18,0,3,194
12103027000,4937,3920,485,194,10,59,22,45,1017
12103027105,3394,2998,174,49,6,44,2,15,396
12103027106,4479,4053,174,27,12,45,2,14,426
12103027107,1555,1173,151,109,2,18,7,4,382
12103027108,2411,2126,103,95,3,22,0,6,285
12103027202,6372,5725,292,23,11,59,3,29,647
12103027204,4705,3994,297,79,8,148,1,10,711
12103027206,6619,5542,509,76,8,141,0,35,1077
12103027207,4723,3905,387,67,10,103,7,15,818
12103027208,6844,5693,575,89,12,157,5,18,1151
12103027209,1271,1153,62,13,3,8,0,6,118
12103027210,4599,4102,213,35,10,35,0,11,497
12103027211,4571,3874,358,80,5,99,1,14,697
12103027212,3563,2848,373,104,1,65,1,5,715
12103027308,4706,3441,512,381,4,105,2,29,1265
12103027309,2092,1792,126,10,2,99,0,1,300
12103027314,3015,2491,255,85,3,55,3,19,524
12103027316,3917,3406,224,50,3,115,1,12,511
12103027317,5391,4219,616,188,6,104,0,24,1172
12103027318,3785,2975,438,102,2,110,2,14,810
12103027319,5322,3684,769,250,11,308,12,29,1638
12103027320,4623,3289,695,193,7,235,0,24,1334
12103027321,1504,1255,119,11,3,57,0,0,249
12103027323,2715,1908,369,166,1,109,0,11,807
12103027324,3910,3309,296,38,1,121,3,8,601
12103027325,3623,3064,251,50,2,127,0,9,559
12103027326,3611,2689,451,130,10,175,3,22,922
12103027327,4895,3223,949,213,6,268,7,31,1672
12103027328,4605,3781,285,61,6,282,0,24,824
12103027329,3925,3285,270,61,10,131,4,14,640
12103027330,2320,2085,137,26,1,37,0,5,235
12103027331,2922,2572,180,22,6,52,0,1,350
12103027332,2858,2410,215,42,7,67,2,8,448
12103027333,4027,3171,431,104,5,151,0,16,856
12103027401,2644,2073,233,178,9,36,0,15,571
12103027404,8010,5768,868,881,12,114,1,54,2242
12103027501,6042,5322,347,71,17,75,5,19,720
12103027503,4088,3464,308,64,14,42,8,16,624
12103027504,2530,2094,237,57,4,41,0,16,436
12103027603,2142,1896,115,15,2,19,0,14,246
12103027604,2762,2468,111,17,2,119,0,10,294
12103027605,1706,1482,89,10,4,52,0,4,224
12103027606,1531,1359,100,13,4,14,2,6,172
12103027701,2785,2449,158,27,6,32,0,7,336
12103027703,1048,943,52,4,0,32,0,2,105
12103027704,2404,2082,168,21,5,60,0,8,322
12103027801,1329,1172,72,16,2,17,0,8,157
12103027802,2554,2220,163,21,12,34,1,21,334
12103027901,2112,1886,109,21,3,17,3,15,226
12103027905,4472,4014,215,32,4,53,3,17,458
12103028002,3660,3282,178,17,0,55,1,10,378
12103028004,1945,1742,107,11,2,30,1,7,203
12103028005,1688,1527,76,8,2,21,1,0,161
12103028006,1432,1264,77,17,9,7,3,4,168
12103028102,3591,2976,234,82,4,91,1,34,615
12103028103,1947,1690,108,65,2,15,2,11,257
12103028104,3446,3162,141,47,3,38,3,11,284
12103028200,2206,1835,138,105,6,36,1,13,371
12103028300,3344,2352,263,456,10,36,14,19,992
12103028403,2703,2423,126,43,9,18,0,11,280
12103028500,1952,1643,96,92,7,11,2,10,309
12103028601,3807,2685,399,431,5,105,2,19,1122
12103028602,2725,2045,290,213,7,87,0,16,680
12103028700,3124,246,113,2656,10,10,2,16,2878
12103990000,0,0,0,0,0,0,0,0,0
12103990100,0,0,0,0,0,0,0,0,0
12105010300,4790,2486,960,972,14,109,3,26,2304
12105010401,2029,1566,257,94,7,14,5,17,463
12105010402,6533,4152,1473,563,59,63,2,78,2381
12105010501,1774,1219,243,156,4,44,3,9,555
12105010502,4351,3332,515,243,6,66,1,7,1019
12105010601,3858,2558,710,298,6,84,6,22,1300
12105010603,3450,2793,327,98,10,51,0,16,657
12105010604,3518,2138,671,406,3,108,5,7,1380
12105010701,4617,2854,1010,474,6,61,1,28,1763
12105010702,3433,2431,507,234,2,90,4,16,1002
12105010800,3550,1848,760,719,16,20,4,39,1702
12105010900,4734,1862,1717,976,15,27,0,7,2872
12105011000,3254,1025,978,1129,13,11,0,22,2229
12105011100,3392,565,1140,1557,1,6,0,19,2827
12105011202,1849,91,178,1477,2,21,2,5,1758
12105011203,3661,214,651,2652,0,14,2,12,3447
12105011204,1552,172,262,1057,0,6,1,2,1380
12105011300,1852,622,461,676,5,13,3,5,1230
12105011400,5081,2063,1521,1227,8,50,0,25,3018
12105011501,5911,3251,1645,647,23,47,5,32,2660
12105011502,7371,4359,1467,981,16,197,3,37,3012
12105011603,2068,1562,266,160,6,13,0,4,506
12105011604,5217,3502,1045,415,18,27,0,21,1715
12105011605,3756,2554,883,128,17,30,2,22,1202
12105011606,2449,1750,457,97,4,11,0,15,699
12105011704,4959,2241,1556,865,9,53,0,16,2718
12105011721,3211,2316,689,62,10,7,2,7,895
12105011722,3206,2169,758,106,9,17,5,6,1037
12105011731,5326,2742,1418,853,16,64,0,28,2584
12105011732,3120,1290,786,810,4,55,10,30,1830
12105011821,3084,2513,292,86,4,45,0,7,571
12105011822,3896,3002,408,145,8,103,0,28,894
12105011832,5106,3159,1064,553,10,131,0,17,1947
12105011834,6739,4688,863,462,19,376,1,34,2051
12105011835,4977,3762,622,205,4,170,2,20,1215
12105011836,3479,2640,483,143,3,56,0,9,839
12105011837,4517,2754,674,367,3,507,5,41,1763
12105011838,4072,2602,679,332,1,253,1,24,1470
12105011901,4913,2674,1271,621,11,101,0,10,2239
12105011902,3530,2528,559,214,14,48,2,12,1002
12105011908,4265,2733,811,450,8,65,0,22,1532
12105011909,3316,2532,412,175,6,50,1,11,784
12105011910,1654,1119,416,33,3,13,1,8,535
12105011911,3544,2514,649,175,6,51,0,19,1030
12105011912,2641,1769,442,247,2,49,1,14,872
12105011913,2864,1366,800,546,0,15,0,18,1498
12105012001,5798,2825,1224,1460,16,32,1,13,2973
12105012002,3125,1735,906,358,11,24,2,6,1390
12105012003,6101,3559,1731,419,17,114,3,25,2542
12105012004,2556,1686,555,147,8,42,0,8,870
12105012113,6722,4253,1415,637,9,133,0,31,2469
12105012124,5657,3989,1026,328,13,63,0,29,1668
12105012125,3029,2221,597,66,8,34,2,10,808
12105012126,4472,2055,1132,717,4,359,1,27,2417
12105012127,8317,4601,1802,995,12,507,0,47,3716
12105012128,4650,2514,1184,599,15,144,1,25,2136
12105012130,2466,1958,295,79,18,17,2,7,508
12105012131,3127,2882,102,55,4,13,0,4,245
12105012132,2812,1428,675,497,19,58,0,7,1384
12105012133,5296,2778,1289,900,9,83,3,13,2518
12105012203,2906,1752,646,305,15,52,0,10,1154
12105012207,3221,2258,670,166,3,37,0,11,963
12105012208,3489,1948,885,494,4,30,1,18,1541
12105012209,6765,4298,1282,760,8,145,0,38,2467
12105012303,4049,2730,679,345,20,107,0,3,1319
12105012304,5381,4118,611,322,4,74,6,20,1263
12105012305,1713,1298,304,13,3,12,0,8,415
12105012306,2476,1962,332,59,2,66,0,7,514
12105012307,3160,2424,467,45,12,70,0,18,736
12105012309,1773,1410,197,47,4,14,0,6,363
12105012404,2347,1316,246,730,2,7,1,10,1031
12105012405,8796,4343,3083,711,19,210,0,65,4453
12105012407,1314,1021,151,67,0,20,0,11,293
12105012408,5048,3551,783,349,18,91,0,19,1497
12105012409,2570,1461,716,224,19,26,0,7,1109
12105012410,2887,1158,901,665,18,60,3,12,1729
12105012411,7046,2871,3013,738,7,109,7,68,4175
12105012412,7457,3483,2791,783,11,86,0,63,3974
12105012413,9648,4313,3789,830,19,244,5,72,5335
12105012414,1603,1263,203,74,0,11,1,5,340
12105012415,3284,1535,1235,240,7,77,5,33,1749
12105012502,12619,4740,5746,1280,27,326,6,80,7879
12105012506,10576,4954,3937,886,28,256,3,93,5622
12105012508,3514,1632,1410,241,9,49,0,15,1882
12105012509,2487,1523,670,138,5,63,3,19,964
12105012510,4255,798,2411,824,11,45,1,58,3457
12105012511,5839,563,3600,1402,0,85,5,39,5276
12105012512,5450,2204,2228,649,9,194,5,44,3246
12105012513,5094,3393,746,597,8,216,0,18,1701
12105012514,8698,3747,3617,830,17,189,0,55,4951
12105012515,7611,2335,3811,954,18,175,4,58,5276
12105012601,6071,1446,2119,2246,8,74,4,36,4625
12105012602,5688,877,3892,765,4,16,0,26,4811
12105012701,4311,801,2609,742,7,46,0,25,3510
12105012702,3823,1428,1738,470,13,57,13,21,2395
12105012802,5551,2308,1932,997,25,119,0,29,3243
12105012803,4583,3495,737,227,5,22,2,9,1088
12105012804,6548,3488,2115,743,2,67,0,16,3060
12105012900,6392,3338,1679,970,19,124,5,41,3054
12105013001,3761,2366,612,451,7,108,2,18,1395
12105013002,5149,3097,1319,443,20,50,3,26,2052
12105013101,4253,3420,434,157,9,75,1,15,833
12105013102,3712,2625,599,245,31,29,1,9,1087
12105013103,1135,643,380,55,1,5,0,1,492
12105013200,1888,822,436,503,8,11,3,4,1066
12105013300,2192,850,527,707,5,3,0,1,1342
12105013400,5352,2283,1160,1607,16,59,3,30,3069
12105013500,3615,2548,468,375,14,97,0,17,1067
12105013601,2096,486,333,1176,0,23,0,8,1610
12105013602,3482,570,374,2413,4,10,1,17,2912
12105013701,1896,1025,372,394,5,32,0,5,871
12105013702,7175,2735,1721,2290,11,111,5,39,4440
12105013801,3807,1983,728,879,5,59,0,7,1824
12105013802,7436,3331,1703,1967,21,150,0,38,4105
12105013901,2993,1151,788,803,10,56,2,59,1842
12105013902,5677,4260,673,438,14,92,3,12,1417
12105014001,5911,4089,831,585,15,174,0,26,1822
12105014003,3778,2264,661,542,13,119,4,18,1514
12105014005,4047,2878,558,291,7,157,5,20,1169
12105014006,3215,2137,439,281,3,226,3,11,1078
12105014104,1985,502,1223,188,3,2,2,10,1483
12105014121,3375,1181,1547,455,4,45,3,33,2194
12105014123,7038,4587,1229,759,10,182,3,13,2451
12105014124,2502,1284,530,550,11,20,0,42,1218
12105014126,5022,813,2629,1311,15,39,0,68,4209
12105014127,7932,968,4413,2112,7,76,7,80,6964
12105014128,5385,2450,2302,384,3,36,7,31,2935
12105014129,3027,2137,588,129,16,26,0,18,890
12105014130,3405,1665,997,534,2,58,4,18,1740
12105014131,2985,1241,824,709,8,62,0,33,1744
12105014201,5564,3771,1133,399,19,13,0,37,1793
12105014202,2832,2033,509,175,1,33,0,4,799
12105014203,2918,2616,168,44,6,12,0,6,302
12105014301,1735,131,175,1375,4,6,1,3,1604
12105014303,3823,1766,873,951,8,45,0,7,2057
12105014304,2708,1691,582,326,3,18,1,6,1017
12105014401,8258,5629,1205,852,19,280,2,35,2629
12105014402,1507,673,486,271,0,6,0,9,834
12105014501,9870,4186,3944,1171,7,241,0,56,5684
12105014502,3228,992,2034,141,0,0,4,5,2236
12105014600,4155,2138,1435,373,14,44,1,23,2017
12105014701,5974,3799,1288,552,11,111,3,45,2175
12105014703,4752,2911,873,666,15,74,3,31,1841
12105014704,5309,3172,880,954,8,74,0,19,2137
12105014802,3058,1561,775,612,8,17,4,1,1497
12105014803,3852,2394,659,503,7,124,1,19,1458
12105014804,9455,6575,1423,537,23,518,4,28,2880
12105014903,2797,1449,1177,61,2,5,3,14,1348
12105014904,4757,2096,2262,275,0,20,0,2,2661
12105014905,2616,1386,951,177,2,6,0,11,1230
12105014906,7851,4769,1724,853,7,176,3,30,3082
12105015000,5249,2311,1234,1415,12,63,0,23,2938
12105015101,3802,2708,597,275,13,62,2,16,1094
12105015102,2527,2056,278,73,0,27,0,1,471
12105015200,4515,1606,725,1987,3,13,5,50,2909
12105015301,4617,2727,842,816,30,21,0,27,1890
12105015302,2739,2159,465,24,22,2,0,1,580
12105015401,2844,1581,414,715,5,25,3,4,1263
12105015402,2880,2182,394,168,7,15,1,14,698
12105015404,1383,1159,121,39,0,12,0,10,224
12105015405,3163,2117,734,159,5,13,7,16,1046
12105015500,4876,1950,1661,1042,10,36,1,27,2926
12105015600,3409,2481,673,80,6,73,5,10,928
12105015701,2387,1471,400,404,16,2,1,13,916
12105015702,4029,2481,704,725,15,14,0,4,1548
12105015801,2424,1737,509,114,3,6,0,4,687
12105015802,3943,1726,1403,736,7,9,0,14,2217
12105015900,2086,1352,556,75,0,30,0,2,734
12105016001,2182,1372,574,148,4,9,3,6,810
12105016002,1636,520,458,619,0,3,0,6,1116
12105016003,1969,1118,692,118,0,0,2,0,851
12105016100,1134,645,126,315,9,13,0,1,489
12105016400,2360,884,510,830,10,12,0,5,1476
12105980000,7,0,1,1,0,0,0,0,7
12107950100,3874,3464,149,46,15,35,1,16,410
12107950201,5835,4826,443,222,16,22,5,27,1009
12107950202,3395,3044,163,38,35,6,0,8,351
12107950300,6754,5020,671,686,36,32,2,24,1734
12107950400,2905,2239,110,420,8,11,0,13,666
12107950500,6312,5164,548,276,37,20,6,21,1148
12107950600,6206,3896,466,1536,24,78,1,29,2310
12107950700,3954,1438,288,2024,6,42,0,11,2516
12107950800,2826,825,140,1744,9,12,2,9,2001
12107950900,6134,3613,389,1835,22,33,0,18,2521
12107951000,4223,3115,251,710,9,21,4,6,1108
12107951100,4529,3610,329,366,13,16,11,12,919
12107951200,5555,4044,1031,246,21,21,4,15,1511
12107951300,3640,2703,440,237,19,22,0,16,937
12107951401,3226,1312,949,782,7,62,0,12,1914
12107951402,3953,2228,1449,106,3,36,1,11,1725
12107980000,0,0,0,0,0,0,0,0,0
12109020200,2396,2109,127,38,9,28,2,4,287
12109020300,3762,2494,314,732,22,18,0,17,1268
12109020400,2525,1808,241,322,9,56,1,3,717
12109020500,3871,3365,228,50,5,78,3,18,506
12109020603,1930,1766,69,6,9,12,0,4,164
12109020604,3065,2730,157,18,2,41,2,13,335
12109020605,17666,13858,1442,512,18,968,23,86,3808
12109020606,11501,9203,944,378,26,387,0,56,2298
12109020704,3622,3213,168,36,6,62,6,12,409
12109020705,6391,5617,378,46,2,139,2,8,774
12109020706,2981,2540,168,20,5,112,0,10,441
12109020707,5797,4789,464,125,10,130,1,34,1008
12109020708,7923,6651,535,97,5,261,0,32,1272
12109020710,2414,2127,101,5,1,65,0,6,287
12109020712,2377,2098,136,18,1,45,2,7,279
12109020713,3008,2799,88,4,1,64,2,4,209
12109020801,9884,6851,1002,426,16,1035,4,75,3033
12109020802,4018,3230,285,121,11,120,0,24,788
12109020803,4283,3713,241,31,1,79,1,18,570
12109020804,4854,3724,441,246,10,171,4,34,1130
12109020807,4286,3386,418,135,3,127,7,19,900
12109020808,12417,8658,1185,517,23,1276,9,63,3759
12109020809,8665,6686,797,403,23,307,4,41,1979
12109020810,7509,5240,786,416,10,571,10,30,2269
12109020811,3156,2017,355,199,2,386,0,15,1139
12109020903,4336,3338,413,256,13,91,0,21,998
12109020904,11292,7977,1299,808,48,564,1,46,3315
12109020905,9361,7092,1123,372,20,234,0,63,2269
12109020906,11348,8115,1538,561,11,385,13,54,3233
12109020907,9269,6712,940,439,16,670,6,47,2557
12109020908,10434,8101,970,455,25,364,7,28,2333
12109021002,4638,2742,375,1269,8,44,0,20,1896
12109021003,5451,3134,373,1639,13,52,1,33,2317
12109021004,2991,2651,118,75,7,20,5,6,340
12109021101,5687,4250,424,755,22,12,0,12,1437
12109021102,5115,4169,394,288,29,43,3,11,946
12109021103,2481,2046,167,122,7,19,1,23,435
12109021207,4091,3380,397,96,10,57,1,14,711
12109021208,6158,5169,448,197,14,92,7,25,989
12109021209,2232,1960,134,33,0,21,1,6,272
12109021210,3990,3362,283,96,9,62,0,16,628
12109021211,3287,2884,195,53,7,45,4,5,403
12109021301,7918,6338,662,340,21,188,8,42,1580
12109021302,5428,4669,370,45,8,43,3,34,759
12109021403,1711,1580,75,5,2,9,2,5,131
12109021404,3210,2921,140,23,2,12,0,6,289
12109021408,7012,6145,393,83,14,133,3,29,867
12109021409,2704,2375,172,15,7,28,0,13,329
12109021410,2980,2646,134,14,1,38,2,33,334
12109990100,0,0,0,0,0,0,0,0,0
12109990200,0,0,0,0,0,0,0,0,0
12111380100,1032,306,123,557,2,4,0,0,726
12111380200,3446,253,229,2817,9,7,0,10,3193
12111380300,6171,260,525,5181,17,4,0,23,5911
12111380400,6919,1446,2784,2417,13,46,3,43,5473
12111380500,6543,2015,2237,2011,7,66,6,24,4528
12111380600,4035,1123,2003,715,1,44,1,15,2912
12111380700,8960,3379,2653,2299,29,196,3,79,5581
12111380800,3352,1945,448,842,2,32,0,13,1407
12111380901,2459,853,405,1125,1,7,0,9,1606
12111380902,5423,488,788,3976,16,10,1,13,4935
12111381000,1771,1207,308,204,5,7,0,0,564
12111381103,3266,2028,407,564,19,44,7,12,1238
12111381104,2027,1354,260,261,3,22,4,11,673
12111381105,2345,1699,300,178,9,24,0,17,646
12111381106,1829,1479,121,129,0,27,0,10,350
12111381107,3204,2398,285,330,7,65,5,12,806
12111381204,3599,3251,177,31,5,54,0,1,348
12111381300,4428,3931,234,63,6,47,2,18,497
12111381401,5248,3139,1045,785,7,58,0,35,2109
12111381402,7023,3393,1872,1348,11,66,2,38,3630
12111381504,3606,2051,828,473,1,65,3,22,1555
12111381505,7237,3220,1723,1733,12,136,6,58,4017
12111381506,3696,1721,782,892,5,94,0,52,1975
12111381507,5106,3726,695,316,12,102,0,27,1380
12111381508,3689,1958,669,754,7,107,1,28,1731
12111381602,3872,2684,505,452,1,46,0,27,1188
12111381603,6991,5401,768,515,16,68,7,22,1590
12111381604,1810,1471,154,82,5,14,0,6,339
12111381605,4372,3604,436,112,5,19,0,24,768
12111381701,2693,2499,118,9,0,25,0,3,194
12111381702,2295,2196,46,7,5,12,0,1,99
12111381802,4757,2285,1103,1017,8,106,0,42,2472
12111381803,6412,3867,1199,885,16,139,0,43,2545
12111381804,6156,3610,1268,767,6,152,5,51,2546
12111381900,6412,5029,736,262,13,118,5,17,1383
12111382007,5233,2408,1333,991,20,139,0,71,2825
12111382008,8250,3799,2234,1549,7,168,7,79,4451
12111382009,4659,2881,887,532,3,129,0,33,1778
12111382010,2095,1531,317,148,8,15,0,15,564
12111382011,2529,1534,545,279,5,24,3,25,995
12111382012,6172,3071,1479,1137,7,90,4,59,3101
12111382013,3238,1779,621,595,8,57,0,23,1459
12111382014,7408,4373,1469,1025,13,132,5,74,3035
12111382015,3786,2014,878,627,4,78,2,41,1772
12111382016,6242,4324,827,691,11,119,0,34,1918
12111382110,7557,3924,1707,1371,18,123,4,73,3633
12111382112,9392,4522,2175,1994,15,149,6,87,4870
12111382114,6548,2913,1609,1585,6,99,6,81,3635
12111382115,7699,3568,1869,1613,11,131,4,96,4131
12111382116,6244,2876,1521,1389,5,108,3,49,3368
12111382117,8201,3376,2096,2042,9,171,10,120,4825
12111382118,5500,2061,1473,1365,8,203,0,82,3439
12111382119,8112,3364,2125,1931,9,164,3,102,4748
12111382120,3498,2430,500,311,1,94,0,33,1068
12111382121,4096,2500,912,383,2,128,3,35,1596
12111382122,5569,4710,449,207,1,71,1,26,859
12111382123,4915,2090,1205,1212,6,138,3,41,2825
12111382124,3507,1611,747,832,10,72,6,42,1896
12111382125,3265,1084,970,969,2,61,0,29,2181
12111382126,12651,8765,1933,1107,10,323,4,65,3886
12111382127,5126,4076,463,213,4,230,0,16,1050
12111382128,5188,2306,1377,1078,12,95,0,57,2882
12111382129,8565,3676,2339,1901,8,213,3,88,4889
12111382130,4017,1788,1047,894,13,49,0,58,2229
12111382201,3559,3109,249,90,9,16,3,5,450
12111382202,4219,2801,729,427,42,55,0,25,1418
12111980000,2,0,1,0,0,1,0,0,2
12111990000,0,0,0,0,0,0,0,0,0
12113010100,3852,3482,82,14,46,10,3,12,370
12113010200,4756,4340,64,26,70,20,5,4,416
12113010301,6291,5121,331,183,42,164,16,43,1170
12113010302,4953,4086,288,176,29,91,5,19,867
12113010303,5219,4421,238,82,45,95,1,17,798
12113010400,2823,2383,100,46,37,30,10,8,440
12113010503,6361,5025,338,368,45,104,20,28,1336
12113010504,6381,5149,297,349,44,109,5,25,1232
12113010505,4394,3276,225,458,20,60,30,21,1118
12113010506,4183,3526,142,128,29,100,2,21,657
12113010601,4636,3057,276,754,31,94,19,30,1579
12113010602,1781,1301,104,214,9,19,4,5,480
12113010704,6973,5393,499,362,32,174,16,35,1580
12113010705,3484,2887,211,95,22,28,15,13,597
12113010707,4424,3796,234,54,13,80,11,30,628
12113010708,6492,5276,324,209,45,168,6,22,1216
12113010709,5861,4703,263,346,29,69,4,23,1158
12113010710,2480,2124,85,60,10,24,2,8,356
12113010711,4764,3910,225,166,28,93,2,24,854
12113010712,3852,3017,260,182,34,44,7,14,835
12113010802,5734,4411,442,243,37,154,8,48,1323
12113010808,10646,6298,1012,2879,44,41,11,28,4348
12113010809,5324,4338,166,285,59,50,10,11,986
12113010812,5076,4288,310,44,36,131,3,5,788
12113010813,5107,4349,277,56,10,110,7,28,758
12113010814,6542,5464,396,94,27,184,7,26,1078
12113010820,6896,5157,618,402,23,169,19,38,1739
12113010821,5793,4102,648,373,13,187,15,33,1691
12113010822,5446,4177,421,315,33,99,15,22,1269
12113010823,4924,3996,328,142,26,97,5,22,928
12113010824,5278,4171,381,184,11,127,2,25,1107
12113010825,3292,2628,241,90,22,83,0,16,664
12113010826,3091,2167,368,140,34,110,30,29,924
12113010827,9096,6321,901,683,36,395,32,51,2775
12113010828,5493,3805,528,469,23,207,12,45,1688
12113010900,6302,5573,267,19,18,98,3,18,729
12113990000,0,0,0,0,0,0,0,0,0
12115000102,4507,2757,1127,440,11,49,2,18,1750
12115000103,4091,3448,290,136,10,87,3,22,643
12115000104,1826,1667,71,17,0,32,0,7,159
12115000200,5222,1985,1186,1410,17,455,14,37,3237
12115000300,3962,325,471,2950,5,11,2,18,3637
12115000401,4197,2555,1069,271,10,80,6,29,1642
12115000404,1258,1061,91,29,0,27,0,6,197
12115000405,3050,2085,729,85,1,23,0,12,965
12115000406,3059,1568,1114,216,0,52,0,26,1491
12115000407,3930,1989,1380,261,4,108,1,39,1941
12115000501,1677,1506,57,13,3,39,2,2,171
12115000502,3378,2391,652,112,11,78,0,21,987
12115000503,3628,2705,677,87,11,28,0,13,923
12115000601,2300,1978,144,19,4,58,0,13,322
12115000602,3678,3064,339,47,0,76,2,15,614
12115000700,3067,2909,64,4,5,49,0,3,158
12115000801,1987,1880,37,8,5,31,0,3,107
12115000802,2772,2609,61,14,1,26,1,12,163
12115000900,2394,1945,195,82,4,77,1,11,449
12115001000,3405,1847,572,468,12,368,2,13,1558
12115001101,4154,2355,838,743,11,31,0,22,1799
12115001102,5352,2258,1618,1162,11,62,2,40,3094
12115001202,4088,2060,1571,209,9,69,1,17,2028
12115001203,4307,3910,183,82,1,46,0,21,397
12115001204,4539,3395,635,139,9,103,7,63,1144
12115001205,3733,2772,492,176,5,87,2,20,961
12115001206,3659,2426,771,212,3,60,0,18,1233
12115001301,3412,2549,508,130,1,119,3,20,863
12115001302,4724,3729,569,106,12,113,0,17,995
12115001303,3886,3131,387,67,5,117,3,22,755
12115001304,1898,1579,213,17,0,21,2,5,319
12115001402,4626,3639,579,120,8,75,0,19,987
12115001403,7032,6167,401,76,2,193,2,18,865
12115001404,5388,4550,334,82,6,183,1,25,838
12115001405,4399,3640,337,78,5,187,0,21,759
12115001503,3388,2533,591,42,9,42,2,23,855
12115001504,3304,2347,677,54,10,42,1,17,957
12115001505,4238,2977,902,69,8,76,2,24,1261
12115001508,2003,1676,200,36,3,28,0,5,327
12115001509,3937,3196,352,42,8,174,1,14,741
12115001510,4511,3733,392,60,11,148,0,22,778
12115001511,3151,2496,279,51,0,155,1,22,655
12115001601,3526,2901,364,52,5,73,0,17,625
12115001602,3811,2794,731,73,0,45,0,29,1017
12115001702,5775,4664,651,88,3,108,7,33,1111
12115001703,3783,2972,535,78,2,49,1,24,811
12115001704,3282,2323,648,63,10,55,2,34,959
12115001801,3742,3325,193,27,3,64,0,12,417
12115001803,2935,2397,332,50,3,38,0,21,538
12115001804,2592,2063,330,42,9,37,0,16,529
12115001805,1870,1619,126,22,7,20,0,7,251
12115001903,1663,1541,40,6,3,19,0,10,122
12115001904,2760,2496,98,7,2,57,0,23,264
12115001905,963,918,19,0,4,10,2,0,45
12115001909,2031,1915,46,7,0,29,0,4,116
12115002003,4392,3486,554,58,13,73,3,21,906
12115002004,4073,3543,282,51,8,69,0,16,530
12115002007,2691,2448,105,24,2,38,3,5,243
12115002008,2731,2085,380,81,1,83,0,1,646
12115002011,1045,972,45,0,0,3,0,4,73
12115002012,3589,3132,238,47,7,45,0,15,457
12115002013,4279,3569,223,48,2,252,2,20,710
12115002014,5576,4908,256,68,6,183,5,18,668
12115002015,2196,1809,189,23,0,79,2,3,387
12115002016,4546,4090,212,39,0,82,0,21,456
12115002101,3686,3167,193,16,3,162,4,12,519
12115002102,3188,2892,128,18,2,57,0,5,296
12115002201,3404,3119,117,17,3,59,5,14,285
12115002203,4198,3590,225,150,14,61,0,8,608
12115002204,2214,1987,78,18,3,51,3,8,227
12115002205,2227,2047,76,19,3,25,2,16,180
12115002302,4518,4135,204,32,9,30,0,10,383
12115002304,2431,2267,60,32,2,21,2,4,164
12115002305,1889,1767,56,6,7,9,0,7,122
12115002306,2767,2572,103,30,1,8,0,2,195
12115002307,1860,1777,42,3,0,9,0,5,83
12115002401,2912,2661,129,14,0,16,0,26,251
12115002403,1413,1330,43,4,2,14,0,2,83
12115002404,2336,2087,120,12,3,33,1,3,249
12115002504,2964,2501,224,24,13,81,0,11,463
12115002505,2383,1948,240,15,1,45,1,11,435
12115002507,5390,4798,335,38,9,68,1,15,592
12115002508,2957,2594,161,30,4,44,0,8,363
12115002509,4660,4171,254,40,5,43,0,12,489
12115002510,3539,3212,159,27,2,34,0,16,327
12115002511,2750,2484,117,19,10,42,2,12,266
12115002601,2648,2415,97,12,2,33,0,4,233
12115002602,2649,2487,50,11,0,23,0,8,162
12115002603,1746,1616,68,5,5,11,0,3,130
12115002604,2937,2705,116,14,9,21,1,12,232
12115002605,2304,2058,148,8,5,18,0,9,246
12115002710,2882,2296,251,166,4,30,7,5,586
12115002714,4999,4523,172,18,16,83,7,10,476
12115002716,8236,7384,383,79,15,130,0,20,852
12115002720,3228,3019,94,11,3,40,0,7,209
12115002721,4812,3642,625,270,7,52,1,27,1170
12115002723,2835,2485,188,47,10,29,3,8,350
12115002724,2425,2370,11,0,0,6,0,1,55
12115002725,5811,5035,390,66,16,105,0,28,776
12115002726,4922,4488,174,45,5,97,0,2,434
12115002727,1452,1233,88,8,2,53,1,6,219
12115002728,2412,2321,44,8,1,6,3,2,91
12115002729,1695,1614,28,4,2,3,1,2,81
12115002730,3026,2859,69,6,4,29,1,7,167
12115002731,3801,3588,86,16,4,52,1,7,213
12115002732,4652,4347,131,14,1,63,0,22,305
12115002733,3784,3595,86,4,5,31,0,3,189
12115002734,6905,6226,275,49,15,128,0,33,679
12115002735,2239,2164,39,3,2,9,3,3,75
12115002736,5265,4088,544,245,22,88,0,42,1177
12115002737,5003,4166,369,168,9,100,0,31,837
12115002738,5134,3889,556,381,12,66,4,24,1245
12115002739,3650,2841,347,222,7,69,0,24,809
12115002740,5266,4007,644,289,8,71,0,34,1259
12115002741,4476,3155,676,343,23,65,0,25,1321
12115002742,6340,4918,651,340,6,170,0,32,1422
12115002743,4791,3590,601,241,4,108,11,30,1201
12115002744,3843,3162,332,122,3,41,2,21,681
12115002745,6155,4628,769,345,10,93,6,21,1527
12115002746,5404,3942,683,391,18,72,1,20,1462
12115002747,2266,1663,280,178,2,36,0,5,603
12115002748,3359,2713,355,96,1,68,1,8,646
12115990000,0,0,0,0,0,0,0,0,0
12117020101,1291,739,215,229,5,29,3,12,552
12117020102,1218,689,157,299,1,8,0,3,529
12117020201,1939,855,288,690,3,18,0,6,1084
12117020202,4500,1356,801,2051,12,82,2,34,3144
12117020301,2394,1561,395,253,6,61,4,19,833
12117020302,2021,557,605,734,3,9,2,10,1464
12117020401,1661,260,223,1096,4,4,0,14,1401
12117020402,3109,1242,421,1129,2,151,4,6,1867
12117020500,2778,496,454,1644,12,58,0,15,2282
12117020601,8592,2665,2704,1902,13,814,4,55,5927
12117020602,6365,2947,1482,859,12,709,6,61,3418
12117020703,6567,4592,619,255,3,763,0,38,1975
12117020704,7645,4520,927,430,9,1383,3,49,3125
12117020705,3579,2396,434,204,14,352,3,30,1183
12117020706,9991,5289,1556,991,13,1651,10,83,4702
12117020707,8625,5724,930,497,21,1004,5,57,2901
12117020803,7142,5027,1093,435,12,251,4,32,2115
12117020805,8427,5349,1256,559,8,862,7,49,3078
12117020806,6441,3168,1525,1003,17,356,0,41,3273
12117020807,6985,3200,2253,846,22,292,3,51,3785
12117020808,3964,2545,698,205,1,283,7,30,1419
12117020810,3906,2434,793,230,4,266,6,38,1472
12117020811,6784,3809,1520,542,11,573,0,41,2975
12117020812,4391,1947,1293,477,2,461,0,63,2444
12117020901,4572,1201,2012,1067,6,93,0,27,3371
12117020902,2683,1239,810,446,11,50,3,14,1444
12117020904,6744,2235,2660,1364,16,137,3,41,4509
12117020905,4415,2241,1199,552,11,164,0,20,2174
12117021000,5793,2783,1310,785,20,584,7,52,3010
12117021100,4161,1030,838,1919,4,170,1,21,3131
12117021201,6863,5668,548,180,19,121,0,35,1195
12117021203,6167,4086,1110,293,3,391,4,27,2081
12117021205,4525,3548,525,103,7,116,6,12,977
12117021206,5849,3733,1052,250,10,429,0,53,2116
12117021306,8821,6494,1346,269,7,337,6,47,2327
12117021307,7536,4876,1659,279,9,349,2,43,2660
12117021311,5750,3355,1046,725,8,257,1,47,2395
12117021312,5613,3211,1217,535,7,342,5,43,2402
12117021313,7948,5590,1080,381,6,468,4,70,2358
12117021314,5423,3185,1256,386,0,327,0,36,2238
12117021315,7870,5082,1604,405,5,421,1,42,2788
12117021316,4619,2659,941,312,8,412,4,34,1960
12117021317,8418,5088,1575,610,10,740,10,45,3330
12117021318,8620,4456,2342,709,5,627,8,74,4164
12117021319,1680,995,445,97,6,48,0,9,685
12117021320,6987,4217,1498,508,16,340,6,29,2770
12117021321,2928,1552,812,270,7,115,0,30,1376
12117021401,8500,4230,2541,959,15,298,9,44,4270
12117021403,9112,6226,1562,415,14,380,2,61,2886
12117021404,7673,4606,1829,490,19,353,3,34,3067
12117021504,3150,2427,387,113,8,58,8,15,723
12117021505,4541,3179,820,197,5,101,0,13,1362
12117021506,3545,2313,657,208,11,183,0,20,1232
12117021507,7369,4054,2036,587,12,277,0,50,3315
12117021604,4162,3148,504,135,1,170,3,14,1014
12117021606,7198,3078,2505,980,13,285,1,50,4120
12117021608,6004,2710,1769,1019,14,154,2,46,3294
12117021609,3287,2577,403,52,3,87,0,15,710
12117021611,4657,3534,682,112,8,121,2,13,1123
12117021612,4377,3272,624,143,3,104,3,35,1105
12117021613,3336,1430,1004,577,6,122,1,16,1906
12117021614,5445,2616,1791,534,16,199,1,35,2829
12117021617,7224,4936,1251,444,8,244,0,34,2288
12117021704,4708,2770,1352,214,3,104,0,47,1938
12117021705,5918,1749,2613,1147,5,133,1,32,4169
12117021706,4243,2212,1192,508,1,146,2,15,2031
12117021707,6796,3080,1922,1091,15,317,2,60,3716
12117021708,6364,3156,1712,711,7,465,0,32,3208
12117021802,4726,2577,1267,502,12,127,1,38,2149
12117021803,3568,1460,1154,628,15,104,4,32,2108
12117021805,1566,1250,159,31,6,48,2,4,316
12117021806,5631,3275,1377,516,6,169,2,37,2356
12117021901,5141,2830,1295,541,7,230,2,32,2311
12117021902,4327,2007,1085,962,8,90,3,22,2320
12117022001,2529,913,552,845,4,118,2,19,1616
12117022002,5103,2539,1598,564,5,143,0,39,2564
12117022004,2332,1360,625,166,0,47,0,26,972
12117022006,3522,2123,750,377,4,65,1,28,1399
12117022007,4067,2109,1078,562,6,94,0,26,1958
12117022101,7254,3782,2266,736,11,159,0,27,3472
12117022104,6734,4013,1888,347,9,175,8,31,2721
12117022105,3630,2429,728,159,17,115,5,29,1201
12117022106,7943,4675,1997,448,8,363,10,31,3268
12117022201,5888,3184,1725,553,2,157,2,20,2704
12117022205,3588,2288,766,214,10,124,0,13,1300
12117022206,6535,3709,1556,473,15,403,8,42,2826
12117022207,6144,3555,1445,405,3,384,3,50,2589
12117022208,4508,2249,1493,414,10,117,3,30,2259
12117022209,4211,2551,1052,192,9,153,3,30,1660
12119910100,4687,3146,592,637,9,90,1,19,1541
12119910300,8218,7372,364,227,13,87,0,20,846
12119910401,3261,2726,206,141,15,14,2,9,535
12119910402,2445,2016,165,147,24,11,1,12,429
12119910500,4619,3236,677,465,6,28,8,18,1383
12119910601,5319,4268,584,135,28,33,5,24,1051
12119910602,2865,2398,186,131,17,13,0,10,467
12119910701,2295,1636,281,231,12,27,0,0,659
12119910702,3109,2086,602,238,9,7,3,20,1023
12119910800,3885,3694,73,28,6,35,0,5,191
12119911000,1521,728,193,597,0,0,0,0,793
12119911201,4310,4023,73,114,7,24,1,12,287
12119911202,3136,2991,49,21,5,25,0,2,145
12119911203,5321,5079,111,24,6,29,0,12,242
12119911204,11654,10875,341,101,7,131,3,17,779
12119911205,3193,3060,49,14,0,29,2,9,133
12119911206,5356,5107,80,35,1,56,0,8,249
12119911207,4768,4561,89,24,5,28,2,11,207
12119911301,3854,3335,195,157,11,23,0,16,519
12119911302,1202,211,19,912,0,5,0,0,991
12119911401,6523,6206,117,32,4,59,0,7,317
12119911402,14773,13149,580,585,14,132,3,39,1624
12119911500,2248,1643,125,388,6,14,0,9,605
12119911702,4546,4275,111,46,4,35,0,6,271
12119911703,4800,4227,174,44,9,222,0,16,573
12119911704,5721,5439,100,25,0,51,0,19,282
12119980000,16,6,3,0,0,0,0,0,10
12119980100,6107,1720,1444,2814,93,30,0,0,4387
12121970100,6308,4055,668,1213,29,62,4,21,2253
12121970200,4440,3005,723,519,13,22,2,16,1435
12121970301,1818,1471,209,16,14,2,0,26,347
12121970303,2235,2004,125,29,9,8,0,8,231
12121970304,4080,3260,563,81,24,17,0,3,820
12121970401,2920,1308,520,962,6,32,3,6,1612
12121970402,3978,2880,435,444,11,63,1,17,1098
12121970501,4129,3269,419,256,15,15,4,13,860
12121970502,6490,4482,538,1224,30,24,2,18,2008
12121970601,2959,2417,279,96,8,12,0,5,542
12121970602,4117,3513,306,80,8,13,0,10,604
12123950100,3305,2654,113,369,19,25,0,3,651
12123950201,1306,1187,39,30,4,2,0,0,119
12123950202,3872,2998,85,593,25,36,0,11,874
12123950301,2859,1101,35,1569,14,54,0,9,1758
12123950302,3058,2211,138,443,23,88,0,0,847
12123950401,5429,3664,407,1180,12,8,0,19,1765
12123950402,1967,1814,49,12,5,11,0,3,153
12123990000,0,0,0,0,0,0,0,0,0
12125960100,3884,2564,182,1032,6,5,0,18,1320
12125960201,2257,1724,109,304,6,10,0,10,533
12125960202,5298,3450,293,1416,17,6,0,19,1848
12125960300,4708,3847,180,445,13,14,0,15,861
12127080101,4546,3936,236,66,4,129,0,17,610
12127080102,5754,5078,258,150,11,94,2,18,676
12127080201,2732,2465,117,20,7,32,0,23,267
12127080202,2662,2411,109,26,5,40,0,9,251
12127080300,3205,2833,163,29,11,22,4,16,372
12127080400,3401,3016,176,30,10,72,0,12,385
12127080500,2482,2101,162,25,10,63,1,13,381
12127080600,3482,2636,194,401,6,47,0,20,846
12127080700,4474,3954,232,45,7,81,2,9,520
12127080803,5023,4049,355,238,11,108,1,12,974
12127080805,6125,4553,657,445,20,84,6,27,1572
12127080806,2847,2293,225,145,6,53,0,14,554
12127080807,5405,4352,462,247,1,103,7,18,1053
12127080808,5699,4308,424,482,9,249,0,37,1391
12127080809,3175,2289,252,298,12,129,0,29,886
12127080901,4526,2832,357,1080,12,41,0,22,1694
12127080902,3832,2410,460,653,17,65,4,24,1422
12127081001,2067,1590,200,169,9,15,0,17,477
12127081002,2452,1782,221,281,7,43,4,6,670
12127081101,2630,2142,184,117,7,81,2,19,488
12127081102,1759,1489,115,33,10,40,0,8,270
12127081201,2708,1958,333,195,11,42,3,9,750
12127081202,1158,843,141,92,1,24,1,7,315
12127081300,2133,1677,174,114,2,54,0,10,456
12127081500,1966,1160,279,361,16,25,1,8,806
12127081600,2321,796,278,1112,2,16,3,14,1525
12127081701,2977,1226,341,1196,11,50,0,23,1751
12127081702,4492,1095,377,2777,13,51,3,27,3397
12127081800,2707,640,296,1578,9,28,5,33,2067
12127081900,3056,171,189,2539,12,4,3,30,2885
12127082000,2477,654,148,1546,7,17,0,7,1823
12127082100,4329,421,350,3356,5,13,0,21,3908
12127082201,4259,2370,459,1148,19,68,1,30,1889
12127082202,1617,1103,105,296,6,41,0,4,514
12127082302,3418,1873,329,939,7,92,1,31,1545
12127082303,3978,1256,436,1984,5,105,4,18,2722
12127082401,3668,2177,356,884,9,59,2,15,1491
12127082404,2824,2067,225,317,17,44,4,16,757
12127082405,4010,3424,206,161,8,31,1,10,586
12127082406,2491,2115,163,70,1,27,6,5,376
12127082410,6657,5260,515,296,14,303,2,26,1397
12127082411,3967,2943,298,334,4,217,3,15,1024
12127082412,2826,2014,208,351,7,87,0,15,812
12127082413,3544,2350,307,484,4,216,3,32,1194
12127082414,3710,3142,211,152,24,74,6,3,568
12127082415,2850,1920,227,490,1,50,2,13,930
12127082503,5859,4803,439,233,6,97,12,24,1056
12127082506,4510,3880,283,107,11,50,0,20,630
12127082508,4796,4095,268,123,16,106,4,19,701
12127082509,4117,3619,210,53,15,51,1,13,498
12127082510,4016,3523,212,30,17,49,0,6,493
12127082511,2562,2119,177,87,7,33,4,10,443
12127082512,5334,4424,409,155,6,131,4,17,910
12127082513,1696,1262,203,38,5,76,0,6,434
12127082604,2703,2285,121,84,4,58,0,15,418
12127082605,3948,3481,208,52,3,85,1,12,467
12127082606,3364,3069,141,12,1,44,0,8,295
12127082607,2157,1945,115,13,1,17,0,7,212
12127082701,1898,1776,69,1,0,8,0,5,122
12127082703,3019,2779,121,4,8,25,0,5,240
12127082704,2326,2150,78,7,1,17,0,13,176
12127082705,2446,2272,90,8,4,15,1,6,174
12127082801,2473,2222,84,49,1,9,3,8,251
12127082802,4297,3785,202,112,8,40,2,8,512
12127082902,6151,5193,328,239,24,44,4,26,958
12127082903,5831,4199,387,889,24,72,3,15,1632
12127082904,5201,4776,146,43,12,47,1,11,425
12127083003,6328,5646,166,260,13,41,2,12,682
12127083005,3683,3335,132,74,4,30,3,4,348
12127083006,6738,5904,322,151,22,61,3,20,834
12127083007,4142,3539,195,97,16,21,2,12,603
12127083008,3964,3420,180,207,17,16,0,15,544
12127083009,3664,3202,178,67,15,34,0,17,462
12127083203,8182,6579,542,201,6,516,1,23,1603
12127083205,5162,3814,361,483,8,278,1,38,1348
12127083206,3974,2318,315,1256,7,13,0,14,1656
12127083207,9319,7302,714,406,35,401,2,47,2017
12127083209,8412,7354,418,85,23,169,3,51,1058
12127083210,6440,5247,469,208,10,251,1,26,1193
12127083211,6400,5328,384,151,9,253,2,31,1072
12127090101,4655,3274,990,150,20,40,2,27,1381
12127090102,3047,1754,1147,51,5,14,0,8,1293
12127090202,6719,4710,1377,227,9,103,0,23,2009
12127090203,5228,3080,1724,229,16,28,3,20,2148
12127090204,8759,6218,1161,640,10,271,1,43,2541
12127090303,3035,2214,552,56,7,19,2,9,821
12127090304,4732,3526,672,224,11,95,0,22,1206
12127090305,3917,2990,507,184,4,44,2,14,927
12127090306,8629,6466,1144,421,11,257,3,37,2163
12127090307,7499,4767,1492,690,11,166,4,34,2732
12127090401,1740,1328,246,76,2,22,0,13,412
12127090402,4040,2967,515,273,11,75,0,105,1073
12127090500,2178,1483,330,230,8,18,0,21,695
12127090600,7015,2474,2075,2130,7,60,14,17,4541
12127090701,5566,4331,665,245,9,48,2,41,1235
12127090702,5272,2364,1089,1511,15,87,1,19,2908
12127090803,5465,3987,900,248,16,52,3,20,1478
12127090804,7435,5207,1434,301,13,99,0,31,2228
12127090806,4756,2298,1586,566,23,110,0,9,2458
12127090807,4378,3368,649,186,16,63,0,16,1010
12127090808,1685,1374,198,17,2,9,4,2,311
12127090903,4886,3833,563,189,13,111,1,26,1053
12127090904,6797,4901,1040,360,17,147,7,28,1896
12127090905,7034,4538,1410,518,15,226,2,43,2496
12127090906,3694,2791,531,141,4,53,1,24,903
12127091001,6534,4184,1351,609,5,82,4,44,2350
12127091005,2040,1705,148,73,3,11,1,12,335
12127091015,5032,2188,2027,477,16,130,2,21,2844
12127091016,6581,2764,2917,525,10,95,4,35,3817
12127091017,3989,1689,1645,364,7,98,3,27,2300
12127091018,7654,3558,2767,815,19,113,4,91,4096
12127091019,5696,2530,2162,642,22,60,11,34,3166
12127091020,7297,3039,2900,973,13,66,6,31,4258
12127091021,2900,1632,828,259,6,42,2,18,1268
12127091023,3023,1471,1130,239,2,60,0,14,1552
12127091025,4658,2300,1591,481,14,32,3,32,2358
12127091028,4925,2020,2049,524,9,69,0,27,2905
12127091029,5129,3312,1093,394,7,62,3,31,1817
12127091030,2765,1339,1035,222,4,21,0,16,1426
12127091031,5467,2894,1672,531,5,80,4,39,2573
12127091032,4075,2100,1363,372,8,61,2,14,1975
12127091033,4004,1869,1434,428,9,59,2,20,2135
12127091034,4030,1662,1623,515,12,39,2,28,2368
12127091035,3863,1832,1363,447,4,49,3,25,2031
12127091036,3334,1565,1238,335,10,45,1,8,1769
12127091037,3989,1689,1617,486,3,38,3,21,2300
12127091038,3748,1947,1238,358,15,53,4,10,1801
12127091039,3728,1900,1284,349,8,53,0,29,1828
12127092500,7388,4276,1003,1320,10,356,3,57,3112
12127990000,0,0,0,0,0,0,0,0,0
12129010101,2149,1839,73,103,17,5,0,7,310
12129010102,2991,2661,40,151,14,11,1,6,330
12129010204,4337,3349,175,465,21,46,11,26,988
12129010205,5650,4442,217,690,27,27,3,16,1208
12129010206,3577,1672,458,1368,13,9,0,14,1905
12129010207,4915,3941,162,486,28,20,0,30,974
12129010208,5250,4141,324,430,15,62,2,21,1109
12129010209,4895,3942,128,509,19,18,2,6,953
12129990000,0,0,0,0,0,0,0,0,0
12131950102,3105,2829,61,37,21,25,0,5,276
12131950103,3031,2483,208,63,14,15,0,14,548
12131950104,3688,3158,137,123,31,14,0,14,530
12131950201,2169,1497,150,343,12,28,0,11,672
12131950202,4280,2377,393,1285,12,12,2,30,1903
12131950303,2681,2045,312,97,24,9,3,9,636
12131950304,3997,2931,448,302,21,44,3,17,1066
12131950305,3429,2575,456,169,20,29,1,6,854
12131950306,2484,2094,155,22,18,43,9,20,390
12131950400,2870,2351,99,227,27,21,4,2,519
12131950501,4569,3603,566,79,81,25,0,9,966
12131950502,7724,6329,691,171,35,101,2,23,1395
12131950604,5595,4672,462,76,9,99,6,19,923
12131950605,6777,5036,1160,99,42,105,0,42,1741
12131950606,2918,2648,111,11,4,27,4,7,270
12131950607,4780,4115,266,83,21,120,0,15,665
12131950608,2701,2254,180,34,8,86,0,22,447
12131950609,2683,2425,110,21,4,35,0,1,258
12131950610,4532,4024,176,48,11,60,4,33,508
12131950611,1292,1198,46,4,0,9,0,8,94
12131990000,0,0,0,0,0,0,0,0,0
12133970102,1694,1529,45,37,11,12,0,0,165
12133970103,3521,2683,136,416,19,31,9,13,838
12133970104,3119,2045,100,740,29,12,5,8,1074
12133970200,3655,3075,92,262,42,16,6,22,580
12133970301,2703,2307,120,102,15,25,2,5,396
12133970302,6467,4352,309,1429,84,21,3,27,2115
12133970303,4159,3493,122,250,22,15,3,12,666
13001950100,3018,2695,100,128,9,5,0,5,323
13001950201,2129,1182,205,674,5,11,0,10,947
13001950202,2159,900,123,1078,1,7,0,0,1259
13001950301,3090,1830,501,626,4,67,0,3,1260
13001950302,2421,1573,387,352,0,19,0,10,848
13001950400,1481,1142,52,236,2,7,0,1,339
13001950500,4146,3352,457,245,12,7,1,3,794
13003960100,1924,1050,368,455,6,0,2,2,874
13003960200,4910,2629,1400,734,16,9,2,14,2281
13003960300,1452,1122,280,19,8,3,0,0,330
13005970100,3017,2543,198,161,1,10,0,11,474
13005970201,4176,2864,286,882,3,18,3,11,1312
13005970202,3947,2696,391,704,0,12,1,10,1251
13007960100,1936,920,115,846,1,9,0,2,1016
13007960200,940,594,28,282,0,9,0,0,346
13009970101,2386,1151,26,1117,8,12,1,6,1235
13009970102,2773,1836,27,818,5,5,3,13,937
13009970201,3744,1434,103,2058,4,24,3,14,2310
13009970202,3161,2411,128,414,4,112,0,7,750
13009970301,2659,1809,60,648,3,45,0,1,850
13009970302,3685,1795,156,1466,4,171,1,11,1890
13009970400,4120,1925,132,1827,8,117,5,8,2195
13009970501,3384,2118,149,956,6,32,2,56,1266
13009970502,2650,1780,70,711,5,11,6,28,870
13009970600,3586,959,67,2441,7,9,0,15,2627
13009970701,1889,399,63,1340,4,12,2,6,1490
13009970702,1830,617,54,1082,1,22,1,11,1213
13009970801,2748,1780,20,874,0,6,3,9,968
13009970802,5184,2418,84,2566,5,21,0,8,2766
13011970100,4798,3964,565,40,8,48,5,17,834
13011970200,4932,4445,163,108,15,52,1,6,487
13011970300,4619,4021,285,106,14,35,2,3,598
13011970400,3686,3148,151,140,17,54,0,2,538
13013180103,5691,4199,547,365,0,302,0,24,1492
13013180104,2206,1568,274,154,5,68,0,20,638
13013180105,2822,2118,348,131,3,112,0,4,704
13013180106,2857,2056,415,145,3,91,0,19,801
13013180107,4312,3049,489,287,10,301,2,9,1263
13013180108,2987,2189,380,160,1,122,2,15,798
13013180203,3497,1552,672,962,3,109,0,34,1945
13013180204,3191,1488,473,947,0,103,0,16,1703
13013180205,5319,2985,703,1118,13,207,2,51,2334
13013180206,3252,2445,307,270,3,91,0,12,807
13013180301,2604,1877,288,270,1,81,3,5,727
13013180302,6255,4627,727,406,17,220,0,15,1628
13013180303,5374,3992,521,319,11,278,0,40,1382
13013180401,6640,4981,562,570,13,243,1,23,1659
13013180402,6840,4300,788,1221,7,223,2,33,2540
13013180501,8269,4611,1513,1419,15,302,3,62,3658
13013180502,4948,3532,648,393,10,154,1,34,1416
13013180503,6441,4013,905,1004,15,226,1,43,2428
13015960101,1729,1548,91,12,0,1,0,3,181
13015960103,3596,3088,150,119,5,49,3,33,508
13015960104,3077,2739,139,55,1,10,1,5,338
13015960105,3600,3063,217,104,6,36,0,13,537
13015960201,3208,2804,161,102,5,5,0,15,404
13015960202,3607,2592,259,496,6,67,1,21,1015
13015960203,4660,3959,206,194,20,44,0,23,701
13015960301,3544,2957,213,149,14,19,1,6,587
13015960302,3538,2823,237,236,12,43,0,20,715
13015960403,4425,2446,655,985,12,102,3,32,1979
13015960404,5604,3296,1107,836,7,98,1,24,2308
13015960405,5024,3123,431,1113,5,136,2,11,1901
13015960406,2947,2299,230,227,10,35,0,7,648
13015960407,2037,1477,159,244,0,54,0,21,560
13015960501,5513,3242,905,1078,10,20,9,24,2271
13015960502,3003,2111,313,405,14,28,0,11,892
13015960601,6093,4898,332,580,7,56,2,28,1195
13015960602,4087,2206,632,967,12,51,0,21,1881
13015960701,4834,2072,1240,1248,10,43,8,14,2762
13015960702,3332,2543,229,309,6,77,4,13,789
13015960801,3441,2471,503,238,11,40,3,23,970
13015960802,3135,2314,603,68,13,19,0,7,821
13015960804,3649,2856,328,205,14,49,0,27,793
13015960805,2039,1671,159,47,10,15,1,7,368
13015960901,3342,2641,300,215,10,9,0,6,701
13015960902,7067,5434,555,668,12,33,1,35,1633
13015961001,5331,4434,234,357,17,17,0,12,897
13015961002,3439,3052,163,52,5,13,0,4,387
13017960100,2375,1979,75,261,3,8,0,3,396
13017960200,1600,1250,45,246,4,0,0,1,350
13017960300,4037,1919,246,1667,17,33,0,10,2118
13017960400,3656,1303,463,1740,8,9,0,18,2353
13017960501,1450,388,64,928,15,13,0,6,1062
13017960502,4076,2380,161,1380,10,53,0,10,1696
13019970100,1496,1109,20,296,0,0,1,10,387
13019970200,3493,2761,404,183,6,13,4,17,732
13019970300,2884,2469,118,185,1,22,1,4,415
13019970400,3241,2400,119,579,4,6,0,17,841
13019970500,3702,3049,125,397,7,16,0,4,653
13019970600,3344,2608,259,294,4,23,4,10,736
13021010100,1596,114,38,1390,6,2,0,2,1482
13021010200,2195,1171,86,837,1,19,1,6,1024
13021010400,1931,64,28,1777,3,5,2,0,1867
13021010500,3215,468,754,1869,1,66,2,12,2747
13021010800,1948,1234,62,484,4,43,0,14,714
13021011001,3748,1332,130,2110,18,22,8,26,2416
13021011002,1131,190,37,860,0,5,0,6,941
13021011100,1809,106,24,1607,8,6,5,0,1703
13021011500,1010,29,8,953,0,0,0,2,981
13021011701,2351,190,46,2024,3,18,0,6,2161
13021011702,4611,318,71,4094,4,3,1,14,4293
13021011800,3586,2117,108,1153,5,75,1,19,1469
13021011900,2131,914,81,1018,8,18,0,9,1217
13021012000,4936,3009,160,1459,4,125,3,16,1927
13021012101,2435,1324,339,670,10,29,0,1,1111
13021012102,4929,2509,213,1872,0,140,0,14,2420
13021012200,2483,582,103,1686,7,27,0,2,1901
13021012400,4148,198,64,3746,2,11,0,10,3950
13021012500,3190,169,39,2887,2,8,0,9,3021
13021012600,4026,485,125,3272,9,15,0,15,3541
13021012700,1843,90,93,1582,9,6,0,5,1753
13021012800,2831,223,104,2413,7,4,4,12,2608
13021012900,1702,408,143,1082,4,4,0,10,1294
13021013101,5732,619,427,4451,12,25,0,24,5113
13021013102,4236,362,282,3476,3,26,0,24,3874
13021013201,5625,492,127,4825,4,45,0,21,5133
13021013202,2576,269,225,1997,4,28,0,10,2307
13021013302,3996,801,75,2955,0,16,0,11,3195
13021013407,4885,2090,176,2131,3,232,2,38,2795
13021013408,5179,3536,184,878,4,430,2,13,1643
13021013409,4252,2087,163,1607,10,254,0,28,2165
13021013411,4792,2357,209,1747,10,294,0,10,2435
13021013412,4316,3328,79,630,8,149,2,8,988
13021013413,2834,1647,96,810,7,188,0,11,1187
13021013502,1534,1013,87,377,0,6,0,2,521
13021013503,2235,959,393,707,8,107,0,13,1276
13021013505,4942,3017,149,1507,14,124,4,12,1925
13021013506,3998,2438,269,1105,10,38,3,9,1560
13021013603,4229,2552,163,1366,7,24,0,23,1677
13021013604,4987,2869,153,1721,7,82,0,27,2118
13021013605,5711,2578,168,2529,25,223,1,21,3133
13021013607,3092,1929,83,831,7,114,0,15,1163
13021013608,3630,1906,79,1459,7,77,1,22,1724
13021013701,2211,879,41,1208,1,29,0,6,1332
13021013702,1223,580,45,515,2,27,0,14,643
13021013800,1608,119,25,1400,3,2,0,3,1489
13021013900,2152,760,101,1182,1,8,0,13,1392
13021014000,3586,356,82,2975,9,10,0,14,3230
13023790100,4535,3908,86,447,3,6,0,12,627
13023790200,2605,1253,66,1185,3,39,3,9,1352
13023790301,2491,1563,221,591,0,82,0,1,928
13023790302,2952,2143,96,565,5,26,5,8,809
13025960101,4169,3838,73,63,6,2,3,9,331
13025960102,2602,2230,58,140,12,5,0,14,372
13025960201,1811,1678,39,16,4,2,0,7,133
13025960202,4336,3841,64,250,16,9,0,0,495
13025960300,5103,4730,92,93,7,24,0,4,373
13027960200,1537,1081,125,253,6,5,1,4,456
13027960301,3437,2434,213,696,5,8,0,5,1003
13027960302,2188,1584,137,392,5,3,0,10,604
13027960400,4018,1546,168,2146,0,31,1,11,2472
13027960500,2570,831,184,1464,3,16,1,4,1739
13027960600,2551,1590,128,733,5,4,3,8,961
13029920101,5580,4512,155,577,20,35,2,8,1068
13029920103,4437,2821,156,1193,8,26,13,15,1616
13029920104,991,824,30,87,2,6,1,1,167
13029920301,1769,1270,101,280,0,21,0,7,499
13029920303,7522,4087,841,1748,17,300,4,30,3435
13029920305,4928,3735,327,488,13,136,3,25,1193
13029920307,8631,6601,567,735,15,170,10,43,2030
13029920308,10880,7471,1092,1222,27,338,20,55,3409
13029980000,0,0,0,0,0,0,0,0,0
13031110100,3648,2604,124,787,3,4,2,12,1044
13031110201,3995,2067,194,1582,6,18,0,9,1928
13031110202,4586,2478,129,1797,5,63,3,12,2108
13031110301,4125,2834,170,927,3,54,6,15,1291
13031110302,6245,3197,498,2231,9,138,1,12,3048
13031110401,5204,2196,204,2546,17,70,1,29,3008
13031110405,5231,1987,537,2368,16,103,11,7,3244
13031110406,2329,984,275,920,6,50,0,3,1345
13031110407,3871,2513,258,847,2,99,0,22,1358
13031110408,3651,2085,258,1116,6,69,5,17,1566
13031110500,5210,3626,263,1003,14,92,8,16,1584
13031110602,4422,2157,117,1952,4,54,0,8,2265
13031110603,3615,2319,176,875,3,126,6,6,1296
13031110604,3157,1729,102,1137,3,53,2,9,1428
13031110701,5830,4269,263,954,14,80,0,25,1561
13031110702,3343,2541,191,343,11,139,10,12,802
13031110703,2792,2270,118,250,0,29,0,5,522
13031110800,2521,1671,101,633,8,10,0,6,850
13031110901,3825,3195,125,292,11,27,2,12,630
13031110902,3499,2990,77,215,18,5,5,12,509
13033950101,3034,1918,138,867,9,10,3,11,1116
13033950102,2701,1402,86,1131,0,3,2,2,1299
13033950200,3151,1974,177,800,11,21,4,6,1177
13033950400,5100,1373,113,3467,12,7,1,17,3727
13033950500,5697,2904,120,2471,6,48,0,17,2793
13033950700,2992,1614,50,1185,6,7,0,12,1378
13033950900,1921,756,93,1036,1,1,0,1,1165
13035150101,3565,3129,73,155,3,9,1,18,436
13035150102,4800,3611,123,850,6,8,1,30,1189
13035150201,5278,2725,167,2129,12,30,6,24,2553
13035150202,3205,1831,106,1113,3,11,0,49,1374
13035150300,8586,5332,334,2561,15,44,1,43,3254
13037950100,2760,947,74,1695,6,12,0,1,1813
13037950200,2813,819,75,1874,2,7,0,0,1994
13039010100,3234,2526,57,504,5,5,0,8,708
13039010201,2311,1362,38,773,12,12,7,14,949
13039010202,2707,2202,117,174,10,19,5,10,505
13039010302,4791,2981,229,1224,10,31,0,45,1810
13039010303,3234,1999,227,727,16,36,2,34,1235
13039010304,2617,1663,203,506,8,53,6,23,954
13039010305,1925,1425,103,240,11,7,1,3,500
13039010403,4236,3309,159,380,22,114,5,32,927
13039010404,5961,3337,537,1405,18,210,15,44,2624
13039010405,6146,3808,581,1209,33,118,2,30,2338
13039010406,1994,1671,73,93,4,51,0,11,323
13039010407,4575,3402,330,492,15,66,0,27,1173
13039010500,3387,2234,559,349,8,83,12,1,1153
13039010602,1214,989,73,64,4,4,0,7,225
13039010603,2785,2238,116,264,2,11,0,16,547
13039010604,3651,2057,256,1093,7,25,11,20,1594
13039990000,0,0,0,0,0,0,0,0,0
13043950100,4911,2850,417,1523,7,17,1,16,2061
13043950200,3494,2330,380,608,8,42,2,9,1164
13043950300,2576,1387,581,550,4,4,0,1,1189
13045910101,6708,3198,528,2439,17,115,0,51,3510
13045910103,5546,3905,341,908,11,84,0,25,1641
13045910105,4785,3368,246,869,13,15,0,17,1417
13045910106,5080,3545,378,824,12,51,4,28,1535
13045910201,3514,2872,127,281,15,28,1,9,642
13045910202,5944,4247,328,1036,13,48,0,21,1697
13045910203,3722,3026,154,305,13,19,3,9,696
13045910301,3249,2433,173,438,14,23,0,4,816
13045910302,3332,2880,137,110,7,41,0,11,452
13045910400,3708,3193,86,232,5,14,2,19,515
13045910502,3290,783,1097,1257,17,21,0,11,2507
13045910503,4659,2109,857,1472,4,37,0,27,2550
13045910504,4683,1988,547,1943,10,55,0,19,2695
13045910600,6061,3622,690,1356,13,59,3,36,2439
13045910704,4166,3134,313,457,5,104,0,15,1032
13045910705,5332,2926,696,1422,17,49,0,28,2406
13045910706,4318,3330,214,499,10,35,2,27,988
13045910707,4350,3507,207,393,8,23,0,19,843
13045910708,3845,2353,426,776,10,64,0,19,1492
13045910709,4741,2803,482,1171,15,11,2,29,1938
13045910800,4131,3627,107,175,7,11,0,14,504
13045910900,3929,3493,96,161,3,24,0,3,436
13045911001,3394,2387,256,568,5,50,0,12,1007
13045911002,3210,1748,511,757,4,22,0,22,1462
13045911101,4186,2792,279,870,6,63,3,1,1394
13045911102,3279,2745,123,301,5,17,0,2,534
13045911201,2840,2107,88,499,10,12,0,9,733
13045911202,3146,2604,99,262,2,9,1,18,542
13047030100,7465,6696,285,65,24,42,3,11,769
13047030201,5196,4485,191,203,17,49,2,15,711
13047030202,6444,5693,213,143,26,85,1,18,751
13047030303,3168,2872,70,46,16,8,0,5,296
13047030304,3683,3330,79,73,3,14,1,16,353
13047030305,1998,1806,56,34,1,8,3,3,192
13047030306,5747,5162,179,97,1,55,3,2,585
13047030402,6667,5772,265,165,8,114,2,24,895
13047030403,5302,4905,112,60,9,35,0,3,397
13047030404,2400,2063,40,41,5,165,6,5,337
13047030501,3022,2454,231,129,3,65,5,1,568
13047030502,3638,3009,166,195,15,104,3,1,629
13047030600,4990,4288,186,147,23,58,15,10,702
13047030701,3739,3167,112,157,27,80,1,3,572
13047030702,4413,3578,156,253,3,143,39,16,835
13049010101,6051,2979,1902,907,14,87,0,19,3072
13049010102,3429,1766,63,1427,14,21,2,8,1663
13049010200,3038,2787,71,52,12,1,0,3,251
13051000601,4791,965,304,3128,16,262,2,11,3826
13051001100,1818,584,87,972,11,78,4,13,1234
13051001200,2013,47,15,1912,7,1,0,1,1966
13051002000,1770,671,108,804,4,91,7,5,1099
13051002100,2192,546,82,1475,1,28,1,13,1646
13051002200,3979,894,174,2698,8,48,3,12,3085
13051002300,1940,160,58,1645,10,7,0,7,1780
13051002600,1505,686,72,629,2,59,5,16,819
13051002700,2729,764,133,1677,8,21,10,14,1965
13051002800,3389,912,195,2010,13,169,1,9,2477
13051002900,2906,2473,133,77,4,74,6,12,433
13051003000,1954,1610,105,112,4,26,0,13,344
13051003301,1734,36,26,1634,3,1,0,1,1698
13051003302,1581,9,13,1534,2,0,1,0,1572
13051003400,4066,2080,164,1582,7,88,2,6,1986
13051003501,2662,649,105,1768,2,29,4,16,2013
13051003502,3562,1119,160,2074,10,51,19,5,2443
13051003601,3350,587,125,2516,10,7,0,10,2763
13051003602,4557,1462,184,2595,13,103,13,27,3095
13051003700,1835,425,89,1234,3,16,0,4,1410
13051003800,3002,996,245,1512,2,201,1,5,2006
13051003900,3495,1359,97,1814,8,57,2,21,2136
13051004001,4218,2793,232,892,8,105,4,30,1425
13051004002,3681,2014,258,1067,3,160,10,19,1667
13051004100,1893,1270,99,348,0,73,20,6,623
13051004207,3833,924,280,2307,2,168,4,23,2909
13051004208,5123,1663,550,2437,3,173,27,23,3460
13051004209,3223,1258,248,1447,3,79,5,14,1965
13051004210,4697,1399,363,2399,10,224,33,25,3298
13051004211,4852,1989,374,1976,13,174,9,29,2863
13051004212,5568,2979,384,1417,5,529,8,36,2589
13051004300,2579,1468,445,423,10,55,16,30,1111
13051004400,2164,43,51,1995,3,5,0,13,2121
13051004500,3899,106,165,3518,4,5,1,8,3793
13051010102,4422,2413,550,1049,4,270,0,16,2009
13051010200,4242,1709,141,2176,4,45,4,13,2533
13051010502,3174,693,130,2244,8,16,4,10,2481
13051010503,2129,1099,676,243,1,10,2,9,1030
13051010504,5002,1171,1648,1626,8,498,2,8,3831
13051010601,4927,1352,758,2606,9,36,3,27,3575
13051010603,2123,695,237,1003,5,81,6,4,1428
13051010701,4032,2231,321,1335,10,21,1,5,1801
13051010702,6276,2053,588,3201,20,89,6,44,4223
13051010703,6218,2283,606,2777,13,182,3,45,3935
13051010704,4260,1964,424,1275,15,344,5,34,2296
13051010705,4020,2013,345,1067,22,330,5,24,2007
13051010706,1788,750,227,590,3,64,5,12,1038
13051010707,3565,1325,388,1323,4,314,5,26,2240
13051010801,3512,2448,243,441,12,178,0,33,1064
13051010806,5724,2600,410,2171,12,188,20,21,3124
13051010807,5908,2867,475,1922,13,295,9,45,3041
13051010810,5233,2355,534,1845,18,183,5,39,2878
13051010811,7026,3977,747,1666,16,249,17,58,3049
13051010812,4920,3059,269,953,7,451,6,35,1861
13051010813,4763,1935,940,1441,9,190,2,38,2828
13051010814,5018,1462,622,2402,22,238,7,27,3556
13051010815,3563,1363,552,1382,14,94,6,3,2200
13051010816,2096,691,159,1033,9,85,12,19,1405
13051010817,4418,1617,550,1835,10,192,7,26,2801
13051010818,2189,1221,204,618,5,11,5,5,968
13051010819,3746,1338,366,1739,1,103,8,19,2408
13051010820,2230,1193,177,637,3,116,0,31,1037
13051010821,1934,1405,85,160,4,161,1,21,529
13051010901,3978,1198,797,1747,10,75,3,15,2780
13051011004,3607,3332,118,51,1,31,0,7,275
13051011005,5259,4870,124,55,0,102,0,10,389
13051011006,4119,3798,86,42,0,82,0,14,321
13051011007,2358,1501,567,178,2,29,0,11,857
13051011008,3872,2686,482,394,23,94,7,23,1186
13051011104,5158,4346,209,204,7,151,0,26,812
13051011107,3143,2743,99,93,6,79,0,20,400
13051011108,3071,2637,115,60,6,114,2,13,434
13051011110,1725,1583,44,18,3,7,0,5,142
13051011111,1705,1573,24,9,12,32,3,2,132
13051011112,3524,2981,130,101,7,134,3,10,543
13051011113,3378,3089,88,41,3,45,3,6,289
13051011114,2499,1653,124,258,3,285,0,23,846
13051011115,3009,2592,84,69,7,127,2,6,417
13051011200,1827,1361,124,185,2,111,0,12,466
13051011300,2173,1100,142,667,3,175,1,9,1073
13051011400,2059,1177,120,554,5,93,4,18,882
13051011500,2708,1827,121,576,1,60,1,13,881
13051011600,1944,57,124,1717,0,0,0,6,1887
13051011700,4934,2778,386,1190,18,436,3,10,2156
13051011800,2164,892,114,994,7,105,2,1,1272
13051011900,2059,1437,73,420,0,52,0,13,622
13051980000,0,0,0,0,0,0,0,0,0
13051990000,0,0,0,0,0,0,0,0,0
13053020100,2578,1503,88,798,6,30,0,19,1075
13053020201,2183,1363,413,151,8,114,2,2,820
13053020203,2076,1077,505,206,11,60,56,17,999
13053020205,2493,1313,555,293,9,92,46,17,1180
13053020206,235,147,49,15,1,8,0,0,88
13055010100,2322,2056,29,115,5,9,0,4,266
13055010201,3093,2582,304,57,10,9,0,8,511
13055010202,3324,2582,515,64,6,21,0,7,742
13055010300,2888,2702,53,51,7,10,0,7,186
13055010401,2405,2096,34,150,1,11,0,3,309
13055010402,2746,2136,121,319,0,11,0,21,610
13055010501,2095,1105,112,844,2,13,0,3,990
13055010502,3575,2598,75,677,7,5,0,19,977
13055010600,2517,2222,54,114,7,13,0,9,295
13057090101,4224,3779,185,44,15,5,0,13,445
13057090102,5376,4579,262,229,13,42,1,22,797
13057090103,2121,1929,82,15,2,3,0,14,192
13057090201,2455,2235,100,25,6,17,0,3,220
13057090202,6655,5951,247,188,22,28,3,18,704
13057090301,5785,4697,459,234,18,112,10,25,1088
13057090302,2478,2153,147,55,5,14,0,9,325
13057090303,6645,5588,424,234,8,90,0,32,1057
13057090401,5566,2560,2173,596,13,18,3,22,3006
13057090402,6801,4820,1019,533,21,74,3,17,1981
13057090503,4680,3953,327,106,10,92,3,10,727
13057090504,5117,4334,319,162,11,61,0,30,783
13057090505,5803,4893,296,232,1,90,6,17,910
13057090506,4471,3971,197,61,7,33,1,10,500
13057090507,2142,1913,105,29,1,14,5,15,229
13057090603,6216,4321,1130,384,20,88,0,35,1895
13057090604,3555,2034,982,336,12,16,0,9,1521
13057090605,3855,1614,1953,150,17,20,0,7,2241
13057090606,4499,3127,919,232,2,20,3,6,1372
13057090703,4699,3468,611,313,12,87,0,8,1231
13057090704,3777,2989,444,122,9,27,5,22,788
13057090705,2783,2309,221,74,6,44,4,13,474
13057090706,4843,4042,314,182,6,80,2,25,801
13057090707,4423,2824,644,602,7,73,0,34,1599
13057090708,5280,3750,630,539,5,81,3,32,1530
13057090709,2724,1884,285,301,5,78,2,28,840
13057090710,3998,3208,280,177,7,104,0,17,790
13057090805,5151,4217,432,156,10,76,1,10,934
13057090806,4917,3817,409,292,6,142,0,36,1100
13057090807,7593,6059,549,393,10,144,1,56,1534
13057090808,6407,5350,428,227,18,89,3,33,1057
13057090809,4062,3367,361,66,2,40,1,40,695
13057090810,4509,3513,376,283,6,126,0,33,996
13057090905,4743,3514,565,279,2,135,0,43,1229
13057090906,6022,4494,540,414,5,241,8,48,1528
13057090907,5084,3668,808,250,11,113,0,40,1416
13057090908,5540,3690,676,566,2,290,4,64,1850
13057090909,6120,3970,771,700,9,282,0,63,2150
13057090910,5316,3568,945,322,1,190,4,30,1748
13057090911,5363,4175,541,196,11,169,2,44,1188
13057090912,4006,3102,474,113,14,71,1,39,904
13057091001,5810,3740,806,826,5,154,0,35,2070
13057091006,4873,3974,374,199,13,53,1,35,899
13057091007,6534,5426,424,319,6,68,0,36,1108
13057091009,6559,4654,554,730,9,241,6,39,1905
13057091010,3094,2684,119,92,1,61,0,23,410
13057091011,4236,2755,540,564,11,88,1,43,1481
13057091012,4264,2753,902,296,14,71,3,21,1511
13057091013,4291,2697,807,500,2,82,0,26,1594
13057091014,4400,2135,1021,860,7,154,0,51,2265
13057091101,5872,4728,431,223,26,82,4,27,1144
13057091104,5916,3539,736,838,10,414,3,58,2377
13057091105,4941,2739,1433,391,3,105,0,22,2202
13057091106,4832,2944,764,591,7,212,0,24,1888
13057091107,3233,2112,384,422,5,102,2,25,1121
13057091108,1961,1558,186,63,15,23,1,7,403
13059000100,3167,2585,119,196,6,133,0,2,582
13059000401,1822,1052,111,110,3,496,0,10,770
13059000402,7400,6010,498,457,89,170,5,46,1390
13059000600,2679,1837,77,576,4,81,4,9,842
13059000900,3661,853,206,2391,11,36,0,15,2808
13059001200,3060,2124,183,542,7,104,5,25,936
13059001700,2034,1331,143,414,2,65,5,7,703
13059001800,2490,1985,150,162,9,55,3,23,505
13059001900,3591,2382,150,818,4,62,0,28,1209
13059002000,1950,1468,105,231,0,67,0,10,482
13059002100,3870,3341,192,32,0,193,3,9,529
13059002200,2671,2070,171,189,5,117,0,13,601
13059030101,3029,2128,208,377,5,207,0,8,901
13059030102,3217,1042,213,1621,3,41,2,180,2175
13059030200,4734,1617,213,2615,15,79,0,26,3117
13059130300,5532,1306,1963,2015,1,49,13,48,4226
13059130400,6291,3193,880,1741,10,174,0,58,3098
13059130500,2832,1587,318,754,1,56,1,28,1245
13059130601,4022,1708,770,1238,7,116,3,21,2314
13059130602,2898,2072,173,357,19,163,1,18,826
13059130701,4011,2634,245,726,23,201,1,44,1377
13059130702,2947,1413,390,819,2,204,0,7,1534
13059140300,5151,1282,1194,2488,3,13,3,32,3869
13059140400,3537,885,1839,726,4,11,1,13,2652
13059140500,2113,436,382,1228,6,3,2,7,1677
13059140600,5036,2563,679,1521,6,58,2,40,2473
13059150300,3861,2529,268,753,4,153,4,20,1332
13059150400,5100,3307,294,505,13,726,0,19,1793
13059150500,5285,3270,345,971,8,402,3,32,2015
13059150600,4089,2094,461,1103,0,210,0,33,1995
13059150701,4928,2553,594,1304,9,187,4,33,2375
13059150702,1439,941,74,338,6,31,0,6,498
13059150800,5939,3639,427,1367,4,156,1,53,2300
13059150900,4285,2964,301,682,8,101,0,57,1321
13061960300,2848,1143,41,1593,1,6,0,7,1705
13063040202,3013,108,276,2245,2,305,2,9,2905
13063040203,4155,68,223,3676,13,53,0,21,4087
13063040204,5347,110,291,4704,12,54,0,33,5237
13063040302,5625,601,1785,2854,21,173,4,32,5024
13063040306,4038,146,1062,2665,7,71,2,17,3892
13063040307,4961,672,1679,1526,10,936,2,26,4289
13063040308,4654,693,1201,2334,11,303,1,22,3961
13063040309,3364,242,788,2137,10,97,2,24,3122
13063040310,4217,447,1289,2163,18,186,1,11,3770
13063040407,4940,513,999,2594,12,702,0,19,4427
13063040409,6243,580,845,3727,3,898,6,31,5663
13063040410,7889,598,1726,5145,18,140,0,53,7291
13063040414,2121,231,993,750,7,91,0,8,1890
13063040416,4131,466,1736,1536,10,313,0,12,3665
13063040417,5178,279,771,3803,12,104,0,44,4899
13063040418,2180,299,463,989,10,346,3,4,1881
13063040419,6061,569,618,3307,16,1319,3,59,5492
13063040420,7536,591,847,5539,9,309,2,39,6945
13063040421,7666,535,535,6164,10,184,0,45,7131
13063040422,3315,63,979,2156,9,18,1,7,3252
13063040423,3764,274,571,2730,5,88,0,21,3490
13063040424,3154,122,177,2653,4,82,2,16,3032
13063040425,5268,554,872,2659,6,995,0,12,4714
13063040426,2726,392,528,1546,1,159,3,7,2334
13063040427,5616,393,848,4035,7,132,3,46,5223
13063040509,4703,214,296,3938,12,104,5,24,4489
13063040510,3293,187,303,2551,8,155,3,20,3106
13063040512,5197,206,425,4262,2,147,1,27,4991
13063040513,5425,345,559,4138,10,227,0,27,5080
13063040518,5541,344,731,4188,6,97,0,22,5197
13063040519,5034,80,135,4641,14,29,0,23,4954
13063040521,3329,232,824,2023,7,168,0,16,3097
13063040522,5340,320,630,3880,13,365,0,24,5020
13063040523,2428,141,301,1626,5,273,0,32,2287
13063040525,2967,154,277,2417,10,22,1,20,2813
13063040527,4039,62,176,3613,14,57,2,33,3977
13063040528,3315,140,911,2126,4,53,1,12,3175
13063040529,3412,126,382,2729,3,60,2,9,3286
13063040530,4238,257,513,3242,10,81,9,24,3981
13063040531,2612,56,70,2402,1,14,0,21,2556
13063040532,1597,37,65,1405,4,40,3,9,1560
13063040533,4688,297,604,3380,12,188,0,63,4391
13063040534,3500,107,313,2809,0,152,0,11,3393
13063040535,3766,188,389,2896,14,151,0,25,3578
13063040536,3340,279,636,2219,8,89,0,17,3061
13063040537,3905,249,349,3061,0,57,8,43,3656
13063040538,2874,150,204,2373,3,22,3,12,2724
13063040606,6221,1317,803,3811,18,53,4,47,4904
13063040609,7187,914,800,4681,16,500,5,59,6273
13063040614,5542,1985,456,2456,14,414,0,40,3557
13063040615,2050,226,262,1386,12,82,1,13,1824
13063040617,1574,294,878,331,0,5,2,25,1280
13063040623,5873,474,1089,4067,15,57,7,41,5399
13063040624,2867,307,387,2012,6,52,0,20,2560
13063040625,4840,457,552,3566,15,47,0,37,4383
13063040626,5209,325,372,4198,8,76,7,42,4884
13063040627,5261,804,756,3188,10,277,0,29,4457
13063040628,3650,651,273,2432,3,156,1,25,2999
13063040629,2735,318,984,1262,16,36,3,39,2417
13063040630,4332,436,484,3146,11,104,2,11,3896
13063040631,7439,505,560,5824,6,275,0,70,6934
13063040632,5140,187,303,4341,13,136,4,28,4953
13063040633,3313,396,503,2157,0,130,0,16,2917
13063040634,3856,299,479,2871,4,36,6,25,3557
13063040635,2474,804,348,1102,8,132,0,5,1670
13063040636,5184,821,380,3700,8,120,0,25,4363
13063040637,3227,89,214,2767,5,36,2,17,3138
13063040638,3542,289,204,2823,9,78,0,37,3253
13063040639,4374,287,264,3624,1,80,0,17,4087
13063980000,0,0,0,0,0,0,0,0,0
13065970100,5118,3461,219,1207,21,20,4,26,1657
13065970200,1631,795,34,743,9,2,3,5,836
13067030104,4018,2291,651,819,7,87,2,7,1727
13067030107,5151,2585,535,1372,7,306,0,59,2566
13067030108,4979,3648,435,498,11,119,7,28,1331
13067030109,3547,2517,424,341,7,68,0,23,1030
13067030110,4882,2465,783,1019,7,289,1,49,2417
13067030111,4971,3039,431,999,18,231,0,30,1932
13067030112,3022,1256,489,1046,3,65,1,20,1766
13067030113,4124,1717,744,1283,3,156,0,28,2407
13067030220,1785,1048,215,306,1,92,0,18,737
13067030233,4667,2631,394,1183,8,191,0,29,2036
13067030235,5222,3631,367,818,0,123,1,20,1591
13067030236,5110,3973,255,458,1,159,0,57,1137
13067030240,5419,3234,725,897,6,184,4,55,2185
13067030241,3015,2273,203,293,10,82,1,13,742
13067030242,4367,2668,671,639,6,186,2,21,1699
13067030243,4621,2461,816,756,12,308,7,40,2160
13067030244,4722,3172,294,735,6,272,0,26,1550
13067030245,3351,2026,244,649,18,152,0,28,1325
13067030246,2386,1412,311,453,1,58,0,23,974
13067030247,5125,2601,672,1324,16,185,10,60,2524
13067030248,6922,3373,630,2231,11,372,2,35,3549
13067030249,4135,1956,366,1364,3,218,0,46,2179
13067030250,5586,4562,228,362,3,192,0,24,1024
13067030251,3226,2236,214,445,0,152,0,21,990
13067030252,5251,4026,300,500,5,166,0,38,1225
13067030253,3235,2410,171,354,0,125,2,17,825
13067030254,1989,793,254,681,6,125,2,12,1196
13067030255,4971,2214,597,1379,9,381,3,67,2757
13067030256,4127,3141,181,445,2,210,0,14,986
13067030257,4286,1815,620,1316,6,238,0,79,2471
13067030258,2853,1685,392,467,10,121,3,32,1168
13067030259,3540,1742,593,734,5,169,2,51,1798
13067030260,2831,1277,386,787,19,183,0,26,1554
13067030261,3643,1987,367,880,4,215,0,29,1656
13067030262,4525,2815,323,916,8,225,0,28,1710
13067030263,3176,2314,201,424,5,68,0,26,862
13067030264,2635,1902,142,311,3,120,0,26,733
13067030265,3430,2328,209,504,0,193,2,30,1102
13067030266,2796,2183,183,259,3,43,5,18,613
13067030267,3172,2276,209,418,13,137,0,29,896
13067030268,3657,2344,175,828,7,101,0,23,1313
13067030269,3407,2048,276,846,2,63,3,22,1359
13067030270,3587,1730,592,947,3,107,2,25,1857
13067030271,2998,1382,187,1156,1,83,0,23,1616
13067030272,2591,1797,220,311,3,88,1,23,794
13067030273,3565,2451,293,530,3,107,0,23,1114
13067030274,4148,2241,594,841,10,163,3,68,1907
13067030275,2192,1097,259,532,5,147,0,14,1095
13067030276,3208,2567,182,231,1,39,2,18,641
13067030277,3552,2613,219,396,2,107,0,32,939
13067030278,3598,2210,362,693,4,137,0,25,1388
13067030319,4785,3220,250,189,11,880,2,17,1565
13067030322,3628,2648,303,280,6,164,2,37,980
13067030324,3670,2498,430,334,3,108,0,53,1172
13067030326,4662,3451,351,297,5,304,0,41,1211
13067030327,5098,3572,336,351,11,570,0,34,1526
13067030329,4751,3256,400,383,15,414,1,51,1495
13067030331,6243,4637,414,285,1,570,3,62,1606
13067030332,3189,2196,163,134,3,559,0,12,993
13067030334,3561,2670,187,89,2,410,2,34,891
13067030335,5399,4217,325,228,4,361,2,21,1182
13067030337,4943,3854,233,144,2,490,1,20,1089
13067030340,3979,3107,205,194,2,272,1,24,872
13067030341,4877,3243,466,422,3,419,0,43,1634
13067030342,5022,3923,282,249,11,288,1,33,1099
13067030343,4926,3984,225,207,7,316,3,14,942
13067030344,3702,889,364,1776,13,329,3,118,2813
13067030345,7193,2569,896,2213,14,1157,0,74,4624
13067030346,3587,2179,614,445,14,115,1,41,1408
13067030347,4885,2922,844,668,6,100,2,61,1963
13067030348,5013,2642,522,801,8,712,5,35,2371
13067030349,3519,2219,351,454,13,234,1,56,1300
13067030350,2473,1568,232,226,7,253,0,34,905
13067030351,2887,2302,174,167,6,131,0,12,585
13067030352,5308,4062,203,122,0,666,0,32,1246
13067030353,3185,1507,278,836,7,362,0,31,1678
13067030354,4755,2920,269,338,15,963,0,54,1835
13067030355,1929,868,175,644,5,140,3,16,1061
13067030356,4425,2283,335,886,10,677,0,47,2142
13067030357,2477,1741,227,116,0,258,0,18,736
13067030358,3952,2182,249,253,8,1038,0,36,1770
13067030359,4434,3360,268,240,3,346,0,23,1074
13067030360,2370,1863,123,91,2,149,0,12,507
13067030361,3670,2334,440,424,11,202,0,40,1336
13067030362,3173,1933,319,378,6,297,1,63,1240
13067030363,3240,2272,287,328,5,120,0,45,968
13067030364,3061,2236,198,269,3,198,0,25,825
13067030365,3426,2652,189,188,0,220,0,26,774
13067030366,3157,2030,147,139,0,671,0,23,1127
13067030367,2865,1994,173,161,2,382,1,26,871
13067030368,2946,2031,201,304,3,219,4,32,915
13067030369,3662,2693,162,77,4,522,0,38,969
13067030370,4222,3100,244,155,3,487,0,21,1122
13067030405,6414,2332,922,1911,18,405,3,305,4082
13067030407,5036,3271,621,438,16,240,12,143,1765
13067030408,3708,1691,413,387,10,698,0,227,2017
13067030409,3654,2367,233,245,0,607,1,19,1287
13067030410,5114,2962,573,989,7,232,5,84,2152
13067030411,2317,328,809,997,13,57,2,35,1989
13067030412,4612,949,1436,1767,3,108,2,99,3663
13067030413,6069,1244,804,2800,11,251,2,251,4825
13067030414,3341,559,591,1788,0,75,0,110,2782
13067030505,6234,2107,1322,2118,6,226,7,114,4127
13067030506,4672,2316,768,1134,14,159,0,62,2356
13067030507,5253,3165,590,694,13,354,7,106,2088
13067030508,3439,1664,600,694,2,257,0,49,1775
13067030509,3768,2510,262,450,10,288,3,40,1258
13067030510,1832,793,143,222,2,532,4,39,1039
13067030511,4663,1931,1497,720,6,242,0,66,2732
13067030602,7532,5929,304,880,15,118,4,44,1603
13067030603,6162,2076,590,2114,10,919,0,114,4086
13067030604,4119,1373,533,1561,13,323,0,66,2746
13067030700,4728,1918,1318,1208,6,105,2,18,2810
13067030800,5617,2374,1937,940,18,133,15,20,3243
13067030906,3997,2251,417,1006,4,136,0,30,1746
13067030907,4047,2423,341,1013,4,76,2,49,1624
13067030908,4168,811,1682,1375,3,125,3,23,3357
13067030909,2874,899,631,1115,1,29,2,117,1975
13067030910,3540,582,1407,1328,9,66,0,19,2958
13067030911,3210,678,941,1404,5,63,1,24,2532
13067030912,6353,2093,2533,1392,19,87,0,42,4260
13067031001,5383,999,3193,998,10,24,0,45,4384
13067031004,8711,1332,3696,3238,15,195,0,48,7379
13067031005,5537,1061,2408,1595,3,247,0,63,4476
13067031006,4388,647,2856,714,4,64,5,19,3741
13067031007,5007,784,1467,2445,12,83,0,36,4223
13067031101,5627,1928,1892,1399,16,131,4,30,3699
13067031110,3045,1863,552,412,1,61,0,26,1182
13067031111,3440,1752,313,1041,20,147,3,23,1688
13067031112,5763,3258,349,1343,9,492,2,24,2505
13067031113,1396,300,255,701,5,41,0,17,1096
13067031114,6880,1749,1583,2475,16,675,2,76,5131
13067031115,4645,1617,1328,1291,4,189,2,36,3028
13067031116,4764,1239,1591,1518,7,184,0,21,3525
13067031117,5691,3411,603,1119,13,246,0,56,2280
13067031118,5993,3352,438,1463,17,379,2,31,2641
13067031119,4172,1266,1125,1469,17,111,4,26,2906
13067031120,4408,1580,681,1730,12,217,2,34,2828
13067031121,2788,822,338,1201,3,278,4,19,1966
13067031122,2960,1345,317,1042,0,93,1,29,1615
13067031207,5182,2448,401,1650,9,438,1,21,2734
13067031209,4719,3059,275,767,5,372,0,27,1660
13067031212,2456,2189,72,67,0,67,0,1,267
13067031213,2532,1236,124,987,5,72,0,7,1296
13067031214,3575,1239,222,1727,13,136,2,41,2336
13067031215,4724,1756,317,2057,8,337,0,39,2968
13067031216,2835,1083,156,726,4,739,0,22,1752
13067031217,4098,1495,303,1164,3,942,0,39,2603
13067031218,2206,1063,175,743,2,116,0,24,1143
13067031219,2028,643,141,1079,0,57,2,16,1385
13067031220,2878,1177,261,1130,3,131,1,31,1701
13067031221,3488,1356,233,1357,1,322,0,38,2132
13067031306,4176,1154,995,1752,11,32,0,25,3022
13067031308,5287,1044,2063,1958,8,36,0,35,4243
13067031314,5262,1474,371,2983,3,182,0,43,3788
13067031315,4934,2332,312,1783,5,281,0,25,2602
13067031316,5793,1067,1171,3136,6,144,2,42,4726
13067031317,4489,912,970,2385,3,63,0,21,3577
13067031318,4608,230,735,3445,8,32,3,18,4378
13067031319,5260,355,1328,3360,13,28,5,36,4905
13067031320,4536,162,703,3519,7,32,1,35,4374
13067031321,2521,142,1061,1230,3,16,2,12,2379
13067031322,5129,448,1536,2946,0,40,0,22,4681
13067031323,2909,826,879,1070,7,12,0,40,2083
13067031324,3972,1863,687,1116,8,79,1,32,2109
13067031325,2227,1310,158,501,1,163,1,9,917
13067031409,6348,1411,1207,3357,8,123,1,42,4937
13067031410,4700,1245,1333,1744,7,151,8,21,3455
13067031411,4229,967,1039,1873,3,148,0,38,3262
13067031412,4666,1062,802,2519,12,72,9,24,3604
13067031413,3698,462,444,2563,7,83,5,21,3236
13067031414,4220,1294,733,1890,4,125,0,27,2926
13067031415,2671,713,544,1276,8,33,3,11,1958
13067031416,4186,913,510,2438,23,76,0,17,3273
13067031417,2676,589,606,1330,6,42,0,15,2087
13067031506,5991,1953,1071,2533,8,126,5,35,4038
13067031507,3549,623,627,2130,3,35,0,26,2926
13067031510,3572,680,692,1939,0,95,0,33,2892
13067031511,5638,1782,437,3032,11,84,6,62,3856
13067031512,5440,1534,624,2933,9,53,3,53,3906
13067031513,4261,972,499,2507,20,62,2,25,3289
13067031514,2752,1018,406,1109,9,38,2,35,1734
13067031515,4123,1397,422,2001,11,115,0,20,2726
13067031516,2471,783,189,1327,2,51,12,8,1688
13067031517,3661,1144,859,1347,16,156,1,40,2517
13067031518,2837,686,706,1241,6,47,0,41,2151
13069010100,3510,2479,241,603,6,18,0,5,1031
13069010200,2974,2296,369,162,2,53,3,4,678
13069010301,2211,1561,322,249,2,12,0,3,650
13069010302,3484,1542,77,1812,3,8,0,0,1942
13069010401,2797,1619,252,761,14,16,4,12,1178
13069010402,2751,1438,438,749,2,21,1,8,1313
13069010500,4223,2294,1060,718,18,44,0,5,1929
13069010600,5733,4211,513,832,8,28,2,8,1522
13069010701,4042,1877,635,1337,0,54,0,13,2165
13069010702,2003,939,718,281,3,4,2,4,1064
13069010801,4928,2032,518,2254,2,13,0,1,2896
13069010802,4436,1870,287,2114,2,28,2,6,2566
13071970101,3034,2011,579,336,8,20,0,3,1023
13071970102,2305,1293,747,217,0,5,0,5,1012
13071970200,2719,2055,164,430,9,20,3,1,664
13071970301,2395,51,72,2192,0,2,2,2,2344
13071970302,3038,1578,583,755,6,6,0,13,1460
13071970400,3592,1783,789,883,15,46,1,8,1809
13071970500,3223,2152,756,195,4,37,0,13,1071
13071970601,2795,2229,295,140,8,55,1,12,566
13071970602,3963,2237,1170,443,0,34,0,6,1726
13071970702,2291,597,630,1000,0,0,0,1,1694
13071970703,4586,2656,780,910,8,99,5,18,1930
13071970704,2932,1596,523,716,4,23,0,2,1336
13071970800,3092,1110,407,1459,11,14,2,9,1982
13071970901,2665,2370,130,73,7,19,1,2,295
13071970902,3268,1870,1084,246,3,8,0,11,1398
13073030103,3563,2282,139,385,6,587,1,14,1281
13073030105,5828,3750,401,837,8,411,15,46,2078
13073030106,3645,2260,216,703,6,207,32,17,1385
13073030107,3591,2399,121,335,7,571,4,17,1192
13073030108,7128,5184,308,474,6,859,0,37,1944
13073030201,6257,4357,400,940,10,275,11,21,1900
13073030202,2819,1964,193,403,11,83,0,14,855
13073030203,5938,4152,435,685,10,204,9,29,1786
13073030304,11526,7493,804,1905,16,534,13,65,4033
13073030306,7028,4459,567,1112,12,359,5,56,2569
13073030307,6697,4707,424,946,10,248,9,49,1990
13073030308,11630,8161,743,1529,24,432,18,51,3469
13073030310,3748,2790,188,323,5,230,0,25,958
13073030311,5364,3968,307,540,8,261,6,44,1396
13073030312,7364,4829,512,1170,20,359,18,46,2535
13073030313,4410,2754,388,847,11,167,6,27,1656
13073030401,2881,2288,70,369,9,10,0,18,593
13073030403,12356,6947,1149,3034,41,292,18,67,5409
13073030404,1957,1552,53,252,10,0,1,2,405
13073030503,12020,7409,1082,2446,37,204,28,67,4611
13073030504,3947,2937,179,566,13,29,11,23,1010
13073030505,8535,3672,1186,2735,24,238,15,56,4863
13073030507,7055,3247,838,2302,18,120,15,49,3808
13073030508,6400,2858,835,2046,12,181,17,25,3542
13073030603,4323,2692,320,737,20,241,19,32,1631
13075960100,2034,1600,104,266,1,2,0,2,434
13075960200,3695,1943,222,1409,7,30,1,1,1752
13075960301,3276,1876,216,1046,0,8,0,20,1400
13075960302,3625,2340,223,886,7,35,3,13,1285
13075960400,4599,2899,369,1146,14,25,0,15,1700
13077170101,1957,1634,75,152,5,9,0,10,323
13077170102,5467,4468,263,456,12,23,4,22,999
13077170200,7444,5478,530,1102,15,40,4,46,1966
13077170303,6274,5149,222,525,12,89,7,22,1125
13077170304,6830,4901,468,1089,15,110,0,16,1929
13077170307,7414,2899,1184,2625,12,330,13,45,4515
13077170308,5633,2654,838,1721,6,144,0,22,2979
13077170309,4978,2157,556,1525,10,500,3,34,2821
13077170310,4505,2908,301,944,10,138,0,19,1597
13077170403,5301,3889,347,648,18,176,2,19,1412
13077170404,5502,4269,322,510,8,122,1,31,1233
13077170405,7418,5192,778,847,12,206,7,46,2226
13077170406,3903,3170,202,215,13,92,7,26,733
13077170407,1348,730,262,264,7,16,0,0,618
13077170408,7537,6062,536,413,11,170,1,33,1475
13077170501,7251,5913,369,552,25,79,0,30,1338
13077170502,7343,5978,342,606,18,55,5,42,1365
13077170503,7795,6342,406,637,10,111,0,30,1453
13077170603,6337,4466,512,839,14,158,6,26,1871
13077170604,4134,1276,428,2178,3,88,0,19,2858
13077170605,3846,1414,391,1823,3,16,0,15,2432
13077170606,4967,3030,496,841,8,374,0,12,1937
13077170607,4156,3247,252,276,1,200,0,36,909
13077170701,3884,1575,257,1854,18,13,2,14,2309
13077170702,3773,1690,278,1614,8,19,0,16,2083
13077170801,5900,4538,213,861,11,23,0,31,1362
13077170802,5261,4392,225,427,13,28,0,7,869
13079070100,3271,1714,43,1402,0,6,1,12,1557
13079070201,5843,5052,168,340,18,14,2,25,791
13079070202,3016,2100,204,525,27,11,0,7,916
13081010100,3590,1808,111,1552,9,7,0,6,1782
13081010201,4580,2216,56,2198,8,10,0,25,2364
13081010202,2561,828,126,1526,0,2,0,12,1733
13081010300,3047,1846,160,902,0,26,0,6,1201
13081010400,5029,2164,156,2417,1,128,4,15,2865
13081010500,1321,1030,25,226,0,7,0,0,291
13083040102,3586,3330,54,27,6,27,0,11,256
13083040103,2609,2343,77,13,19,29,0,10,266
13083040104,2077,1781,66,51,6,39,3,0,296
13083040200,4269,3913,74,7,27,20,0,10,356
13083040300,3710,3419,93,43,10,14,2,0,291
13085970101,1686,1608,22,4,3,10,0,4,78
13085970102,4824,4274,243,31,13,34,6,26,550
13085970103,2842,2637,63,6,11,14,0,3,205
13085970203,4518,4096,152,33,10,42,2,17,422
13085970204,3930,3144,502,47,6,52,2,16,786
13085970205,4037,3461,313,42,5,61,4,18,576
13085970206,4961,4324,310,37,15,22,0,10,637
13087970100,3361,2369,229,650,9,6,1,2,992
13087970200,2749,1952,103,608,10,19,3,3,797
13087970301,3283,1205,222,1736,5,38,1,16,2078
13087970302,4237,1859,308,1965,7,9,5,8,2378
13087970400,5231,1724,183,3162,14,37,2,10,3507
13087970600,6389,3310,409,2394,10,70,1,15,3079
13087970700,1805,1146,188,411,5,4,1,7,659
13087970800,2312,715,269,1274,4,0,2,3,1597
13089020100,2140,1624,230,77,1,83,0,7,516
13089020200,2202,1727,115,105,0,127,2,5,475
13089020300,4036,3282,213,178,4,129,0,30,754
13089020400,2555,2027,153,121,3,93,0,20,528
13089020500,3384,1800,198,1117,5,105,1,18,1584
13089020600,2843,1154,121,1358,0,79,2,24,1689
13089020700,2536,1476,128,665,12,96,1,14,1060
13089020801,2673,1692,147,635,2,53,0,9,981
13089020802,4226,1870,160,1905,7,65,1,20,2356
13089020901,3456,2016,158,998,4,93,0,17,1440
13089020902,2752,1238,118,1197,4,53,3,16,1514
13089021101,3990,3041,218,276,6,273,5,30,949
13089021103,5106,3392,277,905,3,323,0,18,1714
13089021104,2138,1425,152,334,1,148,0,9,713
13089021204,4205,160,3894,40,13,57,0,16,4045
13089021208,4349,2386,640,489,13,577,2,53,1963
13089021210,6109,4834,280,218,0,460,0,44,1275
13089021211,4897,3716,311,226,0,390,2,42,1181
13089021213,3529,3042,153,65,0,127,0,17,487
13089021217,2701,1436,419,401,0,313,0,21,1265
13089021219,4308,3120,266,283,4,356,0,24,1188
13089021220,3258,2102,236,482,6,272,4,20,1156
13089021221,2613,1790,232,226,6,243,2,10,823
13089021222,4325,2630,334,528,8,628,0,18,1695
13089021223,2405,761,81,103,0,1376,0,5,1644
13089021224,3824,1687,479,964,0,517,2,27,2137
13089021225,2131,668,190,753,0,364,0,37,1463
13089021226,3267,1154,313,795,10,829,7,35,2113
13089021227,5766,2755,348,913,6,1466,0,71,3011
13089021228,3094,2507,147,88,3,188,0,13,587
13089021229,3006,2561,166,47,1,104,0,19,445
13089021230,4448,1316,257,388,8,2333,0,26,3132
13089021301,4101,894,1273,1232,0,581,2,14,3207
13089021305,5526,1142,3261,667,8,293,3,23,4384
13089021306,6076,1013,3113,1069,7,671,6,33,5063
13089021307,3951,956,1726,293,7,826,0,34,2995
13089021308,4380,939,2521,209,14,612,0,22,3441
13089021309,2099,73,1530,152,5,307,7,4,2026
13089021310,4272,480,2324,282,7,1083,0,31,3792
13089021405,4949,3691,440,276,3,301,0,30,1258
13089021409,3464,468,1909,901,1,123,1,11,2996
13089021410,5204,1464,2868,489,5,233,1,45,3740
13089021411,3768,2958,187,270,2,203,0,28,810
13089021412,4050,2962,421,198,9,270,2,30,1088
13089021415,4175,2358,676,549,4,366,0,34,1817
13089021416,2278,1026,872,139,0,153,1,8,1252
13089021417,4310,938,2464,526,5,234,1,27,3372
13089021418,2477,259,1677,374,0,108,1,17,2218
13089021419,2420,465,684,976,0,185,0,17,1955
13089021420,2163,155,1755,155,0,60,0,9,2008
13089021421,2517,630,1636,126,0,78,1,4,1887
13089021502,5503,3153,595,975,13,521,2,31,2350
13089021503,4308,2502,633,503,11,459,4,60,1806
13089021505,3394,2201,203,318,6,471,0,48,1193
13089021506,3264,2105,197,303,7,489,4,22,1159
13089021602,4147,3083,172,358,3,342,2,23,1064
13089021604,3400,2557,173,139,3,325,0,29,843
13089021606,3615,2220,374,503,4,304,0,27,1395
13089021607,1947,930,211,501,0,214,0,15,1017
13089021608,4342,1550,972,1353,7,244,0,24,2792
13089021609,2212,1324,363,185,1,220,0,6,888
13089021703,4834,3762,279,227,6,370,0,18,1072
13089021707,2953,2078,145,224,1,345,0,19,875
13089021708,3584,1588,407,1001,2,391,0,26,1996
13089021709,3286,1531,666,692,1,214,0,22,1755
13089021710,3139,1939,383,369,0,291,1,14,1200
13089021711,2903,890,1155,402,9,343,0,26,2013
13089021712,2744,886,427,1068,0,254,1,23,1858
13089021808,5069,2430,1291,687,2,422,0,26,2639
13089021812,2477,979,825,304,8,243,3,14,1498
13089021813,2771,220,1127,1263,10,66,0,16,2551
13089021815,4095,374,1754,1656,9,184,2,26,3721
13089021816,2844,820,1174,593,0,152,0,17,2024
13089021817,2097,585,198,828,2,412,0,14,1512
13089021818,4781,2163,739,1070,12,580,1,35,2618
13089021819,3523,2268,336,391,5,345,0,17,1255
13089021820,2367,691,173,1188,2,210,2,5,1676
13089021821,3203,2203,345,253,4,248,0,11,1000
13089021822,3837,2417,450,519,13,261,4,30,1420
13089021823,3633,1420,445,1352,7,254,0,18,2213
13089021824,2812,378,1109,1008,5,210,0,27,2434
13089021906,5628,573,491,4012,21,296,2,21,5055
13089021908,5528,359,279,4166,10,470,1,23,5169
13089021910,5841,667,240,4099,18,569,0,37,5174
13089021911,2382,55,241,1999,3,15,1,14,2327
13089021912,3613,1822,181,1198,15,213,1,28,1791
13089021913,4854,245,404,3977,15,26,0,8,4609
13089021914,4343,789,319,2986,12,75,1,29,3554
13089021915,4869,794,194,3593,4,87,0,44,4075
13089021916,3616,432,232,2648,7,137,0,27,3184
13089021917,3643,408,235,2737,9,94,0,42,3235
13089022001,4571,2552,443,896,2,434,1,37,2019
13089022005,5047,569,140,3289,9,856,0,36,4478
13089022007,4431,383,207,2806,1,794,1,40,4048
13089022010,2485,480,99,790,2,984,0,12,2005
13089022011,4744,452,105,2811,11,1141,2,20,4292
13089022012,4310,341,172,1191,6,2373,0,24,3969
13089022013,3790,227,158,3078,8,173,3,34,3563
13089022014,2667,98,65,2115,4,323,0,8,2569
13089022015,2109,340,115,1017,2,563,0,13,1769
13089022016,3612,245,104,2265,5,861,0,28,3367
13089022100,4176,908,234,2590,21,239,2,30,3268
13089022203,2435,1061,126,768,2,363,0,11,1374
13089022205,3579,1533,423,852,11,546,0,14,2046
13089022206,4097,1241,259,869,24,1500,0,44,2856
13089022302,4538,2837,320,551,7,579,0,34,1701
13089022303,3236,2214,190,423,0,224,1,13,1022
13089022304,3214,2075,234,219,0,529,1,22,1139
13089022401,4498,3406,304,330,4,236,0,23,1092
13089022403,4119,3393,145,147,3,209,0,27,726
13089022404,4108,1490,192,1559,0,731,0,9,2618
13089022405,2788,1011,175,969,2,529,4,6,1777
13089022501,3960,2265,165,1135,7,172,0,25,1695
13089022502,2861,2255,146,141,4,138,0,9,606
13089022601,4788,3312,250,636,5,300,2,15,1476
13089022602,2475,1742,147,205,3,183,0,25,733
13089022700,5425,3652,291,876,7,217,6,30,1773
13089022800,4297,2847,233,713,10,202,0,29,1450
13089022900,4544,2747,292,1032,7,199,5,26,1797
13089023000,2182,1728,85,198,1,50,2,11,454
13089023101,4281,1184,214,2592,7,59,1,22,3097
13089023102,3289,1297,119,1691,5,40,3,11,1992
13089023107,4482,1071,290,2836,6,77,2,39,3411
13089023108,4429,366,159,3687,10,43,3,26,4063
13089023111,1870,148,155,1424,8,89,0,9,1722
13089023112,3480,212,152,2920,13,85,0,16,3268
13089023113,2985,1175,183,1303,1,139,0,26,1810
13089023114,2948,402,179,1882,15,351,0,24,2546
13089023115,1395,367,630,361,12,23,0,0,1028
13089023209,5582,257,348,4676,8,64,3,58,5325
13089023211,3324,88,97,2947,8,51,0,18,3236
13089023212,3766,117,167,3283,11,24,0,24,3649
13089023213,5754,151,206,5000,14,166,1,27,5603
13089023214,6326,109,149,5790,14,38,0,38,6217
13089023215,4638,272,330,3477,14,365,1,32,4366
13089023216,3473,209,264,2789,6,105,0,23,3264
13089023217,3907,126,177,3411,0,61,3,19,3781
13089023218,3011,58,99,2705,9,25,2,18,2953
13089023219,3689,366,202,2590,3,347,0,59,3323
13089023220,3703,325,154,2809,3,275,2,35,3378
13089023221,3064,207,251,2413,14,51,1,22,2857
13089023222,3591,172,191,2937,1,160,0,26,3419
13089023311,4300,198,281,3610,5,48,0,28,4102
13089023313,4933,92,186,4502,3,15,0,16,4841
13089023315,6559,384,334,5498,18,74,0,61,6175
13089023317,3844,298,407,2975,6,19,0,23,3546
13089023318,3870,175,275,3214,0,45,3,38,3695
13089023319,3296,36,81,3094,3,9,0,11,3260
13089023320,3558,60,94,3275,4,9,0,26,3498
13089023321,4141,67,119,3802,6,29,2,22,4074
13089023322,3004,123,153,2583,7,53,1,19,2881
13089023323,3792,142,223,3205,8,58,10,34,3650
13089023324,3391,69,95,3023,3,53,4,15,3322
13089023325,4928,123,167,4423,8,26,0,20,4805
13089023326,3292,54,142,2982,1,13,0,14,3238
13089023327,6024,75,185,5513,13,21,0,17,5949
13089023328,4641,84,134,4249,1,16,0,23,4557
13089023329,4318,112,139,3847,3,11,0,43,4206
13089023330,2918,74,63,2685,0,6,1,14,2844
13089023331,3577,111,147,3153,4,25,2,22,3466
13089023332,2698,91,117,2327,13,25,0,26,2607
13089023410,5135,91,113,4766,15,20,2,18,5044
13089023411,3856,186,119,3443,5,18,2,7,3670
13089023413,3482,162,54,3126,1,12,3,28,3320
13089023422,5786,105,136,5384,7,21,2,21,5681
13089023424,5366,143,151,4865,3,14,3,37,5223
13089023425,6142,153,149,5558,13,30,0,50,5989
13089023426,4604,78,92,4267,4,17,0,28,4526
13089023427,2947,91,71,2677,12,11,0,12,2856
13089023429,3745,78,70,3452,4,2,0,21,3667
13089023430,5543,111,147,5100,7,12,3,27,5432
13089023431,2032,33,65,1856,3,7,0,14,1999
13089023432,4092,74,100,3770,3,6,0,21,4018
13089023433,4186,100,91,3882,7,6,2,7,4086
13089023434,4621,169,144,4161,0,18,0,18,4452
13089023435,1973,66,53,1800,4,7,0,5,1907
13089023436,3166,35,83,2901,11,13,0,15,3131
13089023437,6527,78,180,6037,7,22,0,34,6449
13089023438,5508,86,176,5041,16,9,0,27,5422
13089023439,3334,39,53,3068,15,31,0,41,3295
13089023440,4897,197,126,4364,9,29,0,32,4700
13089023441,3713,94,111,3363,1,18,2,30,3619
13089023442,3946,117,79,3602,0,23,0,21,3829
13089023443,5716,142,196,5201,5,30,0,21,5574
13089023444,2270,82,76,2022,3,16,0,23,2188
13089023445,4218,149,115,3788,9,29,0,16,4069
13089023446,1888,63,62,1677,1,16,0,13,1825
13089023447,2643,78,52,2421,0,4,0,9,2565
13089023448,3816,95,105,3469,3,34,0,13,3721
13089023501,3259,419,113,2588,11,22,0,18,2840
13089023504,3349,201,79,2944,0,7,4,9,3148
13089023505,2627,220,90,2244,1,5,0,18,2407
13089023506,6170,414,164,5316,7,27,0,54,5756
13089023507,4396,202,210,3827,5,33,3,18,4194
13089023601,2756,957,134,1476,7,45,1,10,1799
13089023602,2352,468,79,1724,6,10,1,15,1884
13089023603,3317,307,73,2804,1,17,1,21,3010
13089023701,2640,905,147,1383,1,50,2,27,1735
13089023702,3811,454,111,3069,6,27,0,33,3357
13089023801,4510,1502,329,2382,8,57,4,27,3008
13089023802,4045,910,256,2703,0,48,0,15,3135
13089023803,4988,939,232,3552,10,39,0,28,4049
13089980000,0,0,0,0,0,0,0,0,0
13091960100,2870,1757,71,1001,0,9,1,1,1113
13091960200,3407,2133,169,963,8,13,2,12,1274
13091960301,3471,1973,96,1247,2,47,3,16,1498
13091960302,2601,1804,48,681,8,0,0,3,797
13091960400,4174,2537,159,1375,1,11,2,7,1637
13091960500,1802,1357,36,356,1,13,0,3,445
13091960600,1600,1304,41,224,1,2,0,0,296
13093970100,4608,1812,284,2426,6,16,1,7,2796
13093970200,1369,638,101,588,0,10,0,1,731
13093970300,5231,2161,412,2526,11,25,1,6,3070
13095000101,2196,151,81,1922,4,10,0,3,2045
13095000102,2756,421,143,2090,8,7,0,9,2335
13095000200,2496,55,52,2345,0,6,0,0,2441
13095000400,5799,1966,222,3238,12,157,1,23,3833
13095000501,4643,1574,157,2651,5,118,0,22,3069
13095000502,4189,2517,91,1403,0,48,4,12,1672
13095000600,3021,1171,80,1650,7,16,0,6,1850
13095000700,1768,692,30,975,0,2,3,7,1076
13095000800,1090,132,24,901,3,1,0,0,958
13095000900,2145,472,80,1505,4,6,0,1,1673
13095001000,2460,272,42,2093,0,5,2,0,2188
13095001100,5606,199,66,5206,5,8,1,14,5407
13095001403,2390,25,11,2304,2,2,0,7,2365
13095001500,2042,18,12,1965,2,0,0,2,2024
13095010302,4867,224,55,4505,2,15,0,5,4643
13095010401,6508,3253,153,2850,2,88,0,33,3255
13095010402,3567,413,50,2978,11,26,3,6,3154
13095010403,1922,980,34,812,7,18,0,15,942
13095010500,1826,550,60,1163,3,4,0,0,1276
13095010601,2269,91,38,2089,2,3,0,0,2178
13095010602,3479,374,35,3009,2,1,0,11,3105
13095010701,2992,230,92,2573,4,8,0,8,2762
13095010702,2865,210,87,2510,3,0,2,8,2655
13095010900,1477,321,122,977,6,7,0,3,1156
13095011000,2869,1430,83,1237,16,4,0,14,1439
13095011200,3108,942,300,1752,7,23,0,6,2166
13095011300,2456,1088,65,1189,7,40,0,6,1368
13095011400,1170,96,18,995,4,14,0,0,1074
13095011600,1814,764,130,833,0,10,4,13,1050
13097080104,4869,893,798,2928,0,78,0,29,3976
13097080105,3235,305,160,2613,2,52,0,13,2930
13097080106,3868,1092,1018,1557,10,26,0,20,2776
13097080107,3309,504,140,2470,3,44,7,25,2805
13097080201,5422,2407,1203,1540,22,75,19,22,3015
13097080203,5404,1504,1001,2537,19,68,3,34,3900
13097080204,3508,1184,497,1629,4,41,0,18,2324
13097080303,4424,1310,711,2101,6,46,21,28,3114
13097080304,5469,1925,372,2825,28,98,3,28,3544
13097080305,5514,846,609,3805,9,24,3,32,4668
13097080306,4189,491,523,2915,8,20,0,62,3698
13097080307,3985,508,346,2893,9,28,0,44,3477
13097080403,4658,2504,373,1453,12,51,7,38,2154
13097080405,5755,4268,244,880,26,63,0,45,1487
13097080406,3716,2891,180,414,12,35,0,30,825
13097080407,6207,2200,559,2815,10,260,0,70,4007
13097080408,3493,1765,648,905,8,20,0,25,1728
13097080505,4408,2070,558,1434,17,85,0,36,2338
13097080506,5903,3283,686,1519,11,53,0,48,2620
13097080507,3766,1921,389,1180,3,51,0,25,1845
13097080508,5888,1978,692,2767,24,132,3,49,3910
13097080509,6531,2393,529,2974,5,290,3,53,4138
13097080512,4479,1865,432,1867,1,60,6,20,2614
13097080513,3217,760,292,1952,14,57,1,38,2457
13097080514,4145,1810,328,1689,18,101,1,36,2335
13097080515,5824,1164,630,3664,6,99,4,28,4660
13097080602,5736,1619,583,3181,12,86,0,69,4117
13097080605,3887,1522,498,1648,4,38,0,14,2365
13097080606,5602,739,313,4272,13,38,8,44,4863
13097080607,4478,1283,397,2440,15,133,3,24,3195
13097080608,3348,873,326,1896,4,61,5,25,2475
13099090100,1234,495,26,690,9,3,0,0,739
13099090200,2788,935,32,1745,6,3,0,0,1853
13099090300,1420,812,21,540,1,12,0,0,608
13099090400,3686,1306,89,2186,9,22,0,8,2380
13099090500,1726,1265,18,373,6,7,0,3,461
13101880100,1611,1014,393,109,33,7,0,1,597
13101880200,2086,1314,698,38,4,1,0,1,772
13103030100,3510,2849,79,435,16,8,0,4,661
13103030204,4585,2995,172,1119,20,18,0,32,1590
13103030205,3517,2423,210,676,11,10,3,4,1094
13103030206,2842,2188,68,484,4,1,0,20,654
13103030207,2595,2215,95,170,2,11,1,3,380
13103030208,4181,3374,243,274,22,10,0,25,807
13103030209,2937,2141,166,489,14,14,1,22,796
13103030301,7951,5945,469,891,18,149,8,34,2006
13103030303,2587,2194,97,121,0,11,0,7,393
13103030306,3142,2084,170,701,6,9,0,15,1058
13103030307,5076,3351,397,917,11,75,3,20,1725
13103030308,4777,3109,287,939,18,180,7,24,1668
13103030309,3869,2550,319,680,3,88,3,20,1319
13103030401,5204,4260,283,292,25,27,1,20,944
13103030403,4458,3597,296,312,8,45,1,8,861
13103030404,3538,2929,141,247,3,21,0,11,609
13105000100,3574,2881,139,419,0,60,3,9,693
13105000200,2933,2346,165,267,3,21,0,16,587
13105000300,3720,1773,144,1676,2,17,0,4,1947
13105000400,3993,2087,326,1416,10,40,0,12,1906
13105000501,1816,1435,84,212,3,20,0,6,381
13105000502,3601,2088,138,1263,8,24,0,6,1513
13107970101,3766,2456,77,1155,5,3,0,0,1310
13107970102,1626,1076,140,340,6,10,0,6,550
13107970200,1717,1192,22,463,1,0,0,0,525
13107970300,4071,1987,151,1838,4,7,2,8,2084
13107970401,3391,1581,139,1569,0,7,0,5,1810
13107970402,1539,1126,64,275,1,31,0,5,413
13107970500,1379,1211,31,101,5,1,0,6,168
13107970601,2494,1409,160,797,5,57,0,8,1085
13107970602,2785,1777,209,708,6,25,0,2,1008
13109970100,2952,1931,474,445,1,0,6,4,1021
13109970200,3836,2295,263,1095,8,59,0,9,1541
13109970300,3986,1812,500,1543,6,19,5,8,2174
13111050100,3873,3611,51,14,13,11,2,12,262
13111050200,6875,6275,281,9,21,23,0,14,600
13111050300,2457,2307,56,5,8,2,0,0,150
13111050400,6943,6376,251,37,21,38,0,24,567
13111050500,5171,4782,114,20,22,39,1,5,389
13113140102,5722,2176,460,2597,16,209,7,25,3546
13113140103,2299,914,349,893,4,42,0,8,1385
13113140104,5940,898,396,4170,11,197,0,54,5042
13113140203,6367,3517,345,1959,14,233,4,47,2850
13113140204,5785,2534,1013,1833,15,121,1,42,3251
13113140206,4725,3464,362,417,8,278,1,27,1261
13113140207,5717,4287,330,369,1,419,0,45,1430
13113140209,2634,1861,219,242,1,187,0,26,773
13113140210,7628,4031,730,1112,16,1341,10,66,3597
13113140303,4563,3416,465,246,8,197,0,24,1147
13113140304,6355,4600,777,356,8,312,6,28,1755
13113140305,5290,3055,519,1123,10,251,7,60,2235
13113140307,5550,4537,302,236,7,205,0,38,1013
13113140308,2447,1861,149,124,2,207,1,11,586
13113140309,5125,3436,380,559,5,487,0,26,1689
13113140403,5777,1878,344,2997,20,277,0,48,3899
13113140404,6969,3325,542,2391,10,314,0,92,3644
13113140405,4182,2572,265,947,5,179,0,33,1610
13113140406,3964,1586,406,1574,13,188,3,19,2378
13113140408,3254,2101,213,715,7,63,2,30,1153
13113140409,3785,1881,171,1326,0,200,0,30,1904
13113140410,4621,1520,300,2334,7,272,1,26,3101
13113140501,6778,5448,306,518,10,153,1,33,1330
13113140502,3717,3246,137,128,14,30,0,10,471
13115000100,4579,4061,169,144,9,24,0,7,518
13115000202,3956,3635,82,77,0,16,0,22,321
13115000203,3116,2494,95,256,15,139,4,10,622
13115000204,3899,3193,203,215,7,72,0,13,706
13115000300,2728,2247,150,174,7,46,1,64,481
13115000401,2595,1563,463,361,3,66,0,18,1032
13115000402,1389,1020,119,155,0,39,0,3,369
13115000403,4083,1787,1219,739,6,176,0,30,2296
13115000500,3740,1316,1533,736,12,13,3,14,2424
13115000600,4549,1922,378,1963,18,48,0,9,2627
13115000700,5173,4621,185,170,4,36,3,2,552
13115000800,4906,3677,180,753,13,45,0,5,1229
13115000900,2336,1789,77,347,0,28,0,12,547
13115001100,2749,1300,615,705,0,28,0,9,1449
13115001200,5596,2339,1900,1057,0,72,3,9,3257
13115001301,2760,1296,959,344,3,55,2,5,1464
13115001302,3775,2141,630,760,11,59,0,5,1634
13115001400,6408,5088,652,363,9,65,0,24,1320
13115001600,3232,1060,390,1619,17,19,0,22,2172
13115001703,3427,3021,125,97,21,15,0,10,406
13115001704,2900,2679,73,42,1,9,1,6,221
13115001705,4616,3491,172,633,3,142,0,12,1125
13115001706,1878,1709,46,40,4,1,6,5,169
13115001800,4709,3869,250,331,10,41,0,28,840
13115002000,4732,4213,129,208,7,18,1,6,519
13115002100,4753,2216,672,1651,11,15,0,21,2537
13117130101,4403,3646,387,128,7,68,0,24,757
13117130102,2790,2503,169,9,5,22,0,2,287
13117130103,4781,3861,628,81,9,32,0,9,920
13117130104,4453,3902,280,40,9,36,2,9,551
13117130105,2578,1789,595,33,14,10,1,20,789
13117130201,5186,4325,428,86,9,87,2,19,861
13117130202,5997,4842,375,260,10,243,2,10,1155
13117130203,5505,4549,449,116,2,69,3,14,956
13117130204,6673,5243,617,331,9,173,1,23,1430
13117130205,6516,4153,1064,571,11,373,6,34,2363
13117130301,6081,4767,605,203,14,180,3,35,1314
13117130302,9344,6719,573,354,19,1253,5,78,2625
13117130303,4077,3255,470,107,3,89,2,21,822
13117130304,6811,4184,477,344,12,1500,1,27,2627
13117130305,6994,5149,581,322,11,546,3,50,1845
13117130306,5407,3666,367,184,3,977,5,20,1741
13117130307,6706,4278,605,340,21,1198,2,18,2428
13117130406,7808,3855,1407,435,20,1693,0,85,3953
13117130409,3464,2152,947,166,6,65,0,30,1312
13117130410,8922,5346,1387,573,19,1125,0,59,3576
13117130411,2796,2061,386,154,2,64,1,15,735
13117130412,3328,2646,472,28,6,25,0,10,682
13117130413,3251,1962,1025,107,3,40,2,16,1289
13117130414,4837,3352,371,225,6,576,2,46,1485
13117130415,3791,2603,607,119,7,287,0,27,1188
13117130503,2855,2462,214,24,4,45,3,9,393
13117130504,3828,2748,845,48,12,38,0,9,1080
13117130505,2833,2493,160,39,5,29,7,7,340
13117130506,3454,2708,341,144,4,129,0,22,746
13117130507,3167,2440,387,101,3,118,0,10,727
13117130508,5519,4530,332,140,11,234,3,30,989
13117130509,3807,2567,591,55,1,418,6,8,1240
13117130511,5075,3232,345,205,7,1093,0,15,1843
13117130512,4383,1904,354,79,11,1915,0,25,2479
13117130601,6646,2681,992,621,17,2041,4,36,3965
13117130602,6062,2011,1736,490,8,1546,4,41,4051
13117130603,8449,4114,559,794,19,2591,1,48,4335
13117130604,5084,2905,355,218,9,1353,0,30,2179
13117130605,4745,3095,284,117,7,1065,4,19,1650
13117130606,5288,3355,281,205,4,1216,3,29,1933
13117130607,9066,3226,386,247,29,4937,0,36,5840
13117130608,6573,1695,227,397,8,4021,0,37,4878
13117130609,6898,2772,425,390,16,3029,1,38,4126
13117130610,6518,3308,284,214,9,2538,0,27,3210
13117130611,4809,2940,189,144,10,1321,0,27,1869
13117130613,6457,3174,346,228,17,2484,6,31,3283
13117130614,3820,1756,201,138,8,1600,0,7,2064
13117130615,3448,2483,120,101,0,625,0,13,965
13119890101,3991,2824,350,643,8,36,0,8,1167
13119890103,2425,2189,69,65,0,7,0,10,236
13119890104,1724,1448,98,115,0,17,0,0,276
13119890201,3178,2768,100,99,8,42,0,16,410
13119890202,2980,2578,87,173,1,61,0,2,402
13119890300,3463,3074,96,101,9,53,0,9,389
13119890401,2098,1787,93,129,1,22,1,4,311
13119890402,3565,2594,228,563,7,23,2,30,971
13121000100,5679,4533,280,307,3,248,1,39,1146
13121000201,2751,2201,150,116,2,140,1,21,550
13121000202,3316,2756,156,76,0,140,0,18,560
13121000400,1865,1480,90,134,1,77,0,10,385
13121000501,4281,1803,373,1118,12,732,5,37,2478
13121000502,1959,1562,104,153,2,63,1,0,397
13121000601,4243,2004,367,920,18,725,6,14,2239
13121000602,3288,1221,226,791,14,872,0,22,2067
13121000700,3500,709,136,2536,4,50,0,4,2791
13121001001,4895,2665,470,683,13,815,1,19,2230
13121001002,7010,4629,482,656,10,911,15,23,2381
13121001101,3523,2257,301,423,5,385,2,23,1266
13121001102,3997,2649,295,522,4,355,0,22,1348
13121001203,2028,1123,178,389,2,236,2,9,905
13121001204,2127,1588,163,133,0,133,2,10,539
13121001205,2615,1339,211,563,7,371,0,17,1276
13121001206,4296,2666,325,409,5,629,3,28,1630
13121001301,2299,1563,137,336,3,99,2,18,736
13121001302,2179,1261,124,523,6,136,0,20,918
13121001400,2504,1965,155,142,3,126,0,15,539
13121001501,2445,1671,140,391,8,125,0,20,774
13121001502,2364,1752,361,75,3,72,0,15,612
13121001600,2460,1853,172,177,1,142,0,5,607
13121001701,2204,736,133,1138,3,96,3,13,1468
13121001702,3531,2427,253,383,2,284,0,14,1104
13121001801,2037,726,114,946,8,136,0,15,1311
13121001802,2474,979,166,1057,4,140,0,18,1495
13121001901,2227,1475,115,375,0,124,2,16,752
13121001902,2258,649,124,1195,9,167,0,14,1609
13121002100,2521,654,158,1423,1,117,6,16,1867
13121002300,1225,31,32,1103,9,9,0,1,1194
13121002400,2504,156,97,2145,1,23,2,11,2348
13121002500,2273,53,104,2027,0,16,5,5,2220
13121002600,1123,70,49,937,3,19,0,7,1053
13121002801,4441,1233,315,2234,10,440,0,29,3208
13121002802,3462,786,209,1979,13,296,9,23,2676
13121002900,2553,1475,132,696,6,102,0,11,1078
13121003000,4058,3131,228,289,2,185,2,24,927
13121003100,2250,1315,200,484,1,118,2,10,935
13121003200,2426,1688,190,342,1,52,2,15,738
13121003500,4258,1078,662,2249,1,144,0,35,3180
13121003600,902,95,37,707,0,13,3,4,807
13121003700,191,2,2,174,0,0,0,0,189
13121003800,3456,34,21,3356,0,9,0,1,3422
13121003900,1756,72,47,1557,4,6,0,20,1684
13121004000,2325,213,69,1951,4,9,0,15,2112
13121004100,1949,283,80,1462,0,39,0,11,1666
13121004200,2443,157,48,2130,0,14,0,7,2286
13121004300,2475,129,78,2217,2,6,0,3,2346
13121004400,2667,68,49,2466,2,12,0,12,2599
13121004800,1175,98,41,964,7,32,0,5,1077
13121004900,2871,1480,142,974,10,85,0,12,1391
13121005000,3366,1937,343,792,0,129,6,20,1429
13121005200,4719,3026,283,1022,3,137,2,12,1693
13121005300,4165,2523,207,1093,6,106,3,22,1642
13121005501,2505,718,124,1469,6,60,0,14,1787
13121005503,1786,10,31,1689,1,9,2,3,1776
13121005504,1235,156,42,973,3,3,1,6,1079
13121005700,1550,67,40,1392,4,9,0,3,1483
13121005800,1528,356,70,995,2,31,0,14,1172
13121006000,3140,472,64,2447,2,32,0,15,2668
13121006100,3269,272,83,2793,5,15,0,16,2997
13121006200,1253,126,45,1044,0,11,0,4,1127
13121006300,1757,149,59,1463,4,6,0,14,1608
13121006400,902,219,144,502,0,3,0,0,683
13121006500,3697,756,134,2609,9,37,0,13,2941
13121006601,2034,387,70,1444,2,20,0,19,1647
13121006602,1050,47,37,946,0,1,0,5,1003
13121006701,2090,66,60,1889,8,7,0,14,2024
13121006702,1862,195,75,1478,0,12,0,20,1667
13121006801,2297,498,331,1448,14,1,0,0,1799
13121006802,1384,5,44,1320,3,1,0,0,1379
13121006900,3733,1459,616,1404,7,82,0,8,2274
13121007001,4055,179,286,3452,7,11,0,29,3876
13121007002,2871,161,212,2398,5,10,0,9,2710
13121007100,2267,63,147,1968,3,17,0,15,2204
13121007200,1968,33,93,1786,0,3,0,12,1935
13121007301,4435,75,225,4024,12,9,0,20,4360
13121007302,3031,55,63,2809,4,2,0,10,2976
13121007400,3141,130,348,2550,1,21,0,8,3011
13121007500,3447,181,190,2907,10,54,0,21,3266
13121007602,2309,91,35,2094,11,8,0,5,2218
13121007603,3979,66,89,3722,9,6,0,22,3913
13121007604,3191,28,59,3037,1,2,1,4,3163
13121007703,3869,41,79,3620,3,6,0,17,3828
13121007705,3969,36,77,3754,6,7,1,18,3933
13121007707,2225,26,52,2067,10,9,0,10,2199
13121007708,3283,38,202,2921,0,7,0,27,3245
13121007709,4211,81,148,3796,0,47,1,15,4130
13121007710,2891,54,73,2657,2,16,2,4,2837
13121007711,2550,34,65,2391,4,14,0,4,2516
13121007805,3780,67,242,3359,17,6,0,7,3713
13121007806,5390,39,251,4934,3,7,1,23,5351
13121007807,2619,36,137,2363,8,1,0,15,2583
13121007808,3749,31,77,3565,8,2,5,6,3718
13121007809,4380,63,74,4142,7,9,1,8,4317
13121007810,4498,47,87,4243,3,10,0,27,4451
13121007900,5067,102,77,4723,7,17,0,25,4965
13121008000,4672,259,121,4088,17,13,0,36,4413
13121008103,4361,36,361,3868,6,4,0,19,4325
13121008104,3413,128,109,3086,0,11,0,4,3285
13121008202,2031,25,78,1882,0,0,0,10,2006
13121008203,2520,64,50,2344,3,8,0,3,2456
13121008204,3260,73,67,3018,4,7,1,9,3187
13121008301,2524,88,72,2281,9,1,0,5,2436
13121008302,1657,47,35,1512,3,3,0,12,1610
13121008400,2865,135,77,2543,5,10,0,1,2730
13121008500,2818,218,104,2368,5,11,0,11,2600
13121008601,4993,130,169,4530,16,10,0,16,4863
13121008602,1413,52,81,1196,3,17,3,18,1361
13121008701,3333,213,236,2718,8,24,11,8,3120
13121008702,2287,425,87,1615,5,69,1,10,1862
13121008801,2654,1226,251,952,4,78,2,7,1428
13121008802,3689,2160,345,826,7,129,1,21,1529
13121008903,2419,539,780,850,0,124,4,16,1880
13121008905,5536,2749,467,1620,16,413,0,21,2787
13121008906,2247,1813,117,145,0,81,0,10,434
13121008907,3065,1794,241,714,5,153,6,13,1271
13121008908,2272,1044,209,702,3,191,1,20,1228
13121008909,1641,1134,125,230,2,62,0,12,507
13121009001,2611,1620,196,505,3,167,3,6,991
13121009002,2981,2698,96,47,2,51,0,12,283
13121009103,3261,2130,254,438,5,266,3,18,1131
13121009104,2830,1947,199,430,1,133,2,14,883
13121009105,1220,1078,20,40,1,26,0,4,142
13121009106,2170,874,218,771,1,160,1,23,1296
13121009201,1873,536,752,417,1,109,0,9,1337
13121009202,2733,1511,196,654,0,198,0,23,1222
13121009203,2762,1203,254,895,7,236,1,16,1559
13121009301,2835,2389,153,145,1,53,0,8,446
13121009302,2276,1818,144,133,1,71,0,16,458
13121009405,4332,1471,287,1388,7,950,2,32,2861
13121009406,2380,683,615,718,5,262,0,11,1697
13121009407,964,431,101,292,3,80,0,6,533
13121009408,1861,655,226,576,0,284,1,24,1206
13121009409,1639,702,284,367,5,228,0,2,937
13121009410,1883,1124,144,353,2,148,0,16,759
13121009411,2657,1526,207,513,10,254,1,16,1131
13121009501,4580,4062,123,190,5,77,0,18,518
13121009503,2010,1099,136,571,10,105,0,9,911
13121009504,3330,2315,208,507,8,142,2,19,1015
13121009601,2979,1851,339,458,3,177,3,31,1128
13121009604,4112,2931,384,396,2,213,1,26,1181
13121009605,2667,1556,211,554,16,206,0,12,1111
13121009606,1511,1241,79,55,1,54,0,11,270
13121009607,4709,3172,342,693,9,355,0,17,1537
13121009700,4580,3469,209,497,7,222,0,28,1111
13121009802,4154,3242,168,331,12,250,0,18,912
13121009803,3062,2238,133,434,0,145,0,20,824
13121009804,2514,2196,80,57,0,80,0,13,318
13121009900,5509,4608,213,217,0,232,0,34,901
13121010003,3963,2783,269,428,12,335,0,9,1180
13121010004,1712,1376,62,97,1,81,0,5,336
13121010005,3728,3205,169,73,2,139,0,23,523
13121010006,4688,2692,305,956,6,478,0,32,1996
13121010007,1914,1570,86,94,0,86,2,15,344
13121010106,4280,2448,452,979,4,149,0,36,1832
13121010107,1859,1575,82,65,3,54,0,14,284
13121010108,3935,2946,212,393,2,233,0,12,989
13121010115,2797,1995,158,304,1,221,1,14,802
13121010117,3812,1175,533,1423,9,432,1,58,2637
13121010120,2492,1289,257,673,5,93,6,42,1203
13121010121,2518,1704,147,276,4,289,6,5,814
13121010124,1726,353,332,906,0,55,4,22,1373
13121010125,3251,964,570,1321,5,173,3,45,2287
13121010126,2681,1034,466,622,4,405,0,14,1647
13121010127,2557,1307,256,447,0,427,4,8,1250
13121010128,1501,210,889,285,0,65,1,4,1291
13121010129,4590,2228,940,878,6,331,3,35,2362
13121010130,4524,1539,224,568,7,2069,1,23,2985
13121010131,2354,1022,138,288,5,791,0,8,1332
13121010132,3301,1761,503,587,9,314,0,22,1540
13121010133,5923,3070,470,1002,14,1071,9,66,2853
13121010134,2397,636,473,926,4,199,1,22,1761
13121010135,2566,797,659,784,6,166,0,39,1769
13121010136,3422,2126,778,259,0,145,5,16,1296
13121010137,3464,2198,481,480,5,140,0,29,1266
13121010204,5113,4361,204,194,5,170,2,16,752
13121010211,3373,2682,170,222,5,170,0,16,691
13121010212,5782,1982,2983,400,4,257,3,28,3800
13121010213,1113,339,134,484,2,87,2,9,774
13121010214,1938,823,242,659,2,121,0,26,1115
13121010215,1869,1083,197,370,2,74,0,31,786
13121010216,3577,1960,434,746,3,258,1,20,1617
13121010217,2422,1435,169,496,2,200,0,8,987
13121010218,2010,1038,159,621,1,86,2,12,972
13121010219,2443,833,286,991,8,150,1,22,1610
13121010220,4717,3396,247,490,2,319,1,27,1321
13121010221,2154,1367,193,264,0,170,0,24,787
13121010222,2671,2160,118,130,3,159,0,14,511
13121010223,3189,2510,145,248,3,175,0,13,679
13121010305,4307,37,70,4038,10,6,1,26,4270
13121010306,5156,98,137,4696,5,21,0,37,5058
13121010307,5425,118,136,4952,7,29,0,30,5307
13121010308,5787,240,174,5154,0,18,4,30,5547
13121010309,3685,558,187,2785,12,10,0,29,3127
13121010310,4901,104,119,4490,4,11,0,24,4797
13121010311,4615,77,142,4234,13,19,0,25,4538
13121010312,3336,35,61,3155,6,20,0,11,3301
13121010313,3931,47,72,3663,16,14,6,20,3884
13121010314,2161,127,52,1905,0,3,0,13,2034
13121010315,5387,150,111,4962,8,12,2,35,5237
13121010401,4589,903,541,2915,7,35,1,28,3686
13121010402,3831,2293,243,1139,5,17,0,12,1538
13121010508,3738,73,110,3448,4,18,0,4,3665
13121010517,5335,113,211,4843,9,7,0,46,5222
13121010518,3897,67,123,3558,0,12,3,64,3830
13121010519,4472,411,391,3497,7,37,1,23,4061
13121010520,5652,333,209,4879,6,65,1,28,5319
13121010521,2215,55,97,2005,3,5,1,12,2160
13121010522,5467,51,153,5027,21,55,5,44,5416
13121010523,1988,68,100,1753,7,1,4,20,1920
13121010524,3035,86,167,2682,9,11,0,14,2949
13121010525,2753,47,72,2537,9,19,2,4,2706
13121010526,6894,217,333,6098,9,30,1,43,6677
13121010527,5847,328,797,4470,7,37,3,29,5519
13121010528,4398,273,831,3153,9,31,0,11,4125
13121010529,6290,140,201,5739,2,23,2,43,6150
13121010530,2804,65,65,2576,7,13,0,17,2739
13121010531,3166,54,145,2815,1,9,0,46,3112
13121010532,3765,94,136,3397,4,9,3,42,3671
13121010533,2201,47,69,2004,4,15,2,24,2154
13121010534,3847,317,277,3055,3,87,0,30,3530
13121010535,3129,388,330,2307,2,19,1,3,2741
13121010536,3887,136,132,3429,4,28,0,37,3751
13121010537,3821,44,158,3468,0,13,0,31,3777
13121010538,3181,540,128,2423,3,5,0,13,2641
13121010539,3927,133,137,3512,3,26,0,27,3794
13121010540,3800,243,387,2962,1,67,2,29,3557
13121010601,3064,845,162,1902,17,26,1,11,2219
13121010603,3466,118,135,3100,7,24,0,26,3348
13121010604,3372,72,204,2951,3,26,0,23,3300
13121010801,2637,681,602,1110,6,84,2,37,1956
13121010802,3916,893,1464,1229,18,178,1,20,3023
13121011000,3085,127,706,2156,10,9,0,17,2958
13121011100,2524,836,270,1241,10,46,7,9,1688
13121011202,4989,936,821,2924,23,36,3,51,4053
13121011203,2498,450,269,1664,1,18,0,18,2048
13121011204,1620,81,55,1400,2,13,0,0,1539
13121011301,4508,399,593,3351,5,32,0,10,4109
13121011306,3371,39,116,3069,5,0,4,15,3332
13121011307,4631,66,150,4264,10,18,0,25,4565
13121011308,1396,30,20,1301,1,2,1,0,1366
13121011309,3655,151,158,3195,3,40,0,25,3504
13121011310,5137,207,789,4004,6,15,0,26,4930
13121011416,5612,4023,375,368,4,514,0,52,1589
13121011417,5115,3964,392,283,2,237,2,27,1151
13121011419,5798,4605,387,312,7,251,2,42,1193
13121011421,3933,1107,1474,961,4,219,2,39,2826
13121011422,3746,2542,374,535,4,108,3,20,1204
13121011423,5484,4121,440,372,2,248,0,46,1363
13121011424,5435,3399,466,684,11,586,2,23,2036
13121011426,2432,1409,340,216,0,330,0,17,1023
13121011428,2776,2181,150,165,1,167,0,13,595
13121011429,5546,3321,720,478,3,682,0,55,2225
13121011430,4338,646,2239,1169,18,87,4,67,3692
13121011431,1970,206,1530,148,1,22,0,8,1764
13121011432,4784,1776,1142,1266,10,331,1,43,3008
13121011433,3034,2200,176,236,0,224,0,29,834
13121011434,3209,1757,547,455,0,240,5,26,1452
13121011435,4271,2413,860,586,10,107,3,69,1858
13121011436,3190,2454,212,191,0,153,0,11,736
13121011437,2911,1626,523,544,0,99,1,14,1285
13121011438,4399,2057,1060,790,4,230,1,38,2342
13121011439,4138,2734,423,586,0,227,0,14,1404
13121011440,2352,1610,146,313,0,177,1,17,742
13121011441,3919,2627,432,403,2,206,1,43,1292
13121011442,2344,1349,236,467,8,163,0,19,995
13121011443,3303,1813,138,242,11,1007,8,6,1490
13121011444,3756,2563,143,162,3,743,0,17,1193
13121011445,3158,2623,179,148,0,67,0,21,535
13121011446,3428,2868,130,172,6,91,0,16,560
13121011505,4316,3392,230,267,0,222,1,18,924
13121011507,4947,4124,248,175,5,166,0,22,823
13121011508,4262,3113,296,245,1,381,6,34,1149
13121011509,2501,1961,159,152,4,108,1,15,540
13121011510,6164,4352,329,266,0,936,0,17,1812
13121011511,2794,1874,182,219,0,399,4,8,920
13121011512,2968,2452,142,105,2,106,0,16,516
13121011513,3450,2924,150,147,0,85,0,17,526
13121011514,3589,2931,210,136,9,126,0,15,658
13121011515,2531,2052,113,100,6,144,0,8,479
13121011612,3462,2135,125,272,0,774,5,20,1327
13121011618,4647,2216,387,441,0,1406,0,45,2431
13121011624,4015,2290,227,295,1,971,0,14,1725
13121011627,4418,1675,240,437,8,1879,1,48,2743
13121011628,2857,1340,138,355,2,885,0,15,1517
13121011629,4712,2276,276,373,3,1561,2,26,2436
13121011630,4262,2025,372,522,2,1108,4,24,2237
13121011631,4542,1817,389,647,0,1435,2,30,2725
13121011632,3641,790,204,519,4,2002,1,14,2851
13121011633,4008,2199,323,414,3,891,1,26,1809
13121011634,2721,1128,404,395,1,631,3,40,1593
13121011635,4075,741,148,335,7,2704,0,22,3334
13121011636,2134,493,366,266,15,840,4,86,1641
13121011637,2836,1750,177,258,14,486,0,28,1086
13121011638,4709,2870,368,435,6,774,0,40,1839
13121011639,1952,982,192,283,1,391,2,15,970
13121011640,5189,3189,551,511,12,704,5,47,2000
13121011641,4291,3200,234,159,3,477,0,23,1091
13121011642,3559,1930,345,498,0,608,0,21,1629
13121011643,4671,1305,470,814,17,1845,2,42,3366
13121011644,3686,1362,437,738,3,941,0,28,2324
13121011645,4220,1803,423,735,10,982,0,31,2417
13121011646,3059,1552,447,493,0,390,0,25,1507
13121011647,5160,2497,1187,707,3,535,4,32,2663
13121011648,2898,1020,154,213,3,1421,5,5,1878
13121011649,5387,1771,248,485,0,2643,1,34,3616
13121011650,4094,1612,305,382,10,1587,0,36,2482
13121011651,2299,1035,190,234,5,709,2,8,1264
13121011652,3372,1056,229,386,8,1567,0,22,2316
13121011653,3753,2372,225,360,8,614,2,21,1381
13121011654,2794,1700,211,436,7,300,0,27,1094
13121011655,2977,2366,210,87,4,190,2,6,611
13121011656,4213,2536,261,313,1,844,0,36,1677
13121011657,3082,1385,269,414,9,834,4,19,1697
13121011658,3931,1743,368,624,5,983,0,50,2188
13121011659,2824,1457,229,258,0,701,1,11,1367
13121011660,4431,2526,312,490,14,887,0,32,1905
13121011661,2187,1659,110,133,10,180,0,7,528
13121011801,1322,379,68,653,2,171,0,3,943
13121011802,1370,91,58,1144,4,15,0,12,1279
13121011901,1859,510,78,1073,1,89,3,13,1349
13121011902,1377,438,61,778,0,30,1,17,939
13121012000,3408,245,79,2912,4,27,0,14,3163
13121012300,2777,673,270,1690,2,29,0,13,2104
13121980000,0,0,0,0,0,0,0,0,0
13123080100,4337,3983,152,13,9,19,0,19,354
13123080200,5693,5100,331,31,9,28,0,7,593
13123080301,2457,1801,546,21,4,30,0,7,656
13123080302,4221,3029,1053,6,4,13,0,13,1192
13123080401,3164,2778,264,16,12,5,0,7,386
13123080402,4274,3376,707,15,6,13,0,22,898
13123080403,2832,2440,253,11,9,5,0,5,392
13123080500,4375,3858,293,14,9,18,0,2,517
13125010100,2884,2573,52,196,0,7,2,0,311
13127000101,1200,1115,38,22,2,2,0,0,85
13127000103,2040,1821,64,69,2,5,1,12,219
13127000104,1262,1189,23,7,2,9,0,7,73
13127000201,1762,1622,49,12,7,7,0,1,140
13127000202,3350,3069,80,58,4,43,3,18,281
13127000301,878,807,28,28,0,9,0,1,71
13127000302,2877,2616,96,82,2,17,0,18,261
13127000303,3612,3358,122,23,2,31,0,5,254
13127000403,3470,2687,294,323,8,21,15,16,783
13127000405,2071,1214,274,417,2,27,6,15,857
13127000406,6160,4056,627,960,28,194,8,25,2104
13127000407,4242,2796,338,778,2,109,2,7,1446
13127000408,3783,2548,284,537,11,197,5,27,1235
13127000409,2777,2047,171,406,14,10,0,14,730
13127000501,4900,2225,331,2195,4,26,4,10,2675
13127000503,3857,1707,384,1517,3,76,21,13,2150
13127000504,3769,1078,291,2158,16,66,12,20,2691
13127000601,3827,2232,332,1012,5,81,2,19,1595
13127000602,1893,1383,216,188,2,27,2,8,510
13127000701,3054,1392,263,1180,2,79,9,15,1662
13127000702,4889,981,688,2971,19,7,1,24,3908
13127000800,3654,436,425,2639,3,12,0,10,3218
13127000900,3746,1651,423,1533,3,4,0,14,2095
13127001001,5063,4274,175,395,14,33,0,25,789
13127001002,6363,4683,320,959,18,83,1,28,1680
13127990000,0,0,0,0,0,0,0,0,0
13129970101,3167,2561,353,65,3,26,0,7,606
13129970102,3134,2840,82,17,15,14,0,1,294
13129970201,2827,2554,138,5,5,9,2,7,273
13129970202,3871,3330,294,75,5,17,0,1,541
13129970301,4563,2930,1137,230,9,44,0,0,1633
13129970302,4782,2879,1336,284,11,88,4,27,1903
13129970400,5160,3836,710,211,14,162,0,12,1324
13129970500,4751,2850,1453,189,5,98,1,6,1901
13129970601,3028,1990,618,238,5,67,1,20,1038
13129970602,3751,1801,1379,338,11,78,3,5,1950
13129970700,4728,4131,282,100,18,33,1,5,597
13129970801,4037,3268,458,143,6,16,3,17,769
13129970802,2275,1911,190,43,2,16,0,4,364
13129970901,4454,3672,457,94,8,30,0,11,782
13129970902,3016,2764,70,43,5,21,0,0,252
13131950100,2328,1921,111,221,10,9,2,6,407
13131950200,2878,2082,115,548,8,13,0,15,796
13131950300,4349,1682,396,2150,10,4,2,6,2667
13131950401,1926,1511,147,182,7,2,1,4,415
13131950402,5139,2172,1344,1392,39,31,0,35,2967
13131950501,2535,1402,475,595,1,4,0,3,1133
13131950502,4635,2313,536,1613,8,39,1,17,2322
13131950600,2446,1632,149,584,6,8,0,0,814
13133950100,2070,1333,139,522,4,11,0,6,737
13133950200,2273,834,171,1177,6,17,0,1,1439
13133950301,3108,2827,79,47,5,50,0,19,281
13133950302,3802,3209,130,330,4,39,1,10,593
13133950304,1867,530,230,1010,2,35,1,4,1337
13133950305,3378,981,417,1870,6,19,0,8,2397
13133950400,900,371,56,463,1,1,0,2,529
13133950500,1517,1041,67,364,0,2,0,8,476
13135050105,5338,2034,1555,1108,7,427,9,20,3304
13135050110,5398,3568,714,630,12,219,0,22,1830
13135050111,2372,1037,896,288,4,62,0,9,1335
13135050112,5075,2120,1375,884,8,449,3,23,2955
13135050113,6131,2004,1556,1172,2,1099,2,43,4127
13135050114,3068,1565,776,284,3,307,0,27,1503
13135050115,4166,1919,1172,593,3,313,1,13,2247
13135050116,7036,3862,489,718,6,1595,10,26,3174
13135050117,3987,2459,403,380,9,549,3,24,1528
13135050118,2752,1294,722,387,0,228,0,11,1458
13135050119,5374,2443,772,614,10,1271,0,32,2931
13135050120,2361,1629,227,236,3,133,0,22,732
13135050121,6334,3424,1028,935,9,593,3,51,2910
13135050205,4401,1567,860,834,6,854,7,32,2834
13135050215,2935,443,496,790,5,1094,0,24,2492
13135050218,5002,1560,1714,609,11,957,2,14,3442
13135050219,3566,1188,458,886,3,878,0,21,2378
13135050221,4244,888,1331,883,3,968,0,35,3356
13135050222,5157,1524,919,920,7,1595,0,47,3633
13135050223,5858,2411,730,1286,18,1125,1,50,3447
13135050224,3984,1520,379,567,10,1306,4,27,2464
13135050225,4293,1704,787,1166,5,441,0,31,2589
13135050226,3749,1135,969,933,6,549,2,21,2614
13135050227,2180,1238,402,311,0,125,0,15,942
13135050228,4581,1053,795,1886,9,601,2,33,3528
13135050229,3229,294,1273,1310,1,219,2,28,2935
13135050230,3554,468,1230,783,2,957,11,18,3086
13135050231,5179,1586,507,836,9,2006,0,40,3593
13135050232,2624,814,189,283,3,1197,0,15,1810
13135050233,3389,851,407,441,8,1576,0,8,2538
13135050234,3776,1818,410,428,8,939,0,27,1958
13135050235,5961,1832,591,1135,4,2105,1,35,4129
13135050236,2819,420,334,715,6,1251,0,15,2399
13135050237,3693,1804,236,416,2,1087,0,17,1889
13135050238,4654,1375,316,1021,8,1766,1,44,3279
13135050239,5183,1830,339,701,10,2065,5,35,3353
13135050240,4032,1522,370,644,2,1275,1,34,2510
13135050241,4414,2146,367,533,3,1139,2,18,2268
13135050242,4763,2349,334,456,0,1399,0,37,2414
13135050243,6524,4087,337,467,11,1298,0,33,2437
13135050244,2917,1437,224,384,6,733,9,9,1480
13135050306,4307,419,2933,416,3,450,1,28,3888
13135050308,3800,2678,199,196,9,540,0,23,1122
13135050311,3622,1887,325,758,8,468,5,31,1735
13135050315,5786,1693,1408,2192,9,218,0,45,4093
13135050317,3898,617,1200,1799,15,120,1,20,3281
13135050318,3310,424,1135,1462,6,109,10,41,2886
13135050321,4638,3644,233,219,0,354,2,10,994
13135050322,4614,3623,198,183,5,393,1,34,991
13135050323,4225,2719,254,299,8,747,0,17,1506
13135050324,4450,1477,682,1134,15,856,1,41,2973
13135050325,4072,1001,1143,531,0,1213,4,22,3071
13135050326,4741,661,2218,946,11,751,5,16,4080
13135050327,3994,324,2361,840,5,323,2,37,3670
13135050328,2986,314,1745,647,3,202,0,17,2672
13135050329,2444,172,1458,579,6,125,3,20,2272
13135050330,3161,376,1892,271,1,556,4,18,2785
13135050331,2642,284,1352,569,10,323,0,26,2358
13135050332,3031,585,1480,698,10,143,0,20,2446
13135050333,4585,564,1810,1490,13,494,0,49,4021
13135050334,5310,1248,2658,446,12,775,0,35,4062
13135050335,3138,1383,567,833,1,163,0,23,1755
13135050336,3218,1377,407,701,0,573,0,17,1841
13135050415,4428,1395,505,1898,21,412,0,32,3033
13135050416,3835,667,916,1998,15,74,1,16,3168
13135050425,6019,2982,665,841,7,1264,4,28,3037
13135050427,6296,2954,1007,1041,9,974,0,36,3342
13135050430,5646,2261,702,1341,26,1033,1,48,3385
13135050433,2567,421,1320,448,8,303,0,17,2146
13135050435,4466,641,2664,681,6,375,0,21,3825
13135050437,2873,279,1396,922,0,197,0,10,2594
13135050438,5342,518,3148,977,8,568,0,30,4824
13135050439,3228,261,1560,1066,1,224,0,19,2967
13135050440,5076,743,2417,1033,0,752,1,20,4333
13135050441,5218,472,2048,1545,9,989,1,45,4746
13135050442,2862,654,1059,461,14,592,0,7,2208
13135050443,3397,786,751,868,10,857,2,19,2611
13135050444,3905,597,1725,544,2,945,3,25,3308
13135050445,3929,204,2807,602,2,245,3,17,3725
13135050446,3847,426,1843,960,10,461,1,36,3421
13135050447,3237,225,2219,511,2,204,0,8,3012
13135050448,4913,375,2871,846,5,690,3,30,4538
13135050449,4457,505,2238,737,8,878,1,30,3952
13135050450,3409,412,2008,459,0,433,6,9,2997
13135050451,3147,167,2391,427,6,105,0,22,2980
13135050452,3019,278,1883,466,4,325,0,17,2741
13135050453,3852,405,1732,1178,3,406,4,34,3447
13135050454,3959,500,2074,860,9,392,8,24,3459
13135050455,2820,222,2106,257,2,171,1,16,2598
13135050456,4339,332,2065,1523,8,307,0,34,4007
13135050457,4331,2058,409,797,4,799,0,46,2273
13135050458,3287,1723,403,595,7,412,0,27,1564
13135050459,3846,859,1548,573,7,725,0,31,2987
13135050460,3386,343,1836,621,8,465,5,27,3043
13135050461,2655,1279,328,332,2,551,0,19,1376
13135050462,4132,1605,347,893,0,1091,1,17,2527
13135050463,4206,431,1597,1758,8,258,8,33,3775
13135050464,5335,839,1152,875,9,2286,0,42,4496
13135050465,3918,1885,551,689,5,636,2,17,2033
13135050466,3115,1769,359,449,11,379,0,17,1346
13135050520,5138,1423,1481,1764,8,233,0,24,3715
13135050521,5738,1838,1933,1432,8,312,0,26,3900
13135050522,4944,1540,1467,1422,6,308,0,44,3404
13135050526,5354,734,2547,1289,2,635,2,30,4620
13135050528,5375,2655,725,796,4,924,3,30,2720
13135050529,4346,1542,1097,797,9,700,0,15,2804
13135050530,6057,2091,798,1141,3,1751,6,46,3966
13135050536,6810,1298,2434,2103,13,731,2,45,5512
13135050537,5587,816,1524,2635,24,333,0,54,4771
13135050539,6035,576,3180,1467,17,587,0,44,5459
13135050541,4867,563,2101,1798,15,194,0,35,4304
13135050542,5366,605,1419,2262,7,857,5,40,4761
13135050549,5136,1963,1260,865,6,832,5,31,3173
13135050550,4175,992,1788,901,7,340,0,25,3183
13135050551,4448,855,1309,1081,0,1045,1,32,3593
13135050552,3952,1377,814,792,8,809,0,27,2575
13135050553,3693,1362,731,715,4,729,3,10,2331
13135050554,4582,446,2219,873,3,926,4,16,4136
13135050555,4514,611,1432,891,4,1482,2,26,3903
13135050556,5754,789,2593,1451,6,763,1,41,4965
13135050557,2984,799,1232,482,5,405,5,10,2185
13135050558,2435,526,984,478,1,369,0,13,1909
13135050559,5067,826,2018,1316,6,736,1,21,4241
13135050560,3846,1063,337,886,2,1410,3,39,2783
13135050561,4511,487,1725,1407,5,753,0,27,4024
13135050562,4442,832,1706,1113,20,558,0,42,3610
13135050563,4080,1457,713,1456,9,260,0,23,2623
13135050564,3462,696,705,1813,4,104,0,16,2766
13135050565,4513,1677,786,829,10,978,0,30,2836
13135050566,3968,1613,714,772,4,684,3,25,2355
13135050567,4829,765,1497,1603,8,814,11,27,4064
13135050568,4450,889,1191,1732,4,474,1,28,3561
13135050569,5645,895,1330,2997,9,175,6,55,4750
13135050570,4040,891,1002,1776,3,178,1,23,3149
13135050571,5931,1102,1431,2695,7,408,1,43,4829
13135050572,3364,1706,543,484,8,462,1,13,1658
13135050573,2995,1191,518,656,4,437,3,17,1804
13135050574,4735,1071,996,1985,13,429,7,48,3664
13135050575,2545,932,672,510,11,293,0,19,1613
13135050576,2785,523,1421,505,6,265,0,18,2262
13135050577,4617,474,1815,1174,4,1000,3,31,4143
13135050578,4114,1601,713,865,7,742,2,26,2513
13135050579,4737,2134,971,858,2,531,1,41,2603
13135050580,3971,1087,511,1721,24,478,0,34,2884
13135050581,4018,968,1068,1233,6,600,1,31,3050
13135050582,2765,1209,585,581,7,230,0,41,1556
13135050583,4383,1487,751,1725,5,295,0,17,2896
13135050584,4341,2326,482,847,6,488,3,24,2015
13135050585,4407,788,1777,1417,2,288,0,20,3619
13135050586,5453,1177,971,2653,17,392,9,36,4276
13135050587,4630,879,881,2494,9,155,0,28,3751
13135050588,5080,1336,727,2462,3,310,1,46,3744
13135050589,5340,946,940,1470,22,1776,4,46,4394
13135050590,4120,709,1215,1470,2,584,1,32,3411
13135050591,3567,1552,478,909,9,468,0,17,2015
13135050611,4513,2123,1110,665,1,445,0,14,2390
13135050612,4819,2123,752,1010,2,688,1,27,2696
13135050613,3992,1713,773,812,3,532,0,10,2279
13135050614,3668,1941,611,704,2,227,0,16,1727
13135050615,2215,1166,384,322,0,211,3,11,1049
13135050616,3715,2192,399,592,2,361,3,22,1523
13135050617,9207,5579,1020,1532,15,604,2,48,3628
13135050618,4453,3076,415,442,7,314,2,41,1377
13135050619,6381,3562,612,1443,5,430,0,38,2819
13135050620,3737,2391,328,548,3,311,3,28,1346
13135050621,4161,2707,307,566,9,375,0,11,1454
13135050622,3425,1912,705,557,1,65,1,40,1513
13135050623,6280,2601,1132,1934,6,346,0,54,3679
13135050624,4079,872,742,2097,4,158,2,42,3207
13135050625,4044,1542,452,1688,11,146,0,30,2502
13135050626,5739,3383,692,1293,10,131,2,24,2356
13135050627,5576,1909,1121,1943,10,347,0,47,3667
13135050628,6223,3101,853,1707,8,247,6,47,3122
13135050629,2308,1348,327,458,0,88,1,4,960
13135050630,4748,2056,628,1371,9,441,0,38,2692
13135050631,7340,4473,923,895,12,706,0,39,2867
13135050632,3399,1851,390,473,0,527,4,57,1548
13135050633,2621,687,553,798,2,472,0,11,1934
13135050634,6306,2426,655,1323,2,1619,0,43,3880
13135050635,3993,2223,583,564,11,425,2,27,1770
13135050636,4251,1996,494,1069,16,536,0,23,2255
13135050715,5661,2356,788,1214,1,997,1,44,3305
13135050719,6149,1323,872,3390,9,211,0,56,4826
13135050722,3341,615,546,1835,8,191,2,41,2726
13135050725,6202,1187,1135,3219,9,380,4,45,5015
13135050729,3768,861,695,1917,4,111,0,24,2907
13135050732,6052,1044,534,4085,10,61,4,38,5008
13135050733,3184,486,663,1833,9,58,4,5,2698
13135050734,4606,898,516,2778,15,203,0,17,3708
13135050735,4365,1569,613,1765,10,114,3,52,2796
13135050736,5807,1529,721,3225,4,103,5,59,4278
13135050737,4240,761,403,2753,11,82,3,48,3479
13135050738,7058,998,607,4935,11,170,1,81,6060
13135050739,4755,1022,521,2811,2,197,3,36,3733
13135050740,2050,866,531,439,4,130,0,2,1184
13135050741,4905,1965,516,1763,9,383,4,61,2940
13135050742,4766,2212,477,1598,1,234,0,20,2554
13135050743,4637,2072,609,1539,3,184,6,30,2565
13135050744,8279,3117,776,3804,29,180,0,63,5162
13135050745,5148,2072,487,1889,21,456,1,33,3076
13135050746,7471,2335,704,3519,14,461,2,95,5136
13135050747,5377,1344,610,2816,4,297,3,42,4033
13135050748,3739,1067,439,1875,0,185,2,31,2672
13135050749,3538,589,471,2011,8,252,9,26,2949
13135050750,5032,808,482,3216,4,327,0,28,4224
13135050751,4096,811,495,2511,1,95,1,39,3285
13135050752,3422,967,997,1243,10,74,1,15,2455
13135050753,3936,1287,561,1776,9,99,1,50,2649
13135050754,2989,958,376,1417,8,104,0,20,2031
13135050755,2473,850,300,973,4,210,1,11,1623
13135050756,4471,2022,306,1000,10,926,1,28,2449
13135050757,3534,1958,449,558,8,357,0,31,1576
13135050758,3371,1677,629,699,3,177,7,22,1694
13135050759,4143,2008,483,1183,19,273,1,36,2135
13135050760,4240,2132,563,670,14,637,1,45,2108
13135050761,3904,1788,662,821,4,434,0,33,2116
13135050762,5971,3058,434,1037,3,1112,0,49,2913
13135050763,4157,1453,335,1325,13,826,2,34,2704
13135050764,3524,1077,360,1368,7,519,4,22,2447
13135050765,3145,1633,278,525,2,520,0,35,1512
13137000100,4010,3706,136,17,3,23,0,10,304
13137000201,4410,3940,183,21,7,26,3,12,470
13137000203,4290,3867,145,73,14,20,3,13,423
13137000204,1674,1500,80,22,0,16,0,2,174
13137000300,4186,3432,403,122,3,43,1,3,754
13137000400,5182,3942,739,85,11,222,3,16,1240
13137000501,2364,1190,638,235,12,200,0,2,1174
13137000502,5368,4319,555,164,14,96,20,27,1049
13137000601,6151,4062,1017,772,11,141,1,4,2089
13137000603,3076,2682,202,22,2,38,1,11,394
13137000604,5320,2054,2782,189,6,165,3,9,3266
13139000101,5299,4225,530,237,14,56,0,14,1074
13139000102,4013,3082,624,133,6,28,2,12,931
13139000203,4542,4147,138,25,13,13,5,0,395
13139000204,4370,3852,236,67,4,44,0,8,518
13139000205,2821,1920,762,29,4,20,0,12,901
13139000206,3663,3311,168,30,4,10,0,17,352
13139000303,2632,2362,143,15,5,7,5,3,270
13139000304,4084,3251,568,56,7,28,1,5,833
13139000305,4315,3482,518,69,7,52,1,21,833
13139000306,2503,2081,203,64,1,19,2,14,422
13139000307,4234,3138,816,56,5,63,0,6,1096
13139000401,3657,2234,793,432,2,82,4,13,1423
13139000402,3138,2513,409,53,2,23,2,11,625
13139000501,3725,2454,776,268,9,53,1,13,1271
13139000502,3380,2634,284,234,11,70,0,25,746
13139000601,3221,2079,712,239,4,73,0,10,1142
13139000602,3661,2420,680,342,10,49,1,9,1241
13139000702,5327,1370,3420,368,19,23,0,23,3957
13139000703,3442,539,1525,1259,0,22,0,20,2903
13139000704,3531,800,1928,650,3,43,0,17,2731
13139000800,3482,599,1604,1185,4,36,3,5,2883
13139000901,3084,2114,545,295,1,47,1,9,970
13139000902,2830,1527,978,189,0,47,0,15,1303
13139001004,3169,1818,652,455,5,100,1,15,1351
13139001005,4403,1926,2052,186,7,153,0,7,2477
13139001006,3097,2065,835,73,1,35,5,9,1032
13139001007,2187,390,1177,450,0,80,1,6,1797
13139001008,4335,781,3068,336,17,43,12,23,3554
13139001101,4995,403,4095,372,3,46,2,30,4592
13139001102,4849,513,3976,147,5,162,1,4,4336
13139001202,6366,1626,4114,394,26,106,0,10,4740
13139001203,2092,369,1337,319,4,8,3,11,1723
13139001204,5555,2254,2761,353,0,68,0,11,3301
13139001302,5515,4229,836,206,10,54,0,21,1286
13139001303,2842,1895,643,90,11,131,1,5,947
13139001304,4039,1721,1482,425,5,257,1,20,2318
13139001402,5485,3723,1202,252,8,144,3,26,1762
13139001404,5533,2655,2020,551,0,128,0,17,2878
13139001405,2649,1375,783,326,3,79,0,5,1274
13139001406,4141,1458,1686,425,3,410,8,37,2683
13139001501,5227,4126,554,214,14,110,0,6,1101
13139001502,4511,3733,376,122,9,86,0,15,778
13139001603,5499,3873,857,358,5,133,1,29,1626
13139001605,4904,3728,660,185,15,101,3,15,1176
13139001606,4494,2825,728,592,6,140,5,36,1669
13139001607,6524,4339,1027,518,16,358,8,19,2185
13139001609,4494,3533,384,168,14,188,0,17,961
13139001610,3509,2379,729,187,8,37,0,14,1130
13139001611,4736,3868,486,169,8,70,2,17,868
13139001612,3032,2679,130,88,3,63,0,1,353
13141480300,2725,1320,24,1280,12,2,1,10,1405
13141480400,6010,1093,39,4745,11,35,0,0,4917
13143010100,3560,3355,31,37,6,2,0,6,205
13143010201,3030,2823,25,99,6,8,0,7,207
13143010202,2914,2688,53,89,0,3,0,13,226
13143010301,3628,3216,80,188,11,8,0,10,412
13143010303,2009,1848,27,60,3,8,0,4,161
13143010304,6301,5520,146,278,8,51,8,18,781
13143010401,2878,2608,42,73,8,35,0,11,270
13143010402,5599,4767,93,429,14,71,1,18,832
13145120198,5059,3404,99,1247,10,72,1,36,1655
13145120200,3267,2556,86,477,21,12,0,3,711
13145120301,3738,2484,151,835,9,29,0,20,1254
13145120302,6999,5799,369,427,18,92,6,22,1200
13145120401,6484,5084,319,653,15,80,0,24,1400
13145120403,3878,2644,234,738,6,43,5,14,1234
13145120404,5243,3954,159,793,22,60,9,19,1289
13147960101,1354,1181,14,58,3,47,0,12,173
13147960102,715,662,7,14,1,0,0,2,53
13147960103,3749,3206,116,239,4,37,1,21,543
13147960200,3770,3197,175,227,1,14,0,14,573
13147960300,3125,2357,156,431,6,66,1,9,768
13147960401,1335,870,32,367,0,18,0,5,465
13147960402,4423,3096,178,927,10,66,0,14,1327
13147960501,1559,1011,78,380,4,14,0,3,548
13147960502,2134,1441,59,560,2,19,0,0,693
13147960503,3664,2229,116,1121,5,54,0,6,1435
13149970100,4451,3579,139,445,11,28,0,8,872
13149970200,3953,3540,57,136,11,15,1,9,413
13149970300,3008,2470,57,349,11,10,3,12,538
13151070109,3401,1237,232,1716,7,58,5,20,2164
13151070113,4266,1503,963,1467,19,125,6,17,2763
13151070114,5177,1006,330,3348,9,226,4,45,4171
13151070115,3847,309,203,2550,10,640,3,15,3538
13151070116,3198,1094,293,1344,6,288,0,37,2104
13151070117,4310,2144,321,1558,6,77,0,19,2166
13151070118,3257,936,190,1937,2,48,1,18,2321
13151070119,5968,779,564,4134,10,262,0,36,5189
13151070120,2630,223,250,1856,10,173,0,26,2407
13151070121,3790,828,248,2514,9,32,0,22,2962
13151070122,3125,512,168,2237,1,28,0,48,2613
13151070123,2378,513,179,1449,5,113,3,21,1865
13151070124,4557,549,303,2949,10,558,3,34,4008
13151070125,2739,1282,243,1018,7,69,0,8,1457
13151070126,3429,953,555,1668,8,78,2,18,2476
13151070127,3139,252,267,2493,4,19,1,24,2887
13151070128,2229,318,207,1630,1,15,5,0,1911
13151070204,5675,2246,322,2654,10,178,1,53,3429
13151070206,4070,2214,238,1352,5,87,1,24,1856
13151070207,3202,1856,158,991,4,42,2,20,1346
13151070208,4793,3027,302,974,3,220,0,37,1766
13151070209,4045,2763,180,814,7,71,4,28,1282
13151070210,2546,1406,163,745,3,95,0,25,1140
13151070211,5032,1111,340,2749,18,510,3,77,3921
13151070212,3153,1504,397,1004,2,44,0,25,1649
13151070213,2856,1844,174,710,3,42,0,6,1012
13151070214,4622,3152,210,947,3,58,0,25,1470
13151070215,1935,1266,94,488,3,10,0,6,669
13151070216,5415,1846,327,2823,10,136,1,40,3569
13151070307,5153,1831,322,2656,8,117,0,36,3322
13151070310,6725,2651,612,2908,9,156,0,45,4074
13151070312,5336,1342,388,3258,6,90,15,50,3994
13151070313,8097,1183,451,5407,15,671,0,54,6914
13151070314,4122,1918,359,1471,7,168,4,34,2204
13151070315,5071,983,334,2811,7,742,7,48,4088
13151070316,2676,548,201,1663,0,143,0,25,2128
13151070317,5607,572,480,4122,10,131,0,54,5035
13151070318,2840,577,238,1861,4,35,1,25,2263
13151070319,5233,537,450,3738,8,222,12,25,4696
13151070320,2645,764,158,1502,3,97,5,30,1881
13151070321,2410,1252,155,785,3,102,2,17,1158
13151070322,6114,863,962,3875,8,112,4,48,5251
13151070323,2592,338,260,1849,8,8,0,30,2254
13151070324,4448,724,188,3338,10,33,2,37,3724
13151070325,2009,688,105,1133,5,6,0,12,1321
13151070405,3405,2262,186,784,10,36,0,5,1143
13151070406,4332,2607,253,1218,7,27,2,18,1725
13151070407,4668,2791,293,1336,17,60,3,39,1877
13151070408,3163,2353,211,402,14,29,4,14,810
13151070409,5336,3913,301,800,17,60,0,17,1423
13151070410,4275,3342,189,500,3,23,0,18,933
13151070411,5163,1924,370,2472,9,184,4,15,3239
13151070412,4845,2064,375,2068,0,56,2,34,2781
13151070503,6384,1826,601,3607,2,76,1,32,4558
13151070504,2053,984,244,685,7,15,0,13,1069
13151070505,6005,3032,473,2124,13,101,0,27,2973
13151070506,3131,1089,270,1577,7,48,2,31,2042
13151070507,2860,1007,171,1537,12,25,0,11,1853
13151070508,5230,1659,416,2825,3,101,4,32,3571
13153020106,2305,1483,116,575,3,18,11,3,822
13153020108,6152,3659,427,1599,17,87,2,32,2493
13153020110,2225,533,106,1447,17,18,0,9,1692
13153020111,4065,1638,550,1629,6,58,0,6,2427
13153020112,5152,2477,300,1617,21,493,0,37,2675
13153020113,5227,2522,507,1896,6,73,5,26,2705
13153020200,5216,2140,429,2243,17,102,13,21,3076
13153020301,1588,167,102,1227,7,15,0,11,1421
13153020302,4616,809,421,3181,10,48,0,10,3807
13153020400,3068,721,381,1826,2,14,0,2,2347
13153020600,1061,588,163,172,6,26,0,8,473
13153020700,3308,776,437,1920,4,32,1,19,2532
13153020800,2612,753,265,1406,9,27,0,10,1859
13153020900,4239,2204,378,1284,14,40,1,38,2035
13153021001,2841,1298,183,1140,8,50,0,17,1543
13153021002,3480,2055,252,873,11,81,0,11,1425
13153021108,6793,4523,367,1365,10,163,1,40,2270
13153021114,8315,5413,507,1627,15,253,15,28,2902
13153021115,6938,4216,457,1617,13,183,3,36,2722
13153021116,3967,1795,302,1588,4,129,4,26,2172
13153021117,4396,2455,813,736,12,169,9,15,1941
13153021118,2539,789,436,1103,4,73,1,6,1750
13153021119,4564,2218,290,1594,9,183,1,26,2346
13153021120,5869,3321,325,1760,8,104,8,33,2548
13153021121,2240,1553,99,430,5,45,0,2,687
13153021122,3931,2725,187,694,13,118,2,15,1206
13153021123,6419,3137,377,2023,8,559,7,23,3282
13153021124,5922,3431,352,1040,6,753,0,26,2491
13153021125,6099,2969,502,1951,10,285,7,34,3130
13153021203,4182,3073,192,636,8,41,3,9,1109
13153021204,6609,3664,441,1834,21,285,13,32,2945
13153021205,4264,2707,179,1074,9,103,1,15,1557
13153021206,2454,881,149,1303,0,20,0,13,1573
13153021300,4222,2311,113,1581,4,71,0,19,1911
13153021401,5574,3599,180,1533,5,60,1,21,1975
13153021402,6334,4115,364,1507,6,98,11,17,2219
13153021501,1047,884,38,65,1,7,3,2,163
13153021502,3800,2609,120,896,10,21,1,5,1191
13155950100,2427,2178,87,71,4,1,1,4,249
13155950201,3550,1447,459,1481,5,94,0,16,2103
13155950202,3689,2777,117,672,6,24,0,4,912
13157010104,4449,2991,775,311,14,173,1,18,1458
13157010105,3708,3099,210,119,0,166,1,12,609
13157010106,3629,2823,353,214,6,101,2,15,806
13157010107,5179,4360,360,125,8,140,1,12,819
13157010108,3985,3014,456,210,6,119,0,8,971
13157010109,4211,2840,600,395,6,176,3,28,1371
13157010200,5006,4204,362,125,20,57,11,23,802
13157010300,5658,3844,648,797,16,130,0,27,1814
13157010400,5568,4606,306,384,0,84,2,3,962
13157010500,5554,4430,589,233,9,33,1,27,1124
13157010601,5085,3797,391,554,9,61,2,25,1288
13157010602,5216,4015,473,450,6,95,1,13,1201
13157010701,2479,2083,89,185,5,17,0,12,396
13157010703,4011,3458,179,102,3,93,2,22,553
13157010704,3910,3157,295,241,6,55,0,10,753
13157010705,4473,3478,386,244,8,168,1,17,995
13157010706,3786,2865,240,447,5,76,2,22,921
13159010100,2665,2029,231,289,6,2,0,8,636
13159010200,3195,2676,116,177,12,8,1,13,519
13159010501,3413,2899,99,244,6,10,0,14,514
13159010502,2647,1357,146,1040,7,1,0,18,1290
13159010503,2668,1810,92,692,3,1,0,9,858
13161960101,2864,1826,722,231,5,11,1,9,1038
13161960102,4254,3221,578,315,10,16,4,8,1033
13161960201,3836,2366,465,873,8,7,1,13,1470
13161960202,2291,1251,174,785,0,15,0,2,1040
13161960300,1534,1286,108,89,3,1,1,1,248
13163960100,4911,2319,170,2271,5,12,0,11,2592
13163960200,2004,1384,46,497,10,13,0,4,620
13163960300,5808,2208,132,3313,4,37,0,10,3600
13163960400,2986,923,114,1889,2,8,0,0,2063
13165960100,6666,3399,252,2841,26,12,5,26,3267
13165960200,2008,1212,51,695,3,0,0,4,796
13167960100,2575,2266,51,178,11,1,2,3,309
13167960201,3254,1706,32,1453,4,9,8,9,1548
13167960202,1705,793,7,843,2,14,3,0,912
13167960300,1655,1035,27,543,6,4,2,2,620
13169030101,2888,2319,61,372,1,51,0,10,569
13169030103,1996,1558,33,321,4,13,0,2,438
13169030105,3685,2631,70,837,10,5,1,16,1054
13169030106,3513,1167,51,2177,1,9,1,10,2346
13169030200,3308,2489,47,664,4,4,4,13,819
13169030303,2209,1928,15,192,6,11,0,5,281
13169030304,3403,2706,75,506,3,7,0,8,697
13169030305,4397,3473,87,663,8,36,1,2,924
13169030306,2948,1803,37,1007,9,2,0,7,1145
13171970100,7180,5886,178,803,8,27,2,24,1294
13171970201,3688,2377,94,1085,0,14,0,2,1311
13171970202,3378,1761,95,1392,4,19,2,3,1617
13171970300,4254,2320,108,1608,1,42,0,19,1934
13173950100,1718,1443,47,146,7,12,2,9,275
13173950201,3775,2263,112,1217,3,28,9,8,1512
13173950202,4384,2889,413,775,21,41,3,16,1495
13175950100,3470,2171,103,1054,1,7,2,8,1299
13175950201,4985,3064,101,1530,6,144,1,13,1921
13175950202,5122,3508,112,1296,10,63,3,5,1614
13175950300,1683,362,54,1178,7,4,0,14,1321
13175950400,4276,1434,98,2456,3,159,0,24,2842
13175950500,3830,2135,137,1395,11,61,2,2,1695
13175950600,2084,1515,18,499,3,4,2,2,569
13175950700,2639,2153,26,353,6,9,0,5,486
13175950800,4305,1644,122,2432,2,26,2,12,2661
13175950900,2578,75,38,2395,6,1,0,6,2503
13175951001,3886,3092,194,494,0,9,0,8,794
13175951002,3817,1382,148,2121,6,7,2,12,2435
13175951100,4199,3066,210,761,15,5,0,13,1133
13175951400,2696,2280,63,255,4,8,0,17,416
13177020101,3383,2620,88,513,4,49,0,4,763
13177020102,3559,2651,88,643,14,32,0,8,908
13177020200,1577,925,34,569,2,6,0,0,652
13177020301,4025,2718,97,975,14,49,1,14,1307
13177020302,4811,3268,111,1097,5,188,1,17,1543
13177020403,6711,4623,178,1357,7,305,4,32,2088
13177020404,4591,3252,184,858,5,84,1,7,1339
13177020405,4506,2701,173,1319,6,137,2,16,1805
13179010101,5170,2273,1052,1242,27,118,34,36,2897
13179010102,2456,1171,459,617,14,77,19,8,1285
13179010103,1827,862,339,463,21,53,14,2,965
13179010202,3845,1004,535,1913,15,88,37,15,2841
13179010204,2575,690,250,1442,5,21,12,11,1885
13179010205,4911,1387,641,2329,23,155,24,23,3524
13179010206,6605,2524,854,2553,15,129,64,36,4081
13179010207,4761,1271,570,2446,12,92,42,21,3490
13179010208,6453,1645,914,3170,22,120,65,47,4808
13179010301,1907,426,186,1122,7,43,12,10,1481
13179010302,6241,2133,775,2632,12,207,63,60,4108
13179010401,2369,888,172,1142,2,30,6,7,1481
13179010402,4820,1503,524,2345,9,116,38,15,3317
13179010501,3950,3150,116,492,15,14,5,5,800
13179010503,2879,1630,200,792,11,33,2,11,1249
13179010504,2798,1157,167,1295,12,23,0,11,1641
13179010600,1689,290,32,1314,3,6,0,4,1399
13179990000,0,0,0,0,0,0,0,0,0
13181970100,3576,2224,38,1168,11,15,0,0,1352
13181970200,4114,2972,54,948,7,5,3,10,1142
13183970101,3748,1928,1038,567,7,23,0,28,1820
13183970102,6789,3561,623,1882,35,106,66,41,3228
13183970201,2083,1268,130,537,0,8,6,4,815
13183970202,3548,2017,188,1042,20,27,16,18,1531
13183980000,0,0,0,0,0,0,0,0,0
13185010101,4407,2414,432,1204,20,66,14,25,1993
13185010102,6559,3606,636,1729,31,143,16,24,2953
13185010103,4387,2365,311,1265,7,159,8,31,2022
13185010201,3856,2814,144,755,11,21,0,6,1042
13185010203,5696,4081,287,1048,23,46,6,15,1615
13185010204,8983,6355,469,1366,25,315,9,32,2628
13185010301,5121,3049,332,1132,11,311,3,37,2072
13185010302,2651,2246,137,172,3,17,1,9,405
13185010401,1486,1089,98,220,0,15,2,6,397
13185010403,2768,343,94,2193,1,13,4,11,2425
13185010404,4728,1091,311,3057,13,74,1,26,3637
13185010500,4022,498,280,3086,0,14,1,18,3524
13185010601,6070,1864,414,3323,20,165,5,20,4206
13185010604,5957,2707,416,2420,13,119,8,39,3250
13185010700,3588,2623,201,654,6,8,0,14,965
13185010801,3395,436,235,2638,5,7,0,12,2959
13185010802,1856,40,80,1698,0,0,0,5,1816
13185010900,1631,281,100,1186,11,6,0,2,1350
13185011000,3053,219,214,2513,7,0,3,7,2834
13185011100,4084,1852,330,1665,9,48,0,25,2232
13185011200,4615,3029,238,1046,14,87,2,32,1586
13185011301,4851,1438,275,2896,9,64,6,15,3413
13185011302,2243,465,88,1589,2,5,0,6,1778
13185011401,2625,1276,142,1077,10,45,0,6,1349
13185011402,2470,967,321,1114,1,8,7,0,1503
13185011404,4144,2643,503,834,8,15,1,9,1501
13185011405,4735,3118,334,1057,15,57,1,6,1617
13185011500,3900,3104,243,381,17,20,2,3,796
13185011600,4370,3293,207,628,20,60,0,9,1077
13187960103,3230,2844,137,20,9,21,1,9,386
13187960104,4446,3763,342,50,24,32,4,3,683
13187960105,2650,2412,88,6,23,6,1,15,238
13187960106,3572,3229,126,26,13,16,9,10,343
13187960203,4238,3805,153,31,19,11,0,9,433
13187960204,4483,3660,374,171,12,79,5,24,823
13187960205,4999,4491,180,25,24,29,1,15,508
13187960206,5870,5037,390,83,27,63,0,33,833
13189950100,2228,1942,49,145,13,15,0,0,286
13189950200,5471,1824,160,3338,6,3,1,11,3647
13189950300,3048,1365,64,1522,4,17,0,3,1683
13189950401,2099,1271,38,705,0,14,2,5,828
13189950402,3482,1368,88,1916,5,8,2,3,2114
13189950500,5304,3647,391,1018,17,19,8,15,1657
13191110101,1369,862,32,413,3,0,0,3,507
13191110102,903,646,20,199,0,6,0,2,257
13191110103,1454,1225,35,144,5,2,0,1,229
13191110201,2297,1420,46,721,2,1,0,10,877
13191110202,1819,882,36,836,4,13,0,3,937
13191110300,3133,2025,62,863,18,21,0,16,1108
13191980000,0,0,0,0,0,0,0,0,0
13191990000,0,0,0,0,0,0,0,0,0
13193000100,1662,569,53,1002,1,4,2,3,1093
13193000200,1509,792,25,636,0,26,0,2,717
13193000300,4185,1200,131,2759,7,20,2,6,2985
13193000400,4726,1517,263,2753,7,106,3,9,3209
13195020100,5398,4788,200,137,8,65,0,32,610
13195020200,4278,3759,144,89,1,35,0,15,519
13195020300,4581,3508,119,503,3,295,0,10,1073
13195020400,6240,4388,638,915,8,18,2,7,1852
13195020501,1840,1292,168,278,4,29,0,6,548
13195020502,5723,3917,615,815,20,57,2,31,1806
13195020600,2060,1897,72,16,0,22,0,5,163
13197920100,4027,3268,195,315,10,38,14,5,759
13197920200,3471,1218,365,1807,2,17,1,6,2253
13199970501,2586,1502,47,935,4,15,0,3,1084
13199970502,2739,1535,61,1035,3,21,2,6,1204
13199970600,2786,1853,43,771,9,14,0,3,933
13199970701,2930,1477,94,1264,14,12,2,9,1453
13199970702,4571,3169,127,1084,22,14,0,11,1402
13199970801,3409,1755,80,1460,4,2,2,12,1654
13199970802,1592,793,23,724,8,0,0,6,799
13201950100,1651,1252,49,287,6,15,0,3,399
13201950200,1874,823,25,987,0,7,0,0,1051
13201950300,2475,1874,62,474,3,4,1,2,601
13205090100,3243,2105,157,847,9,12,0,14,1138
13205090200,3391,2196,194,890,4,14,0,4,1195
13205090300,2664,332,97,2187,0,8,0,0,2332
13205090401,2926,1396,69,1389,3,24,0,3,1530
13205090402,4080,1482,254,2222,12,34,0,9,2598
13205090501,3178,799,59,2239,2,8,0,4,2379
13205090502,2273,1796,134,280,7,8,0,7,477
13207050101,6562,5117,235,918,16,41,0,23,1445
13207050102,4251,2735,96,1224,5,18,0,12,1516
13207050200,6291,3251,166,2645,5,48,0,21,3040
13207050301,5110,3954,84,854,1,57,0,13,1156
13207050302,5743,4897,133,443,7,75,0,17,846
13209950100,1991,1737,65,146,2,1,0,2,254
13209950200,4603,2460,333,1658,6,33,0,7,2143
13209950300,2016,1468,173,316,3,0,0,4,548
13211010100,2924,2291,135,400,14,5,0,8,633
13211010200,4007,3311,97,459,6,10,0,3,696
13211010301,3889,2071,141,1531,7,34,1,15,1818
13211010302,4343,2824,123,1192,4,36,0,28,1519
13211010400,3218,2628,130,338,10,16,0,14,590
13211010500,1716,1362,86,185,1,21,0,0,354
13213010100,3407,3135,137,9,10,8,0,2,272
13213010201,1712,1553,105,12,0,3,1,0,159
13213010203,3611,2785,716,15,2,3,0,5,826
13213010204,5598,4282,1061,69,14,5,0,13,1316
13213010300,3985,3545,262,19,8,11,0,5,440
13213010401,3443,2357,915,20,5,25,0,5,1086
13213010402,3494,2606,727,29,3,28,0,3,888
13213010500,4992,3665,1119,31,12,8,0,10,1327
13213010600,4251,3608,408,18,17,17,1,7,643
13213010700,5480,4628,464,41,8,19,0,8,852
13215000200,2533,1643,248,432,7,51,3,21,890
13215000300,2531,905,484,1042,3,2,6,27,1626
13215000400,3236,2134,328,508,8,49,6,19,1102
13215000800,2354,1242,281,686,9,8,2,5,1112
13215000900,3086,1379,264,1212,7,35,7,19,1707
13215001000,4937,2707,338,1512,38,88,3,44,2230
13215001100,2887,2377,118,188,4,58,6,27,510
13215001200,3572,2282,175,888,6,30,8,20,1290
13215001400,1922,560,99,1110,5,27,8,12,1362
13215001600,2793,602,139,1866,6,8,3,28,2191
13215001800,1202,477,93,572,3,0,2,9,725
13215002000,2981,159,124,2561,3,16,7,7,2822
13215002100,2587,974,257,1184,3,33,5,17,1613
13215002200,2664,202,121,2214,11,1,1,3,2462
13215002300,1854,631,66,1061,3,19,4,6,1223
13215002400,1315,83,41,1136,4,1,3,4,1232
13215002500,1074,182,30,809,2,9,6,4,892
13215002700,2632,126,153,2245,3,9,0,4,2506
13215002800,1895,101,73,1653,1,1,1,11,1794
13215002901,2748,371,118,2138,2,22,5,16,2377
13215002902,3151,223,219,2575,8,24,3,11,2928
13215003000,2656,210,375,1974,9,11,1,23,2446
13215003200,2295,127,201,1864,8,3,0,5,2168
13215003301,1362,171,117,999,2,9,3,1,1191
13215003302,2367,241,170,1844,4,21,4,11,2126
13215003400,2046,274,228,1413,8,20,7,1,1772
13215010106,5673,2849,542,1740,11,204,5,22,2824
13215010108,4633,1422,409,2381,7,112,19,22,3211
13215010109,2411,1282,221,617,1,151,4,21,1129
13215010110,3763,1679,364,1105,6,413,0,18,2084
13215010111,7131,3896,601,2026,9,193,16,20,3235
13215010204,6896,3868,541,1641,19,414,12,53,3028
13215010205,3165,1837,259,614,6,231,7,37,1328
13215010206,3739,2080,271,820,5,314,13,38,1659
13215010207,4266,3045,284,522,14,191,2,23,1221
13215010208,6266,3439,439,1439,6,610,15,27,2827
13215010209,4441,2539,469,811,12,282,22,14,1902
13215010301,2590,2089,67,144,4,226,3,8,501
13215010303,5252,3588,379,700,19,297,6,25,1664
13215010304,2322,1365,208,474,6,155,0,14,957
13215010401,6556,4509,563,930,24,133,10,30,2047
13215010402,4693,2447,457,1361,11,183,30,18,2246
13215010501,6830,3079,554,2579,18,190,10,29,3751
13215010502,2042,683,163,1084,4,13,6,12,1359
13215010602,5083,1023,312,3463,6,53,18,26,4060
13215010605,3884,176,151,3423,0,24,8,11,3708
13215010606,1715,651,213,845,0,1,0,0,1064
13215010607,5429,683,335,4165,8,36,10,42,4746
13215010608,4529,378,198,3740,2,26,10,29,4151
13215010701,7028,788,327,5578,10,41,29,16,6240
13215010702,5998,375,167,5214,18,43,13,9,5623
13215010704,2768,130,82,2428,12,9,0,13,2638
13215010705,4423,384,241,3569,10,37,5,26,4039
13215010801,1580,959,229,182,2,69,18,6,621
13215010802,5535,3250,1126,442,37,124,92,24,2285
13215011100,2502,1358,221,710,16,46,5,33,1144
13215011200,1826,779,90,825,3,17,1,10,1047
13215011400,1897,1031,140,594,6,3,5,20,866
13215011500,5376,1039,1030,2849,9,150,19,25,4337
13217100101,6112,4558,289,979,3,44,4,25,1554
13217100102,5349,3026,215,1783,1,69,2,37,2323
13217100202,5614,4664,185,497,4,43,0,23,950
13217100203,3196,2617,95,378,0,6,3,11,579
13217100204,3206,2419,110,519,3,28,1,13,787
13217100301,6229,2195,436,3260,18,105,0,35,4034
13217100302,3918,2202,396,1103,3,31,5,13,1716
13217100400,3804,1310,265,2040,13,32,3,24,2494
13217100503,5022,760,471,3550,5,20,0,41,4262
13217100504,5939,487,262,4858,4,61,26,38,5452
13217100505,5502,859,293,3975,17,57,18,63,4643
13217100506,4905,825,502,3313,17,62,2,35,4080
13217100507,4997,1264,246,3215,3,32,0,35,3733
13217100600,7269,2572,496,3604,12,149,9,114,4697
13217100701,2811,652,132,1877,3,34,2,13,2159
13217100702,3349,889,259,2016,1,16,5,21,2460
13217100801,5982,3475,336,1815,17,40,0,43,2507
13217100802,4559,3093,148,1087,7,20,2,17,1466
13217100902,6097,2133,574,3034,18,37,5,38,3964
13217100903,7253,2054,761,4045,15,72,8,30,5199
13217100904,5871,2367,261,2886,7,35,15,37,3504
13217100905,5499,2325,432,2412,4,51,4,28,3174
13219030101,1742,1574,64,18,0,28,0,2,168
13219030102,2356,1959,104,62,3,149,0,7,397
13219030103,2579,1937,213,219,2,92,0,16,642
13219030104,8351,6602,374,235,3,799,0,51,1749
13219030201,3390,2234,473,410,2,154,0,17,1156
13219030202,3307,2575,155,173,1,271,0,14,732
13219030300,6124,5197,284,180,8,257,0,20,927
13219030401,1545,1356,76,19,0,35,0,2,189
13219030402,6390,5282,319,340,7,167,0,28,1108
13219030500,2308,2053,99,74,4,10,0,7,255
13219030600,3707,3117,186,167,1,104,0,7,590
13221960100,1839,1321,78,304,0,71,0,9,518
13221960203,3452,2345,241,673,11,2,2,12,1107
13221960204,3367,2544,252,396,16,15,0,16,823
13221960205,2086,1747,110,108,7,28,1,6,339
13221960206,2540,1817,64,531,4,9,2,6,723
13221960300,1541,1129,124,236,2,9,0,4,412
13223120104,2996,2659,124,80,4,2,0,15,337
13223120105,7318,5678,383,806,7,136,4,42,1640
13223120106,2564,1822,188,331,4,56,0,28,742
13223120107,7109,4329,690,1448,12,235,5,42,2780
13223120108,8799,5452,696,2103,19,106,13,45,3347
13223120109,6525,4492,465,1088,30,104,3,51,2033
13223120110,7492,5618,515,935,24,97,3,34,1874
13223120111,6925,4951,447,1055,10,70,3,62,1974
13223120203,5414,4202,397,516,17,62,7,11,1212
13223120205,4557,2394,366,1492,17,64,8,30,2163
13223120206,3827,2238,303,1046,4,51,0,31,1589
13223120207,3099,2201,266,391,10,53,6,17,898
13223120208,4246,2504,285,1154,14,36,2,44,1742
13223120301,6732,3925,598,1800,10,73,0,44,2807
13223120303,1878,1350,97,328,9,14,3,8,528
13223120304,2183,1276,155,606,0,33,0,18,907
13223120305,3812,2230,284,1057,6,51,5,16,1582
13223120306,3966,1989,314,1386,16,67,2,31,1977
13223120307,4774,2225,498,1713,10,45,5,30,2549
13223120401,5802,4394,325,771,17,13,4,16,1408
13223120402,6067,5046,211,447,20,44,4,22,1021
13223120403,6476,4521,361,1167,10,42,2,43,1955
13223120503,4836,3469,316,787,11,37,0,30,1367
13223120504,3135,2246,231,452,7,27,2,17,889
13223120505,6393,4730,471,771,10,32,0,33,1663
13223120506,3725,2125,321,1047,8,39,1,53,1600
13223120507,4931,1438,525,2591,15,84,11,22,3493
13223120601,4817,1872,604,1994,10,60,2,47,2945
13223120603,5982,2909,672,2005,10,70,8,59,3073
13223120604,5506,3464,403,1312,9,33,0,36,2042
13223120605,5998,4456,329,877,6,19,0,26,1542
13223120606,4242,2819,173,997,6,36,0,33,1423
13223120607,6535,3420,551,2056,32,35,11,32,3115
13225040101,1666,1319,45,180,2,31,0,15,347
13225040103,5208,2996,199,1709,10,72,0,28,2212
13225040104,3163,2158,254,583,19,17,0,20,1005
13225040105,2897,2197,96,466,6,21,4,8,700
13225040200,4845,1609,985,2081,5,27,2,5,3236
13225040301,2906,990,722,1097,1,12,0,7,1916
13225040302,2101,442,134,1460,10,3,0,2,1659
13225040400,5195,408,112,4563,10,11,0,13,4787
13227050101,2487,2348,60,1,6,22,0,11,139
13227050102,3388,3153,77,9,11,18,0,7,235
13227050201,3855,3273,312,62,9,24,0,2,582
13227050202,3442,3075,145,59,15,16,0,6,367
13227050300,4666,4235,154,27,15,19,0,12,431
13227050400,3943,3650,85,17,6,25,2,5,293
13227050500,5058,4594,148,39,17,30,0,9,464
13227050601,4235,3815,153,58,5,30,2,11,420
13227050602,2142,1979,64,14,1,7,0,7,163
13229960100,2943,2445,160,233,4,11,0,6,498
13229960200,1705,1401,163,98,3,6,0,9,304
13229960301,3760,2619,183,801,10,14,0,13,1141
13229960302,3060,2679,122,154,3,14,0,5,381
13229960401,5854,5117,265,238,14,31,0,12,737
13229960402,2394,2142,105,73,7,6,0,0,252
13231010101,3357,2827,75,311,2,20,0,10,530
13231010102,4122,3489,107,348,10,17,0,12,633
13231010200,3903,3537,69,110,5,22,0,15,366
13231010300,3981,3307,53,478,8,1,0,18,674
13231010400,3526,3153,44,198,3,17,0,7,373
13233010100,5907,4874,193,551,11,16,6,32,1033
13233010201,5008,3193,1108,476,9,60,0,13,1815
13233010202,3469,2802,226,277,14,13,0,17,667
13233010300,4903,3218,1196,336,8,16,1,10,1685
13233010400,5849,3668,1412,531,18,18,8,19,2181
13233010500,5993,3691,1033,1021,15,27,4,19,2302
13233010600,5753,4348,179,882,13,43,0,17,1405
13233010700,5971,4367,238,1045,13,46,2,29,1604
13235950100,2711,1652,131,879,0,5,2,11,1059
13235950201,2744,1103,62,1475,6,30,1,13,1641
13235950202,3163,2364,104,555,1,40,0,21,799
13235950300,1237,903,30,252,1,17,0,3,334
13237960101,3377,2913,163,177,5,10,0,13,464
13237960103,2718,2147,175,280,1,25,0,2,571
13237960104,2935,2543,112,190,8,23,0,2,392
13237960201,1347,705,322,248,1,8,1,3,642
13237960203,3568,1549,376,1521,8,19,0,13,2019
13237960204,3214,629,220,2294,0,12,0,1,2585
13237960301,2805,2095,136,459,7,5,0,3,710
13237960302,2083,1735,53,216,3,6,0,3,348
13239960300,2235,1190,31,917,13,12,0,9,1045
13241970101,2202,1879,216,21,0,7,0,2,323
13241970102,1252,1075,138,5,3,5,0,0,177
13241970103,1722,1494,137,4,6,9,0,2,228
13241970201,3818,3146,471,19,9,16,1,13,672
13241970202,2859,2498,195,25,2,14,0,7,361
13241970302,1591,1413,115,17,5,4,0,7,178
13241970303,2358,2107,149,15,2,5,0,4,251
13241970304,1081,1013,31,1,1,0,0,0,68
13243790100,1579,787,24,729,1,0,1,4,792
13243790200,4846,1463,119,3133,8,21,2,19,3383
13245000100,3754,2156,146,1229,10,45,8,24,1598
13245000200,2679,924,85,1504,10,19,4,6,1755
13245000300,1105,324,24,656,7,1,0,11,781
13245000600,2254,662,66,1435,0,13,0,11,1592
13245000700,1155,146,19,934,2,17,2,3,1009
13245001000,2681,1191,156,1143,4,79,0,14,1490
13245001100,1725,1501,51,75,5,45,4,7,224
13245001200,4501,1915,173,2158,9,48,2,17,2586
13245001300,1261,431,32,730,0,16,0,9,830
13245001400,1194,74,22,1030,0,23,2,9,1120
13245001602,4022,2717,106,974,4,64,2,24,1305
13245001603,1504,434,82,888,4,24,6,4,1070
13245001604,3431,394,189,2626,14,75,6,15,3037
13245010101,2969,2217,121,341,8,107,8,21,752
13245010104,4512,1913,252,1899,8,241,6,19,2599
13245010105,4916,3231,271,964,8,152,8,22,1685
13245010107,2496,1181,103,974,5,112,0,7,1315
13245010108,2327,559,175,1424,6,68,8,12,1768
13245010109,3464,1955,199,981,0,143,8,22,1509
13245010201,5372,3883,197,864,4,140,10,21,1489
13245010203,4375,1256,330,2372,17,120,51,24,3119
13245010205,2192,812,154,1006,6,90,3,21,1380
13245010206,4940,2151,251,2031,11,207,7,29,2789
13245010207,5782,1637,369,3432,17,81,1,23,4145
13245010208,6392,1131,353,4255,17,290,12,38,5261
13245010300,4768,679,204,3700,5,27,3,19,4089
13245010400,3555,381,113,2941,15,6,0,3,3174
13245010506,4485,1193,165,2960,15,18,0,13,3292
13245010507,5765,1015,342,4135,5,50,10,27,4750
13245010508,3514,885,182,2253,5,33,2,10,2629
13245010509,4261,1318,152,2556,14,40,6,16,2943
13245010510,4976,1844,179,2758,4,46,0,23,3132
13245010511,3490,839,136,2368,5,8,0,16,2651
13245010512,4743,422,290,3811,9,42,2,10,4321
13245010513,3272,409,93,2594,3,27,7,6,2863
13245010514,3733,276,187,3102,10,29,3,7,3457
13245010515,3625,788,481,2152,9,32,3,11,2837
13245010601,2431,155,51,2154,2,7,0,11,2276
13245010602,2451,36,25,2315,1,6,3,8,2415
13245010706,6045,2125,349,3154,27,50,6,58,3920
13245010707,2914,254,97,2407,27,25,2,4,2660
13245010708,5584,707,263,4273,19,64,12,40,4877
13245010709,4929,283,237,4209,4,42,9,11,4646
13245010710,5743,1525,393,3438,30,89,32,20,4218
13245010711,3496,806,172,2296,10,50,21,12,2690
13245010713,5476,455,217,4506,11,116,19,13,5021
13245010714,3425,222,147,2828,9,43,11,11,3203
13245010801,2189,1012,405,434,8,65,24,23,1177
13245010802,6177,3303,1721,379,0,440,7,8,2874
13245010903,5019,2953,230,1524,33,19,9,16,2066
13245010904,3639,1586,137,1642,11,44,7,29,2053
13245010905,4841,3329,206,1005,16,15,10,25,1512
13245010907,2104,1194,87,657,6,22,10,18,910
13245010908,4559,2524,158,1591,12,53,10,11,2035
13245011000,1946,807,44,940,8,68,5,9,1139
13245011100,2449,277,60,1940,2,111,0,4,2172
13247060101,3605,1951,532,915,11,38,0,17,1654
13247060103,2265,1435,160,519,4,28,1,4,830
13247060104,3478,1260,290,1714,14,37,13,26,2218
13247060201,4703,755,2603,1179,0,21,1,23,3948
13247060203,5222,1183,396,3328,6,64,1,44,4039
13247060204,4698,1062,295,3027,5,140,4,34,3636
13247060305,5597,799,662,3807,6,74,26,35,4798
13247060306,4259,578,227,3203,8,47,7,29,3681
13247060310,2478,505,302,1528,11,40,1,15,1973
13247060311,3804,733,295,2594,6,40,0,18,3071
13247060312,4104,677,124,2953,7,179,3,18,3427
13247060313,3806,615,183,2763,8,90,2,33,3191
13247060314,3577,285,191,2865,9,89,1,16,3292
13247060315,3636,649,198,2618,2,33,1,23,2987
13247060316,4441,788,364,3068,10,55,0,28,3653
13247060317,4396,457,442,3298,3,35,0,16,3939
13247060318,2872,858,508,1323,12,40,1,9,2014
13247060403,3749,1443,136,1933,14,42,0,19,2306
13247060406,5509,2025,377,2694,7,136,0,47,3484
13247060407,3599,1542,319,1510,6,54,1,24,2057
13247060408,3484,1388,179,1714,5,34,0,18,2096
13247060409,3531,1340,156,1727,4,87,1,45,2191
13247060410,4709,1248,476,2687,10,66,8,37,3461
13247060411,2048,924,125,818,0,63,0,39,1124
13249960100,2560,1739,106,639,1,14,2,0,821
13249960200,1987,1618,69,224,3,6,0,7,369
13251970200,1670,958,15,613,14,3,0,2,712
13251970300,3458,1973,73,1288,5,34,0,7,1485
13251970401,1232,686,21,499,0,0,2,1,546
13251970402,3466,1822,51,1461,7,19,0,10,1644
13251970500,2542,1514,71,888,2,0,0,6,1028
13251970600,1699,1065,56,536,11,5,1,5,634
13253200100,3090,2553,75,322,5,2,0,11,537
13253200200,3452,1321,102,1907,1,59,0,9,2131
13253200300,2605,1743,51,732,0,0,0,5,862
13255160101,3885,3130,202,351,6,51,0,7,755
13255160102,2107,1248,355,365,4,15,0,10,859
13255160201,3372,2521,212,465,15,9,0,11,851
13255160202,4853,3354,239,1048,8,58,0,18,1499
13255160300,3122,735,106,2164,14,11,0,16,2387
13255160401,2446,726,131,1488,4,8,0,7,1720
13255160402,3672,866,353,2272,2,20,3,2,2806
13255160500,6830,2895,479,3015,20,176,9,22,3935
13255160600,3973,3384,156,218,11,18,0,10,589
13255160701,5087,1626,265,2890,3,104,3,24,3461
13255160702,2087,1209,105,677,0,7,1,8,878
13255160800,4038,784,238,2882,7,3,0,22,3254
13255160900,2625,1332,166,995,10,3,0,19,1293
13255161000,5828,4491,218,839,19,36,0,32,1337
13255161100,4117,3264,182,482,3,42,3,5,853
13255161201,4092,2656,136,1098,8,44,0,12,1436
13255161202,5172,2884,123,1899,20,35,4,22,2288
13257970101,3363,2380,115,643,15,42,0,17,983
13257970102,4270,3523,172,260,15,57,0,11,747
13257970201,1849,1700,35,21,1,7,0,3,149
13257970202,3843,3080,146,400,5,37,1,17,763
13257970301,3681,2359,108,969,9,20,3,6,1322
13257970302,3027,2403,87,353,13,26,2,15,624
13257970401,3470,3118,87,101,5,12,3,4,352
13257970402,3281,2760,107,189,10,24,0,3,521
13259950100,1846,576,22,1178,2,9,3,0,1270
13259950400,3468,762,1195,1283,8,158,2,8,2706
13261950100,1041,709,37,255,4,12,0,0,332
13261950200,5135,1327,319,3278,2,94,0,8,3808
13261950300,6362,1758,98,4310,5,36,1,9,4604
13261950400,2568,1483,114,881,7,13,0,2,1085
13261950500,3690,2115,233,1192,10,40,0,18,1575
13261950600,2059,789,160,1038,6,13,0,3,1270
13261950700,6640,2112,725,3376,6,287,3,9,4528
13261950800,2121,1235,84,721,0,8,0,6,886
13263960100,2293,1018,35,1187,1,3,0,6,1275
13263960200,1907,630,34,1208,3,7,0,0,1277
13263960300,1533,779,43,661,1,7,1,0,754
13265010200,1559,591,69,833,4,6,0,2,968
13267950100,3220,2306,260,552,8,5,0,2,914
13267950202,5986,2990,855,2022,5,14,0,9,2996
13267950203,2583,1197,188,1070,4,35,2,6,1386
13267950204,1721,1176,178,308,1,8,0,2,545
13267950300,4140,2605,313,1096,7,38,0,6,1535
13267950401,2296,1712,150,357,2,2,0,9,584
13267950402,2896,1839,359,556,9,25,4,12,1057
13269950100,1119,867,8,201,2,3,0,0,252
13269950200,2200,1216,61,852,18,2,0,9,984
13269950301,1900,1117,64,648,2,14,0,2,783
13269950302,2597,1384,35,1106,5,10,2,8,1213
13271950101,4700,1268,1634,1692,11,5,0,8,3432
13271950102,2072,593,74,1388,4,2,0,0,1479
13271950103,1875,1381,106,335,6,21,0,4,494
13271950200,1342,1131,55,133,1,0,0,0,211
13271950500,2488,1597,59,778,6,2,0,5,891
13273120200,1590,937,58,545,0,4,0,1,653
13273120300,2927,468,43,2334,6,13,0,0,2459
13273120400,3319,954,35,2215,5,39,1,8,2365
13273120500,1349,830,41,446,0,1,0,2,519
13275960100,1338,600,82,615,2,3,0,1,738
13275960200,3988,3220,108,523,29,23,0,9,768
13275960300,2394,1745,108,457,17,5,0,2,649
13275960400,2471,1822,79,480,17,10,1,10,649
13275960501,4695,2687,219,1540,14,67,0,10,2008
13275960502,2825,1902,90,652,3,57,0,10,923
13275960601,3568,2573,134,682,8,36,0,3,995
13275960602,2480,1206,110,983,2,94,0,5,1274
13275960701,3693,1382,95,2035,6,31,7,24,2311
13275960702,2548,631,62,1746,7,9,1,13,1917
13275960800,5536,2076,135,3128,12,50,0,13,3460
13275960900,3380,1783,90,1416,9,6,0,7,1597
13275961000,4246,3024,161,882,14,13,0,13,1222
13275961100,2636,1343,104,1120,10,2,0,4,1293
13277960100,2605,2203,180,166,0,14,0,0,402
13277960200,2758,2095,190,382,7,14,0,4,663
13277960301,4919,3101,322,1120,4,242,0,7,1818
13277960302,2435,1580,210,475,6,84,0,8,855
13277960401,4601,2565,705,1032,3,115,0,13,2036
13277960402,2392,973,454,860,4,27,0,4,1419
13277960500,4969,4015,415,319,7,45,0,16,954
13277960601,2654,497,441,1646,2,8,2,0,2157
13277960602,3246,271,426,2432,11,4,0,1,2975
13277960700,4798,1442,649,2517,6,40,0,31,3356
13277960800,2413,1235,903,213,2,12,0,3,1178
13277960900,3554,2212,324,887,4,45,0,4,1342
13279970101,2548,1276,503,683,1,15,1,4,1272
13279970102,2057,1228,235,515,5,5,0,9,829
13279970201,2551,1822,253,360,0,11,3,7,729
13279970202,3071,1362,80,1549,9,12,0,8,1709
13279970301,3221,1830,327,962,0,23,1,15,1391
13279970302,2591,1555,127,795,1,36,1,4,1036
13279970400,4132,2004,255,1638,10,96,0,20,2128
13279970500,3748,2475,838,311,0,6,0,12,1273
13279970600,3111,2455,426,167,5,3,0,0,656
13281960100,4785,4299,180,112,9,33,2,27,486
13281960200,3158,2932,81,6,7,27,0,4,226
13281960301,1938,1805,64,5,4,8,0,1,133
13281960302,2612,2433,90,1,8,13,1,3,179
13283960100,1234,1083,47,70,5,0,0,0,151
13283960200,5172,2982,123,1929,14,7,0,7,2190
13285960101,3339,2238,77,856,11,29,0,4,1101
13285960102,3058,1987,173,710,9,11,2,14,1071
13285960201,2979,2341,93,380,3,44,3,7,638
13285960202,2524,2010,58,310,8,48,3,7,514
13285960300,4347,3647,200,291,2,61,3,15,700
13285960401,3502,1850,162,1302,4,57,2,14,1652
13285960402,3565,1746,154,1341,2,182,2,15,1819
13285960501,4890,1751,437,2403,4,102,8,15,3139
13285960503,5364,2249,251,2282,26,382,3,34,3115
13285960504,2695,1490,100,898,7,122,0,8,1205
13285960600,5335,1813,171,3160,2,45,0,3,3522
13285960700,5506,2495,188,2332,8,284,0,27,3011
13285960800,3173,871,275,1905,3,8,1,7,2302
13285960901,4158,1232,260,2416,6,97,4,32,2926
13285960903,3582,2756,126,488,6,49,0,5,826
13285960904,3078,2289,60,580,8,34,0,10,789
13285961000,5574,2927,116,2300,17,44,5,15,2647
13285961100,2757,2407,55,203,1,9,0,7,350
13287970201,3545,984,105,2381,2,3,0,3,2561
13287970202,2144,1165,133,742,1,35,0,9,979
13287970300,3317,2551,134,521,4,11,0,13,766
13289060101,2376,1908,48,296,8,11,0,7,468
13289060102,2212,860,39,1252,4,20,0,1,1352
13289060200,3434,1719,37,1551,4,6,0,10,1715
13291000101,3255,3008,126,3,16,12,0,13,247
13291000103,3056,2841,83,12,5,9,0,0,215
13291000104,3164,2914,95,25,9,14,0,0,250
13291000201,3050,2832,82,6,4,10,0,4,218
13291000203,2366,2188,59,5,9,8,0,14,178
13291000204,3593,3316,126,14,12,10,0,3,277
13291000206,3835,3388,184,58,13,22,0,15,447
13291000207,2313,2159,61,3,6,15,0,14,154
13293010100,3118,2662,71,268,9,7,0,12,456
13293010201,4727,2937,129,1431,5,61,0,12,1790
13293010202,2768,2448,49,158,8,9,0,9,320
13293010300,3776,3271,54,237,17,22,0,24,505
13293010401,2012,905,33,1008,4,8,0,15,1107
13293010402,4645,2899,122,1426,7,18,0,12,1746
13293010500,5404,2278,163,2727,13,23,1,19,3126
13293010600,1250,609,12,596,0,3,0,3,641
13295020101,4357,3810,126,197,9,26,0,13,547
13295020102,2726,2322,57,185,15,10,1,5,404
13295020200,3647,2863,197,387,17,14,3,6,784
13295020301,5148,4300,249,330,11,27,1,24,848
13295020302,5207,4663,127,105,12,7,3,12,544
13295020400,3080,2873,49,13,4,9,0,14,207
13295020503,4329,3962,72,88,11,24,0,10,367
13295020504,3164,2806,59,150,11,9,1,11,358
13295020505,2925,2672,58,53,8,5,0,9,253
13295020506,4091,3702,80,77,1,10,3,28,389
13295020601,7186,6422,186,287,0,50,2,20,764
13295020602,4360,3848,97,160,8,17,0,9,512
13295020701,2599,2244,51,129,18,34,0,8,355
13295020702,4418,3718,88,352,12,23,5,15,700
13295020800,3110,2749,36,173,4,13,4,14,361
13295020902,2054,1859,64,53,0,11,0,0,195
13295020903,2472,2280,55,25,3,2,2,2,192
13295020904,2781,2561,34,76,5,2,0,4,220
13297110101,4711,4110,173,186,11,74,5,23,601
13297110102,4706,3581,251,424,12,264,0,26,1125
13297110200,5725,4859,207,422,9,36,1,15,866
13297110301,3381,2025,119,1057,14,14,6,26,1356
13297110302,4257,1829,214,1948,6,23,1,25,2428
13297110400,7494,3641,362,3033,15,91,0,49,3853
13297110503,3864,3042,180,357,4,46,0,26,822
13297110504,5678,3390,777,1092,5,152,0,46,2288
13297110505,4879,3656,385,581,21,40,1,42,1223
13297110506,5891,4440,479,611,7,80,1,45,1451
13297110508,5021,3610,204,925,13,80,7,7,1411
13297110509,5454,2554,439,2016,14,149,3,55,2900
13297110510,3147,2530,179,237,1,36,1,34,617
13297110601,5451,4584,192,369,6,46,10,21,867
13297110602,5785,5117,174,230,12,65,0,16,668
13297110603,5749,4536,344,463,11,70,7,34,1213
13297110701,3610,2698,146,584,10,61,1,8,912
13297110702,4278,3017,200,842,4,24,0,24,1261
13297110801,4267,2968,107,969,8,28,0,27,1299
13297110802,3325,2312,96,790,5,30,0,3,1013
13299950100,1550,1423,32,41,7,5,2,0,127
13299950200,7682,5703,285,1479,13,20,1,24,1979
13299950300,2266,1521,134,537,1,13,2,8,745
13299950400,1839,151,40,1550,0,8,1,11,1688
13299950500,5353,2992,174,1893,12,66,0,26,2361
13299950600,5895,4047,208,1201,19,178,2,21,1848
13299950700,1530,274,56,1132,2,9,0,5,1256
13299950801,3151,2542,260,253,6,13,0,8,609
13299950802,3163,985,203,1809,9,5,6,1,2178
13299950900,3822,2637,220,808,8,16,4,8,1185
13301970400,2703,970,27,1630,4,10,0,8,1733
13301970500,2512,1004,26,1417,14,5,1,2,1508
13303950100,1693,1157,21,481,0,1,0,1,536
13303950300,4826,1841,83,2748,2,32,0,15,2985
13303950400,4830,1596,75,3019,6,26,0,3,3234
13303950500,4901,2444,121,2228,23,7,0,0,2457
13303950700,3738,1374,34,2222,6,10,0,11,2364
13305970100,4526,4036,122,189,9,18,0,16,490
13305970201,3642,2978,206,318,6,20,1,6,664
13305970202,4314,2678,311,1119,4,23,0,13,1636
13305970300,5034,2988,311,1530,8,24,0,25,2046
13305970400,3545,2975,133,310,6,6,0,17,570
13305970500,4660,2208,410,1818,19,59,0,25,2452
13305970600,4423,3438,239,593,6,24,1,28,985
13307960100,1215,549,28,592,0,2,5,3,666
13307960200,1133,587,31,471,0,10,1,0,546
13309780100,2652,1797,79,672,6,4,0,4,855
13309780200,4819,2360,193,2203,3,13,0,2,2459
13311950101,1368,1230,41,19,3,5,0,3,138
13311950102,1309,1173,19,31,2,25,0,2,136
13311950202,3380,3030,82,22,12,25,0,6,350
13311950204,2750,2522,59,22,4,22,0,18,228
13311950205,2486,2277,44,21,13,7,0,11,209
13311950206,4604,3763,229,277,23,31,0,48,841
13311950207,4507,4000,220,34,25,19,0,10,507
13311950301,3830,3516,100,19,8,15,0,13,314
13311950302,3769,3448,119,22,15,10,0,5,321
13313000101,4184,3684,279,27,10,23,0,11,500
13313000103,4279,3005,946,148,8,37,2,20,1274
13313000104,4398,3718,331,98,8,56,1,19,680
13313000200,4294,3186,891,63,12,12,0,10,1108
13313000301,4463,2081,2077,117,6,68,1,15,2382
13313000303,4313,2385,1553,183,1,77,0,8,1928
13313000304,4311,2745,1309,73,7,50,1,14,1566
13313000401,6679,1290,4878,376,8,26,0,12,5389
13313000402,1893,748,1016,74,2,17,0,0,1145
13313000501,3697,2572,598,170,9,174,1,15,1125
13313000502,7296,3084,3291,576,11,104,4,32,4212
13313000600,3981,3275,485,69,1,25,0,3,706
13313000700,4646,3950,412,101,13,15,0,15,696
13313000801,2571,2041,347,11,11,37,3,7,530
13313000802,4779,3779,487,185,7,168,1,13,1000
13313000900,3762,2297,1117,142,2,87,2,20,1465
13313001000,3896,605,2987,253,3,11,0,5,3291
13313001100,4579,2164,2183,116,13,3,1,6,2415
13313001200,7643,2798,4227,339,8,92,0,26,4845
13313001300,4462,908,3288,165,7,8,0,10,3554
13313001400,6238,3230,2442,161,13,228,0,14,3008
13313001500,6500,4330,1772,106,22,76,2,29,2170
13315960100,3748,1743,100,1844,1,10,0,0,2005
13315960200,1352,908,38,379,0,3,1,2,444
13315960300,1398,1103,77,144,2,21,2,4,295
13315960400,2268,1431,57,729,0,15,0,3,837
13317010101,1541,963,46,474,1,6,0,2,578
13317010102,1644,1059,159,355,2,17,0,5,585
13317010301,1968,1390,53,439,11,19,0,6,578
13317010302,4412,1540,141,2570,8,17,0,5,2872
13319960200,2924,1272,138,1419,7,8,0,0,1652
13319960300,4087,2504,72,1332,13,13,1,10,1583
13319960400,1866,1334,29,412,10,1,2,3,532
13321950100,3264,2606,42,523,4,1,0,7,658
13321950201,2277,1724,80,412,10,8,1,4,553
13321950202,4292,2571,73,1465,4,54,5,14,1721
13321950400,4369,3419,97,659,14,8,0,11,950
13321950500,4239,2058,68,2011,6,5,2,8,2181
13321950600,2343,2049,21,185,11,11,0,9,294
15001020100,5433,1479,514,19,9,1535,728,35,3954
15001020202,2035,495,239,16,3,528,132,6,1540
15001020300,3822,1003,484,43,8,741,611,30,2819
15001020400,3517,650,482,31,3,796,665,15,2867
15001020500,5944,1044,756,58,18,1360,1273,29,4900
15001020600,5631,612,533,16,6,838,1688,19,5019
15001020701,4811,480,496,19,3,2091,453,12,4331
15001020702,4647,464,465,19,2,2142,342,5,4183
15001020801,4365,624,539,11,2,1435,350,4,3741
15001020802,6544,1181,690,30,12,2258,550,15,5363
15001020900,4802,687,600,4,7,1679,444,13,4115
15001021003,7423,1994,1091,44,16,1204,1177,34,5429
15001021011,4388,1326,638,18,15,541,632,26,3062
15001021013,4820,742,609,20,3,1636,553,11,4078
15001021014,8402,2557,1097,63,33,1569,1000,46,5845
15001021015,6080,2134,895,40,31,811,681,36,3946
15001021016,5525,2540,610,56,26,319,729,48,2985
15001021017,4572,2068,549,46,37,211,611,44,2504
15001021101,2793,1668,219,27,21,226,204,21,1125
15001021107,1365,588,162,3,8,126,243,9,777
15001021108,6336,2254,951,60,48,704,832,66,4082
15001021203,6111,2334,619,56,47,833,1159,45,3777
15001021204,2868,1254,265,19,2,493,291,13,1614
15001021300,5913,2614,560,46,20,603,831,20,3299
15001021402,3876,970,429,20,26,1203,319,20,2906
15001021502,5432,2536,531,18,14,574,544,48,2896
15001021504,5932,1109,619,15,16,817,1854,25,4823
15001021510,3550,1790,312,8,7,444,499,10,1760
15001021511,1568,667,158,10,8,257,177,7,901
15001021512,4531,1957,417,34,15,744,466,24,2574
15001021513,6109,2732,650,29,14,721,635,29,3377
15001021605,3787,1626,444,26,8,667,386,28,2161
15001021606,4120,1859,311,34,7,791,394,32,2261
15001021607,4452,2397,400,19,21,731,223,16,2055
15001021608,3832,1831,380,38,18,588,312,19,2001
15001021705,6366,2065,601,13,16,1007,772,50,4301
15001021706,3795,909,305,8,7,582,830,4,2886
15001021707,4997,1881,546,25,9,770,659,13,3116
15001021708,4152,2307,345,17,24,550,352,23,1845
15001021800,6979,2347,910,28,26,1137,862,24,4632
15001021902,4212,1136,368,25,11,1130,404,19,3076
15001022000,2678,942,248,13,13,526,194,4,1736
15001022102,2114,835,238,15,9,433,124,3,1279
15001990000,0,0,0,0,0,0,0,0,0
15001990100,0,0,0,0,0,0,0,0,0
15001990300,0,0,0,0,0,0,0,0,0
15001990400,0,0,0,0,0,0,0,0,0
15001990500,0,0,0,0,0,0,0,0,0
15001990600,0,0,0,0,0,0,0,0,0
15001990700,0,0,0,0,0,0,0,0,0
15001990800,0,0,0,0,0,0,0,0,0
15001990900,0,0,0,0,0,0,0,0,0
15001991000,0,0,0,0,0,0,0,0,0
15001991100,0,0,0,0,0,0,0,0,0
15001991200,0,0,0,0,0,0,0,0,0
15001991300,0,0,0,0,0,0,0,0,0
15001991400,0,0,0,0,0,0,0,0,0
15001991500,0,0,0,0,0,0,0,0,0
15001991600,0,0,0,0,0,0,0,0,0
15001991700,0,0,0,0,0,0,0,0,0
15003000107,2740,652,173,0,0,1177,71,3,2088
15003000108,3213,1194,187,25,2,1143,82,8,2019
15003000110,4254,1086,269,34,2,1804,133,0,3168
15003000114,1726,731,84,2,0,538,32,12,995
15003000115,2774,731,162,24,0,1237,105,12,2043
15003000116,2500,769,172,27,0,1075,56,4,1731
15003000117,1464,340,112,20,1,637,36,10,1124
15003000118,1771,422,101,10,2,828,47,7,1349
15003000119,2195,294,99,6,0,1182,76,1,1901
15003000120,2624,503,121,10,0,1332,67,0,2121
15003000121,2774,933,154,34,6,1064,68,8,1841
15003000122,3112,280,199,7,2,1787,128,10,2832
15003000200,5745,1026,330,38,3,2644,262,29,4719
15003000301,3608,745,141,18,4,1857,85,21,2863
15003000302,2702,510,159,7,0,1334,57,8,2192
15003000401,2758,650,94,1,2,1488,45,16,2108
15003000402,4147,840,157,10,0,2508,56,9,3307
15003000500,3872,1073,178,9,1,1842,127,19,2799
15003000600,1276,394,45,6,1,567,31,8,882
15003000700,3215,356,151,11,2,2012,99,11,2859
15003000800,3770,542,199,21,0,2164,174,15,3228
15003000901,2622,420,115,4,0,1495,65,8,2202
15003000903,3039,440,158,22,4,1701,173,9,2599
15003000904,1975,520,126,10,6,884,76,4,1455
15003000905,2357,716,130,17,2,951,71,10,1641
15003001000,3145,640,211,21,1,1439,130,8,2505
15003001101,1961,122,106,7,1,624,781,3,1839
15003001102,2249,195,114,14,8,829,693,7,2054
15003001201,3022,356,176,26,0,1718,213,8,2666
15003001202,3254,414,223,24,1,1785,134,9,2840
15003001300,4437,546,248,33,4,2536,233,22,3891
15003001400,2655,374,153,20,0,1533,109,3,2281
15003001501,1473,147,81,9,0,910,69,3,1326
15003001502,2334,322,137,8,5,1270,137,8,2012
15003001601,1981,363,137,11,0,956,97,16,1618
15003001602,1784,323,103,7,0,942,80,5,1461
15003001700,2333,1197,143,11,4,516,81,29,1136
15003001801,1119,460,79,27,8,311,88,3,659
15003001803,2911,1116,244,79,4,990,112,21,1795
15003001804,1785,717,118,30,0,637,45,7,1068
15003001901,423,226,42,7,0,108,6,0,197
15003001905,1377,621,99,27,3,447,20,2,756
15003001906,2877,1010,131,75,11,1261,55,21,1867
15003001907,2546,1035,186,61,7,924,62,25,1511
15003002003,2126,719,166,60,6,939,50,8,1407
15003002004,1140,402,81,33,1,499,14,9,738
15003002005,1899,648,164,74,1,649,96,10,1251
15003002006,2267,736,169,53,9,962,93,18,1531
15003002101,1746,236,142,22,0,836,187,3,1510
15003002102,1839,265,202,31,1,759,256,6,1574
15003002203,1836,367,107,36,7,975,63,14,1469
15003002204,1308,268,117,29,2,602,84,0,1040
15003002205,1888,314,90,23,0,1048,170,7,1574
15003002206,1961,216,192,42,4,763,393,9,1745
15003002301,3293,489,244,26,3,1713,285,2,2804
15003002302,2087,234,190,32,2,1061,240,4,1853
15003002401,2912,333,220,45,5,1569,296,10,2579
15003002403,1567,156,105,8,5,857,176,6,1411
15003002404,1423,187,81,8,0,767,157,0,1236
15003002500,3941,479,260,57,7,2187,424,13,3462
15003002600,4174,510,302,64,5,2072,513,5,3664
15003002701,4078,1261,386,178,6,1109,433,2,2817
15003002702,4705,821,371,63,1,2225,259,40,3884
15003002801,1778,318,100,15,3,923,81,12,1460
15003002802,2353,647,147,16,3,1025,63,14,1706
15003002900,2251,526,88,17,3,1186,36,9,1725
15003003000,4305,924,235,19,3,2145,87,18,3381
15003003102,3345,437,123,6,1,2098,59,9,2908
15003003103,1567,152,49,2,0,1071,41,0,1415
15003003104,2175,527,113,19,0,1025,41,12,1648
15003003404,4517,807,291,55,0,2304,391,17,3710
15003003408,2256,256,153,24,1,1181,251,1,2000
15003003409,1901,225,181,50,1,923,160,11,1676
15003003410,1482,163,113,28,0,697,248,4,1319
15003003411,1231,249,92,27,2,555,77,8,982
15003003412,1618,359,100,15,5,762,121,7,1259
15003003413,2532,420,227,46,3,1198,175,0,2112
15003003414,4118,854,284,55,8,1921,277,13,3264
15003003501,2286,369,163,35,8,1164,159,7,1917
15003003503,1500,124,80,33,6,740,278,8,1376
15003003504,2712,329,112,42,1,1843,78,0,2383
15003003603,3181,274,162,40,3,1996,303,9,2907
15003003604,2554,273,91,32,0,1833,80,8,2281
15003003605,1036,118,64,13,0,521,135,7,918
15003003606,3058,537,176,50,4,1692,175,7,2521
15003003701,2522,521,113,42,2,1557,38,4,2001
15003003702,3929,801,169,42,1,2393,76,13,3128
15003003703,3457,760,147,56,1,1942,108,13,2697
15003003801,4909,855,315,70,7,2728,169,7,4054
15003003802,5114,888,252,47,1,3137,85,7,4226
15003003900,559,172,64,23,4,165,47,4,387
15003004000,1627,510,92,56,7,647,83,8,1117
15003004101,1618,274,155,17,8,651,174,5,1344
15003004102,2438,360,187,43,5,1101,315,4,2078
15003004201,1602,237,84,27,0,972,66,5,1365
15003004202,1922,417,117,25,0,942,83,0,1505
15003004301,2273,558,179,28,3,872,131,16,1715
15003004302,3313,333,312,44,8,1361,650,9,2980
15003004401,2536,193,150,14,4,1437,159,0,2343
15003004402,2550,173,201,4,0,684,654,2,2377
15003004500,5360,1016,312,33,5,2823,214,20,4344
15003004600,3883,381,162,21,1,2418,162,7,3502
15003004701,2305,277,121,16,0,1207,130,13,2028
15003004702,2477,235,95,13,3,1545,204,5,2242
15003004801,3079,154,132,15,0,1997,246,5,2925
15003004802,3873,224,182,18,0,2465,419,2,3649
15003004900,3351,142,173,18,0,2183,338,9,3209
15003005000,4106,324,245,32,1,2544,378,8,3782
15003005100,2905,396,113,34,3,2077,30,6,2509
15003005200,3001,302,124,60,11,1909,310,8,2699
15003005300,4302,282,307,59,5,1876,1146,15,4020
15003005400,1545,3,77,0,0,331,965,2,1542
15003005500,2157,49,81,3,0,1600,265,2,2108
15003005601,1808,33,70,10,0,1355,211,2,1775
15003005602,5124,48,113,8,0,4069,459,5,5076
15003005700,2483,382,169,76,5,1175,405,15,2101
15003005800,3322,47,165,8,0,2295,468,5,3275
15003005900,2994,278,114,84,2,1161,541,2,2716
15003006000,5661,47,146,17,5,4699,433,5,5614
15003006100,4517,64,165,23,2,3709,183,0,4453
15003006202,2705,40,83,9,0,506,1690,10,2665
15003006203,6425,98,208,26,4,3722,1812,0,6327
15003006301,4068,130,96,18,4,2902,416,4,3938
15003006302,3152,58,145,12,1,853,1758,1,3094
15003006401,2362,43,65,4,1,1930,132,0,2319
15003006402,6393,292,412,31,3,4209,618,6,6101
15003006500,4694,424,293,54,1,2733,451,7,4270
15003006703,1725,385,138,28,0,815,67,1,1340
15003006704,7162,1074,648,329,7,3452,425,23,6088
15003006806,1758,57,74,6,1,1312,50,2,1701
15003006810,2374,969,483,319,7,185,139,2,1405
15003006811,1047,432,223,176,6,88,49,4,615
15003006812,1363,88,54,17,0,925,50,0,1275
15003006813,4680,402,231,49,0,3080,200,10,4278
15003006814,2442,147,155,30,4,1468,273,8,2295
15003006815,2165,178,217,43,1,1130,224,11,1987
15003006816,2411,100,138,23,1,1652,181,2,2311
15003006817,4809,200,219,33,3,3205,480,10,4609
15003006818,1695,181,125,38,0,1029,82,2,1514
15003006819,2646,214,205,59,0,1535,174,0,2432
15003006900,3879,1800,608,547,9,332,97,24,2079
15003007001,1565,690,287,241,9,138,57,6,875
15003007002,2163,1126,383,248,16,148,44,6,1037
15003007100,3060,1423,578,350,9,194,98,28,1637
15003007302,4172,2444,597,268,9,250,65,19,1728
15003007400,7651,4674,1339,561,18,590,28,28,2977
15003007504,3372,106,342,33,1,1140,1137,5,3266
15003007507,6626,766,399,82,6,3224,361,11,5860
15003007508,6994,1139,526,244,1,3498,450,5,5855
15003007701,4921,684,324,63,5,2878,234,16,4237
15003007702,5487,713,396,49,8,2972,235,14,4774
15003007804,2005,65,100,10,0,1362,130,0,1940
15003007807,5292,753,499,249,1,2545,265,5,4539
15003007808,3459,305,332,59,0,1706,350,3,3154
15003007809,3384,261,190,49,1,2261,96,1,3123
15003007812,2164,195,242,45,1,976,175,5,1969
15003007813,2880,182,202,42,0,1538,189,0,2698
15003007814,3416,245,155,57,0,2355,72,1,3171
15003007815,2034,246,134,28,2,1166,65,0,1788
15003007816,3443,503,288,60,0,1765,164,12,2940
15003007817,1631,136,96,13,0,923,78,2,1495
15003008001,2664,174,235,33,4,1100,584,20,2490
15003008002,2897,118,199,13,0,1810,203,6,2779
15003008005,6997,639,701,40,6,3144,576,19,6358
15003008008,1655,420,234,63,4,459,143,1,1235
15003008009,2760,286,306,70,2,1201,272,8,2474
15003008010,2439,74,164,11,1,1593,164,0,2365
15003008011,2697,124,180,21,0,1667,161,13,2573
15003008012,2933,108,180,6,0,2015,141,3,2825
15003008013,2634,70,126,1,0,1924,48,2,2564
15003008301,4553,1730,907,300,9,363,477,33,2823
15003008302,7253,271,569,26,1,4336,737,29,6982
15003008405,4988,413,542,101,0,2556,382,4,4575
15003008407,3778,792,521,177,12,1276,191,23,2986
15003008408,9057,2886,1311,583,9,2189,337,37,6171
15003008410,6931,826,748,226,10,3345,318,19,6105
15003008411,3609,423,418,59,13,1643,235,6,3186
15003008413,3400,168,243,23,5,2264,212,7,3232
15003008414,2168,328,288,71,3,896,105,9,1840
15003008415,4275,505,511,151,3,1766,250,22,3770
15003008416,2217,186,251,51,0,1036,148,3,2031
15003008417,3661,487,454,99,1,1458,312,19,3174
15003008418,5762,674,629,64,2,2506,745,1,5088
15003008502,2364,555,326,161,9,280,452,17,1809
15003008609,2179,479,252,60,4,806,180,10,1700
15003008610,1240,751,120,57,2,172,19,4,489
15003008611,62,17,17,0,0,6,10,0,45
15003008623,4408,404,437,78,3,1448,631,11,4004
15003008624,3069,309,297,52,3,1666,148,10,2760
15003008625,4032,144,466,17,1,2534,243,7,3888
15003008626,3973,222,435,48,2,1801,338,8,3751
15003008627,9793,1495,1307,377,4,2959,1147,14,8298
15003008628,3847,327,390,47,0,1679,445,14,3520
15003008629,2110,204,293,42,0,783,269,4,1906
15003008630,2779,523,456,67,5,644,331,20,2256
15003008631,3226,797,496,116,10,955,176,20,2429
15003008632,5317,555,611,70,10,1989,563,14,4762
15003008633,2726,507,431,94,11,772,201,10,2219
15003008634,2800,486,535,62,9,673,288,14,2314
15003008702,6490,147,276,33,3,4989,506,2,6343
15003008704,3331,81,178,14,4,2438,239,0,3250
15003008705,3250,62,198,44,1,872,1742,0,3188
15003008706,3650,181,364,28,4,1692,805,5,3469
15003008707,6985,103,212,12,1,5877,249,2,6882
15003008801,4056,60,152,13,0,3394,120,4,3996
15003008802,5304,141,232,33,3,3970,425,28,5163
15003008906,4026,592,429,71,4,1644,184,25,3434
15003008909,3820,404,475,68,9,1662,179,11,3416
15003008912,3103,57,135,8,0,2418,159,0,3046
15003008913,5128,136,256,8,1,3739,308,0,4992
15003008917,4579,503,361,65,2,2382,137,10,4076
15003008918,5529,806,623,108,10,2227,269,22,4723
15003008921,3121,107,230,12,1,2045,229,0,3014
15003008926,1742,476,330,108,1,377,66,4,1266
15003008928,4102,438,356,75,2,1994,133,8,3664
15003008929,4906,581,456,84,6,2442,151,6,4325
15003008930,2416,271,137,34,0,1470,50,9,2145
15003008931,3224,455,252,28,0,1566,36,1,2769
15003008932,2645,300,249,24,0,1225,116,1,2345
15003008933,3223,430,304,26,0,1516,92,3,2793
15003008934,3526,383,248,51,0,1983,187,6,3143
15003008935,3931,351,440,115,3,1724,571,8,3580
15003008936,3275,121,193,17,0,2196,216,6,3154
15003008937,1737,38,68,5,0,1360,143,0,1699
15003008938,3242,106,242,68,9,1688,781,0,3136
15003008939,2595,601,446,155,4,636,165,11,1994
15003008940,2936,232,309,46,4,1198,313,6,2704
15003008941,1934,300,196,18,1,817,105,9,1634
15003008942,2370,249,337,45,2,735,267,1,2121
15003008943,1372,109,109,17,3,787,39,2,1263
15003008944,3517,406,440,91,2,1537,123,8,3111
15003008945,1436,126,146,31,1,618,78,0,1310
15003008946,2910,296,251,34,1,1514,182,3,2614
15003008947,1846,178,165,9,0,1070,68,1,1668
15003008948,2839,207,284,36,2,1437,147,1,2632
15003008949,1540,189,124,27,0,897,33,3,1351
15003008950,2068,87,129,19,1,1335,158,2,1981
15003008951,2101,102,96,14,0,1470,115,2,1999
15003008952,6000,645,542,129,3,3176,241,27,5355
15003009000,2412,1214,586,266,4,85,59,18,1198
15003009100,5684,528,541,31,3,3158,425,8,5156
15003009201,3423,382,556,59,5,1103,298,4,3041
15003009202,2762,282,282,21,1,1147,245,6,2480
15003009203,2260,145,302,22,0,1050,179,5,2115
15003009301,1575,96,259,34,5,340,480,1,1479
15003009302,3324,257,372,39,0,1613,346,2,3067
15003009401,1471,229,127,68,4,597,120,3,1242
15003009402,3843,277,590,77,16,1103,895,8,3566
15003009507,2734,1364,731,338,3,100,77,36,1370
15003009508,991,410,252,194,5,44,19,5,581
15003009509,2643,1115,637,393,11,121,95,21,1528
15003009510,1255,519,347,224,2,42,31,2,736
15003009511,2546,1009,687,385,7,89,129,6,1537
15003009512,4735,2579,1185,481,5,179,79,58,2156
15003009608,5664,256,756,37,16,1005,1832,21,5408
15003009609,5070,739,791,116,3,791,929,7,4331
15003009610,7105,517,1094,65,14,1475,1750,17,6588
15003009704,3553,274,499,40,6,725,980,11,3279
15003009705,3640,314,560,62,9,758,822,8,3326
15003009706,3196,155,424,10,0,275,1057,9,3041
15003009707,6575,543,1150,66,12,616,2149,16,6032
15003009801,3805,1053,491,179,27,387,693,36,2752
15003009803,2825,464,478,29,5,272,721,3,2361
15003009804,3660,337,722,60,0,402,847,11,3323
15003009902,3998,985,405,23,12,1221,325,7,3013
15003009905,3879,994,427,11,2,1336,185,17,2885
15003009906,1921,1088,213,18,1,176,53,21,833
15003010000,3768,1531,729,363,31,351,188,30,2237
15003010101,2892,1623,261,9,9,278,143,29,1269
15003010102,2414,1292,193,6,10,250,146,37,1122
15003010103,3292,510,225,11,4,647,992,12,2782
15003010202,7391,1602,377,28,11,988,2543,25,5789
15003010203,1381,390,100,6,5,172,264,4,991
15003010204,2836,541,283,13,0,169,803,10,2295
15003010205,1693,550,178,23,0,137,226,5,1143
15003010303,5036,1000,512,22,0,856,774,31,4036
15003010305,5356,1152,575,27,11,1331,509,15,4204
15003010308,3427,314,224,25,4,1698,249,13,3113
15003010309,3897,993,325,35,5,1176,308,12,2904
15003010310,2497,441,277,19,5,696,182,7,2056
15003010503,2263,461,214,22,0,696,205,2,1802
15003010505,3527,633,270,13,5,1382,235,11,2894
15003010507,5510,811,783,42,12,1466,723,7,4699
15003010508,2748,1045,253,24,2,623,201,18,1703
15003010509,2087,142,280,4,1,572,348,2,1945
15003010510,3273,488,329,32,1,1010,421,2,2785
15003010601,3921,397,449,15,3,1383,443,6,3524
15003010602,5986,915,524,33,0,2404,424,10,5071
15003010701,4397,1847,370,35,16,1052,167,14,2550
15003010702,3832,465,273,15,5,1779,221,13,3367
15003010901,3256,1697,297,26,3,403,150,12,1559
15003010903,4157,1420,487,30,1,687,285,18,2737
15003010904,3803,1562,334,42,8,502,304,28,2241
15003010905,2630,883,266,23,2,502,212,20,1747
15003011000,3697,1271,235,20,6,963,179,43,2426
15003011103,4212,1183,325,22,5,1189,217,11,3029
15003011104,5089,1824,410,22,4,1061,328,22,3265
15003011105,3664,1943,342,45,5,429,159,19,1721
15003011106,6143,2061,513,46,1,1523,369,45,4082
15003011201,4611,2761,347,14,5,407,136,41,1850
15003011202,1676,1103,108,4,1,123,48,4,573
15003011300,6057,650,587,23,5,1157,1746,13,5407
15003011401,1759,717,337,237,3,200,57,15,1042
15003011500,11046,1186,1555,364,15,3267,1462,43,9860
15003011600,2023,483,114,4,2,758,185,17,1540
15003940003,2509,433,218,6,2,120,904,9,2076
15003940004,2331,74,208,1,1,57,1196,2,2257
15003940005,2367,28,240,5,0,73,1058,0,2339
15003940006,2446,27,254,5,0,43,1221,3,2419
15003940007,2059,89,237,27,1,137,992,3,1970
15003980000,0,0,0,0,0,0,0,0,0
15003980200,304,57,32,16,1,109,2,0,247
15003980300,16,2,6,2,0,2,2,0,14
15003980600,9,1,3,2,0,1,0,0,8
15003980700,0,0,0,0,0,0,0,0,0
15003980800,3,0,2,0,0,0,0,0,3
15003981000,30,3,3,0,0,5,5,0,27
15003981100,167,91,45,21,1,4,1,2,76
15003981200,0,0,0,0,0,0,0,0,0
15003981300,252,76,87,17,0,19,17,5,176
15003981400,96,44,24,5,0,8,0,0,52
15003981700,2841,1663,675,199,9,102,33,30,1178
15003981801,2402,1428,578,135,2,84,5,24,974
15003981802,948,630,211,24,1,18,5,2,318
15003981803,3292,1866,920,263,10,89,46,42,1426
15003981900,349,228,62,15,2,25,0,1,121
15003982000,1060,658,119,80,5,81,10,2,402
15003982100,1,1,0,0,0,0,0,0,0
15003982200,31,1,5,0,0,4,7,2,30
15003990001,0,0,0,0,0,0,0,0,0
15005031900,82,27,18,0,0,9,15,4,55
15005990000,0,0,0,0,0,0,0,0,0
15007040104,1557,970,102,1,12,92,155,7,587
15007040105,4393,2386,387,23,9,693,187,30,2007
15007040106,2157,1636,153,15,1,113,26,18,521
15007040204,5735,2461,608,31,14,831,493,47,3274
15007040205,4069,1425,502,27,11,956,253,10,2644
15007040301,6843,1723,836,36,19,2156,598,19,5120
15007040302,2127,658,261,21,7,450,302,13,1469
15007040401,7324,1017,594,32,10,3465,727,22,6307
15007040402,3158,574,223,15,2,1501,199,3,2584
15007040500,6455,1275,572,42,12,2502,489,15,5180
15007040603,2936,1195,312,17,7,734,141,7,1741
15007040604,3538,1335,410,22,7,701,237,12,2203
15007040701,2704,1069,390,3,11,453,166,4,1635
15007040702,6315,1758,636,28,9,2197,369,29,4557
15007040800,3769,524,297,5,10,1640,515,6,3245
15007040900,5971,1027,634,24,8,1703,905,25,4944
15007041200,84,0,7,0,1,0,73,0,84
15007940000,4163,1161,470,10,6,317,990,16,3002
15007990100,0,0,0,0,0,0,0,0,0
15007990200,0,0,0,0,0,0,0,0,0
15007990300,0,0,0,0,0,0,0,0,0
15009030100,2719,824,190,6,5,81,1013,7,1895
15009030201,2764,1715,264,14,16,81,233,16,1049
15009030203,4334,2204,537,39,12,340,352,47,2130
15009030204,3558,2029,398,24,16,266,172,45,1529
15009030304,3269,1033,340,10,7,293,634,22,2236
15009030305,5810,2994,453,27,21,762,307,57,2816
15009030306,2243,1608,158,15,4,176,76,24,635
15009030307,1542,1222,72,6,5,97,32,8,320
15009030403,3522,1569,390,10,20,352,318,15,1953
15009030404,5562,1892,760,13,9,911,644,18,3670
15009030405,1850,648,222,5,1,337,121,17,1202
15009030406,7490,2416,898,50,9,1504,621,38,5074
15009030501,2493,1076,285,26,18,387,196,21,1417
15009030705,4566,1160,529,35,4,1843,399,9,3406
15009030706,2472,1101,252,25,10,615,131,20,1371
15009030708,3157,1696,353,39,16,397,237,16,1461
15009030709,3434,2289,293,34,14,273,104,21,1145
15009030710,2403,1654,228,30,5,216,51,9,749
15009030711,2438,1183,260,18,6,522,122,18,1255
15009030712,1990,925,305,28,5,276,146,5,1065
15009030713,3366,1531,419,26,12,531,277,19,1835
15009030800,7413,1582,763,31,10,1755,1098,17,5831
15009030901,2848,494,402,24,18,574,672,11,2354
15009030902,3428,583,431,27,3,1146,441,10,2845
15009030903,6505,590,599,23,9,2700,1068,11,5915
15009031001,6473,1663,633,31,15,2173,435,23,4810
15009031002,4162,791,483,36,5,1276,484,20,3371
15009031102,5865,630,484,28,17,3201,689,3,5235
15009031104,2144,428,255,18,2,774,121,22,1716
15009031105,6446,249,484,23,2,4024,767,44,6197
15009031106,6002,596,539,21,5,2975,860,16,5406
15009031107,2079,425,148,18,15,317,501,1,1654
15009031402,3208,748,343,14,4,978,467,8,2460
15009031404,3223,1355,549,41,12,538,275,15,1868
15009031405,6280,888,532,44,4,3449,513,27,5392
15009031501,2367,959,202,11,4,691,172,8,1408
15009031503,2544,1354,431,30,13,255,166,36,1190
15009031504,1202,747,127,7,2,101,52,7,455
15009031505,3541,1967,510,39,18,485,117,30,1574
15009031601,3367,475,306,14,7,1600,343,8,2892
15009031700,4441,712,281,14,4,657,1378,23,3729
15009031801,2846,399,173,5,8,247,1137,10,2447
15009031900,6276,786,549,21,4,3025,966,12,5490
15009032000,1112,736,84,10,4,83,58,8,376
15009980000,0,0,0,0,0,0,0,0,0
15009990000,0,0,0,0,0,0,0,0,0
15009990200,0,0,0,0,0,0,0,0,0
15009991200,0,0,0,0,0,0,0,0,0
16001000101,1577,1175,159,49,17,79,1,10,402
16001000102,3261,2511,264,139,16,95,9,18,750
16001000201,3568,3128,150,27,7,59,4,27,440
16001000202,6352,5585,267,49,10,129,1,51,767
16001000302,3432,2774,254,122,17,49,4,8,658
16001000303,2231,1775,221,36,17,67,0,1,456
16001000305,2726,2328,160,21,13,38,5,8,398
16001000306,4419,3759,288,61,6,78,8,14,660
16001000401,2139,1653,210,82,22,36,4,20,486
16001000402,3637,2815,385,141,32,64,1,17,822
16001000501,3014,2386,184,216,11,41,8,13,628
16001000502,3437,3024,154,16,5,62,5,16,413
16001000601,2341,2033,136,9,5,44,0,10,308
16001000602,3343,2846,198,25,6,65,4,19,497
16001000701,5020,4256,316,66,16,115,7,22,764
16001000703,2417,1933,124,12,0,234,0,5,484
16001000704,3771,3204,174,18,8,185,0,10,567
16001000803,4511,3841,271,38,15,90,8,20,670
16001000805,3314,2805,143,3,14,183,6,11,509
16001000806,2472,1914,248,39,13,111,8,19,558
16001000807,2211,1665,151,46,17,182,10,24,546
16001000808,1849,1509,83,6,8,155,2,7,340
16001000809,2578,1988,131,175,4,119,4,15,590
16001000810,3146,2579,237,20,14,91,8,17,567
16001000901,2209,1669,305,41,3,48,1,4,540
16001000902,4961,3787,610,77,11,161,18,171,1174
16001001001,2219,1829,143,32,8,65,13,9,390
16001001002,2337,1717,221,71,4,123,0,36,620
16001001003,2957,2334,269,133,7,35,6,23,623
16001001100,4966,3308,1130,92,42,67,17,37,1658
16001001201,3463,2953,223,32,15,39,12,11,510
16001001203,3847,2972,407,48,33,84,19,22,875
16001001204,3528,2635,490,85,25,113,12,30,893
16001001401,2701,2072,209,134,9,80,3,17,629
16001001402,2808,2174,252,103,16,100,4,11,634
16001001500,3821,3182,262,73,21,60,17,21,639
16001001600,4642,3638,528,83,39,84,12,13,1004
16001001701,2052,1535,265,62,18,32,1,15,517
16001001702,3849,2791,455,203,39,80,23,23,1058
16001001800,4794,3809,437,93,37,125,13,32,985
16001001900,5294,4115,661,70,29,103,10,29,1179
16001002000,6002,3903,1073,464,47,176,60,22,2099
16001002100,2070,1748,149,9,11,39,1,15,322
16001002223,4988,4193,330,23,11,173,5,31,795
16001002225,3670,2863,335,40,14,135,15,25,807
16001002226,2907,2327,245,49,10,91,12,10,580
16001002227,2883,2504,155,10,7,63,2,21,379
16001002228,2949,2272,295,68,19,105,21,8,677
16001002229,3975,3239,290,25,19,145,19,25,736
16001002230,3693,2973,262,39,23,178,13,10,720
16001002231,2694,2117,272,48,22,79,3,17,577
16001002313,4433,3262,532,129,27,229,24,12,1171
16001002314,5485,3923,956,84,28,202,18,23,1562
16001002315,5560,4098,555,254,31,307,34,21,1462
16001002316,2656,1928,348,138,21,99,6,8,728
16001002317,2989,2192,434,112,22,46,9,11,797
16001002318,4787,3578,604,113,27,156,21,15,1209
16001002319,4518,2789,1025,162,14,201,42,43,1729
16001002412,3975,3318,319,44,13,51,7,19,657
16001002414,2758,2196,281,39,28,69,1,4,562
16001002415,2578,2073,207,37,16,53,6,18,505
16001002416,5512,4317,412,294,21,150,9,42,1195
16001002417,2832,2399,175,10,7,59,2,13,433
16001002418,3782,3085,320,51,24,51,10,16,697
16001002419,3716,3190,203,33,15,60,2,19,526
16001010101,4206,3276,244,16,9,428,3,22,930
16001010102,5974,5162,354,23,14,64,2,35,812
16001010224,4246,3739,237,16,4,53,4,16,507
16001010226,3247,2769,242,15,16,25,4,21,478
16001010227,3461,2981,236,16,16,23,10,17,480
16001010228,2776,2365,230,3,13,25,4,12,411
16001010229,4919,4170,353,18,14,69,16,21,749
16001010230,4607,3970,295,11,9,60,7,35,637
16001010231,2552,2266,115,15,6,39,3,13,286
16001010232,3611,3185,222,11,3,58,4,2,426
16001010233,2888,2465,185,26,9,74,0,9,423
16001010234,4874,4013,508,16,18,85,6,17,861
16001010235,4738,4072,318,16,20,36,7,29,666
16001010236,3161,2823,140,18,4,26,0,8,338
16001010237,5400,4330,514,61,32,87,21,22,1070
16001010336,2167,1819,170,11,11,31,0,8,348
16001010337,5043,4102,469,61,10,123,12,39,941
16001010338,3691,3157,240,15,15,69,1,23,534
16001010339,3962,3159,343,52,12,135,6,14,803
16001010340,3781,3111,320,33,20,83,3,19,670
16001010341,5707,4684,421,40,13,224,5,18,1023
16001010342,5572,4546,422,56,17,186,17,17,1026
16001010343,2832,2306,219,28,20,128,3,6,526
16001010344,3117,2497,360,47,13,49,6,6,620
16001010345,3945,3072,461,47,14,73,21,14,873
16001010346,1628,1330,166,28,4,38,0,10,298
16001010347,3848,2982,539,46,16,50,12,8,866
16001010348,3672,2835,472,56,24,51,23,26,837
16001010349,3578,2952,328,30,14,45,6,19,626
16001010350,2785,2413,152,27,10,45,7,23,372
16001010351,3759,3221,258,14,19,77,3,22,538
16001010352,5698,4794,525,23,17,70,12,12,904
16001010353,4658,3984,325,21,7,70,13,25,674
16001010354,5606,4624,501,46,30,111,25,23,982
16001010355,1961,1738,90,5,5,50,3,21,223
16001010356,4039,3380,276,32,10,129,5,8,659
16001010357,3979,3507,193,28,6,96,6,21,472
16001010358,5588,4659,425,35,8,161,13,32,929
16001010359,4229,3333,319,99,12,219,0,25,896
16001010360,3773,3109,223,23,11,184,11,20,664
16001010361,4264,3477,367,42,27,97,4,15,787
16001010362,5324,4282,403,67,2,178,24,45,1042
16001010363,5188,4127,597,51,20,127,13,27,1061
16001010364,5412,4106,891,48,29,80,9,25,1306
16001010365,4231,3385,352,41,11,198,5,19,846
16001010366,3478,2814,322,36,11,99,7,14,664
16001010367,5656,4489,658,38,21,100,14,11,1167
16001010368,3194,2514,419,28,14,49,9,10,680
16001010369,2369,1898,283,27,2,48,5,5,471
16001010370,2822,2271,233,39,8,106,3,17,551
16001010371,3215,2426,292,64,9,228,4,12,789
16001010403,4194,3457,444,22,21,51,9,6,737
16001010404,3861,3114,494,12,22,17,5,27,747
16001010405,3264,2644,304,53,11,43,8,3,620
16001010406,5859,4646,730,45,33,56,4,38,1213
16001010407,6460,5392,619,53,22,51,4,23,1068
16001010408,4062,3436,380,15,7,31,2,15,626
16001010409,4610,3776,404,20,31,104,20,24,834
16001010410,6420,4506,788,385,30,257,54,23,1914
16001010411,3114,2488,276,55,18,115,9,6,626
16001010501,7796,6076,1115,216,206,44,7,18,1720
16001010503,5452,3899,403,26,40,721,44,14,1553
16001010505,2511,1890,213,16,4,244,16,9,621
16001010506,4307,3492,274,27,19,271,6,7,815
16003950100,1836,1665,70,0,11,7,0,4,171
16003950200,2543,2327,82,3,16,1,0,14,216
16005000200,3713,3388,134,7,21,18,2,13,325
16005000301,4274,3234,524,14,205,48,25,18,1040
16005000302,5159,4198,525,25,73,65,6,14,961
16005000400,6796,5839,514,24,49,54,17,37,957
16005000500,1956,1756,93,2,24,6,0,7,200
16005000600,3688,2969,378,29,63,50,8,15,719
16005000700,3729,3043,258,91,49,134,8,8,686
16005000800,3097,2312,418,67,87,80,2,16,785
16005000900,2259,1742,273,51,28,20,15,17,517
16005001000,3116,2492,326,36,71,35,13,23,624
16005001102,3888,3110,392,37,81,88,14,9,778
16005001103,4886,4141,320,26,24,110,23,10,745
16005001104,3255,2663,264,22,22,143,23,0,592
16005001200,3362,2679,353,16,77,69,13,13,683
16005001300,2613,2079,330,17,31,14,2,17,534
16005001400,4382,3356,570,73,63,50,27,26,1026
16005001500,6226,4963,770,29,135,32,19,18,1263
16005001601,2607,2035,324,33,46,19,5,5,572
16005001602,3944,3148,475,29,54,28,5,28,796
16005001603,2632,2128,264,38,70,27,14,17,504
16005001700,3778,3389,187,14,31,35,0,32,389
16005001900,5143,4784,141,8,40,12,7,20,359
16005940000,2141,670,142,0,1245,7,0,4,1471
16005981800,374,329,18,0,11,4,1,4,45
16007950100,3645,3393,142,2,17,2,2,0,252
16007950200,2727,2584,66,8,8,11,0,0,143
16009940000,4858,3623,155,4,750,15,6,49,1235
16009950100,4672,4150,99,4,46,15,9,21,522
16011940000,3009,286,341,0,2298,3,3,5,2723
16011950101,3920,3454,304,20,12,5,2,19,466
16011950102,5506,4441,787,9,33,23,2,13,1065
16011950200,4005,3470,416,3,28,8,6,11,535
16011950300,5574,3569,1782,6,34,14,7,22,2005
16011950400,7263,5675,1126,33,132,29,11,20,1588
16011950501,2741,2126,423,9,61,23,1,12,615
16011950502,5239,3464,1332,11,213,32,4,11,1775
16011950600,5681,4424,1028,14,35,32,0,8,1257
16011950700,5054,4028,792,10,46,23,2,17,1026
16013960101,1517,1166,290,3,3,4,4,10,351
16013960102,3682,2841,600,17,4,43,1,30,841
16013960201,6226,4048,1882,7,12,66,4,26,2178
16013960202,4861,3173,1444,5,12,29,4,20,1688
16013960301,2155,1911,132,5,2,17,0,8,244
16013960302,2453,2170,160,3,1,31,2,6,283
16013960501,1801,1264,459,3,0,11,0,13,537
16013960502,1577,1451,54,2,0,10,0,3,126
16015950201,2090,1860,77,3,9,13,2,44,230
16015950202,2208,2008,98,4,17,4,1,13,200
16015950203,3312,2883,149,12,29,19,1,27,429
16017950100,2555,2334,67,3,9,11,14,18,221
16017950201,3189,2820,114,21,28,14,1,27,369
16017950202,2728,2488,69,8,14,13,3,10,240
16017950203,4386,3950,165,12,17,34,2,43,436
16017950300,3727,3263,177,15,21,28,7,26,464
16017950401,1296,1178,39,0,18,2,0,3,118
16017950402,3964,3503,168,12,19,31,1,27,461
16017950403,2721,2448,78,13,6,23,2,18,273
16017950500,3439,3169,76,4,25,14,2,16,270
16017950600,2284,2100,45,4,23,8,0,7,184
16017950701,2908,2559,117,8,26,9,2,28,349
16017950702,2095,1855,59,6,25,12,2,14,240
16017950801,3156,2862,85,3,18,19,1,19,294
16017950802,3978,3606,91,0,34,21,2,9,372
16017950901,1334,1222,29,3,8,1,0,11,112
16017950902,3350,2987,125,3,16,12,0,19,363
16019970100,6780,6166,302,8,26,71,0,27,614
16019970300,6703,6047,417,12,24,25,4,11,656
16019970401,2953,2417,393,11,7,33,1,7,536
16019970402,7323,6347,750,2,16,25,15,10,976
16019970404,5565,3659,1676,19,26,38,7,17,1906
16019970405,8791,6958,1337,30,21,142,12,25,1833
16019970502,5416,4515,567,18,36,76,17,12,901
16019970503,6531,5753,448,23,12,76,4,22,778
16019970504,3594,3199,237,21,10,47,0,16,395
16019970505,4765,3877,565,28,19,52,7,20,888
16019970601,2765,2192,440,7,14,20,5,8,573
16019970602,6234,4744,977,51,54,99,8,11,1490
16019970603,2490,2127,212,21,5,38,6,8,363
16019970700,5518,3833,1322,61,63,55,12,9,1685
16019970800,3944,3100,583,32,46,18,1,23,844
16019970900,5049,4249,531,32,23,56,12,13,800
16019971000,5050,4133,623,15,29,19,6,25,917
16019971100,3700,2860,534,33,56,34,6,23,840
16019971200,4537,3002,1245,26,56,37,7,12,1535
16019971301,7160,5351,1390,41,56,66,5,29,1809
16019971302,5883,4509,1039,50,31,70,2,17,1374
16019971401,4561,3587,710,26,20,60,1,11,974
16019971402,6752,5826,452,20,25,220,7,29,926
16019971500,1900,1492,344,6,2,15,0,10,408
16021970100,6469,5719,291,20,103,35,7,43,750
16021970200,5587,4831,401,7,42,37,2,28,756
16023970100,2574,2336,134,2,15,3,2,2,238
16025970100,1077,938,59,2,0,8,0,5,139
16027020100,1263,870,291,14,1,13,6,1,393
16027020200,4705,2313,2066,46,28,26,17,24,2392
16027020300,4415,2965,1096,30,35,30,14,17,1450
16027020403,4782,3234,1145,43,32,42,17,23,1548
16027020404,4837,2676,1790,25,52,43,2,16,2161
16027020405,2829,1888,710,6,28,16,0,34,941
16027020406,3786,2808,739,23,16,27,11,21,978
16027020501,3774,2536,1024,7,26,17,10,8,1238
16027020503,3624,2517,868,26,5,35,15,16,1107
16027020505,3380,2141,928,27,25,16,40,15,1239
16027020506,2747,1745,756,31,17,17,12,10,1002
16027020601,6121,3975,1647,36,33,99,36,34,2146
16027020603,5139,3404,1332,34,30,39,19,34,1735
16027020604,2443,1643,609,18,1,22,17,25,800
16027020700,4090,3222,595,13,19,47,4,25,868
16027020903,4794,3284,1126,38,20,64,17,18,1510
16027020904,4936,3747,859,23,21,44,18,19,1189
16027020905,4413,3411,695,15,20,44,17,12,1002
16027020906,6025,4321,1222,82,17,57,31,45,1704
16027020907,3745,2927,589,22,12,44,16,23,818
16027020908,4531,3238,998,17,16,42,25,22,1293
16027020909,3516,2455,733,54,17,70,20,16,1061
16027020910,2476,2016,271,21,9,43,0,11,460
16027021003,4222,2406,1456,40,33,30,11,12,1816
16027021004,6683,3583,2697,20,26,43,8,11,3100
16027021005,6434,3430,2508,50,35,56,17,42,3004
16027021006,4807,3043,1524,21,22,38,8,13,1764
16027021007,3406,2178,860,55,31,38,19,31,1228
16027021008,4236,2478,1475,18,19,37,2,18,1758
16027021101,6805,4313,2031,52,33,49,11,25,2492
16027021102,2889,2072,591,28,9,34,3,5,817
16027021103,3639,2716,614,27,5,41,23,15,923
16027021104,4413,3276,758,56,21,84,20,17,1137
16027021105,5316,4045,813,69,18,53,15,32,1271
16027021201,3826,1860,1745,19,24,33,2,19,1966
16027021202,4266,2333,1681,6,28,14,7,32,1933
16027021300,2955,1254,1533,15,17,9,3,23,1701
16027021500,5174,3140,1489,116,38,89,11,28,2034
16027021600,4258,2687,1287,20,30,31,12,11,1571
16027021701,4610,2965,1355,28,17,60,7,22,1645
16027021702,6989,3226,3353,31,41,28,25,35,3763
16027021801,4225,3241,732,6,14,16,0,12,984
16027021802,3317,2500,591,13,11,43,5,6,817
16027021901,6651,5264,837,16,40,33,11,40,1387
16027021904,3794,2429,1139,0,19,30,7,23,1365
16027021905,4678,3904,506,26,15,24,0,28,774
16027021906,5227,4606,328,10,15,24,5,29,621
16027021907,3421,2812,364,7,18,21,3,21,609
16027022100,5091,3681,1082,10,33,27,4,23,1410
16027022200,5490,3400,1771,5,55,27,6,30,2090
16027022301,3111,2314,609,6,8,6,0,19,797
16027022302,1365,996,280,9,5,12,3,3,369
16027022303,2364,1862,365,9,3,10,2,13,502
16027022400,5072,4051,703,16,13,36,6,13,1021
16029960100,4124,3762,231,0,23,8,14,4,362
16029960200,2903,2629,153,0,23,1,1,10,274
16031950100,2816,2184,590,2,6,2,0,1,632
16031950200,3464,2851,510,8,4,16,0,15,613
16031950300,5660,3945,1457,22,17,41,5,35,1715
16031950400,4295,1852,2264,11,33,30,3,6,2443
16031950500,6008,3989,1743,18,36,28,12,20,2019
16031950600,2412,1701,622,3,26,14,9,3,711
16033950100,790,463,288,3,2,1,0,2,327
16035940001,1950,1713,91,21,44,16,1,3,237
16035940002,3828,3439,150,7,74,19,1,14,389
16035970100,2956,2730,59,12,15,10,0,18,226
16037960200,4275,3893,156,3,32,15,1,19,382
16039960100,2774,2069,563,1,19,12,3,18,705
16039960201,4996,3778,711,75,53,84,3,28,1218
16039960202,4398,3259,631,101,35,68,22,33,1139
16039960300,4280,3167,618,78,54,95,11,14,1113
16039960401,5526,3802,1032,126,46,142,12,25,1724
16039960402,3501,2131,918,70,19,139,16,18,1370
16039960500,3191,1790,624,237,8,226,34,9,1401
16041970100,6743,6156,357,11,31,9,5,9,587
16041970200,7451,6545,666,11,44,19,2,11,906
16043970100,1517,1410,46,2,4,5,3,6,107
16043970200,3556,2964,488,2,13,7,5,13,592
16043970301,4838,3895,754,14,36,24,3,9,943
16043970302,3477,3023,302,3,15,8,13,6,454
16045960100,4780,4243,298,4,26,16,2,37,537
16045960200,6496,5436,539,8,44,42,1,25,1060
16045960301,4352,3752,342,7,27,27,7,17,600
16045960302,3495,2701,543,10,27,14,10,17,794
16047960101,3938,2610,1094,7,20,18,0,14,1328
16047960102,3656,2596,916,1,10,6,1,4,1060
16047960201,4892,2958,1727,9,25,6,3,24,1934
16047960202,3112,1880,1110,3,15,10,0,10,1232
16049940000,4301,3620,138,12,302,7,2,31,681
16049960100,2126,1925,56,3,16,4,0,9,201
16049960201,1794,1618,67,7,23,13,2,5,176
16049960202,4724,4219,210,9,43,24,1,39,505
16049960300,2190,1994,93,21,23,6,0,3,196
16049960400,1406,1280,47,2,7,1,0,7,126
16051960100,3986,2902,970,6,7,6,0,19,1084
16051960200,4203,3698,364,4,20,10,3,9,505
16051960301,3304,3007,163,5,18,15,2,24,297
16051960302,6001,4933,765,14,37,24,10,19,1068
16051960401,6394,5508,638,24,22,32,5,32,886
16051960402,7003,6382,356,20,23,31,10,3,621
16053970100,3273,2130,1053,0,5,8,0,9,1143
16053970200,4242,2146,1953,12,28,5,1,7,2096
16053970300,5895,3245,2389,12,23,33,2,15,2650
16053970400,3467,1650,1689,9,20,10,7,11,1817
16053970501,4862,3422,1245,6,20,20,5,16,1440
16053970502,2498,1560,847,0,14,4,7,12,938
16055000101,3051,2759,100,4,7,18,0,27,292
16055000102,4722,4193,219,10,26,18,1,20,529
16055000201,3561,3163,140,5,17,15,3,24,398
16055000202,3514,3136,117,0,22,29,3,36,378
16055000203,3486,3124,101,1,25,21,1,20,362
16055000301,7280,6352,341,20,58,40,3,44,928
16055000303,5689,4928,285,14,57,37,11,25,761
16055000304,3224,2891,142,1,15,11,0,15,333
16055000401,7020,6078,391,33,47,51,11,7,942
16055000402,9289,7984,562,30,71,77,16,32,1305
16055000501,6254,5404,335,13,55,47,17,50,850
16055000502,6296,5460,390,17,50,33,8,18,836
16055000503,4384,3805,216,13,29,39,12,18,579
16055000601,4774,4158,283,9,29,33,0,36,616
16055000602,6462,5465,440,30,71,43,6,35,997
16055000701,4966,4265,264,11,45,74,8,20,701
16055000702,4850,4205,258,5,43,61,3,24,645
16055000703,7972,6929,426,27,57,121,14,23,1043
16055000704,5688,4791,426,11,43,65,10,24,897
16055000800,5897,5187,259,21,56,42,12,42,710
16055000901,3448,2865,264,22,48,46,2,12,583
16055000902,3099,2691,174,16,29,20,5,8,408
16055001002,4890,4257,250,15,43,34,8,28,633
16055001003,2322,2047,118,4,23,18,3,8,275
16055001004,4154,3688,192,14,16,25,7,25,466
16055001100,2204,1983,93,5,5,9,3,9,221
16055001201,3322,2875,165,15,29,30,0,22,447
16055001202,3236,2840,146,15,38,25,3,17,396
16055001300,4173,3554,256,23,41,30,7,30,619
16055001400,2681,2337,146,16,20,20,6,13,344
16055001500,3294,2860,177,2,24,12,4,13,434
16055001600,2778,2327,159,7,23,25,5,57,451
16055001700,4769,4233,177,9,34,60,0,26,536
16055001801,3085,2822,103,1,7,35,0,7,263
16055001802,6024,5347,258,9,27,55,2,41,677
16055001901,1732,1532,44,3,21,3,0,29,200
16055001902,1166,1055,35,3,4,6,0,4,111
16055002000,3897,3502,180,4,13,37,0,30,395
16055940000,2709,2015,124,5,447,6,1,8,694
16057005101,3009,2509,166,26,33,49,2,10,500
16057005102,4889,3845,384,61,26,226,12,41,1044
16057005200,6582,5730,246,35,26,146,10,37,852
16057005301,2580,2139,139,37,13,55,0,23,441
16057005302,5547,4422,386,67,50,204,3,31,1125
16057005400,5989,4891,441,80,37,255,13,16,1098
16057005500,4038,3636,124,7,34,8,1,17,402
16057005600,3789,3442,114,5,17,18,7,41,347
16057005700,3094,2862,73,0,27,7,0,11,232
16059970100,2504,2276,97,6,13,13,2,24,228
16059970200,3008,2726,98,10,24,9,2,12,282
16059970300,2462,2278,100,1,9,6,2,2,184
16061940001,1539,1263,65,4,125,2,0,7,276
16061940002,1952,1737,69,2,56,3,1,5,215
16061950300,42,31,4,0,0,2,0,0,11
16063950100,5127,3245,1639,6,22,10,4,5,1882
16065950101,2771,2588,82,10,5,8,2,10,183
16065950102,2852,2468,290,11,0,12,0,6,384
16065950103,2065,1770,181,12,1,40,2,2,295
16065950200,4761,3979,507,31,10,77,2,6,782
16065950301,7781,6138,896,234,52,239,66,33,1643
16065950303,12294,9737,1441,256,40,323,76,57,2557
16065950304,7208,5939,738,60,13,103,20,31,1269
16065950401,4298,3537,406,80,10,101,25,17,761
16065950402,2730,2400,212,8,5,11,4,2,330
16065950501,2560,2363,127,4,5,4,2,1,197
16065950502,3593,3066,368,3,12,15,16,0,527
16067970100,3358,2151,1101,2,11,4,4,10,1207
16067970200,6214,3691,2276,13,35,23,4,18,2523
16067970300,3022,2061,876,1,4,1,2,9,961
16067970400,4738,2689,1854,4,25,13,0,13,2049
16067970500,4281,2354,1802,7,17,10,0,7,1927
16069940000,4833,2680,156,16,1736,19,0,12,2153
16069960200,371,342,6,0,3,0,0,1,29
16069960300,5200,4384,255,35,156,38,4,19,816
16069960400,3330,2809,168,30,55,38,4,12,521
16069960500,4443,3887,187,25,71,44,12,14,556
16069960600,5149,4483,226,18,92,60,3,8,666
16069960700,5776,5113,246,19,70,38,0,18,663
16069960800,3909,3555,111,18,42,31,0,9,354
16069960900,3257,2861,133,13,57,11,8,18,396
16069961000,5822,5322,142,10,54,45,1,15,500
16071960100,4564,4259,178,2,14,14,4,8,305
16073950101,4718,2986,1463,8,25,9,2,34,1732
16073950102,3403,2365,854,17,16,18,3,16,1038
16073950200,3792,2709,598,3,333,15,3,18,1083
16075960100,7010,5282,1185,16,50,44,6,37,1728
16075960200,3553,2503,776,6,36,21,13,16,1050
16075960301,1679,1451,104,0,4,8,0,20,228
16075960302,7735,5502,1658,22,39,101,10,38,2233
16075960400,5409,4502,545,8,34,33,2,22,907
16077960100,1625,1304,104,1,146,4,5,16,321
16077960200,6253,3522,2520,16,26,14,3,6,2731
16079960200,4311,3896,120,3,34,13,0,40,415
16079960300,4015,3526,154,4,61,27,3,31,489
16079960400,4843,4349,176,8,50,13,3,12,494
16081960101,1290,1139,108,2,0,3,0,0,151
16081960102,659,508,136,0,0,0,0,0,151
16081960103,1933,1596,269,8,4,18,0,9,337
16081960104,2012,1488,458,1,8,11,0,3,524
16081960105,2978,2205,596,4,4,12,0,19,773
16081960106,1145,960,139,0,0,2,0,3,185
16081960107,1613,1245,314,1,9,5,0,3,368
16083000200,7519,6034,882,89,45,132,4,15,1485
16083000300,5906,4560,1073,10,18,22,5,14,1346
16083000400,4291,2902,1156,11,29,11,2,16,1389
16083000500,6587,5582,676,12,40,17,0,25,1005
16083000600,3274,2743,377,13,9,16,3,6,531
16083000701,11083,8611,1400,199,68,292,34,34,2472
16083000702,4531,3412,658,98,15,132,17,15,1119
16083000800,6433,4505,1289,162,34,133,21,21,1928
16083000900,5069,4326,397,17,18,126,1,11,743
16083001001,4763,3807,582,44,31,77,17,14,956
16083001002,4378,3097,875,63,30,56,54,15,1281
16083001100,3390,2402,606,116,28,109,19,6,988
16083001201,4145,2647,1173,82,20,61,9,10,1498
16083001202,4845,2829,1549,68,42,179,6,6,2016
16083001301,7292,5931,1046,20,46,28,0,26,1361
16083001302,2384,1808,449,6,14,8,0,15,576
16083001600,4156,2973,1022,11,12,4,9,18,1183
16085970100,2870,2576,107,2,19,10,3,16,294
16085970200,3171,2775,224,2,13,27,0,25,396
16085970301,2053,1814,123,9,5,7,1,15,239
16085970302,3652,3302,147,3,17,11,4,22,350
16087970100,1710,1563,43,0,10,9,2,4,147
16087970200,3841,2912,683,9,30,24,2,21,929
16087970300,4949,3643,936,8,34,48,3,28,1306
17001000100,4644,4231,93,117,9,42,7,9,413
17001000201,2067,1827,38,79,4,18,0,13,240
17001000202,2870,2393,98,183,8,23,0,4,477
17001000400,3793,2953,67,528,11,3,3,23,840
17001000500,1719,1366,31,198,3,4,2,14,353
17001000600,3590,3193,103,119,2,31,0,5,397
17001000700,1243,908,69,153,5,12,0,11,335
17001000800,2455,1885,67,289,6,9,2,12,570
17001000900,2572,2139,53,137,0,7,0,16,433
17001001001,3245,2885,77,102,5,13,0,8,360
17001001002,3109,2839,56,69,3,17,0,11,270
17001001100,8015,7075,165,261,3,206,11,21,940
17001010100,4403,4136,56,12,3,4,0,23,267
17001010200,3634,3412,50,15,5,19,0,12,222
17001010301,2800,2686,34,11,4,2,0,6,114
17001010302,3062,2901,31,7,6,3,4,2,161
17001010400,3605,3366,62,34,7,20,0,7,239
17001010500,3069,2796,43,73,7,26,0,12,273
17001010600,5842,5398,94,77,1,41,4,14,444
17003957600,1820,1533,28,177,10,6,0,2,287
17003957700,1491,1198,33,174,6,0,0,1,293
17003957800,1030,345,10,624,6,0,0,2,685
17003957900,899,198,11,637,0,0,0,3,701
17005951200,2924,2659,47,88,9,4,0,3,265
17005951300,6883,5033,458,956,32,83,11,81,1850
17005951400,2918,2761,40,9,4,0,0,6,157
17005951500,4000,3811,59,20,7,7,0,3,189
17007010101,4396,2605,1432,136,8,56,2,22,1791
17007010102,3756,1995,1469,147,11,20,0,6,1761
17007010200,5640,3262,1974,140,14,29,0,31,2378
17007010300,6674,3615,2589,140,1,54,2,14,3059
17007010400,6912,4523,1895,149,7,96,1,34,2389
17007010501,4501,3828,377,64,0,98,0,16,673
17007010502,5795,4840,570,98,14,85,0,5,955
17007010601,3847,2951,736,30,3,11,2,20,896
17007010603,6380,5173,714,92,5,144,0,17,1207
17007010604,5547,3897,1124,175,9,44,2,16,1650
17009970400,2349,2255,17,3,5,6,0,1,94
17009970500,3895,2509,265,1032,2,5,0,1,1386
17011964700,2866,2631,121,10,2,16,2,9,235
17011964800,3231,3054,67,6,1,5,5,3,177
17011964900,2635,2391,129,17,11,15,0,3,244
17011965000,3668,2355,1108,28,5,69,1,6,1313
17011965100,4224,3384,607,52,7,20,0,11,840
17011965200,3474,2627,617,47,6,47,0,10,847
17011965300,3370,2991,174,40,5,49,10,0,379
17011965400,3555,3265,127,36,1,47,3,3,290
17011965500,3506,3284,72,7,9,21,0,1,222
17011965600,2715,2529,73,16,2,9,0,5,186
17013951200,2306,2165,36,3,4,5,0,4,141
17013951300,2131,2052,28,4,0,2,0,2,79
17015960100,3773,3542,111,17,5,12,1,7,231
17015960200,1976,1857,62,5,3,3,3,0,119
17015960300,3000,2568,257,57,3,4,1,14,432
17015960400,1944,1828,51,9,0,4,0,2,116
17015960500,2461,2298,54,9,0,9,0,7,163
17015960600,2548,1650,222,579,38,8,0,2,898
17017960100,2251,2145,12,15,9,9,0,0,106
17017960200,2501,2303,88,17,8,5,3,0,198
17017960300,3054,2273,625,63,5,31,10,1,781
17017960400,2545,1308,895,230,9,38,7,2,1237
17017960500,2691,1032,1169,381,5,34,13,7,1659
17019000200,2266,221,284,1262,12,407,1,14,2045
17019000301,6593,2368,636,363,6,2994,0,32,4225
17019000302,3830,923,314,173,0,2270,2,23,2907
17019000401,5125,2975,451,238,0,1295,1,10,2150
17019000402,4001,2089,479,228,3,980,0,58,1912
17019000500,3608,2560,204,340,5,258,2,14,1048
17019000700,3290,862,1060,1036,5,136,3,14,2428
17019000800,6052,2502,609,1619,3,949,0,27,3550
17019000901,4731,1205,604,2451,4,149,0,18,3526
17019000902,6833,3639,405,1657,6,742,4,25,3194
17019001000,4366,2709,201,1100,0,91,0,21,1657
17019001100,3519,2760,177,295,8,108,0,18,759
17019001201,6611,2969,513,2133,16,498,3,28,3642
17019001203,4414,3079,244,579,6,259,0,11,1335
17019001204,3453,2293,133,267,2,561,2,6,1160
17019001205,7271,4262,408,968,3,1232,4,64,3009
17019001206,1886,1553,48,84,2,126,0,8,333
17019001301,5796,4200,293,581,10,419,1,16,1596
17019001302,4892,3573,157,246,5,625,0,27,1319
17019001400,7616,3918,743,592,6,1982,0,27,3698
17019005300,3800,833,240,1505,1,1070,2,17,2967
17019005401,4531,2012,953,1124,12,165,0,22,2519
17019005402,3170,2091,537,240,0,109,0,8,1079
17019005500,5289,3084,555,1057,22,199,5,20,2205
17019005601,6088,2926,460,1841,2,436,0,36,3162
17019005602,2441,1484,93,313,2,470,3,8,957
17019005701,5030,3007,319,997,13,423,0,24,2023
17019005702,1559,1227,63,118,0,87,0,2,332
17019005800,3479,2336,308,112,3,478,0,32,1143
17019005901,2722,1340,423,208,5,602,0,10,1382
17019005902,2402,904,258,115,6,1015,0,16,1498
17019006000,3218,964,513,441,0,1165,2,10,2254
17019010100,4529,2597,757,812,11,57,0,14,1932
17019010204,4377,2372,989,678,9,50,6,20,2005
17019010300,3494,1446,414,1227,6,39,1,15,2048
17019010400,4498,3919,253,101,4,15,0,15,579
17019010500,4593,4287,79,23,4,29,3,5,306
17019010601,5749,5141,201,40,9,108,5,6,608
17019010603,7972,7051,262,79,18,169,0,23,921
17019010604,2451,2051,70,130,0,25,0,20,400
17019010701,3875,3541,117,14,11,37,0,17,334
17019010702,3767,3595,40,15,1,9,0,7,172
17019010800,4313,4002,78,21,0,18,0,17,311
17019010901,6029,5151,148,135,14,280,3,36,878
17019010902,4215,3773,121,75,10,27,1,8,442
17019011001,2072,1436,143,248,5,113,3,11,636
17019011002,1888,1259,154,213,4,145,2,15,629
17019011100,2161,791,155,121,5,999,1,2,1370
17021958100,2835,2667,44,4,8,5,0,21,168
17021958200,3593,3369,33,16,7,8,0,9,224
17021958300,3975,3697,52,27,6,58,0,3,278
17021958400,3719,3511,58,32,6,21,0,1,208
17021958500,2138,1955,59,20,9,8,0,3,183
17021958600,2155,2046,19,13,2,1,1,1,109
17021958700,5819,4716,740,231,1,28,0,0,1103
17021958800,2448,2335,19,4,6,19,0,2,113
17021958900,2554,2415,31,16,1,9,0,2,139
17021959000,4796,4515,39,17,13,22,0,18,281
17023060100,4696,4511,39,7,12,17,0,14,185
17023060200,4312,3999,118,25,11,27,0,8,313
17023060300,4850,4624,79,17,3,5,0,8,226
17023060400,1597,1546,10,5,2,3,0,0,51
17025971900,2376,2267,18,1,3,4,0,4,109
17025972000,2829,2692,54,4,1,6,0,5,137
17025972100,5155,4748,116,23,17,59,0,7,407
17025972200,2928,2774,35,2,12,8,0,2,154
17027900100,6512,6052,164,30,23,40,2,20,460
17027900200,1910,1822,34,4,3,1,0,4,88
17027900300,6928,6462,273,15,9,21,0,7,466
17027900401,1201,1133,10,5,3,2,1,2,68
17027900403,3921,3441,77,167,19,31,0,7,480
17027900404,1403,1315,14,8,1,9,0,8,88
17027900500,5664,4233,338,810,9,35,0,19,1431
17027900601,2460,2343,62,3,3,0,0,0,117
17027900602,6900,6044,415,98,10,36,2,26,856
17029000100,2658,2490,79,9,0,3,0,1,168
17029000200,5556,5201,101,40,6,44,0,6,355
17029000300,4293,3818,124,113,11,27,0,13,475
17029000400,2629,2231,112,105,2,19,1,6,398
17029000500,6017,5257,216,216,12,28,1,7,760
17029000600,3228,3066,32,17,9,12,0,7,162
17029000701,2806,2292,99,209,2,88,0,7,514
17029000702,2767,2033,125,321,4,154,0,17,734
17029000800,2831,1517,466,556,9,90,17,110,1314
17029000900,4109,3600,128,144,7,91,5,11,509
17029001000,3177,2876,81,67,4,30,0,7,301
17029001100,3464,2994,113,180,8,20,0,5,470
17029001200,3328,2977,92,66,8,11,0,14,351
17031010100,4905,1527,737,2128,18,147,1,61,3378
17031010201,6939,1573,2173,2496,17,368,6,80,5366
17031010202,2742,991,731,756,4,144,0,12,1751
17031010300,6305,2772,1140,1747,8,325,2,35,3533
17031010400,5079,3002,621,599,6,561,0,84,2077
17031010501,4206,2039,529,1049,10,324,1,44,2167
17031010502,3278,1734,443,570,20,287,0,40,1544
17031010503,2565,1328,272,408,3,399,0,20,1237
17031010600,6225,3125,1083,1221,3,421,0,63,3100
17031010701,3673,1308,1127,877,2,210,0,20,2365
17031010702,4776,1267,1798,1173,17,310,2,22,3509
17031020100,4202,1014,1134,1371,11,490,0,24,3188
17031020200,7128,3821,996,763,13,1286,1,74,3307
17031020301,5261,3827,324,153,2,759,0,86,1434
17031020302,5010,2488,1021,615,9,675,1,46,2522
17031020400,4435,1593,1037,957,15,641,0,16,2842
17031020500,6599,1357,1432,1524,26,2003,1,54,5242
17031020601,6699,3019,1117,459,5,1787,0,91,3680
17031020602,4662,1274,1281,478,10,1396,2,75,3388
17031020701,1879,968,302,72,2,467,0,6,911
17031020702,7717,2830,1333,648,17,2504,1,104,4887
17031020801,5648,2159,1506,373,17,1386,0,23,3489
17031020802,7546,1428,1680,888,23,3260,0,58,6118
17031020901,5848,1000,1344,1414,18,1829,0,47,4848
17031020902,4488,1434,800,769,10,1332,0,17,3054
17031030101,3687,1772,504,667,3,573,2,30,1915
17031030102,3121,1565,425,518,7,458,0,13,1556
17031030103,2104,1101,256,260,2,384,0,25,1003
17031030104,3521,1918,384,378,6,667,3,65,1603
17031030200,5627,3811,809,336,4,385,0,18,1816
17031030300,3148,1170,998,470,14,373,0,18,1978
17031030400,2597,1366,657,219,4,223,0,13,1231
17031030500,6183,3726,1192,456,8,440,1,30,2457
17031030601,3293,1491,458,562,5,640,3,20,1802
17031030603,2045,897,306,417,3,329,1,13,1148
17031030604,3737,1851,419,498,3,820,0,26,1886
17031030701,1671,791,240,439,4,126,0,14,880
17031030702,2318,1237,208,202,5,555,0,16,1081
17031030703,3075,1634,379,576,0,366,1,14,1441
17031030706,2933,1604,276,542,0,373,0,19,1329
17031030800,4284,3082,432,186,1,345,0,15,1202
17031030900,2952,1946,523,94,4,259,5,18,1006
17031031000,3868,2537,682,142,2,291,0,20,1331
17031031100,4691,2880,645,272,9,592,3,22,1811
17031031200,5541,1943,779,1578,10,1022,3,26,3598
17031031300,6719,3452,720,1216,16,1090,0,25,3267
17031031400,5221,3505,510,439,1,550,1,34,1716
17031031501,4155,1410,429,1394,10,717,1,38,2745
17031031502,4712,1636,608,1912,2,345,0,24,3076
17031031700,6294,3576,936,1061,19,381,3,21,2718
17031031800,1910,1225,375,68,0,155,1,9,685
17031031900,2522,1736,312,167,3,174,0,10,786
17031032100,7543,4267,1043,1284,8,574,2,39,3276
17031040100,3905,2438,747,233,7,299,0,12,1467
17031040201,6408,4070,1250,189,16,597,1,18,2338
17031040202,7318,3066,1633,560,21,1797,0,27,4252
17031040300,2928,1587,450,98,0,638,2,25,1341
17031040401,3129,2161,544,64,0,174,1,25,968
17031040402,4746,3378,675,144,6,286,0,33,1368
17031040600,2530,1917,335,39,2,125,1,9,613
17031040700,3426,2362,542,111,2,241,0,12,1064
17031040800,1636,1212,200,41,1,83,1,5,424
17031040900,2063,1490,293,47,5,132,0,7,573
17031050100,2568,1984,320,40,0,115,4,6,584
17031050200,5309,3903,731,68,0,328,1,39,1406
17031050300,2671,1826,482,39,3,192,3,6,845
17031050500,5117,3938,448,71,2,351,0,26,1179
17031050600,2443,1904,241,41,2,143,0,0,539
17031050700,1513,1218,135,26,0,60,0,5,295
17031050800,1406,1071,133,15,2,95,0,3,335
17031050900,1426,1079,181,20,1,77,0,7,347
17031051000,1538,1107,218,38,0,109,0,8,431
17031051100,1599,1225,209,13,3,61,0,4,374
17031051200,1581,1219,196,25,0,56,0,10,362
17031051300,2907,2218,309,65,4,180,0,6,689
17031051400,2492,1538,417,228,4,152,0,15,954
17031060100,2830,2146,311,88,1,126,1,22,684
17031060200,2313,1630,351,82,5,128,0,1,683
17031060300,3076,2354,310,29,1,224,0,8,722
17031060400,3709,2932,310,48,5,252,1,10,777
17031060500,1374,938,193,59,2,134,1,5,436
17031060800,5295,3421,572,336,8,716,1,26,1874
17031060900,7104,4805,815,526,7,637,3,32,2299
17031061000,2279,1717,248,98,9,105,0,16,562
17031061100,1367,1119,113,25,1,45,1,3,248
17031061200,1932,1531,162,53,0,94,0,4,401
17031061500,1797,1459,138,26,2,97,0,6,338
17031061800,1051,739,117,55,1,94,0,8,312
17031061901,3625,2553,363,188,3,349,1,24,1072
17031061902,4665,3585,333,181,5,374,3,21,1080
17031062000,2843,2150,256,79,1,199,4,6,693
17031062100,3817,2892,344,132,1,284,0,8,925
17031062200,3244,2636,213,81,0,169,0,5,608
17031062300,1667,1316,133,18,1,95,0,12,351
17031062400,1673,1338,137,32,1,72,0,4,335
17031062500,1675,1273,153,76,5,97,0,10,402
17031062600,2477,1819,232,20,0,258,0,8,658
17031062700,2955,2322,252,56,5,182,1,21,633
17031062800,3851,3112,261,86,1,177,0,18,739
17031062900,4125,3356,315,68,3,210,0,15,769
17031063000,3417,2554,300,109,3,287,0,4,863
17031063100,2376,1830,173,51,4,189,0,11,546
17031063200,6900,5118,599,239,5,664,1,18,1782
17031063301,2833,2055,216,169,4,250,0,14,778
17031063302,4577,3332,352,162,5,487,1,22,1245
17031063303,1274,998,76,20,0,143,0,4,276
17031063400,2417,1814,206,104,0,168,3,9,603
17031070101,4171,3232,264,107,2,383,0,20,939
17031070102,3063,2286,240,109,2,270,1,15,777
17031070103,1845,1397,113,66,2,192,1,15,448
17031070200,4200,3212,344,122,2,318,0,21,988
17031070300,4349,3531,292,75,5,266,2,8,818
17031070400,3250,2554,235,135,3,173,0,6,696
17031070500,3322,2671,216,126,0,196,0,2,651
17031070600,3449,2679,277,36,2,311,0,15,770
17031070700,3699,2462,428,147,5,463,1,16,1237
17031071000,4357,3320,366,194,4,271,4,15,1037
17031071100,3091,2484,211,110,1,156,0,4,607
17031071200,2973,2276,198,133,2,235,4,9,697
17031071300,3893,3146,222,51,0,295,1,17,747
17031071400,4962,3750,345,248,0,411,2,24,1212
17031071500,6282,5149,328,249,1,309,0,22,1133
17031071600,1793,1349,94,103,2,137,0,24,444
17031071700,1660,1178,91,156,1,149,0,11,482
17031071800,2652,1781,160,397,1,208,1,10,871
17031080100,6388,5346,359,144,0,348,0,16,1042
17031080201,3375,2840,174,81,0,169,0,11,535
17031080202,4225,3376,310,73,4,321,1,16,849
17031080300,5499,4319,324,283,6,366,4,22,1180
17031080400,4569,1603,191,2420,5,199,0,14,2966
17031081000,8746,5866,617,943,25,998,0,18,2880
17031081100,4187,3014,254,340,12,399,3,17,1173
17031081201,5080,3952,302,242,0,416,0,17,1128
17031081202,3357,2842,126,91,5,205,0,11,515
17031081300,5540,4114,360,187,0,695,0,26,1426
17031081401,2508,1671,189,127,4,431,2,10,837
17031081402,7052,4555,430,372,7,1370,0,49,2497
17031081403,9843,6081,765,397,8,2172,4,39,3762
17031081500,5917,4220,348,172,2,949,4,18,1697
17031081600,4168,2943,276,116,1,635,2,34,1225
17031081700,5537,3883,406,273,13,748,0,21,1654
17031081800,11373,8912,590,248,7,1185,3,42,2461
17031081900,1325,748,92,337,1,91,1,2,577
17031090100,3585,2901,452,17,5,95,0,6,684
17031090200,6626,5513,677,38,1,196,0,36,1113
17031090300,1314,1124,110,7,0,17,0,25,190
17031100100,5538,3798,1089,60,22,403,2,29,1740
17031100200,7024,5389,1082,73,3,225,0,43,1635
17031100300,6252,5069,723,30,2,249,0,28,1183
17031100400,3207,2538,419,16,4,116,3,8,669
17031100500,6116,4441,925,87,4,437,0,34,1675
17031100600,4897,3282,1041,57,5,378,0,16,1615
17031100700,4967,3460,943,36,7,388,1,19,1507
17031110100,5568,3582,1127,154,8,495,0,21,1986
17031110200,2772,1662,778,36,6,213,0,17,1110
17031110300,5348,3345,1244,62,8,523,0,12,2003
17031110400,4522,2723,1136,72,3,434,0,18,1799
17031110501,4786,2687,1222,44,9,643,0,11,2099
17031110502,3220,1768,818,63,6,423,2,22,1452
17031120100,4402,3457,475,33,1,227,0,17,945
17031120200,4748,3436,526,37,4,540,0,25,1312
17031120300,6920,4630,701,85,2,1188,1,32,2290
17031120400,3526,1865,945,53,4,521,0,19,1661
17031130100,5205,3075,362,99,2,1514,0,48,2130
17031130200,1403,745,328,16,0,250,0,6,658
17031130300,5083,1899,1088,311,17,1542,0,22,3184
17031140100,3464,975,1818,169,11,399,0,18,2489
17031140200,5834,1603,2613,423,18,985,11,34,4231
17031140301,2693,315,1387,129,23,727,0,18,2378
17031140302,4060,1179,1687,241,16,777,2,36,2881
17031140400,6503,2548,2118,84,10,1402,1,39,3955
17031140500,3451,1102,1690,65,4,465,7,20,2349
17031140601,2545,509,1414,122,0,451,0,9,2036
17031140602,5041,1000,3070,342,12,434,3,61,4041
17031140701,2784,641,1488,93,7,438,1,28,2143
17031140702,5535,1336,3409,249,6,402,1,17,4199
17031140800,6486,3400,1994,251,5,555,0,39,3086
17031150200,7434,3749,2560,212,15,599,3,41,3685
17031150300,7120,4319,2095,90,16,350,3,32,2801
17031150401,4681,2695,1454,79,9,308,0,23,1986
17031150402,3831,1951,1497,52,2,216,1,16,1880
17031150501,3823,2173,1114,58,3,354,0,8,1650
17031150502,4239,2028,1687,79,15,333,0,14,2211
17031150600,3882,1799,1710,90,16,160,2,10,2083
17031150700,4429,1903,2062,123,1,187,1,16,2526
17031150800,4903,1782,2599,109,8,238,0,37,3121
17031151001,2833,691,1944,57,4,79,0,2,2142
17031151002,4588,1162,3012,157,15,143,3,14,3426
17031151100,5140,1808,2846,138,11,242,0,12,3332
17031151200,3880,1580,1926,68,3,197,0,25,2300
17031160100,2444,1371,650,41,8,254,7,7,1073
17031160200,3278,1946,761,118,6,271,0,20,1332
17031160300,3769,1847,972,305,8,493,0,18,1922
17031160400,4854,2146,1872,255,18,335,2,25,2708
17031160501,3703,1070,2083,129,0,284,1,13,2633
17031160502,3300,1050,1649,148,7,315,1,22,2250
17031160601,3380,1463,1437,125,8,187,0,31,1917
17031160602,3481,1435,1531,97,1,284,1,20,2046
17031160700,5766,2255,2573,179,10,538,3,21,3511
17031160800,4997,1649,2659,153,9,388,1,26,3348
17031160900,2410,1371,658,84,15,170,0,13,1039
17031161000,1899,1225,451,48,5,114,0,13,674
17031161100,1940,1280,340,56,3,156,0,13,660
17031161200,2820,732,1688,70,6,244,0,13,2088
17031161300,3899,1325,2144,137,8,170,0,13,2574
17031170100,2034,1490,289,118,0,95,0,2,544
17031170200,3812,1777,1657,40,4,207,2,23,2035
17031170300,5216,2869,1890,73,2,292,0,9,2347
17031170400,4141,2345,1364,73,0,257,0,24,1796
17031170500,5316,3483,1476,79,9,139,1,13,1833
17031170600,2551,1720,603,24,3,154,0,3,831
17031170700,3068,1859,1019,27,0,108,0,12,1209
17031170800,3799,2147,1329,54,0,180,0,6,1652
17031170900,1662,916,604,54,0,64,0,3,746
17031171000,7313,3771,2755,171,9,397,0,27,3542
17031171100,4235,1733,2054,103,4,248,0,29,2502
17031180100,6656,2354,3582,267,5,309,2,34,4302
17031190100,2325,273,1903,37,0,80,1,7,2052
17031190200,5652,705,4587,149,5,125,0,21,4947
17031190300,5738,1337,4046,123,9,135,1,39,4401
17031190401,4325,927,2980,108,2,242,4,13,3398
17031190402,5294,1073,3787,154,3,215,0,12,4221
17031190601,4382,417,3713,131,5,74,0,15,3965
17031190602,5378,533,4559,149,2,87,1,10,4845
17031190701,2972,283,2490,101,1,54,1,7,2689
17031190702,4952,317,4381,171,2,46,1,13,4635
17031190800,6831,585,5939,147,4,83,0,26,6246
17031190900,1927,200,1573,82,0,50,0,4,1727
17031191000,2422,138,2165,63,8,24,0,4,2284
17031191100,7533,426,6711,251,17,54,1,16,7107
17031191200,3810,138,3567,46,5,8,0,22,3672
17031191301,5214,254,4446,324,1,115,0,41,4960
17031191302,4940,232,4390,206,3,57,3,15,4708
17031200100,4118,688,3150,102,1,104,0,12,3430
17031200200,5162,480,4371,178,11,64,1,9,4682
17031200300,2015,199,1714,56,1,16,0,4,1816
17031200401,3743,200,3326,146,2,29,0,11,3543
17031200402,4192,273,3688,130,10,39,0,16,3919
17031210100,4066,1819,1682,112,5,267,0,30,2247
17031210400,2912,686,1955,101,8,86,0,24,2226
17031210501,3555,1271,1926,121,12,110,2,17,2284
17031210502,4099,1423,2333,107,7,107,1,20,2676
17031210601,2717,898,1439,82,8,182,1,13,1819
17031210602,4148,1348,2394,154,4,136,0,10,2800
17031210700,3907,1653,1877,92,3,163,0,8,2254
17031210800,986,383,503,19,1,46,0,3,603
17031210900,3170,1378,1344,119,10,177,1,22,1792
17031220300,2207,1406,518,55,2,122,0,11,801
17031220400,2579,1597,703,47,4,115,0,7,982
17031220500,2751,1672,691,133,3,127,0,25,1079
17031220601,1635,888,564,44,0,53,0,13,747
17031220602,4877,2537,1636,292,0,193,1,21,2340
17031220701,2920,914,1734,102,0,75,0,16,2006
17031220702,3653,1245,2009,159,2,111,0,23,2408
17031220901,2903,557,2001,212,3,62,1,14,2346
17031220902,2959,713,2096,64,1,27,0,5,2246
17031221000,2432,862,1283,133,6,49,0,16,1570
17031221100,4440,2053,1829,234,10,150,0,5,2387
17031221200,2954,1629,913,182,1,108,0,15,1325
17031221300,3062,1739,924,113,1,168,2,7,1323
17031221400,3385,1735,1248,75,5,192,5,13,1650
17031221500,2909,1393,1054,213,0,145,0,7,1516
17031221600,3159,2174,510,63,3,217,1,18,985
17031222200,2156,1596,258,57,0,140,0,9,560
17031222500,1415,710,523,72,0,36,1,3,705
17031222600,1599,808,575,98,0,51,0,8,791
17031222700,2082,770,945,212,9,66,0,12,1312
17031222800,960,279,550,81,0,16,0,5,681
17031222900,1089,243,723,63,3,15,0,5,846
17031230100,1504,557,655,202,0,39,1,0,947
17031230200,1834,451,1123,152,0,54,0,5,1383
17031230300,956,124,716,78,2,19,1,2,832
17031230400,2235,258,1798,101,1,27,0,4,1977
17031230500,3419,105,2946,308,0,23,5,15,3314
17031230600,6817,230,4795,1707,7,15,0,9,6587
17031230700,6218,447,5038,550,4,78,0,27,5771
17031230800,1234,147,938,85,0,20,0,10,1087
17031230900,5044,1188,2998,641,5,63,0,31,3856
17031231100,1214,55,552,578,1,2,0,7,1159
17031231200,5983,143,2947,2790,2,7,0,21,5840
17031231500,5655,122,1398,4019,5,13,0,12,5533
17031240200,1556,1089,210,57,0,131,0,2,467
17031240300,1362,1047,150,15,0,84,0,3,315
17031240500,2610,1999,241,51,1,211,0,5,611
17031240600,1489,880,423,47,1,86,0,5,609
17031240700,1499,545,636,191,4,68,2,6,954
17031240800,1687,697,725,106,4,64,0,11,990
17031240900,1122,418,472,132,3,50,0,11,704
17031241000,2363,847,980,387,5,61,0,14,1516
17031241100,3574,1806,1120,336,0,170,1,14,1768
17031241200,1714,1154,302,66,3,124,0,1,560
17031241300,1848,1213,252,172,1,111,0,2,635
17031241400,5273,3789,560,357,8,317,1,5,1484
17031241500,2954,2013,447,85,0,266,0,12,941
17031241600,3534,2327,678,130,4,268,2,6,1207
17031242000,4692,2409,1057,731,3,292,0,16,2283
17031242100,3976,2802,585,71,0,305,4,9,1174
17031242200,4082,2911,592,124,2,221,4,13,1171
17031242300,3568,2681,439,76,8,192,0,14,887
17031242400,2902,2314,282,59,1,129,0,13,588
17031242500,3426,2084,940,174,2,107,0,8,1342
17031242600,5665,2798,2036,458,7,142,1,22,2867
17031242700,1938,707,748,390,0,39,2,5,1231
17031242800,1507,1091,252,33,5,52,1,10,416
17031242900,1962,1330,356,81,0,93,0,1,632
17031243000,2234,1352,542,76,3,133,0,12,882
17031243100,2249,1159,753,37,1,177,0,18,1090
17031243200,2287,1336,624,66,2,148,2,10,951
17031243300,2431,1675,460,59,0,127,0,23,756
17031243400,2880,1616,834,175,0,157,0,7,1264
17031243500,4746,3201,441,453,5,422,0,30,1545
17031250200,2779,59,1431,1223,3,22,0,7,2720
17031250300,4742,72,1902,2698,5,24,0,9,4670
17031250400,5789,77,1680,3895,8,17,0,16,5712
17031250500,7315,2404,2414,2107,7,170,0,22,4911
17031250600,4203,53,842,3236,2,11,0,11,4150
17031250700,5932,39,1211,4587,5,6,0,7,5893
17031250800,2432,30,734,1621,2,6,0,9,2402
17031251000,1075,15,272,758,3,0,0,2,1060
17031251100,4468,34,1058,3282,3,15,1,14,4434
17031251200,3910,21,948,2861,8,3,0,4,3889
17031251300,5098,69,895,4037,3,7,0,10,5029
17031251400,3986,206,375,3307,0,7,0,19,3780
17031251500,4342,78,711,3466,3,4,1,4,4264
17031251600,3522,23,579,2827,0,5,0,5,3499
17031251700,1347,18,439,863,2,2,0,2,1329
17031251800,5101,22,313,4687,4,0,1,11,5079
17031251900,5387,84,362,4841,5,8,0,17,5303
17031252000,5646,91,246,5199,12,14,1,7,5555
17031252101,1502,36,60,1373,0,1,2,0,1466
17031252102,6187,29,300,5755,4,2,0,12,6158
17031252201,2940,19,266,2606,4,2,2,2,2921
17031252202,4783,33,255,4412,4,3,0,16,4750
17031260100,1477,31,81,1330,3,0,0,1,1446
17031260200,1054,17,79,926,5,4,0,5,1037
17031260300,1528,14,131,1354,4,5,0,4,1514
17031260400,1398,3,86,1269,5,0,0,1,1395
17031260500,1833,17,128,1656,4,0,0,2,1816
17031260600,2114,7,177,1894,6,0,0,1,2107
17031260700,1691,33,164,1426,3,2,0,8,1658
17031260800,2271,41,99,2064,2,3,0,11,2230
17031260900,1778,50,75,1603,8,2,3,13,1728
17031261000,2289,18,137,2082,5,5,0,3,2271
17031270500,1619,12,49,1520,2,0,0,0,1607
17031271200,1172,30,96,1016,0,2,0,6,1142
17031271300,1060,24,58,951,2,4,2,1,1036
17031271400,1535,66,127,1292,2,8,1,0,1469
17031271500,1373,28,79,1235,3,3,0,0,1345
17031271800,976,15,63,862,0,7,1,3,961
17031280100,7421,5245,447,363,9,1050,4,25,2176
17031280400,1231,92,72,991,2,38,0,2,1139
17031280800,1198,43,66,1056,1,8,0,3,1155
17031280900,1077,132,66,826,0,24,0,4,945
17031281900,7031,3264,398,321,13,2699,4,54,3767
17031282700,2558,590,615,929,1,330,0,7,1968
17031282800,1634,551,423,248,1,332,0,17,1083
17031283100,2717,806,184,748,2,861,0,18,1911
17031283200,1670,539,160,565,1,323,0,15,1131
17031283800,3343,994,392,1497,6,347,1,11,2349
17031290900,3975,35,347,3520,3,6,0,8,3940
17031291200,2286,15,113,2125,2,3,0,4,2271
17031291600,874,122,549,146,1,26,1,6,752
17031292200,2942,88,287,2504,6,5,0,11,2854
17031292400,2041,40,188,1784,0,1,0,1,2001
17031292500,4057,51,367,3552,6,6,0,8,4006
17031300500,3243,94,2817,301,0,4,0,8,3149
17031300600,3253,96,2672,425,3,14,0,17,3157
17031300700,4798,95,4500,141,19,15,0,6,4703
17031300800,4136,53,3937,91,0,5,3,5,4083
17031300900,4553,139,4286,56,15,18,0,6,4414
17031301100,2323,166,2007,115,1,11,0,11,2157
17031301200,4087,237,3317,448,6,22,4,6,3850
17031301600,4995,65,4874,23,2,2,0,14,4930
17031301701,4279,52,4149,37,11,10,0,7,4227
17031301702,4121,49,4032,8,2,3,2,14,4072
17031301801,3947,72,3816,26,8,7,0,6,3875
17031301802,3376,56,3243,49,3,3,0,9,3320
17031301803,5107,108,4962,15,0,2,1,8,4999
17031310200,1588,562,685,152,3,116,0,6,1026
17031310300,1767,414,1094,96,0,85,0,13,1353
17031310400,1375,383,859,44,2,44,1,9,992
17031310500,1399,258,1012,54,2,42,2,4,1141
17031310600,5498,1172,3624,359,8,211,0,11,4326
17031310700,1700,322,1190,99,4,36,1,4,1378
17031310800,4175,706,3128,106,0,138,0,18,3469
17031310900,4781,699,3735,156,7,76,5,36,4082
17031320101,9532,5989,658,480,12,1934,0,59,3543
17031320102,4846,2688,431,178,6,1268,0,38,2158
17031320400,2856,1803,232,250,4,449,10,12,1053
17031320600,6395,3316,498,784,5,1466,3,39,3079
17031330101,4592,2367,265,477,1,1269,1,24,2225
17031330102,10811,5360,838,1813,8,2162,0,66,5451
17031330103,8248,3336,678,2594,13,1232,3,65,4912
17031330200,4008,1440,226,1158,12,945,1,20,2568
17031340300,1865,258,103,35,3,1440,1,8,1607
17031340400,1844,258,106,48,2,1404,1,3,1586
17031340500,1629,662,166,72,0,700,0,2,967
17031340600,1151,16,16,1074,1,16,0,4,1135
17031350100,2228,176,68,1029,3,875,2,30,2052
17031350400,1512,20,84,1371,5,1,0,1,1492
17031351000,3640,269,117,2569,12,521,1,19,3371
17031351100,2038,33,36,1902,0,21,0,7,2005
17031351400,1392,42,71,1219,0,9,0,7,1350
17031351500,823,40,48,626,1,95,0,1,783
17031360200,1651,13,25,1548,0,24,0,7,1638
17031380100,2207,89,75,1924,1,15,0,15,2118
17031380200,2408,50,45,2239,6,6,0,7,2358
17031380600,3947,90,103,3648,2,12,0,11,3857
17031381200,2077,35,43,1932,6,2,0,6,2042
17031381400,1796,38,46,1623,0,11,0,5,1758
17031381500,667,16,24,607,3,0,0,2,651
17031381700,18,1,9,7,0,0,0,0,17
17031381800,1462,34,45,1326,0,9,0,5,1428
17031381900,1106,28,30,996,0,3,0,6,1078
17031390100,1553,87,75,1278,1,48,0,6,1466
17031390200,1883,225,68,1453,2,47,2,5,1658
17031390300,2617,101,68,2371,10,11,2,7,2516
17031390400,2871,260,75,2373,6,29,0,25,2611
17031390500,1666,431,82,953,1,103,0,12,1235
17031390600,1994,780,89,901,2,97,0,14,1214
17031390700,6532,1237,306,3636,5,1029,1,35,5295
17031400300,1504,20,54,1406,5,2,0,1,1484
17031400400,1995,11,59,1880,5,1,0,0,1984
17031400500,2372,25,78,2232,0,2,0,0,2347
17031400800,3178,17,87,2970,9,2,4,20,3161
17031410100,2272,640,150,1139,0,228,3,7,1632
17031410200,1165,459,148,334,0,145,0,2,706
17031410500,2922,821,247,1335,5,375,1,11,2101
17031410600,2371,963,186,573,5,485,0,7,1408
17031410700,2399,1079,180,534,0,434,2,25,1320
17031410800,2993,1038,253,870,5,659,0,14,1955
17031410900,3670,1505,351,1190,1,416,1,19,2165
17031411000,3902,1621,275,1211,9,574,0,20,2281
17031411100,2379,1335,222,193,3,440,2,25,1044
17031411200,1713,998,87,173,2,332,0,26,715
17031420100,1642,25,42,1518,2,5,0,5,1617
17031420200,1781,185,96,1345,4,80,0,6,1596
17031420300,2818,871,261,1082,2,420,0,23,1947
17031420400,1544,236,83,985,4,167,0,9,1308
17031420500,2053,50,43,1883,1,14,0,5,2003
17031420600,2524,70,65,2302,9,2,1,4,2454
17031420700,3021,37,115,2772,4,3,0,11,2984
17031420800,2457,54,73,2242,1,7,0,6,2403
17031421200,1405,15,37,1312,1,2,0,10,1390
17031430101,4091,64,74,3818,4,4,2,16,4027
17031430102,3104,77,82,2808,5,13,3,17,3027
17031430200,5086,174,149,4581,7,13,2,5,4912
17031430300,2558,11,53,2412,4,9,2,13,2547
17031430400,3031,49,94,2827,5,0,1,4,2982
17031430500,4098,26,101,3853,3,3,0,23,4072
17031430600,1670,43,29,1510,1,13,0,19,1627
17031430700,2175,70,70,1959,2,6,0,4,2105
17031430800,1862,24,43,1754,1,6,1,4,1838
17031430900,1797,13,29,1725,2,0,0,7,1784
17031431200,2898,30,86,2687,8,7,0,3,2868
17031431301,3590,33,63,3374,4,9,0,14,3557
17031431302,4351,23,112,4103,4,7,0,6,4328
17031431400,6716,176,193,6107,14,32,0,12,6540
17031440101,4171,25,64,4014,0,1,0,8,4146
17031440102,3633,24,49,3480,1,8,1,3,3609
17031440201,5054,29,61,4831,7,0,1,18,5025
17031440202,3525,19,42,3371,5,6,3,10,3506
17031440300,4677,23,62,4428,5,4,0,9,4654
17031440600,1996,6,51,1889,0,5,0,6,1990
17031440700,1497,14,21,1427,0,3,0,1,1483
17031440800,1620,7,24,1544,0,5,1,5,1613
17031440900,2462,5,49,2352,2,0,0,15,2457
17031450300,3252,11,73,3093,2,5,0,9,3241
17031460100,2840,91,537,2092,1,3,0,11,2749
17031460200,1948,83,993,834,14,4,0,0,1865
17031460301,2987,76,901,1917,3,5,1,8,2911
17031460302,3282,54,350,2773,3,1,0,8,3228
17031460400,3411,21,118,3165,0,4,0,19,3390
17031460500,5400,41,97,5108,2,12,0,13,5359
17031460800,3639,73,1348,2147,7,0,0,17,3566
17031461000,1460,43,410,962,2,5,0,1,1417
17031470100,2527,4,65,2386,8,4,0,4,2523
17031480100,2001,5,14,1936,0,3,0,4,1996
17031480200,1103,2,31,1050,0,1,0,6,1101
17031480300,1348,15,14,1300,2,1,0,5,1333
17031480400,5650,32,104,5362,13,10,0,9,5618
17031480500,2986,50,449,2419,13,4,0,15,2936
17031490200,3040,19,55,2879,1,9,0,5,3021
17031490500,1995,22,52,1858,7,5,0,13,1973
17031490600,1443,1,31,1369,2,3,0,3,1442
17031490700,2656,4,88,2509,1,1,0,0,2652
17031490800,3502,24,61,3322,4,8,0,7,3478
17031490901,3403,17,55,3243,0,0,0,10,3386
17031490902,4647,15,71,4455,0,1,0,19,4632
17031491000,3807,36,160,3511,7,4,0,13,3771
17031491100,4079,47,74,3843,9,3,4,7,4032
17031491200,2019,18,47,1923,0,2,0,2,2001
17031491300,2023,16,61,1909,2,2,0,5,2007
17031491400,2593,16,80,2395,1,5,1,6,2577
17031500100,3545,13,62,3408,1,0,0,1,3532
17031500200,1688,10,45,1580,1,4,1,8,1678
17031500300,1587,421,386,716,8,4,0,0,1166
17031510100,3231,259,2701,215,8,13,2,8,2972
17031510200,2922,110,602,2160,2,0,0,10,2812
17031510300,4850,16,94,4609,8,1,0,12,4834
17031520100,1745,154,1437,128,1,4,2,4,1591
17031520200,3338,232,2689,367,8,7,2,9,3106
17031520300,5675,486,4943,148,15,17,0,30,5189
17031520400,4055,423,3476,100,0,8,0,16,3632
17031520500,4420,948,3269,113,9,23,0,10,3472
17031520600,2530,387,2052,54,6,5,0,3,2143
17031530100,2197,62,996,1062,3,8,0,17,2135
17031530200,4128,30,152,3830,4,0,0,22,4098
17031530300,3964,13,86,3755,1,2,0,20,3951
17031530400,2059,20,95,1881,2,4,0,4,2039
17031530501,4514,48,116,4234,11,5,0,21,4466
17031530502,1570,0,19,1529,5,0,0,0,1570
17031530503,4898,22,80,4714,2,6,0,16,4876
17031530600,2774,15,54,2640,0,0,1,10,2759
17031540101,4324,32,151,4040,7,6,2,5,4292
17031540102,2938,9,55,2790,2,0,0,3,2929
17031550100,7019,2130,4030,687,9,32,1,27,4889
17031550200,2969,979,1733,187,3,12,0,3,1990
17031560100,1477,163,993,223,1,84,0,2,1314
17031560200,1710,31,630,1027,0,0,1,1,1679
17031560300,3253,653,2337,172,1,56,0,5,2600
17031560400,1630,278,1229,22,0,79,0,3,1352
17031560700,3635,1066,2418,51,9,44,1,21,2569
17031560800,5682,2505,2965,61,16,54,0,16,3177
17031560900,5112,2847,2097,28,9,37,5,20,2265
17031561000,5308,3032,2082,62,9,29,2,15,2276
17031561100,5581,2470,2969,43,8,24,2,19,3111
17031570100,1316,156,1044,15,1,89,0,1,1160
17031570200,2096,267,1659,16,0,149,1,1,1829
17031570300,6376,644,5468,33,4,163,2,8,5732
17031570400,1769,194,1401,41,4,101,0,8,1575
17031570500,2639,401,2092,19,4,109,0,4,2238
17031580100,3228,209,2036,57,0,907,0,4,3019
17031580200,3466,211,2699,64,1,468,1,8,3255
17031580300,2577,97,2043,60,0,356,0,3,2480
17031580400,4546,269,3490,67,0,689,0,10,4277
17031580501,5170,369,4145,102,3,515,0,15,4801
17031580502,5345,226,4442,46,14,560,1,28,5119
17031580600,5405,319,4499,63,1,487,0,24,5086
17031580700,5621,323,4588,68,4,597,0,15,5298
17031580800,2058,82,1904,23,1,34,2,4,1976
17031590500,1854,386,973,34,2,408,0,9,1468
17031590600,3477,521,2314,48,3,526,0,3,2956
17031590700,3027,331,1941,63,2,630,0,9,2696
17031600400,4297,939,539,43,0,2704,0,2,3358
17031600600,2988,668,907,38,1,1313,2,17,2320
17031600700,2591,638,647,86,5,1157,3,2,1953
17031600900,3682,1120,1027,287,7,1145,0,19,2562
17031610300,5410,266,4716,215,10,149,1,8,5144
17031610400,2029,50,1932,14,2,19,2,0,1979
17031610800,1512,983,340,38,0,122,0,0,529
17031611200,2680,87,2118,384,0,37,2,10,2593
17031611300,3668,106,3269,250,3,7,0,9,3562
17031611400,3737,69,3516,129,0,8,0,5,3668
17031611500,3587,138,3080,317,3,21,0,12,3449
17031611600,1921,35,1217,614,2,3,0,7,1886
17031611700,2180,57,1534,570,0,4,0,3,2123
17031611800,2205,32,1267,876,0,2,2,7,2173
17031611900,1984,15,880,1056,1,1,0,6,1969
17031612000,1448,21,378,1010,0,8,0,4,1427
17031612100,1168,20,208,905,1,7,0,1,1148
17031612200,3939,126,2854,894,0,24,0,9,3813
17031620100,4567,321,3763,163,1,284,2,16,4246
17031620200,2390,384,1889,40,12,35,0,12,2006
17031620300,6410,978,5241,47,9,105,0,14,5432
17031620400,5027,256,4652,29,4,63,0,6,4771
17031630300,5385,189,5096,27,2,31,1,18,5196
17031630400,7204,297,6762,37,10,49,1,34,6907
17031630500,6271,181,5959,58,4,23,0,30,6090
17031630600,3250,149,2821,167,4,82,4,5,3101
17031630800,6641,246,6045,249,0,22,1,50,6395
17031630900,5204,201,4845,101,0,20,0,22,5003
17031640100,1312,254,970,57,0,11,0,5,1058
17031640300,6710,2354,4075,116,10,67,0,16,4356
17031640400,3390,1663,1586,51,5,28,0,11,1727
17031640500,3896,1771,1857,126,0,53,0,27,2125
17031640600,4063,1536,2237,124,8,75,0,13,2527
17031640700,3298,973,2210,68,0,19,0,4,2325
17031640800,1799,210,1533,15,2,24,0,0,1589
17031650100,4765,316,4281,119,2,16,0,10,4449
17031650200,7251,873,6262,50,4,36,0,2,6378
17031650301,5829,670,5049,50,0,35,0,12,5159
17031650302,4522,261,4120,75,4,16,0,8,4261
17031650400,6894,331,6275,209,2,41,1,10,6563
17031650500,4401,402,3391,556,2,28,0,4,3999
17031660301,1850,40,1321,443,5,0,0,26,1810
17031660302,5549,139,4513,833,3,3,2,15,5410
17031660400,5692,265,5202,165,0,16,0,9,5427
17031660500,5013,275,4286,394,0,20,0,9,4738
17031660600,6404,128,3389,2741,5,26,0,10,6276
17031660700,2076,16,528,1490,4,1,0,3,2060
17031660800,6114,128,3082,2780,10,17,4,13,5986
17031660900,4446,142,1430,2765,0,15,0,22,4304
17031661000,5756,90,1572,3951,6,10,0,22,5666
17031661100,6633,259,4012,2262,5,30,0,16,6374
17031670100,1349,23,318,989,4,2,0,2,1326
17031670200,1325,21,331,954,3,0,0,5,1304
17031670300,1287,8,335,923,0,7,0,0,1279
17031670400,1585,19,414,1104,0,8,0,2,1566
17031670500,1148,0,419,706,0,0,0,1,1148
17031670600,1339,5,353,957,0,0,0,2,1334
17031670700,1252,0,278,936,1,0,1,14,1252
17031670800,1477,18,211,1205,0,0,0,13,1459
17031670900,1172,3,235,918,0,3,0,3,1169
17031671100,994,1,112,848,0,4,0,7,993
17031671200,980,6,176,770,2,0,2,0,974
17031671300,2048,6,308,1674,0,0,0,9,2042
17031671400,1558,6,417,1092,0,1,2,11,1552
17031671500,2716,16,679,1964,3,2,0,2,2700
17031671600,1804,2,174,1575,2,7,3,1,1802
17031671800,1142,9,136,967,2,1,0,5,1133
17031671900,1122,10,159,901,0,5,0,12,1112
17031672000,3397,18,631,2673,5,3,0,11,3379
17031680500,1307,9,150,1114,0,0,0,1,1298
17031680600,1165,6,167,966,1,2,0,0,1159
17031680900,3573,25,117,3325,13,3,0,10,3548
17031681000,2573,31,119,2370,6,2,0,3,2542
17031681100,2873,30,118,2669,1,2,0,10,2843
17031681200,2353,15,126,2158,5,0,1,10,2338
17031681300,2182,9,85,2034,4,0,0,2,2173
17031681400,2474,13,239,2151,3,6,0,6,2461
17031690300,2302,33,49,2172,0,6,0,9,2269
17031690400,3363,19,62,3161,0,7,2,23,3344
17031690500,992,9,20,934,3,0,0,0,983
17031690900,4250,14,116,4005,6,2,0,11,4236
17031691000,2668,18,39,2510,1,3,0,13,2650
17031691100,2980,19,76,2822,2,0,0,14,2961
17031691200,2277,5,29,2197,0,0,0,6,2272
17031691300,2374,20,33,2260,5,0,0,9,2354
17031691400,3411,13,81,3211,0,0,0,10,3398
17031691500,1806,5,34,1720,4,2,0,5,1801
17031700100,3326,101,1475,1668,4,4,1,21,3225
17031700200,6554,647,5116,690,0,42,0,10,5907
17031700301,5762,800,4334,495,0,60,0,18,4962
17031700302,5662,1160,3475,901,4,25,0,10,4502
17031700401,5822,308,2522,2900,6,24,0,7,5514
17031700402,4082,271,1391,2309,2,27,0,18,3811
17031700501,6912,211,639,5905,6,15,0,20,6701
17031700502,2978,112,205,2572,0,14,1,20,2866
17031710100,1015,13,57,924,4,0,1,0,1002
17031710200,4635,25,176,4337,3,11,0,13,4610
17031710300,1424,2,96,1286,0,2,2,0,1422
17031710400,5424,23,330,4970,2,3,0,13,5401
17031710500,4036,17,146,3774,13,3,0,11,4019
17031710600,1706,7,40,1610,9,1,0,3,1699
17031710700,3420,11,103,3231,6,3,0,12,3409
17031710800,4804,26,80,4565,10,3,0,12,4778
17031710900,1942,0,36,1854,0,4,0,6,1942
17031711000,3058,19,111,2871,6,6,0,11,3039
17031711100,2499,2,77,2349,1,0,0,1,2497
17031711200,4687,21,142,4454,3,5,0,12,4666
17031711300,1462,10,43,1354,0,1,1,7,1452
17031711400,2394,10,109,2246,3,0,0,4,2384
17031711500,2372,5,66,2234,3,1,0,8,2367
17031720100,3344,1910,201,1101,2,19,0,14,1434
17031720200,4131,1422,229,2254,7,24,0,21,2709
17031720300,3637,2098,227,1129,1,36,0,17,1539
17031720400,1961,1582,159,168,0,15,0,1,379
17031720500,2086,1830,125,57,1,19,0,11,256
17031720600,1691,1277,73,293,5,14,0,2,414
17031720700,3073,890,164,1837,0,31,3,18,2183
17031730100,2462,9,59,2361,0,5,0,1,2453
17031730201,5627,9,116,5341,5,3,0,23,5618
17031730202,2893,10,38,2785,0,2,0,11,2883
17031730300,1046,1,34,989,0,2,0,8,1045
17031730400,3386,14,88,3226,3,0,0,4,3372
17031730500,4220,18,87,4008,6,4,0,13,4202
17031730600,3254,25,39,3118,3,4,0,4,3229
17031730700,2281,9,83,2125,0,11,0,12,2272
17031740100,3234,2486,525,84,6,33,0,25,748
17031740200,5830,4936,613,117,4,36,0,32,894
17031740300,4869,4230,436,67,1,11,0,24,639
17031740400,4695,3604,420,485,7,36,1,18,1091
17031750100,3736,11,103,3505,5,5,1,25,3725
17031750200,3024,1020,152,1699,8,23,0,23,2004
17031750300,2470,2063,161,176,0,7,0,13,407
17031750400,2909,1669,227,904,0,13,1,12,1240
17031750500,5618,1042,223,4150,17,24,1,21,4576
17031750600,3420,25,98,3215,6,1,0,8,3395
17031760801,4403,2273,438,170,4,1386,3,32,2130
17031760802,2374,2020,243,26,3,51,0,3,354
17031760803,6394,4691,782,178,8,507,0,13,1703
17031770201,5894,3963,761,231,18,759,0,15,1931
17031770202,5060,4045,492,70,3,285,3,6,1015
17031770300,7234,5276,1173,132,6,443,0,17,1958
17031770400,4375,2690,997,83,7,472,0,22,1685
17031770500,4632,563,3948,41,5,32,0,10,4069
17031770601,3272,2180,549,39,4,418,0,3,1092
17031770602,4762,1754,2256,121,0,539,0,7,3008
17031770700,2537,1780,543,32,0,106,0,7,757
17031770800,5661,3255,1793,71,3,435,0,11,2406
17031770901,5245,4069,577,23,1,467,0,14,1176
17031770902,3732,3132,306,23,0,226,5,7,600
17031800100,2395,2107,94,21,5,87,0,5,288
17031800200,6466,5538,279,71,3,290,0,33,928
17031800300,3613,3185,146,10,0,146,3,12,428
17031800400,3936,3448,172,4,2,137,0,19,488
17031800500,5133,4562,195,15,2,165,0,16,571
17031800600,2429,2137,93,8,2,100,0,12,292
17031800700,5257,4315,229,17,2,445,0,14,942
17031800800,2426,1852,156,8,0,309,0,8,574
17031800900,4505,2666,384,71,0,1203,0,9,1839
17031801000,5337,3867,217,46,3,918,3,29,1470
17031801100,4871,4033,261,31,4,252,0,33,838
17031801200,3651,3268,94,12,2,148,0,14,383
17031801300,4430,3677,212,51,1,272,1,25,753
17031801400,2922,2076,126,37,2,537,0,16,846
17031801500,6572,5216,297,104,4,745,0,16,1356
17031801601,4734,3651,165,40,3,776,2,1,1083
17031801603,4138,1914,360,196,16,1527,0,15,2224
17031801605,5883,4486,205,31,2,976,0,16,1397
17031801606,6716,4905,241,47,5,1315,0,62,1811
17031801607,5225,3220,228,87,1,1526,0,11,2005
17031801608,7057,4923,160,44,3,1735,0,16,2134
17031801701,3846,2988,143,2,2,562,0,7,858
17031801702,4756,3833,163,19,0,585,0,10,923
17031801800,5972,4895,219,43,3,626,0,9,1077
17031801901,5016,3150,1151,69,3,474,4,26,1866
17031801902,3420,2808,186,22,3,279,0,12,612
17031802002,5130,3826,340,49,7,710,1,38,1304
17031802003,2679,1602,406,56,1,525,0,7,1077
17031802004,5871,2461,957,185,0,2146,0,28,3410
17031802100,3734,3142,116,29,0,230,0,24,592
17031802200,4848,4051,210,47,1,356,0,20,797
17031802300,5968,3952,326,67,1,1375,3,15,2016
17031802402,5543,2806,1654,96,3,843,1,19,2737
17031802403,1531,1165,91,17,0,203,0,0,366
17031802404,7558,3048,3388,159,2,811,4,24,4510
17031802503,6412,3446,1048,149,6,1610,0,39,2966
17031802504,6442,2695,2957,54,3,591,0,26,3747
17031802505,6723,2097,3150,248,7,1077,1,46,4626
17031802506,2285,792,1165,94,2,197,0,2,1493
17031802605,7125,5016,477,104,2,1373,4,16,2109
17031802607,1536,1316,93,5,0,80,0,0,220
17031802608,6730,5540,324,72,12,615,0,17,1190
17031802609,6290,2275,2695,109,10,1105,0,18,4015
17031802610,1757,1191,164,26,3,317,5,6,566
17031802701,6682,3917,1472,93,0,1051,0,5,2765
17031802702,4710,3092,312,57,0,1121,0,28,1618
17031802801,5041,4091,433,49,3,314,1,12,950
17031802802,6991,5400,649,95,3,615,3,27,1591
17031802900,6055,5267,250,35,3,292,0,18,788
17031803005,2614,2112,175,33,4,226,0,11,502
17031803007,5153,4131,304,43,6,529,0,17,1022
17031803008,4767,3662,412,54,0,497,3,4,1105
17031803010,5351,3941,590,83,0,553,1,12,1410
17031803012,2234,1438,366,62,5,329,1,5,796
17031803013,5490,4060,609,52,0,606,1,6,1430
17031803014,3677,2306,862,46,0,397,0,13,1371
17031803015,4631,3476,503,58,8,475,2,16,1155
17031803016,2490,1077,167,26,2,1161,0,3,1413
17031803017,6283,4173,925,132,11,889,0,12,2110
17031803100,3616,3047,180,29,0,198,0,14,569
17031803200,5586,4849,278,33,5,268,4,13,737
17031803300,5726,4352,442,199,9,524,1,15,1374
17031803400,6592,5485,410,72,0,360,0,16,1107
17031803500,5803,5025,310,39,3,232,0,27,778
17031803603,6824,4716,247,67,5,1551,3,18,2108
17031803604,4209,3152,509,90,4,309,6,8,1057
17031803605,7002,4337,1346,198,13,915,0,24,2665
17031803607,4819,3816,464,57,1,293,4,13,1003
17031803608,7544,4869,1159,433,15,744,3,36,2675
17031803611,5698,2127,2577,299,5,578,0,19,3571
17031803612,3831,1165,1935,331,9,296,0,5,2666
17031803613,3434,658,2402,66,4,241,0,10,2776
17031803614,4422,1228,2476,226,5,405,1,29,3194
17031803615,2752,1627,379,133,0,539,0,5,1125
17031803616,4635,3046,672,201,11,555,0,13,1589
17031803701,2707,2005,294,35,1,269,0,10,702
17031803702,6376,4639,549,85,0,874,0,30,1737
17031803800,4522,3493,531,54,4,291,2,7,1029
17031803901,3935,2843,476,82,0,425,0,14,1092
17031803902,3429,2444,715,15,1,132,1,8,985
17031804000,4763,3209,1005,45,0,331,0,19,1554
17031804102,7307,5349,270,73,6,1387,0,19,1958
17031804104,4949,2799,254,98,4,1632,0,12,2150
17031804105,4168,3083,211,55,1,669,0,10,1085
17031804106,7264,4363,365,73,0,2231,0,9,2901
17031804108,4798,1669,560,463,2,1946,0,44,3129
17031804109,3078,2285,203,52,0,413,0,1,793
17031804202,7793,5419,474,48,3,1614,0,20,2374
17031804203,3458,1921,120,32,1,1290,0,2,1537
17031804204,5263,3906,281,53,4,859,0,14,1357
17031804305,6952,3091,2642,344,0,677,0,18,3861
17031804306,5626,2226,2954,136,12,164,1,12,3400
17031804308,5518,2994,948,280,0,1113,0,37,2524
17031804309,3038,1172,1416,112,3,265,0,4,1866
17031804312,2238,955,109,62,1,1038,0,9,1283
17031804313,6354,2591,1837,400,7,1316,0,15,3763
17031804314,1682,1046,265,52,0,275,0,5,636
17031804315,2446,1338,454,83,1,505,1,3,1108
17031804316,5027,2027,1209,267,6,1402,1,8,3000
17031804403,7297,2801,2568,541,7,1132,3,32,4496
17031804404,5147,1302,3237,170,0,351,2,8,3845
17031804405,3570,634,2316,354,3,168,0,12,2936
17031804406,6292,1705,3405,233,5,807,0,13,4587
17031804505,3970,2484,818,168,5,325,2,10,1486
17031804506,5472,3406,699,206,1,1020,0,12,2066
17031804508,2343,533,1105,398,1,243,0,9,1810
17031804509,6012,1405,3515,324,9,612,0,22,4607
17031804510,5872,869,4543,152,4,213,2,23,5003
17031804511,2426,398,1466,100,0,408,0,7,2028
17031804512,3995,1837,478,350,2,1186,1,18,2158
17031804513,4065,2330,458,124,5,1008,3,19,1735
17031804514,4690,2544,732,78,1,1208,0,9,2146
17031804603,5651,2337,1101,444,2,1582,1,28,3314
17031804606,7088,4940,458,83,2,1395,1,16,2148
17031804607,7123,4833,475,147,10,1472,0,18,2290
17031804608,4027,2102,511,110,3,1174,0,4,1925
17031804609,6147,2743,418,141,8,2668,0,14,3404
17031804610,2524,1586,139,33,0,701,0,4,938
17031804611,4653,3240,327,101,5,836,0,6,1413
17031804701,7045,2707,1653,764,13,1687,0,26,4338
17031804705,4148,1848,832,308,6,975,0,29,2300
17031804706,2553,1712,309,39,0,396,0,4,841
17031804709,6814,3381,1259,257,10,1719,2,23,3433
17031804710,4292,2905,535,114,7,576,0,12,1387
17031804711,7629,2939,1591,596,14,2183,2,30,4690
17031804712,5456,3098,606,353,12,1203,0,16,2358
17031804713,5037,2002,542,192,18,2102,0,29,3035
17031804714,3534,2258,522,107,7,502,1,7,1276
17031804715,3426,826,1387,109,14,1018,0,18,2600
17031804716,5360,2233,698,265,6,2029,0,15,3127
17031804803,5721,3417,647,229,5,1266,0,13,2304
17031804804,6809,3411,1521,304,10,1353,0,19,3398
17031804805,6860,4225,1094,183,8,1076,2,23,2635
17031804806,3796,1368,1241,388,18,634,1,13,2428
17031804807,5224,3330,776,202,1,736,0,10,1894
17031804808,2596,1937,227,27,0,297,0,3,659
17031804809,4259,3076,320,87,6,615,0,15,1183
17031804810,7097,4209,886,294,7,1456,6,20,2888
17031804901,6927,5661,420,70,0,505,0,18,1266
17031804902,5626,3735,588,107,5,1013,0,23,1891
17031805001,4985,4278,268,28,5,287,0,13,707
17031805002,7422,3716,1609,383,6,1505,0,23,3706
17031805105,7278,2806,3217,213,5,863,11,21,4472
17031805106,2778,2269,171,26,2,259,0,1,509
17031805107,6793,2813,2211,357,0,1211,1,18,3980
17031805108,6400,2489,1836,400,4,1513,3,20,3911
17031805109,4396,3516,240,51,1,490,0,17,880
17031805110,4440,3643,251,39,0,404,0,16,797
17031805111,7786,3182,2505,352,8,1522,6,39,4604
17031805112,3482,1746,727,72,6,851,0,13,1736
17031805201,3475,2170,243,53,5,931,0,6,1305
17031805202,4078,2783,302,59,4,760,1,9,1295
17031805301,3588,1859,334,69,5,1238,0,3,1729
17031805302,3873,2179,312,52,4,1222,2,1,1694
17031805401,4056,2969,508,21,5,443,2,7,1087
17031805402,5467,4016,450,35,0,810,0,16,1451
17031805501,3998,3265,413,33,0,186,0,1,733
17031805502,4295,3867,185,15,3,89,0,10,428
17031805600,4710,4197,238,12,2,123,0,4,513
17031805701,5485,4807,339,8,0,158,1,29,678
17031805702,2089,1737,171,2,0,97,0,12,352
17031805801,2580,2263,139,11,3,91,0,10,317
17031805802,5096,4292,362,32,2,242,0,18,804
17031805901,4341,3132,501,98,3,488,1,24,1209
17031805902,6503,5032,476,59,1,763,0,21,1471
17031806001,5818,2292,668,289,16,2367,2,43,3526
17031806002,7833,3519,996,394,9,2780,0,17,4314
17031806004,7554,3736,1306,207,5,2148,0,20,3818
17031806005,3258,922,538,189,9,1477,0,52,2336
17031806006,4885,2082,394,133,3,2115,0,81,2803
17031806102,4400,2656,715,146,9,756,0,22,1744
17031806103,5269,3415,739,72,7,872,0,13,1854
17031806104,4134,1800,707,535,12,969,0,5,2334
17031806201,4908,2970,898,154,2,783,5,13,1938
17031806202,4998,3702,527,150,2,472,0,20,1296
17031806300,4687,3238,973,73,0,225,1,30,1449
17031806400,2492,1714,437,44,1,211,0,6,778
17031806501,2665,750,1277,76,0,511,0,5,1915
17031806502,4202,2128,1488,75,2,400,0,13,2074
17031806600,3602,2041,975,68,0,417,2,10,1561
17031806700,4486,3070,312,298,0,582,0,8,1416
17031806801,4294,2275,336,241,3,1250,5,39,2019
17031806802,3445,1771,310,306,0,907,1,33,1674
17031806900,5342,2604,501,338,4,1715,0,26,2738
17031807000,5866,2540,840,592,3,1656,0,34,3326
17031807100,3984,2635,358,421,1,356,0,58,1349
17031807200,6059,2800,643,708,4,1597,0,52,3259
17031807300,7718,3355,770,674,8,2637,8,38,4363
17031807400,6824,3124,842,580,13,1923,3,33,3700
17031807500,3327,1504,401,200,2,1036,6,26,1823
17031807600,6705,2840,787,435,5,2367,0,34,3865
17031807700,6147,3096,707,348,10,1745,0,35,3051
17031807800,2878,1744,307,39,2,719,0,0,1134
17031807900,4201,2577,298,61,1,1103,0,19,1624
17031808001,3981,2140,285,62,1,1417,0,5,1841
17031808002,5281,2965,410,125,5,1644,1,21,2316
17031808100,4010,3133,364,60,2,377,0,9,877
17031808200,5646,3463,544,116,1,1385,0,21,2183
17031808301,6520,3333,514,148,7,2297,0,31,3187
17031808302,4367,2081,372,164,5,1556,0,19,2286
17031808400,4622,2414,381,73,7,1586,0,16,2208
17031808500,4239,2405,383,74,7,1218,0,11,1834
17031808600,2465,1958,164,24,1,221,0,7,507
17031808702,5481,2945,560,319,6,1286,9,31,2536
17031808800,3988,3085,199,147,0,350,2,16,903
17031808900,4149,3394,211,125,1,196,0,14,755
17031809000,4001,3464,111,120,0,103,0,19,537
17031809100,3437,2806,155,122,0,140,0,7,631
17031809200,4980,708,1277,2580,7,120,0,34,4272
17031809300,5043,2801,390,492,1,1072,1,20,2242
17031809401,2747,1854,147,185,6,466,0,6,893
17031809402,3374,1949,221,110,0,933,0,34,1425
17031809500,4346,2692,275,359,5,775,0,36,1654
17031809600,3319,1268,617,1057,8,123,0,17,2051
17031809700,3714,1547,815,979,12,124,1,28,2167
17031809800,2678,1849,199,289,5,163,6,16,829
17031809900,3046,2257,234,163,4,203,1,23,789
17031810000,5640,3977,426,361,11,521,0,37,1663
17031810100,4480,2664,538,666,4,315,0,20,1816
17031810200,6222,2025,1066,2277,21,406,5,77,4197
17031810301,4105,1465,911,1238,4,258,0,25,2640
17031810302,3360,1784,426,740,4,147,0,19,1576
17031810400,5409,4547,440,23,4,225,1,12,862
17031810501,5293,4314,634,19,0,230,2,14,979
17031810502,5355,4077,759,23,5,402,0,12,1278
17031810600,4949,3317,1006,50,8,460,0,7,1632
17031810701,4865,2535,2053,65,11,129,0,9,2330
17031810702,3914,2142,1412,181,1,92,0,10,1772
17031810800,5124,3056,1781,72,4,139,0,2,2068
17031810900,6360,3259,2456,274,5,249,7,25,3101
17031811000,4258,3083,897,66,3,123,0,5,1175
17031811100,6703,4434,1873,120,2,134,1,20,2269
17031811200,5401,2860,2160,105,4,153,0,18,2541
17031811301,4802,1226,3181,173,0,135,0,18,3576
17031811302,3565,622,2576,280,8,36,1,7,2943
17031811401,5001,1996,2640,91,4,186,0,16,3005
17031811402,4572,1785,2375,79,6,217,2,29,2787
17031811500,6031,2864,2817,32,5,221,0,19,3167
17031811600,6053,3637,1839,93,8,368,0,12,2416
17031811701,3455,771,2484,45,5,102,1,8,2684
17031811702,5384,1455,3492,163,3,181,3,19,3929
17031811800,5644,1941,3366,93,4,153,0,14,3703
17031811900,6051,4040,584,503,6,609,0,61,2011
17031812000,5666,4268,407,366,3,323,0,32,1398
17031812100,4763,2538,389,1298,5,175,3,26,2225
17031812200,3984,2772,274,487,3,196,0,10,1212
17031812301,4978,2968,475,795,0,499,2,23,2010
17031812302,2681,1796,220,332,0,133,0,15,885
17031812400,3458,2669,185,185,0,197,0,21,789
17031812500,3680,1896,345,1128,2,137,0,9,1784
17031812600,3898,1857,440,1150,4,173,2,34,2041
17031812700,3192,1894,295,579,0,218,0,18,1298
17031812801,3387,1850,360,741,2,246,0,20,1537
17031812802,2521,1503,232,499,1,133,0,19,1018
17031812900,4846,3428,427,455,0,238,0,20,1418
17031813000,3935,2399,379,727,4,142,2,22,1536
17031813100,4678,2353,553,1213,7,224,3,17,2325
17031813200,4582,2923,506,611,1,233,0,31,1659
17031813301,3634,154,3247,186,2,11,4,1,3480
17031813302,3858,95,3581,157,0,0,0,16,3763
17031813400,7571,506,6668,279,1,53,0,19,7065
17031813500,7169,504,6150,377,5,66,0,17,6665
17031813600,5443,268,4980,105,2,31,2,28,5175
17031813701,3886,148,3388,281,5,24,0,5,3738
17031813702,4199,147,3842,163,4,14,0,3,4052
17031813801,2856,95,2667,53,1,8,2,2,2761
17031813802,4958,289,4452,129,5,50,1,13,4669
17031813900,6768,514,5827,354,8,27,0,10,6254
17031814000,4706,330,4132,187,2,28,2,5,4376
17031814100,4683,255,4159,215,0,13,3,12,4428
17031814200,7671,358,7152,102,9,20,0,8,7313
17031814300,4690,301,4218,91,14,32,0,10,4389
17031814400,7781,762,6830,88,5,37,0,10,7019
17031814500,5395,606,4597,103,8,42,0,3,4789
17031814600,5616,1038,3807,535,8,125,0,31,4578
17031814700,5548,1226,3585,410,5,215,0,13,4322
17031814800,6445,1495,3890,735,10,196,0,21,4950
17031814900,6557,1181,3913,1179,5,143,2,25,5376
17031815000,4254,609,3023,447,21,93,2,10,3645
17031815100,4318,756,3135,238,3,98,0,20,3562
17031815200,6901,1460,4921,271,1,123,2,33,5441
17031815300,3756,1309,2100,156,14,82,0,4,2447
17031815400,5545,2418,2437,400,8,140,3,9,3127
17031815500,8310,1880,5915,251,4,150,0,23,6430
17031815600,5608,2906,2045,311,10,185,0,21,2702
17031815701,4124,3067,730,79,0,87,0,19,1057
17031815702,5302,4028,890,83,3,112,0,22,1274
17031815800,1630,1306,239,11,1,10,0,1,324
17031815900,4773,2094,475,1675,10,283,0,42,2679
17031816000,3307,1965,280,670,4,192,3,29,1342
17031816100,6259,2697,868,2000,12,404,0,42,3562
17031816200,4163,1602,1918,458,4,135,1,9,2561
17031816300,4778,1032,3427,181,0,88,0,13,3746
17031816401,4664,343,4127,140,0,17,0,9,4321
17031816402,4460,565,3595,258,2,15,0,6,3895
17031816500,4262,468,3579,142,2,29,1,12,3794
17031816600,4522,278,4037,134,3,44,0,6,4244
17031816700,2693,441,1999,127,0,68,0,2,2252
17031816800,5765,1577,2034,1771,13,223,3,13,4188
17031816900,5561,182,1985,3222,10,77,1,14,5379
17031817000,5510,191,1635,3583,7,16,0,19,5319
17031817101,4563,107,760,3539,1,20,0,19,4456
17031817102,3158,65,657,2361,1,6,1,13,3093
17031817200,4821,69,1325,3311,5,11,0,17,4752
17031817300,2799,21,1155,1572,0,6,0,0,2778
17031817400,3652,374,2389,798,0,31,0,7,3278
17031817500,3612,78,1179,2247,4,18,1,9,3534
17031817600,3825,94,949,2653,7,34,0,17,3731
17031817700,4803,86,1005,3612,3,10,3,11,4717
17031817900,5532,448,804,4060,0,70,0,20,5084
17031818000,4428,1244,1078,1859,8,135,0,22,3184
17031818100,2330,1166,631,350,5,104,0,10,1164
17031818200,4762,1701,1215,1510,7,167,1,15,3061
17031818300,5922,879,2335,2423,6,181,1,21,5043
17031818401,3613,1268,965,1157,8,110,1,19,2345
17031818402,3282,1642,684,720,0,152,0,25,1640
17031818500,5650,3809,792,706,0,240,1,0,1841
17031818600,5093,3717,719,306,5,153,2,20,1376
17031818700,3691,2641,805,78,16,54,1,5,1050
17031818800,5692,4089,1189,93,4,76,2,23,1603
17031818900,4496,3351,635,267,4,127,0,8,1145
17031819000,4768,4243,313,15,4,48,0,6,525
17031819100,4600,1984,2095,278,9,76,0,25,2616
17031819200,6154,2482,3227,185,7,105,1,18,3672
17031819300,2777,1687,848,100,3,52,0,11,1090
17031819400,5686,3068,1939,315,3,154,0,12,2618
17031819500,3664,2493,490,429,5,85,0,12,1171
17031819600,4083,3598,267,36,0,47,0,8,485
17031819700,6028,5443,262,19,1,65,0,10,585
17031819801,5364,4904,208,18,0,75,0,10,460
17031819802,2741,2503,125,10,0,39,1,1,238
17031819900,3514,3198,172,12,2,34,0,8,316
17031820000,2230,1585,148,43,0,348,0,10,645
17031820101,7889,6678,475,147,4,411,0,17,1211
17031820103,4285,3004,891,143,2,115,0,11,1281
17031820104,4453,3051,964,196,2,122,0,6,1402
17031820202,3128,1952,1007,29,16,39,0,7,1176
17031820203,4038,3210,348,55,0,308,0,14,828
17031820204,4434,3445,581,69,4,229,1,10,989
17031820300,5588,1332,3826,156,6,203,1,17,4256
17031820400,5556,451,4290,696,14,19,2,20,5105
17031820501,5905,3994,1530,114,10,112,0,11,1911
17031820502,5380,3486,1272,348,5,136,4,14,1894
17031820603,5530,3381,1652,246,7,114,2,8,2149
17031820604,3689,2844,558,137,6,31,0,14,845
17031820605,4523,1435,615,2282,5,50,0,6,3088
17031820606,3866,2895,598,172,5,95,0,6,971
17031820700,7110,2111,4568,168,11,91,1,38,4999
17031820800,3695,1278,2232,64,1,54,0,5,2417
17031820901,5582,2909,2280,123,11,137,2,27,2673
17031820902,5051,2119,2608,103,0,150,0,13,2932
17031821001,5205,3288,1544,79,0,164,0,5,1917
17031821002,5764,3408,2020,95,7,105,3,18,2356
17031821101,4876,2690,1776,41,10,226,0,14,2186
17031821102,4231,1849,2030,99,5,157,0,11,2382
17031821200,5641,569,2490,2456,7,12,0,14,5072
17031821300,5477,641,2864,1839,15,26,0,28,4836
17031821401,2870,67,200,2542,0,2,0,18,2803
17031821402,3200,76,81,2961,7,2,0,17,3124
17031821500,1421,44,48,1304,3,0,2,0,1377
17031821600,4542,1298,1045,1947,4,53,0,34,3244
17031821700,4859,3368,591,707,0,52,0,26,1491
17031821800,5415,2866,1046,1257,11,76,6,23,2549
17031821900,5129,3367,729,864,7,51,2,12,1762
17031822000,4343,2979,1118,86,7,38,2,16,1364
17031822101,4606,2847,1284,265,5,87,0,13,1759
17031822102,4504,2203,1166,875,6,152,0,9,2301
17031822200,3929,2385,1273,110,0,39,0,22,1544
17031822301,4088,2777,995,146,1,76,0,11,1311
17031822302,4447,2778,1120,275,8,164,1,26,1669
17031822400,6362,4523,1230,232,11,167,1,22,1839
17031822500,4496,2927,1070,197,13,107,1,18,1569
17031822601,4793,3284,1117,155,12,75,2,29,1509
17031822602,7296,5173,935,608,3,363,0,24,2123
17031822701,4438,2362,1143,654,13,166,0,7,2076
17031822702,3828,2403,741,418,4,146,0,9,1425
17031822801,3258,2146,600,350,4,81,0,6,1112
17031822802,3669,2710,675,121,4,48,0,11,959
17031822900,2078,1455,450,76,0,26,0,12,623
17031823001,6624,4261,1024,915,4,212,0,33,2363
17031823002,6006,4392,1012,328,1,79,0,16,1614
17031823101,4515,3417,698,165,0,93,0,17,1098
17031823102,3642,2671,597,155,2,71,3,18,971
17031823200,4775,3096,1055,368,7,134,6,9,1679
17031823302,5739,2091,1347,2041,0,116,0,16,3648
17031823303,4581,2338,1436,660,1,29,3,9,2243
17031823304,5872,2671,1527,1373,6,102,1,21,3201
17031823400,4892,1002,2617,1132,0,37,0,6,3890
17031823500,4301,1155,2178,831,11,13,6,14,3146
17031823602,6209,4998,631,337,1,106,0,13,1211
17031823603,2021,81,1183,725,0,0,0,7,1940
17031823604,3509,3057,228,71,0,57,0,5,452
17031823605,4177,3318,392,284,3,53,0,14,859
17031823702,7050,5146,748,810,3,160,0,23,1904
17031823703,8659,6169,1546,255,7,420,0,35,2490
17031823704,4191,3208,703,88,1,113,0,18,983
17031823705,4666,3430,762,162,0,145,0,19,1236
17031823801,5873,5023,414,44,2,214,2,20,850
17031823803,7146,5901,794,144,6,147,0,31,1245
17031823805,3189,2716,229,76,2,64,0,26,473
17031823806,3847,2906,515,175,3,95,1,31,941
17031823901,3515,2953,226,91,0,153,0,13,562
17031823903,4657,4119,305,67,0,70,0,16,538
17031823904,4043,3704,165,20,2,79,0,16,339
17031824003,6242,5542,430,39,0,73,5,18,700
17031824004,5374,4774,305,42,0,117,1,9,600
17031824005,5933,5077,450,55,3,190,0,0,856
17031824006,5096,4417,358,55,0,160,0,3,679
17031824105,7297,5960,568,229,0,350,1,19,1337
17031824106,7021,5704,654,200,5,304,0,8,1317
17031824107,6747,5497,562,215,4,276,0,31,1250
17031824113,6322,5277,412,101,2,348,0,18,1045
17031824114,5299,4179,382,216,2,375,1,10,1120
17031824115,3843,3012,471,96,3,132,0,13,831
17031824116,5244,3839,710,291,11,221,1,33,1405
17031824119,5456,4491,351,156,2,325,0,3,965
17031824121,3138,2621,252,87,0,83,2,7,517
17031824122,6209,5162,438,163,0,307,0,7,1047
17031824123,7753,6058,810,407,5,251,0,11,1695
17031824124,3679,2300,364,607,7,292,0,8,1379
17031824125,4098,3240,551,45,1,162,0,8,858
17031824126,5951,4858,420,174,0,336,0,11,1093
17031824127,3706,3134,229,128,3,135,0,6,572
17031824128,4638,3803,251,171,8,296,0,12,835
17031824129,4357,3622,260,135,2,248,1,4,735
17031824300,4499,274,527,3576,2,11,0,17,4225
17031824400,2007,707,421,795,2,22,0,7,1300
17031824503,6880,5322,792,386,0,163,0,22,1558
17031824505,6783,4616,922,482,23,496,3,30,2167
17031824507,4136,3227,425,240,0,113,0,10,909
17031824508,3699,2996,335,157,9,113,0,15,703
17031824509,4154,3134,579,257,6,67,0,7,1020
17031824601,4392,3076,790,272,0,67,0,25,1316
17031824602,6245,4208,1139,493,14,153,0,10,2037
17031824701,3782,1786,1319,463,5,68,3,7,1996
17031824702,5453,2079,2196,959,3,38,0,18,3374
17031824800,7178,1077,4347,1455,13,160,0,18,6101
17031824900,3244,426,894,1822,2,28,0,12,2818
17031825000,4766,2887,871,463,17,322,0,55,1879
17031825200,2016,889,681,274,5,109,0,1,1127
17031825302,5938,4035,790,682,0,232,0,21,1903
17031825303,3785,2933,459,250,0,67,0,8,852
17031825304,3923,3109,340,171,0,172,0,15,814
17031825400,5337,4236,443,371,1,117,4,19,1101
17031825501,5766,518,348,4723,8,19,0,23,5248
17031825503,6540,762,335,5176,6,31,0,25,5778
17031825504,3591,153,162,3118,7,28,0,26,3438
17031825505,5364,343,248,4582,6,52,0,10,5021
17031825600,5138,409,879,3631,7,72,0,7,4729
17031825700,4046,491,1035,2419,2,12,0,15,3555
17031825801,3569,128,159,3196,0,9,0,12,3441
17031825802,5862,194,632,4905,0,10,0,13,5668
17031825803,5908,248,516,4997,4,0,0,36,5660
17031825900,3296,269,990,1928,4,4,0,18,3027
17031826000,2660,223,1023,1313,10,0,3,6,2437
17031826100,5931,734,1816,3259,14,5,0,9,5197
17031826201,3844,272,226,3250,7,7,0,8,3572
17031826202,5710,701,1198,3654,12,22,1,15,5009
17031826301,3923,203,290,3286,3,15,0,20,3720
17031826303,4068,142,104,3689,10,0,0,43,3926
17031826304,2874,77,105,2619,2,5,1,26,2797
17031826401,3725,59,182,3397,2,5,0,15,3666
17031826402,4728,122,220,4285,4,7,0,7,4606
17031826500,5614,170,278,5016,5,8,0,23,5444
17031826600,4595,120,161,4212,0,3,2,18,4475
17031826700,4573,137,121,4214,8,9,3,22,4436
17031826800,4596,548,1883,2024,13,27,2,13,4048
17031826901,1462,12,266,1148,0,0,0,7,1450
17031826902,1255,18,197,1004,0,5,0,8,1237
17031827000,2968,63,406,2394,11,9,0,22,2905
17031827100,2265,41,275,1741,0,158,0,3,2224
17031827200,3693,135,923,2541,9,9,3,27,3558
17031827300,2277,62,484,1484,0,187,3,14,2215
17031827400,3230,102,448,2607,1,3,3,6,3128
17031827500,4465,210,2307,1868,7,0,1,14,4255
17031827600,3012,19,220,2696,2,3,0,13,2993
17031827700,2452,212,282,1875,7,14,2,10,2240
17031827801,4645,782,398,3316,1,20,0,12,3863
17031827802,3314,220,243,2737,2,20,1,16,3094
17031827804,3149,314,172,2553,3,18,0,13,2835
17031827805,2953,284,168,2438,5,0,0,7,2669
17031827901,2421,163,55,2117,4,16,0,8,2258
17031827902,4558,883,878,2552,2,69,0,39,3675
17031828000,5411,1610,1352,2256,2,24,1,27,3801
17031828100,5083,2035,1092,1767,13,26,0,32,3048
17031828201,4491,1166,977,2161,7,34,1,35,3325
17031828202,4590,1224,672,2485,3,47,1,8,3366
17031828300,3363,1451,495,1302,3,10,0,14,1912
17031828401,3598,2030,300,1062,0,37,0,20,1568
17031828402,3688,1302,423,1767,6,27,0,18,2386
17031828503,4322,607,607,2933,6,17,3,36,3715
17031828504,5474,925,819,3434,3,21,0,25,4549
17031828505,6682,1913,1427,3117,3,61,2,41,4769
17031828507,3999,670,303,2862,6,35,0,14,3329
17031828508,4630,723,375,3360,7,23,0,11,3907
17031828601,4198,2378,514,1081,4,56,0,17,1820
17031828602,4666,1349,344,2672,2,85,0,33,3317
17031828701,3780,700,325,2645,5,5,0,13,3080
17031828702,4742,538,454,3605,1,6,3,22,4204
17031828801,5122,1741,896,2183,4,79,3,18,3381
17031828802,2982,964,860,1041,0,4,0,10,2018
17031828900,3399,328,1810,1201,5,1,0,4,3071
17031829000,882,13,79,748,0,7,0,2,869
17031829100,3512,267,2406,771,0,4,3,8,3245
17031829200,5547,1023,2742,1617,10,15,13,16,4524
17031829301,3931,978,1007,1807,6,13,0,28,2953
17031829302,3633,238,1003,2267,7,10,6,26,3395
17031829401,1049,17,166,851,0,0,0,0,1032
17031829402,3088,675,187,2017,1,39,9,5,2413
17031829500,4001,1249,1897,670,5,66,2,9,2752
17031829600,3035,1520,793,517,2,50,2,14,1515
17031829700,3344,698,315,2215,11,20,0,12,2646
17031829800,6891,2427,347,3696,7,107,1,24,4464
17031829902,6457,574,213,5383,4,60,3,21,5883
17031829903,4529,267,285,3806,6,51,0,7,4262
17031829904,4168,1869,226,1854,3,118,0,24,2299
17031830001,2432,1419,701,184,4,62,0,4,1013
17031830003,7640,203,241,6878,9,57,2,46,7437
17031830004,7529,556,286,6383,7,94,0,44,6973
17031830005,3768,560,130,2901,0,58,0,32,3208
17031830006,2526,453,201,1749,2,27,0,10,2073
17031830007,4638,375,296,3801,16,29,0,19,4263
17031830008,4342,221,176,3811,3,34,0,11,4121
17031830100,3297,414,273,2448,11,23,0,31,2883
17031830201,5105,507,201,4191,7,37,1,9,4598
17031830202,3377,606,283,2346,0,13,0,17,2771
17031830300,5369,761,331,4028,2,35,0,45,4608
17031830400,4091,924,424,2508,4,22,0,16,3167
17031830500,4410,73,4260,36,3,6,0,13,4337
17031830600,4935,1626,1933,795,8,324,0,35,3309
17031830700,4006,1704,548,1267,10,291,4,10,2302
17031830800,2405,1661,400,75,6,144,0,9,744
17031830900,3076,1663,969,126,5,197,2,15,1413
17031831000,2633,2048,252,42,0,163,1,5,585
17031831100,6697,2432,3515,196,6,343,0,30,4265
17031831200,4832,301,4199,230,6,38,0,15,4531
17031831300,1251,26,760,443,0,11,0,4,1225
17031831400,2820,256,537,1929,12,29,2,12,2564
17031831500,4421,1029,2730,391,5,189,0,15,3392
17031831600,7745,1529,5259,614,7,167,0,80,6216
17031831700,2237,856,1128,66,2,121,2,3,1381
17031831800,5868,2254,1574,317,7,1429,3,67,3614
17031831900,3040,2498,243,42,0,132,1,9,542
17031832000,2062,1631,187,55,1,91,0,5,431
17031832100,3410,2160,356,524,5,188,0,28,1250
17031832200,3289,2502,395,52,4,167,2,14,787
17031832300,2054,1431,305,47,0,156,3,6,623
17031832400,3601,2148,917,135,2,245,0,16,1453
17031832500,3334,2478,272,267,0,185,1,12,856
17031832600,4147,3443,232,64,0,241,0,37,704
17031832900,1995,914,200,85,1,710,0,9,1081
17031833000,5637,3933,341,384,3,679,1,23,1704
17031833100,9493,5971,709,799,5,1609,9,49,3522
17031833300,2912,1333,277,161,2,962,0,47,1579
17031833900,2333,67,987,1230,0,10,0,7,2266
17031834000,3609,22,91,3410,6,4,0,5,3587
17031834200,4693,47,129,4310,13,8,2,23,4646
17031834300,6240,35,120,5859,7,12,2,26,6205
17031834400,3765,163,111,3320,6,29,0,21,3602
17031834500,1765,17,34,1664,0,5,0,2,1748
17031834600,2357,21,204,2056,7,3,0,17,2336
17031834700,1759,11,153,1544,1,4,3,6,1748
17031834800,1753,9,127,1554,0,5,0,2,1744
17031834900,1952,6,146,1756,4,2,0,6,1946
17031835000,6398,89,3614,2619,0,7,0,23,6309
17031835100,5585,130,4604,759,32,4,0,34,5455
17031835200,2038,556,1365,59,1,44,2,2,1482
17031835500,1584,50,212,1254,0,9,0,9,1534
17031835600,898,15,183,672,0,4,0,5,883
17031835800,1698,43,48,1528,5,8,0,2,1655
17031836000,2338,62,97,2095,3,1,1,6,2276
17031836100,1893,20,68,1772,3,4,0,7,1873
17031836200,2178,1086,242,116,1,575,5,19,1092
17031836300,1492,477,109,701,0,133,0,2,1015
17031836400,3621,151,144,3168,1,33,0,21,3470
17031836500,1527,15,35,1433,0,2,0,6,1512
17031836600,2929,552,1544,696,6,38,0,12,2377
17031836700,2481,194,587,1629,4,5,0,5,2287
17031836800,2645,215,290,2057,2,18,0,12,2430
17031836900,1439,53,141,1202,1,9,0,1,1386
17031837000,2042,129,163,1697,1,7,0,6,1913
17031837100,1652,202,204,1149,2,21,2,8,1450
17031837300,2489,111,171,2154,1,2,0,14,2378
17031837400,1990,150,223,1546,3,15,1,2,1840
17031837800,2837,444,276,1884,7,109,0,19,2393
17031838000,2651,470,253,1677,13,128,0,21,2181
17031838100,1821,536,141,970,4,95,3,2,1285
17031838200,1675,475,272,240,4,616,0,22,1200
17031838300,2580,1309,195,776,5,216,0,9,1271
17031838600,1518,67,114,1295,0,20,0,5,1451
17031838700,4132,25,290,3730,2,0,0,8,4107
17031838800,3102,102,1316,1606,11,3,0,21,3000
17031839000,10435,5938,918,1141,14,1912,7,57,4497
17031839100,8234,4358,765,975,15,1720,1,36,3876
17031839200,2749,288,104,1771,0,465,4,25,2461
17031839500,1590,220,79,1163,3,56,2,9,1370
17031839600,1729,87,74,1491,3,17,0,6,1642
17031839700,4545,1730,1449,152,6,1064,0,32,2815
17031839800,2686,1029,538,31,5,994,2,5,1657
17031839900,4431,2127,1050,133,5,950,0,19,2304
17031840000,3001,1060,548,43,0,1273,0,15,1941
17031840100,3029,641,306,31,5,1989,0,7,2388
17031840200,2497,401,397,56,0,1621,0,6,2096
17031840300,4196,446,2284,74,4,1343,0,9,3750
17031840400,3369,489,1396,36,4,1387,1,12,2880
17031840700,3900,294,3371,145,10,47,0,5,3606
17031840800,3332,61,3238,8,2,1,0,3,3271
17031841000,1136,278,94,528,2,173,0,7,858
17031841100,7356,338,203,292,0,6439,0,5,7018
17031841200,4873,779,3653,230,3,106,0,19,4094
17031841300,4173,690,3167,142,5,80,1,17,3483
17031841500,2904,46,165,2630,4,1,0,9,2858
17031841700,1509,115,707,645,5,3,2,1,1394
17031841800,2404,8,67,2253,3,4,0,4,2396
17031841900,6500,2454,968,988,17,1761,0,162,4046
17031842000,2590,672,200,1123,1,479,5,49,1918
17031842100,6650,202,3702,2611,4,26,0,25,6448
17031842200,4212,2376,279,954,4,400,1,19,1836
17031842300,3529,2235,413,448,4,287,0,14,1294
17031842400,3041,16,53,2909,5,7,0,6,3025
17031842500,2644,0,62,2534,3,1,0,0,2644
17031842600,4245,1780,1493,214,5,670,0,12,2465
17031842800,7637,369,6910,41,3,282,1,12,7268
17031842900,2480,356,356,1629,2,62,0,9,2124
17031843000,2880,16,140,2665,8,4,0,7,2864
17031843100,1747,137,136,1428,2,10,2,3,1610
17031843200,2422,392,1827,106,11,46,0,6,2030
17031843300,1572,96,384,1031,6,16,0,4,1476
17031843400,1524,29,553,913,5,0,0,4,1495
17031843500,6030,503,1782,3677,10,33,0,7,5527
17031843600,3089,99,141,2706,4,12,0,22,2990
17031843700,2544,1569,483,91,3,243,0,9,975
17031843800,2000,389,695,728,2,134,0,10,1611
17031843900,3666,228,99,3145,6,29,3,24,3438
17031844600,1776,48,48,1631,0,6,0,12,1728
17031844700,2342,68,414,1788,2,7,0,11,2274
17031980000,0,0,0,0,0,0,0,0,0
17031980100,18,3,6,3,0,0,1,2,15
17031990000,0,0,0,0,0,0,0,0,0
17033880100,2656,2566,28,14,5,5,0,9,90
17033880200,3491,3305,31,39,7,6,1,4,186
17033880300,3338,3039,115,39,11,22,1,3,299
17033880400,2870,2589,74,36,6,21,0,4,281
17033880500,3414,2672,177,476,3,15,0,5,742
17033880600,2910,2770,22,4,4,7,0,4,140
17035972400,2913,2738,36,13,4,6,0,4,175
17035972500,3356,3221,25,3,4,9,0,3,135
17035972600,4181,3988,51,12,5,6,0,10,193
17037000100,6737,5297,1081,49,13,47,0,4,1440
17037000200,4513,3873,407,24,6,7,3,13,640
17037000300,2520,2110,240,42,8,2,0,4,410
17037000401,3975,3433,236,52,6,93,1,13,542
17037000402,5184,4445,310,61,4,106,0,8,739
17037000500,4070,2904,684,227,10,69,0,13,1166
17037000600,5919,4856,502,179,2,104,3,19,1063
17037000700,3694,3049,277,145,1,70,0,16,645
17037000800,6635,4320,1425,504,14,93,7,20,2315
17037000900,4960,3302,761,334,4,298,1,6,1658
17037001002,5860,2508,698,1763,8,580,3,29,3352
17037001003,4134,853,488,2481,3,96,1,16,3281
17037001004,2374,1341,283,532,2,86,3,17,1033
17037001300,5267,3303,1201,384,2,100,0,25,1964
17037001400,6371,4473,837,585,8,152,0,26,1898
17037001500,3831,2312,1174,155,5,24,1,11,1519
17037001600,4383,3280,742,117,7,40,1,7,1103
17037001700,3388,3002,222,22,2,19,3,3,386
17037001800,3764,3380,214,25,7,22,0,11,384
17037001900,2363,2115,145,2,2,4,0,0,248
17037002000,4732,3943,552,33,3,35,0,14,789
17037002100,2461,1830,512,26,0,19,1,3,631
17037002200,3285,1320,606,988,2,214,1,20,1965
17039971400,2493,2331,47,17,2,3,3,2,162
17039971500,2601,2511,28,2,0,4,3,1,90
17039971600,3589,3389,80,14,7,12,1,5,200
17039971700,3271,2967,160,23,2,14,1,0,304
17039971800,3562,3172,195,52,8,7,8,8,390
17041952000,2181,2027,80,10,3,4,0,0,154
17041952100,4025,3724,95,16,7,10,3,9,301
17041952200,4668,4251,158,26,7,55,0,6,417
17041952300,5395,5140,145,6,9,6,2,4,255
17041952400,3471,2278,1087,9,2,28,1,15,1193
17043840000,2835,839,1795,42,5,107,0,6,1996
17043840101,5680,2758,2416,68,3,302,0,16,2922
17043840102,4734,3100,1213,113,2,226,0,4,1634
17043840103,6440,4468,1131,96,0,577,0,21,1972
17043840104,6031,1815,3744,139,8,228,0,24,4216
17043840201,6348,4642,677,84,10,710,0,23,1706
17043840202,5065,3670,813,33,0,454,0,16,1395
17043840303,3597,1549,1604,174,1,213,0,3,2048
17043840304,3627,2712,567,39,4,236,0,9,915
17043840600,5068,4000,545,76,2,239,3,16,1068
17043840703,4295,1798,1688,397,8,325,0,9,2497
17043840704,3217,1343,1641,77,6,97,0,7,1874
17043840705,3759,2210,736,146,2,533,1,13,1549
17043840706,3370,2021,590,70,6,586,0,7,1349
17043840801,2621,1138,1293,85,0,65,0,3,1483
17043840802,5866,2357,2895,126,7,328,1,26,3509
17043840901,3833,2576,719,125,3,302,0,21,1257
17043840904,3610,1081,1060,543,6,819,1,13,2529
17043840906,2970,1238,957,343,11,357,0,14,1732
17043840907,4658,1860,1267,255,12,1162,0,16,2798
17043840908,4420,1682,1545,287,4,760,2,17,2738
17043840910,4918,2050,1892,291,6,539,6,16,2868
17043840911,3125,1049,1010,81,3,898,0,12,2076
17043841002,3321,2824,207,50,1,145,1,4,497
17043841003,3631,2603,482,112,4,287,8,19,1028
17043841004,3480,2760,390,78,5,142,0,6,720
17043841102,5787,3564,1106,271,4,679,0,17,2223
17043841103,3775,2801,511,67,0,252,0,12,974
17043841104,4411,3420,475,33,0,344,2,20,991
17043841108,4589,1559,1503,784,8,590,6,12,3030
17043841109,4057,2132,870,243,9,637,0,20,1925
17043841110,3478,2732,348,69,3,203,0,4,746
17043841111,3651,2758,316,41,8,458,0,11,893
17043841112,3112,1968,447,97,6,498,1,3,1144
17043841113,3886,2003,761,249,0,778,0,17,1883
17043841114,4476,2709,584,220,7,804,0,16,1767
17043841204,5974,1931,1570,259,6,2026,4,34,4043
17043841205,4506,2714,675,83,4,905,1,31,1792
17043841206,5877,3674,1026,160,1,832,0,17,2203
17043841207,2945,958,1267,114,0,545,0,7,1987
17043841208,5048,2182,1409,277,5,994,0,21,2866
17043841209,3952,2239,428,143,10,998,0,27,1713
17043841210,4385,1808,961,461,3,992,0,28,2577
17043841307,5799,4075,693,176,1,676,0,12,1724
17043841308,4028,2930,281,54,5,629,0,9,1098
17043841310,3512,2426,237,43,2,691,0,16,1086
17043841312,3795,1090,1686,185,10,733,0,23,2705
17043841313,2872,2081,378,63,5,260,0,12,791
17043841314,6288,4275,687,104,4,928,0,17,2013
17043841315,3371,1506,861,269,5,623,3,9,1865
17043841316,3555,2631,359,54,2,375,0,11,924
17043841318,2835,1727,520,60,3,434,7,4,1108
17043841320,2613,878,734,135,4,756,0,17,1735
17043841321,2391,1450,201,89,1,589,0,13,941
17043841322,4326,1612,808,219,5,1570,1,20,2714
17043841323,3102,1699,464,142,0,675,0,6,1403
17043841324,2683,1603,316,88,2,560,0,11,1080
17043841325,5535,3356,654,123,1,1202,2,29,2179
17043841326,3356,2548,283,44,6,364,0,21,808
17043841327,4366,3210,344,42,5,629,2,17,1156
17043841401,6894,3579,2772,135,8,227,0,11,3315
17043841403,3899,3117,416,78,0,103,0,4,782
17043841404,3223,2649,312,22,2,135,0,5,574
17043841501,5927,1720,3763,199,3,110,0,18,4207
17043841503,3600,476,3002,23,4,29,0,3,3124
17043841504,2970,1016,1754,77,6,42,0,6,1954
17043841603,4709,2680,1664,75,8,142,0,13,2029
17043841604,4169,2116,1234,248,3,353,3,22,2053
17043841605,3552,1959,1204,81,5,176,0,8,1593
17043841606,2065,1597,196,47,1,152,0,3,468
17043841607,4884,3050,1210,152,12,223,0,25,1834
17043841704,4609,3272,315,376,0,469,0,13,1337
17043841705,5858,2752,1074,333,9,1477,0,26,3106
17043841706,4564,1331,1182,322,7,1570,0,25,3233
17043841707,3305,1063,916,345,5,884,0,14,2242
17043841708,4594,1910,1160,739,1,614,1,25,2684
17043841801,5305,4245,253,76,4,505,0,21,1060
17043841802,5515,4525,377,76,8,293,0,19,990
17043841901,2467,2134,131,17,3,96,0,8,333
17043841902,4088,3100,268,132,7,374,3,17,988
17043842000,4400,3871,188,5,0,133,0,7,529
17043842100,5891,4918,292,161,1,273,3,22,973
17043842200,4731,3986,252,170,0,160,0,0,745
17043842300,3584,3099,174,77,0,113,0,5,485
17043842400,5062,3635,354,291,0,541,0,40,1427
17043842500,3578,2973,209,63,0,152,0,8,605
17043842601,4107,3364,207,78,1,272,0,18,743
17043842602,4335,3794,170,47,0,138,0,10,541
17043842603,4359,3196,405,307,4,283,0,12,1163
17043842604,4383,3398,252,359,3,195,0,18,985
17043842605,4289,3389,290,146,6,246,1,16,900
17043842702,4479,3265,392,262,8,361,0,10,1214
17043842703,4039,3193,254,76,2,334,0,5,846
17043842704,5215,3662,414,438,6,508,0,17,1553
17043842706,4787,3901,328,118,0,265,0,12,886
17043842708,2551,2032,154,31,0,222,0,0,519
17043842709,3471,2176,440,247,4,461,0,13,1295
17043842710,3805,2658,360,271,3,367,5,9,1147
17043842711,2810,2288,157,41,1,230,0,10,522
17043842800,4781,3883,369,37,1,302,0,13,898
17043842900,6022,4887,487,162,7,249,1,43,1135
17043843000,4087,3151,429,159,7,197,0,11,936
17043843100,3970,2093,1192,360,7,170,0,15,1877
17043843200,5335,2926,1733,256,9,204,0,25,2409
17043843301,4020,2458,1082,131,6,231,0,2,1562
17043843302,2959,2350,355,61,2,106,0,9,609
17043843400,3492,2720,404,79,1,170,0,4,772
17043843500,5528,4395,484,164,6,271,0,8,1133
17043843601,3426,2477,519,122,0,121,0,22,949
17043843602,3106,2619,261,27,0,87,0,5,487
17043843700,4373,3590,408,43,3,145,0,26,783
17043843800,3433,2709,419,84,0,96,0,7,724
17043843900,4216,3573,283,41,9,139,0,12,643
17043844001,3716,3109,237,35,0,220,0,4,607
17043844002,4205,3644,231,19,0,142,2,17,561
17043844100,4077,3522,262,39,2,129,0,8,555
17043844201,5822,4099,728,233,8,531,0,30,1723
17043844202,2741,2096,218,35,3,263,0,9,645
17043844304,4077,1825,444,201,5,1504,0,15,2252
17043844305,3962,2678,229,349,10,536,0,5,1284
17043844306,5956,2271,1311,729,11,1433,4,30,3685
17043844307,3749,1817,557,295,11,914,3,18,1932
17043844308,2383,1421,183,218,6,467,1,16,962
17043844309,2390,1648,154,113,0,388,5,1,742
17043844310,2417,1244,183,200,0,712,0,14,1173
17043844401,4075,3044,239,305,2,357,0,16,1031
17043844402,4670,2575,349,272,8,1315,0,19,2095
17043844501,3277,2434,327,102,6,297,0,9,843
17043844502,3247,1953,103,91,4,1002,1,8,1294
17043844601,3627,2603,286,88,2,525,1,18,1024
17043844602,5286,3785,384,241,4,699,0,16,1501
17043844701,4265,3221,521,100,11,271,0,5,1044
17043844702,5601,4299,303,90,4,677,3,16,1302
17043844801,4376,3676,329,17,1,179,3,12,700
17043844802,3472,2929,271,33,1,145,0,6,543
17043844901,3716,3123,251,64,3,143,4,8,593
17043844902,4229,3637,159,42,0,224,1,9,592
17043845000,5458,4249,600,149,4,210,0,16,1209
17043845100,6522,5273,337,56,3,508,0,25,1249
17043845200,4847,3792,219,58,5,557,0,9,1055
17043845300,3166,2683,151,18,0,167,1,14,483
17043845401,3656,2448,210,49,3,802,0,15,1208
17043845402,3060,1981,227,114,8,606,4,2,1079
17043845502,5413,3639,563,348,1,700,1,16,1774
17043845505,4066,2673,452,271,0,538,0,11,1393
17043845506,3995,2347,780,228,6,540,6,19,1648
17043845507,3423,2885,248,39,1,166,1,15,538
17043845508,3753,2864,217,51,0,539,2,3,889
17043845509,3334,1989,223,79,1,937,1,2,1345
17043845510,3308,1754,307,272,7,866,7,10,1554
17043845601,4354,2981,589,372,1,242,0,13,1373
17043845602,4965,4075,312,116,6,254,0,13,890
17043845701,3935,3248,270,100,4,172,0,6,687
17043845702,4839,4044,286,72,7,240,2,7,795
17043845703,4582,2802,487,564,8,579,2,9,1780
17043845704,4896,3439,486,438,1,376,3,7,1457
17043845802,3689,2872,245,64,1,394,4,9,817
17043845803,5649,2865,564,1549,4,462,3,21,2784
17043845805,4145,2861,491,149,0,507,3,7,1284
17043845807,6100,4616,395,168,0,726,2,15,1484
17043845808,3868,2617,305,63,0,750,0,17,1251
17043845809,4374,2972,300,233,4,714,1,23,1402
17043845810,4067,2688,437,367,2,451,5,16,1379
17043845811,3891,2799,471,155,1,326,0,10,1092
17043845901,3418,2313,209,99,0,688,0,15,1105
17043845902,3489,2499,257,91,6,529,0,6,990
17043846002,4737,3676,326,246,8,317,0,17,1061
17043846003,4490,3512,348,148,0,314,0,12,978
17043846004,3756,2786,430,178,7,220,0,13,970
17043846102,4606,2380,631,558,4,816,6,29,2226
17043846103,5257,4028,340,155,0,485,5,6,1229
17043846104,4359,2641,459,201,1,849,0,14,1718
17043846105,3499,2690,225,59,0,379,3,11,809
17043846106,3639,2376,280,123,4,708,0,2,1263
17043846201,5855,3746,444,560,1,868,0,38,2109
17043846202,6426,3862,402,332,5,1600,1,23,2564
17043846203,4383,3046,218,97,5,861,0,18,1337
17043846205,3708,2540,183,66,4,737,2,32,1168
17043846206,4244,3385,339,120,4,218,0,16,859
17043846207,5345,4216,343,73,1,502,0,11,1129
17043846208,3179,2644,122,25,1,267,0,14,535
17043846209,4167,3206,282,83,4,381,9,6,961
17043846304,6258,3424,296,147,3,2169,1,33,2834
17043846305,5687,3951,639,325,6,507,1,18,1736
17043846307,4752,2853,619,499,7,568,0,26,1899
17043846308,3825,1696,903,535,10,566,4,12,2129
17043846310,4551,2022,1302,731,6,305,1,21,2529
17043846311,5232,3116,795,700,2,377,6,35,2116
17043846312,4506,3373,325,248,8,368,0,31,1133
17043846313,5021,3462,226,179,5,971,0,14,1559
17043846314,3332,2603,355,90,5,176,0,10,729
17043846315,4226,3396,309,104,4,225,0,9,830
17043846404,6135,3760,770,463,2,905,5,20,2375
17043846405,3899,2725,248,100,9,672,2,17,1174
17043846408,4291,1556,302,272,12,2019,0,23,2735
17043846409,4529,2437,538,246,6,1148,0,11,2092
17043846410,5071,2037,688,745,3,1400,1,28,3034
17043846411,5312,1986,609,611,8,1930,0,23,3326
17043846412,4726,2972,405,301,4,857,0,39,1754
17043846413,3708,2667,219,205,10,467,1,11,1041
17043846504,6350,4398,732,437,5,494,4,31,1952
17043846507,3166,1252,376,424,0,976,5,20,1914
17043846509,5876,1763,735,901,22,2205,4,49,4113
17043846510,3271,1386,532,408,4,819,0,17,1885
17043846511,6565,3023,1781,877,0,520,0,33,3542
17043846513,2766,1379,171,170,4,916,0,10,1387
17043846514,4159,1538,258,324,0,1874,2,22,2621
17043846515,5420,2425,1463,692,4,600,1,21,2995
17043846517,6116,2942,582,807,3,1485,1,35,3174
17043846518,3648,2495,299,177,2,533,0,16,1153
17043846519,3191,1536,310,241,5,945,0,30,1655
17043846521,5036,3811,271,148,4,566,0,11,1225
17043846522,4046,1721,347,290,3,1533,0,29,2325
17043846523,2775,2375,165,42,2,84,1,10,400
17043846524,4709,2748,297,286,4,1204,3,13,1961
17043846603,4070,836,2969,73,2,142,0,12,3234
17043846604,3697,1700,1609,62,2,270,0,6,1997
17043846701,4159,1445,2286,99,7,212,3,15,2714
17043846702,3872,1665,1731,117,8,251,2,11,2207
17045070100,2459,2337,24,12,2,7,0,15,122
17045070200,1729,1660,19,7,2,0,0,2,69
17045070300,3906,3722,72,18,2,14,0,0,184
17045070400,5270,4973,84,28,9,29,0,7,297
17045070500,3502,3313,26,17,2,1,0,9,189
17047956900,2153,2096,12,4,8,1,0,2,57
17047957000,2037,1969,21,3,0,0,3,1,68
17047957100,2055,1929,30,9,0,20,1,8,126
17049950100,3910,3786,36,5,0,22,0,6,124
17049950200,5196,4862,111,12,1,33,3,4,334
17049950300,4130,3936,52,10,11,13,0,2,194
17049950400,3649,3466,35,16,7,6,0,5,183
17049950500,4629,4432,57,5,1,13,0,9,197
17049950600,5499,5152,112,34,10,49,0,6,347
17049950700,3587,3205,149,40,0,71,1,4,382
17049950800,4068,3522,320,29,6,39,2,9,546
17051950500,2670,2572,43,5,0,3,0,8,98
17051950600,2328,2241,22,10,4,0,0,4,87
17051950700,3913,3733,36,13,6,13,0,2,180
17051950800,5600,4211,484,709,50,25,0,9,1389
17051950900,2031,1873,32,38,14,14,0,3,158
17051951000,2045,1984,18,4,3,0,0,5,61
17051951100,2901,2811,22,1,3,12,1,0,90
17053961600,1745,1562,109,1,3,5,0,3,183
17053961700,1840,1738,50,4,3,0,0,10,102
17053961800,4628,4091,230,38,13,13,0,6,537
17053961900,1750,1603,54,5,2,12,0,13,147
17053962000,3571,3271,111,27,3,27,0,10,300
17055040100,3025,2810,68,11,5,2,0,0,215
17055040200,2979,2807,30,2,4,7,1,3,172
17055040300,3046,2878,26,12,9,1,0,7,168
17055040400,3636,3400,51,11,6,6,0,14,236
17055040500,3053,2913,41,15,4,16,0,2,140
17055040600,2640,2392,75,19,9,20,0,5,248
17055040700,4370,3971,122,11,17,20,0,6,399
17055040800,3259,3098,29,17,10,3,0,4,161
17055040900,2313,2133,37,9,8,11,0,0,180
17055041000,2541,2320,44,25,6,22,2,4,221
17055041100,3298,3025,83,12,9,8,1,11,273
17055041200,3644,3463,36,18,5,3,0,7,181
17057952800,2658,2501,53,5,6,0,2,6,157
17057952900,3028,2910,29,3,6,10,0,3,118
17057953000,2120,2030,30,9,4,0,0,0,90
17057953100,2301,2194,29,3,6,6,0,9,107
17057953200,2570,2462,15,7,3,1,0,1,108
17057953300,3278,3081,57,34,1,11,1,11,197
17057953400,1724,1569,37,49,7,4,0,2,155
17057953500,4273,2864,354,931,6,10,2,16,1409
17057953600,4409,4080,53,38,10,23,0,12,329
17057953700,2320,2212,16,14,6,3,0,0,108
17057953800,2454,2331,24,7,3,1,1,14,123
17057953900,2474,2382,41,2,1,0,0,3,92
17059972700,2304,2198,12,12,0,12,0,0,106
17059972800,2642,2485,41,13,5,11,0,3,157
17061973600,3082,2966,21,3,5,2,1,5,116
17061973700,1588,1483,21,1,0,2,0,4,105
17061973800,1619,1564,7,1,2,3,0,9,55
17061973900,2315,2214,14,2,3,8,2,0,101
17061974000,3381,3224,43,11,3,6,0,5,157
17063000102,8255,6268,1349,209,13,83,0,13,1987
17063000103,7593,5910,1027,228,0,97,6,28,1683
17063000200,6864,5580,731,168,6,102,7,17,1284
17063000300,3350,2457,684,32,1,30,0,18,893
17063000400,5675,4647,665,99,5,59,0,11,1028
17063000500,2799,2509,184,3,0,13,0,5,290
17063000600,2826,2537,181,12,2,19,0,4,289
17063000700,6113,5463,360,32,10,34,3,8,650
17063000800,5465,4839,342,29,10,19,0,11,626
17063000900,3593,3262,189,21,1,10,0,7,331
17065973100,3023,2827,58,26,10,7,0,1,196
17065973200,2367,2259,14,6,4,3,0,0,108
17065973300,2603,2488,24,4,2,2,0,0,115
17067953700,2079,2008,21,6,1,2,0,0,71
17067953800,2598,2351,116,2,7,14,1,3,247
17067953900,1802,1724,29,5,6,1,0,2,78
17067954000,2259,2104,41,20,11,4,1,6,155
17067954100,3164,2953,58,27,5,17,0,10,211
17067954200,2270,2149,25,4,5,11,2,1,121
17067954300,3448,3310,28,9,3,8,0,7,138
17069970900,2071,1919,36,9,0,9,2,1,152
17069971000,1578,1455,29,2,0,8,0,3,123
17071973300,1999,1872,27,17,1,5,4,0,127
17071973400,1701,1623,31,6,3,2,1,0,78
17071973500,2687,2565,54,6,1,7,0,0,122
17073030100,5757,4966,438,49,10,17,3,12,791
17073030201,4496,4169,143,17,8,13,0,8,327
17073030202,3823,3569,80,19,6,8,0,4,254
17073030203,4430,4086,180,16,2,16,3,18,344
17073030301,3711,3391,116,28,0,27,2,11,320
17073030302,3464,3205,103,5,8,22,0,11,259
17073030400,2482,2355,67,9,0,7,0,12,127
17073030500,2330,2195,58,4,0,21,0,0,135
17073030600,2781,2096,459,106,5,0,0,0,685
17073030800,3552,2334,585,458,9,13,1,8,1218
17073030900,3570,2732,530,165,6,10,2,3,838
17073031000,3470,2953,277,119,6,29,0,2,517
17073031100,2613,2420,74,20,3,4,1,4,193
17073031200,2805,2623,60,14,0,5,0,1,182
17075950100,2528,2291,84,38,0,6,0,3,237
17075950200,3586,3286,112,13,4,12,0,9,300
17075950300,3179,2993,73,13,4,4,0,6,186
17075950400,3227,2708,284,48,7,24,0,7,519
17075950500,3795,3359,181,41,15,18,0,7,436
17075950600,3490,2289,1044,30,1,12,0,3,1201
17075950700,2752,2475,131,22,5,9,0,4,277
17075950800,2327,2201,65,4,0,8,0,5,126
17075950900,2193,2000,111,3,2,6,0,4,193
17077010100,3366,3185,55,3,11,3,0,1,181
17077010200,3850,3407,95,110,13,7,1,4,443
17077010300,2759,2607,54,10,3,3,0,2,152
17077010400,4298,3834,100,151,15,22,3,13,464
17077010601,1970,1747,98,34,5,8,0,12,223
17077010602,3288,2389,159,521,0,17,0,14,899
17077010700,2991,1972,181,633,1,13,2,19,1019
17077010800,3345,1987,369,718,7,51,0,22,1358
17077010900,2364,1030,126,1061,4,15,4,11,1334
17077011001,1653,1218,47,187,0,113,3,10,435
17077011002,4495,3113,199,613,5,265,2,20,1382
17077011100,2604,1267,168,656,19,272,1,23,1337
17077011200,5091,2031,420,1637,14,724,1,22,3060
17077011400,3057,1947,200,520,2,164,2,20,1110
17077011600,3721,3093,128,122,10,140,3,19,628
17077011701,1354,916,181,126,0,39,2,8,438
17077011702,2768,1770,257,401,5,192,0,19,998
17079977300,2830,2719,24,5,10,7,2,4,111
17079977400,2671,2528,45,10,3,4,1,7,143
17079977500,3786,3687,15,7,6,4,1,8,99
17081050100,4142,3843,66,44,11,27,0,0,299
17081050200,3077,2950,21,10,1,9,0,0,127
17081050300,4243,4002,41,39,5,4,0,10,241
17081050400,4733,3973,168,406,11,12,0,2,760
17081050500,3724,3048,72,318,11,113,0,9,676
17081050600,3084,2576,66,195,4,85,2,4,508
17081050700,3669,3114,104,142,4,36,1,12,555
17081050800,4155,3861,71,36,2,27,2,4,294
17081050900,2351,1302,147,649,21,6,0,13,1049
17081051000,1356,540,80,631,3,7,0,7,816
17081051100,2579,1973,63,313,4,26,2,7,606
17083010100,5152,4824,65,38,4,12,0,13,328
17083010200,3320,3099,67,24,9,8,0,1,221
17083010300,3602,3297,65,73,2,23,3,6,305
17083010401,6098,5741,81,6,6,25,0,8,357
17083010402,1877,1779,29,0,0,3,0,4,98
17083010500,1463,1365,20,15,0,3,0,0,98
17085020101,1778,1718,25,5,4,0,0,1,60
17085020102,2460,2335,48,4,0,0,0,6,125
17085020200,4800,4455,150,31,3,27,6,6,345
17085020300,4909,4326,398,28,4,37,0,18,583
17085020401,2197,2043,55,8,7,10,0,14,154
17085020402,2896,2681,92,22,10,7,0,3,215
17085020500,2995,2796,88,16,3,15,0,4,199
17087977600,4332,4072,51,16,8,8,0,7,260
17087977700,3067,2901,49,10,2,5,1,0,166
17087977800,3462,3228,75,26,7,5,2,5,234
17087980000,2447,694,377,1367,3,0,1,0,1753
17089850101,6608,2428,3323,261,16,380,0,21,4180
17089850103,6034,4061,907,152,5,681,0,13,1973
17089850105,6895,4417,957,257,0,1003,2,20,2478
17089850106,7801,5203,1667,205,7,420,0,38,2598
17089850201,4156,675,3151,99,12,144,2,12,3481
17089850202,6823,815,5687,194,1,34,0,26,6008
17089850301,7667,1311,5251,908,14,45,1,27,6356
17089850302,4788,1792,2316,348,1,169,0,18,2996
17089850400,2553,1819,454,160,0,40,0,3,734
17089850500,3954,2868,699,108,3,132,1,8,1086
17089850600,7443,5278,1214,238,9,442,0,31,2165
17089850703,2128,1766,289,8,2,9,0,6,362
17089850704,4916,4698,101,27,0,57,0,0,218
17089850705,9050,6780,1470,236,11,222,4,18,2270
17089850706,1922,1736,104,9,1,18,0,2,186
17089850707,8375,6183,1062,173,4,639,2,21,2192
17089850708,4473,2683,822,146,4,635,0,20,1790
17089850709,3862,2940,358,96,6,345,0,5,922
17089850710,7261,4328,1731,331,8,493,0,23,2933
17089850711,4808,3465,547,82,4,510,0,5,1343
17089850800,6968,2151,4255,273,16,91,0,23,4817
17089851000,6693,2868,2789,573,3,231,0,35,3825
17089851101,4377,1446,2396,287,6,91,1,16,2931
17089851102,3710,1338,1981,205,10,37,10,10,2372
17089851301,3843,640,2841,226,2,56,0,12,3203
17089851302,3203,366,2481,225,5,49,0,17,2837
17089851400,6806,1032,5206,333,6,100,4,15,5774
17089851500,1049,188,710,90,0,38,0,0,861
17089851600,6623,1831,4018,485,17,107,1,11,4792
17089851801,8379,5095,2103,328,5,498,2,21,3284
17089851904,7754,3459,3219,419,12,404,2,34,4295
17089851907,7921,4418,2001,304,1,889,5,19,3503
17089851908,5121,1917,2246,389,7,364,4,27,3204
17089851909,4367,2260,1464,243,29,243,0,18,2107
17089851910,3927,1955,1395,288,0,158,1,16,1972
17089851911,5317,3209,740,188,2,926,0,15,2108
17089851912,3358,2359,447,109,3,320,0,29,999
17089851913,5668,4012,649,119,8,679,0,28,1656
17089852001,4492,3304,816,66,10,150,0,9,1188
17089852002,6722,5241,863,86,0,242,0,29,1481
17089852004,2911,2364,165,7,2,294,0,8,547
17089852005,4902,4316,260,34,5,126,3,15,586
17089852101,7015,5502,464,91,3,659,1,31,1513
17089852103,6526,5341,391,75,7,447,0,16,1185
17089852104,2986,2040,431,68,3,297,0,7,946
17089852201,4832,4028,456,83,2,73,1,6,804
17089852203,4997,3199,1267,135,9,209,0,10,1798
17089852204,4467,3295,501,290,0,208,0,19,1172
17089852300,2052,1666,232,40,3,25,0,6,386
17089852403,5111,4536,338,11,6,32,0,15,575
17089852404,2545,2176,118,30,0,121,1,10,369
17089852405,3112,2792,164,27,2,20,0,9,320
17089852406,2874,2472,224,29,1,29,0,2,402
17089852407,3513,2979,182,37,4,169,0,7,534
17089852408,4754,4229,259,28,2,49,0,11,525
17089852500,6500,5232,833,51,2,130,0,10,1268
17089852606,4584,4123,237,21,1,77,0,5,461
17089852607,3611,3100,250,23,3,86,0,8,511
17089852608,3703,3352,166,26,2,29,2,11,351
17089852700,7086,5650,897,171,3,110,0,15,1436
17089852803,4992,3819,560,281,1,88,1,20,1173
17089852805,5552,3864,1076,207,2,210,0,14,1688
17089852806,6814,5424,515,220,4,372,0,15,1390
17089852807,3897,3000,390,196,3,157,1,4,897
17089852808,7022,5644,675,210,3,203,2,36,1378
17089852903,5193,2435,1735,666,10,202,2,23,2758
17089852904,2079,180,1631,206,2,22,0,5,1899
17089852905,4684,1093,2780,612,3,78,0,12,3591
17089852906,5176,2226,2041,524,5,218,1,22,2950
17089852907,4930,794,3583,413,10,67,0,20,4136
17089853001,3586,1987,980,336,6,147,0,11,1599
17089853004,3228,2235,679,141,1,79,6,6,993
17089853005,5521,1886,2365,916,6,168,0,16,3635
17089853006,3343,1134,1546,356,4,182,2,15,2209
17089853007,5574,1030,3230,823,11,366,2,7,4544
17089853008,4122,1005,2270,560,1,175,4,13,3117
17089853100,2793,690,1740,229,4,61,0,11,2103
17089853200,6044,1037,3835,762,8,267,1,7,5007
17089853300,3745,437,3125,107,19,19,2,2,3308
17089853401,2189,108,1918,138,1,15,0,3,2081
17089853402,4527,181,4132,151,2,14,0,12,4346
17089853500,4530,212,3994,276,0,13,1,7,4318
17089853601,3002,263,2559,130,3,19,0,8,2739
17089853602,3478,197,2843,374,5,15,13,0,3281
17089853900,5744,3469,1580,348,10,95,12,21,2275
17089854001,4099,2485,1188,235,2,57,0,14,1614
17089854002,5676,2313,2542,578,12,44,2,21,3363
17089854100,4117,626,3206,207,5,18,0,3,3491
17089854200,4700,648,3724,223,7,28,4,6,4052
17089854301,5371,493,4586,214,7,22,0,9,4878
17089854302,3970,598,3110,177,1,18,1,5,3372
17089854401,2727,695,1605,349,1,13,0,20,2032
17089854402,3726,1370,1349,545,0,363,0,9,2356
17089854403,6710,1635,3391,1170,7,269,0,17,5075
17089854504,7941,6725,611,135,4,160,2,25,1216
17089854505,7821,6824,417,52,0,231,0,15,997
17089854506,3887,2986,418,122,0,216,0,7,901
17089854507,5722,4846,477,53,3,134,0,16,876
17089854508,5861,3396,1486,486,0,225,3,24,2465
17089854509,6781,5017,892,344,13,214,1,23,1764
17089854600,3976,953,2250,546,6,99,0,12,3023
17089854700,2345,690,1207,336,3,39,1,8,1655
17089854800,7998,6897,438,68,4,289,1,39,1101
17089854900,5433,2033,2351,666,5,219,0,16,3400
17091010100,2450,2161,180,8,2,1,2,3,289
17091010201,2101,1869,93,27,1,8,1,23,232
17091010203,4597,3965,309,93,4,38,0,8,632
17091010204,5261,4567,325,130,8,33,3,13,694
17091010300,3671,3378,143,9,12,7,0,10,293
17091010400,5011,4578,177,30,6,22,0,9,433
17091010500,6718,5409,358,479,4,182,0,26,1309
17091010601,5529,4511,342,275,6,158,0,9,1018
17091010602,6137,4375,704,560,13,135,0,25,1762
17091010701,4648,3180,346,761,5,154,2,14,1468
17091010702,6860,5292,729,426,6,57,0,14,1568
17091010800,3624,2397,534,473,6,23,1,18,1227
17091010900,4294,3361,630,84,5,13,1,16,933
17091011000,1847,183,244,1352,2,0,0,9,1664
17091011100,1873,1413,339,40,2,9,0,3,460
17091011200,2024,1647,161,113,0,4,0,4,377
17091011300,2091,1649,174,193,4,8,0,10,442
17091011400,1623,569,331,650,7,8,0,9,1054
17091011500,1987,173,366,1351,5,0,0,18,1814
17091011600,1589,102,202,1192,2,0,0,6,1487
17091011700,3151,1497,591,897,5,32,0,9,1654
17091011800,2653,2011,317,154,7,14,0,14,642
17091011900,1317,996,182,60,2,6,0,9,321
17091012000,4927,3526,376,732,7,72,0,20,1401
17091012100,3352,2217,475,463,11,26,1,17,1135
17091012200,3215,1680,511,864,8,22,0,4,1535
17091012300,4080,684,1346,1865,11,8,0,24,3396
17091012400,4548,1330,1493,1549,17,15,1,10,3218
17091012500,2103,1179,298,501,0,2,1,10,924
17091012600,4221,3692,244,86,5,12,0,8,529
17093890103,5506,3529,903,550,4,296,0,15,1977
17093890104,6050,3221,764,790,7,984,0,48,2829
17093890105,9032,5459,1381,902,5,853,0,54,3573
17093890106,4966,3790,692,176,2,67,7,17,1176
17093890107,4869,3325,721,322,6,283,0,22,1544
17093890108,5473,4252,607,233,7,101,0,12,1221
17093890201,4416,2344,1644,180,6,59,0,22,2072
17093890202,3089,1592,1204,149,1,14,0,2,1497
17093890301,6159,3699,1567,451,7,149,0,20,2460
17093890302,6091,4150,1326,241,5,121,0,28,1941
17093890401,6290,4668,963,327,11,68,0,14,1622
17093890402,9883,7325,1397,614,0,185,0,40,2558
17093890403,5970,3624,1278,586,5,202,0,25,2346
17093890404,9887,5026,2977,1003,3,394,0,24,4861
17093890501,9398,4794,3281,745,4,195,0,25,4604
17093890502,4638,2824,1487,105,11,26,1,17,1814
17093890601,4513,3741,464,125,9,28,0,12,772
17093890602,5700,4654,570,167,3,52,1,23,1046
17093890701,5364,3081,1206,696,7,186,0,24,2283
17093890702,5527,3382,1075,603,9,222,0,24,2145
17093890703,9048,6210,1620,728,5,140,1,19,2838
17095000100,3011,2818,83,4,9,8,3,7,193
17095000200,2985,2805,78,22,0,8,0,0,180
17095000300,4134,3378,284,259,4,24,0,10,756
17095000400,4873,3833,212,552,7,79,0,18,1040
17095000500,5462,3356,502,1339,4,37,0,23,2106
17095000600,3497,2614,282,336,3,37,0,32,883
17095000700,1901,1483,143,149,3,3,0,0,418
17095000800,2391,1473,273,283,6,43,3,66,918
17095000900,2047,1093,358,380,8,22,0,6,954
17095001000,3657,2650,370,340,9,18,4,13,1007
17095001100,2245,1489,136,467,3,11,0,11,756
17095001200,1612,1329,50,132,0,44,0,0,283
17095001300,3722,3422,108,33,6,8,0,6,300
17095001400,1717,1634,23,4,3,3,1,2,83
17095001500,3682,3362,106,44,4,12,1,9,320
17095001600,3031,2876,43,10,4,4,0,4,155
17097860103,3376,2523,457,122,10,79,0,27,853
17097860104,3452,2352,506,316,14,67,2,19,1100
17097860105,5191,1817,1643,1148,4,283,5,24,3374
17097860106,3491,765,1308,1134,4,102,0,20,2726
17097860200,3492,1378,1141,733,14,51,4,26,2114
17097860301,3440,515,1449,1216,9,31,1,42,2925
17097860302,3032,574,1269,995,5,40,4,21,2458
17097860400,5865,1683,2412,1242,15,223,2,40,4182
17097860500,4724,973,1989,1471,6,24,1,36,3751
17097860600,7663,3038,3329,883,16,108,2,55,4625
17097860805,1648,1455,121,13,6,4,0,1,193
17097860806,5148,4157,548,87,11,81,0,15,991
17097860807,3469,3126,184,28,2,21,0,4,343
17097860808,2639,2307,185,5,0,24,0,4,332
17097860809,2930,2610,149,35,7,27,0,1,320
17097860811,4429,3548,406,109,5,180,2,16,881
17097860812,3816,2744,475,192,11,198,3,14,1072
17097860813,3300,2664,376,66,7,35,1,3,636
17097860903,6270,4711,999,138,16,89,4,11,1559
17097860905,5608,4071,1146,89,13,48,2,30,1537
17097860906,10453,6576,2093,521,7,773,4,25,3877
17097860907,3845,2915,574,90,2,113,0,10,930
17097860908,1875,1596,177,21,3,14,0,2,279
17097861007,4180,3364,340,102,11,192,2,24,816
17097861008,5271,4079,754,102,9,122,0,14,1192
17097861009,5131,3721,582,181,5,421,0,11,1410
17097861010,5930,4020,1161,186,5,323,0,20,1910
17097861011,7864,4416,2238,352,3,489,3,41,3448
17097861012,4861,3848,512,151,6,107,0,13,1013
17097861013,3052,2339,349,135,0,99,0,18,713
17097861014,3663,2384,822,111,2,171,0,16,1279
17097861105,4330,3080,591,155,8,310,0,27,1250
17097861106,8127,5574,1137,396,9,653,3,36,2553
17097861107,4047,3007,489,175,0,225,0,11,1040
17097861108,5948,4406,813,168,6,279,0,28,1542
17097861201,6730,2047,4115,282,8,96,15,19,4683
17097861202,4031,1822,1803,116,4,109,2,5,2209
17097861301,5080,1951,2509,308,11,98,5,12,3129
17097861303,4778,1059,3396,176,2,45,0,13,3719
17097861304,3368,717,2434,103,3,24,0,10,2651
17097861402,8778,3978,3029,594,10,798,8,29,4800
17097861403,2556,702,1677,87,6,29,1,5,1854
17097861404,5947,1817,3407,306,6,233,3,22,4130
17097861504,8472,1435,4236,745,14,1797,0,48,7037
17097861505,3543,2157,464,233,1,519,2,15,1386
17097861506,6109,2223,1709,1393,0,508,4,27,3886
17097861507,3076,1281,1201,229,13,187,0,49,1795
17097861508,3437,1794,711,442,2,310,5,30,1643
17097861509,3295,1931,570,417,12,219,4,24,1364
17097861510,5071,2223,1828,382,9,421,4,32,2848
17097861603,6106,4257,624,304,7,687,0,24,1849
17097861604,5636,3440,853,376,4,677,0,42,2196
17097861607,4569,3080,922,202,14,140,0,12,1489
17097861608,3652,2763,445,144,7,138,3,15,889
17097861609,4716,2357,582,477,1,1100,4,30,2359
17097861610,3755,2246,421,251,7,614,3,18,1509
17097861611,4471,3052,448,163,7,615,1,14,1419
17097861701,1804,761,787,133,0,45,0,13,1043
17097861702,4289,1180,2342,546,1,54,0,41,3109
17097861803,6683,1183,3921,980,16,335,8,70,5500
17097861804,4090,406,2865,600,6,106,0,30,3684
17097861901,3747,875,2221,362,9,177,0,20,2872
17097861902,6376,1130,3397,1261,7,336,0,53,5246
17097862000,6070,570,4449,730,11,123,3,70,5500
17097862100,5383,738,3454,925,7,23,8,78,4645
17097862200,3969,848,1808,1118,11,54,4,28,3121
17097862300,3146,259,1743,1026,3,17,1,37,2887
17097862401,3619,455,2446,543,6,59,1,51,3164
17097862402,3026,159,2404,369,9,12,0,33,2867
17097862501,3942,171,3380,259,7,25,1,34,3771
17097862502,2281,82,1709,421,0,12,2,18,2199
17097862603,7062,774,4782,990,11,364,2,54,6288
17097862604,4694,516,3624,352,0,109,0,30,4178
17097862605,4097,731,2034,1044,2,189,1,19,3366
17097862700,4238,133,3254,751,3,22,5,18,4105
17097862800,1963,83,728,1045,2,15,3,29,1880
17097862901,3692,195,2539,854,5,12,1,39,3497
17097862902,2782,148,1419,1093,0,19,2,24,2634
17097863003,5857,2690,1479,996,44,387,36,26,3167
17097863004,3613,1594,572,738,7,395,17,24,2019
17097863005,4523,2040,1042,980,27,219,32,24,2483
17097863006,898,377,196,219,6,50,7,11,521
17097863100,2563,135,1147,1150,0,35,0,22,2428
17097863201,3310,196,1893,1065,0,47,6,28,3114
17097863202,5478,3992,701,158,0,400,1,23,1486
17097863300,2629,2394,74,9,2,41,0,19,235
17097863400,4276,3561,288,119,4,163,3,9,715
17097863500,4538,3948,205,33,0,195,0,14,590
17097863601,3508,2660,189,39,3,440,3,9,848
17097863603,3518,2782,131,51,2,408,0,6,736
17097863604,2990,2523,227,38,1,76,0,9,467
17097863701,4556,3817,271,51,3,246,0,20,739
17097863702,4045,2636,271,125,9,820,2,17,1409
17097863801,5108,4327,267,68,4,288,1,13,781
17097863902,6000,3587,618,192,14,1389,4,14,2413
17097863903,4424,3646,312,52,4,213,3,11,778
17097863904,5972,3797,279,95,3,1583,0,10,2175
17097864001,6270,3197,2273,143,1,492,0,14,3073
17097864002,6068,1638,3918,120,4,256,1,19,4430
17097864105,6006,4406,635,62,0,699,2,8,1600
17097864106,4023,2593,1088,29,4,151,1,10,1430
17097864107,4920,3206,1031,115,6,403,1,10,1714
17097864108,5868,3044,2335,64,7,282,1,14,2824
17097864109,6196,4586,652,101,3,556,0,24,1610
17097864110,6233,4532,796,156,6,520,5,18,1701
17097864203,4310,3335,674,46,7,75,0,23,975
17097864204,4484,3007,1115,69,3,133,2,17,1477
17097864206,3478,2239,1081,20,6,36,0,9,1239
17097864207,7478,5505,939,158,3,555,0,17,1973
17097864208,3878,2999,641,42,4,59,0,7,879
17097864303,4581,3798,241,60,0,244,0,15,783
17097864305,4030,3558,146,28,6,145,0,11,472
17097864306,2292,2004,78,18,4,108,0,6,288
17097864307,1861,1595,84,16,2,107,0,9,266
17097864308,4528,3863,246,48,6,204,0,5,665
17097864402,8168,6002,519,116,4,1211,10,16,2166
17097864403,5852,4454,285,52,13,861,0,11,1398
17097864407,6632,5087,342,76,7,880,1,15,1545
17097864408,6232,4940,757,62,7,290,1,16,1292
17097864409,4572,3446,545,74,1,343,0,9,1126
17097864410,5066,3977,234,25,0,680,1,0,1089
17097864411,4851,4155,195,19,0,315,0,5,696
17097864412,4090,3412,171,15,0,375,1,5,678
17097864510,4961,1741,974,195,11,1900,7,35,3220
17097864511,6403,3509,1104,177,6,1390,0,41,2894
17097864512,4659,2551,407,71,7,1484,1,16,2108
17097864513,6301,4208,425,81,6,1323,1,27,2093
17097864514,2653,1210,106,34,1,1235,0,14,1443
17097864515,3020,1984,147,39,6,731,2,4,1036
17097864516,4695,3107,221,56,1,1129,0,8,1588
17097864517,2933,1836,86,48,1,898,2,11,1097
17097864518,5594,3603,167,19,6,1661,0,14,1991
17097864519,5169,3276,170,58,3,1528,0,14,1893
17097864520,5698,3053,304,61,20,2109,0,19,2645
17097864521,2537,1339,89,29,1,1051,1,0,1198
17097864522,4967,3759,195,30,0,776,2,13,1208
17097864523,4024,2150,201,90,5,1486,0,22,1874
17097864524,3297,2169,216,60,9,694,1,22,1128
17097864601,3606,2973,151,26,0,306,0,5,633
17097864602,3824,3267,158,24,7,234,0,19,557
17097864700,2914,2544,126,15,3,131,0,27,370
17097864801,5561,4454,272,166,8,412,0,68,1107
17097864802,3093,2556,138,26,0,277,0,6,537
17097864901,4371,3867,187,27,2,148,1,9,504
17097864903,4907,4210,184,34,1,303,0,17,697
17097864904,2450,2155,101,7,0,137,0,0,295
17097865000,1276,1126,46,4,1,39,0,4,150
17097865200,5361,2269,2575,160,13,159,0,26,3092
17097865300,3505,2920,248,66,6,141,0,19,585
17097865400,4197,2986,831,80,1,177,0,17,1211
17097865501,2470,1681,466,101,0,82,0,13,789
17097865502,2313,2072,113,20,4,40,0,9,241
17097865600,3497,3171,134,22,2,71,0,12,326
17097865700,5985,4978,468,66,4,197,0,18,1007
17097865801,3257,2775,234,24,0,134,0,11,482
17097865802,2945,2596,121,25,0,133,0,6,349
17097866000,6842,3769,1439,748,4,602,0,39,3073
17097866100,3433,250,2276,556,9,215,1,48,3183
17097866200,6162,4890,285,83,9,715,0,20,1272
17097990000,0,0,0,0,0,0,0,0,0
17099961701,6351,5590,442,39,3,20,0,8,761
17099961702,3120,2789,164,10,2,18,0,9,331
17099961800,3685,3286,261,7,7,14,0,14,399
17099961900,4285,3153,913,37,4,62,3,17,1132
17099962000,3539,2097,1273,53,0,11,1,3,1442
17099962100,5100,4209,600,86,7,67,0,10,891
17099962200,4880,4337,279,28,8,47,0,8,543
17099962300,6936,5175,496,991,11,37,0,20,1761
17099962400,3836,3382,225,24,8,24,0,14,454
17099962500,2288,2013,144,11,2,9,0,6,275
17099962600,5727,4670,552,142,13,77,3,20,1057
17099962700,2169,1634,330,63,5,18,0,9,535
17099962800,3355,2814,316,63,10,23,0,9,541
17099962900,3056,2329,546,43,8,8,0,8,727
17099963000,4734,4016,395,58,3,117,0,21,718
17099963100,3226,2736,299,40,2,26,0,5,490
17099963200,2967,2465,304,39,2,33,0,6,502
17099963300,2410,1548,617,97,0,16,1,3,862
17099963400,3856,3400,293,16,9,25,0,1,456
17099963500,4954,4331,294,111,1,72,0,5,623
17099963600,3310,2779,312,51,5,10,0,13,531
17099963700,5459,4893,286,33,15,12,0,11,566
17099963800,4114,3304,444,140,4,19,0,18,810
17099963900,4919,3897,643,128,11,48,0,20,1022
17099964000,2416,2231,103,6,2,5,0,1,185
17099964100,3612,3259,183,18,5,16,0,15,353
17099964200,2288,1799,275,67,4,12,0,21,489
17099964300,3066,2309,467,113,2,9,0,2,757
17101880700,2644,2493,32,16,1,10,1,6,151
17101880800,4948,3218,335,1271,8,11,2,10,1730
17101880900,2711,2550,34,34,0,4,1,6,161
17101881000,1823,1644,45,22,0,8,1,4,179
17101881100,3154,2872,68,50,3,25,2,3,282
17103000100,2762,2475,121,24,0,9,0,13,287
17103000200,3227,2969,126,16,3,22,4,15,258
17103000300,4072,3481,281,102,0,51,2,12,591
17103000400,7503,5038,766,1414,7,56,0,15,2465
17103000500,4709,4064,299,75,6,56,0,10,645
17103000600,3425,2788,268,146,5,25,1,19,637
17103000700,1809,1610,112,4,0,4,0,2,199
17103000800,3399,3113,144,20,7,17,1,5,286
17103000900,3239,2897,207,30,2,8,2,4,342
17105960100,4012,3602,179,34,1,16,0,10,410
17105960200,3305,3066,86,13,3,8,0,7,239
17105960300,3117,2835,139,17,3,13,0,1,282
17105960400,3099,2894,84,15,1,21,0,7,205
17105960500,3187,2658,279,104,6,21,0,18,529
17105960600,4098,3575,250,81,7,17,0,19,523
17105960700,4755,3427,399,763,5,39,0,14,1328
17105960800,5554,5203,178,33,8,18,0,9,351
17105960900,2287,2068,145,7,4,3,0,3,219
17105961000,2401,2190,120,14,0,15,1,1,211
17107952900,3532,3265,81,40,5,46,0,6,267
17107953000,2365,2237,28,9,5,9,0,5,128
17107953100,3103,2705,108,102,5,18,0,5,398
17107953200,3692,3278,95,112,3,31,0,11,414
17107953300,3335,3007,70,69,9,15,0,13,328
17107953400,3783,3415,79,103,7,36,1,6,368
17107953500,5069,3539,328,1058,13,21,0,28,1530
17107953600,3108,3006,29,1,1,2,0,2,102
17109010100,3454,3200,52,42,1,7,2,7,254
17109010200,1806,1714,23,0,2,10,0,2,92
17109010300,1973,1722,66,37,0,65,0,7,251
17109010401,1031,639,44,159,4,133,0,4,392
17109010402,3565,2485,259,473,9,146,0,18,1080
17109010600,2143,1651,60,261,4,29,0,8,492
17109010700,4017,3531,94,142,4,61,2,5,486
17109010900,2324,1939,97,131,12,59,0,4,385
17109011000,2182,2076,32,5,7,3,0,3,106
17109011100,2700,2601,13,1,4,5,2,0,99
17109980000,2043,1504,222,247,0,42,0,15,539
17111870103,2517,2073,311,18,1,3,0,13,444
17111870104,4848,4266,309,51,5,42,0,13,582
17111870105,3504,3110,222,10,0,46,0,2,394
17111870106,3091,2793,157,9,2,16,0,4,298
17111870200,5959,4287,1416,23,5,25,0,14,1672
17111870301,4545,2293,2095,21,1,20,0,8,2252
17111870302,4550,1950,2399,35,1,50,0,12,2600
17111870402,5884,3152,2105,280,13,155,0,25,2732
17111870403,4404,3543,591,17,15,40,2,24,861
17111870404,3896,2918,713,17,12,68,0,13,978
17111870501,4351,3745,317,31,6,85,0,1,606
17111870502,4637,3831,578,20,4,20,0,7,806
17111870603,4357,3098,949,51,0,50,0,9,1259
17111870604,6113,4839,806,86,7,125,1,11,1274
17111870605,6322,5072,922,35,0,97,1,10,1250
17111870606,3945,2773,984,33,0,44,0,6,1172
17111870702,7588,6324,818,56,6,79,0,7,1264
17111870703,5350,4804,257,27,5,31,0,13,546
17111870704,3605,3130,286,23,7,20,0,6,475
17111870807,5178,3837,901,106,1,106,0,36,1341
17111870808,3682,3004,380,59,0,104,1,8,678
17111870809,6801,5743,565,69,16,180,1,12,1058
17111870810,4406,3768,364,37,2,53,4,16,638
17111870811,4493,3635,591,25,6,44,0,7,858
17111870812,4715,3578,808,40,1,128,0,18,1137
17111870813,5115,4335,418,44,1,110,2,15,780
17111870814,3954,3330,293,10,2,123,1,9,624
17111870903,3600,2267,1032,113,3,35,1,18,1333
17111870904,4812,3488,1061,59,6,38,0,11,1324
17111870905,4683,3058,1212,103,7,94,0,25,1625
17111870906,5510,4002,993,169,9,116,3,33,1508
17111870907,2967,2257,501,34,0,73,2,7,710
17111871003,4352,3385,747,24,13,30,0,13,967
17111871004,6072,4776,976,76,12,38,0,10,1296
17111871105,5227,4225,571,35,5,146,0,27,1002
17111871107,5369,4211,420,105,12,380,1,20,1158
17111871108,5556,4360,600,97,2,327,2,9,1196
17111871109,4888,3561,698,106,16,322,0,16,1327
17111871110,4360,3137,500,88,4,427,0,13,1223
17111871111,5352,3823,714,155,4,409,2,19,1529
17111871112,5344,4374,503,58,6,181,0,20,970
17111871113,3988,3023,530,66,1,218,0,7,965
17111871114,4999,3778,655,46,8,284,0,17,1221
17111871115,2994,2172,477,48,0,176,1,13,822
17111871201,6779,5522,757,94,10,139,0,8,1257
17111871202,5827,3642,1681,105,11,89,1,26,2185
17111871205,4596,3279,961,67,0,85,0,16,1317
17111871206,6648,4947,595,167,0,663,1,24,1701
17111871207,4772,3362,745,143,3,357,5,13,1410
17111871208,3820,3141,386,12,4,157,0,8,679
17111871209,3482,2410,749,67,8,111,0,20,1072
17111871301,4831,3928,544,74,0,91,1,22,903
17111871304,3417,2818,390,22,0,59,1,6,599
17111871305,6502,5185,870,27,9,169,0,18,1317
17111871307,4646,3791,582,44,5,77,0,12,855
17111871310,4323,3536,538,37,7,65,2,7,787
17111871311,4786,3335,949,162,6,186,1,13,1451
17111871312,6393,5369,482,51,7,266,4,16,1024
17111871313,1793,886,802,15,3,37,3,5,907
17111871402,6099,5101,494,42,5,186,0,21,998
17111871404,4389,3306,642,117,2,199,1,4,1083
17111871501,6302,5598,349,45,4,96,0,11,704
17111871502,8411,6609,912,147,6,420,0,18,1802
17111871600,4530,3766,532,20,8,59,0,7,764
17113000105,3931,3364,138,139,0,124,0,14,567
17113000106,2568,1927,178,188,2,154,0,10,641
17113000107,3931,2992,218,417,8,78,0,21,939
17113000108,6024,3142,552,1853,4,161,0,28,2882
17113000109,6001,4826,357,357,2,199,0,14,1175
17113000200,5446,3641,669,727,6,154,0,13,1805
17113000301,4221,3161,314,404,6,149,1,23,1060
17113000302,5585,4120,261,869,8,67,0,22,1465
17113000400,2789,2157,176,252,0,118,0,6,632
17113000501,2523,1709,191,365,2,142,0,5,814
17113000502,2413,2109,90,89,1,29,0,10,304
17113000504,5046,3533,268,671,8,289,0,25,1513
17113000506,3752,3084,83,113,3,308,1,3,668
17113000507,2779,1967,94,78,8,547,0,14,812
17113001103,3249,2233,246,334,6,283,2,11,1016
17113001105,4744,3196,242,579,9,489,0,14,1548
17113001106,3142,1695,492,560,3,192,2,7,1447
17113001107,3824,2876,200,234,9,342,1,5,948
17113001108,4656,3280,158,284,16,736,2,10,1376
17113001200,2395,1794,158,248,7,60,0,9,601
17113001301,1809,1407,84,182,5,25,0,10,402
17113001302,2077,1497,177,176,4,132,1,16,580
17113001303,1526,1053,152,198,0,11,0,5,473
17113001402,3786,2905,231,409,6,75,2,7,881
17113001403,3981,2531,353,787,7,33,2,21,1450
17113001404,4349,3022,646,370,22,17,1,27,1327
17113001500,2268,1042,395,605,8,6,4,17,1226
17113001600,2425,1441,188,635,3,25,3,9,984
17113001700,2179,1500,172,332,8,15,2,11,679
17113001800,3085,2601,121,89,9,126,2,4,484
17113002101,5052,3467,806,448,13,62,3,31,1585
17113002102,1542,1223,179,35,0,15,4,7,319
17113005102,7385,6717,149,99,10,141,0,17,668
17113005103,4985,3923,182,173,5,487,0,18,1062
17113005104,4600,2716,156,189,9,1390,0,19,1884
17113005201,1197,1073,39,21,1,17,0,13,124
17113005202,3113,2845,72,40,7,10,0,18,268
17113005401,7291,6324,180,93,10,426,3,23,967
17113005402,3708,3454,103,8,1,11,0,12,254
17113005501,2353,2204,38,10,4,3,1,0,149
17113005502,2420,2304,38,6,2,5,0,9,116
17113005601,1782,1666,24,14,0,1,0,2,116
17113005602,2037,1859,81,6,0,5,0,8,178
17113005700,4981,4585,149,27,1,25,0,14,396
17113005800,4210,3099,232,334,3,377,0,9,1111
17113005900,4100,2798,401,615,6,16,1,18,1302
17113006000,3694,3378,91,37,6,31,0,9,316
17115000200,2327,896,86,1118,2,5,0,6,1431
17115000300,3523,1297,63,1862,10,0,1,10,2226
17115000400,1175,433,43,609,4,7,0,6,742
17115000501,797,330,15,392,6,13,0,5,467
17115000502,2415,1266,118,826,4,41,0,30,1149
17115000600,1625,354,42,1099,7,0,3,17,1271
17115000900,1682,467,61,1001,5,5,2,11,1215
17115001000,1158,755,42,272,7,1,0,7,403
17115001100,3194,2267,95,566,3,34,1,10,927
17115001200,2694,1601,64,841,5,6,2,13,1093
17115001300,2275,1923,36,162,3,26,1,10,352
17115001400,2374,1946,28,269,2,23,1,6,428
17115001500,3961,3196,83,408,12,26,0,15,765
17115001600,2136,1477,73,413,7,18,1,11,659
17115001700,2129,1403,87,485,8,9,0,9,726
17115001801,2209,1456,53,508,4,36,0,8,753
17115001802,2148,1514,46,415,0,5,2,8,634
17115001900,2476,1273,76,913,0,62,0,24,1203
17115002001,1039,664,20,230,4,96,0,0,375
17115002002,2745,1123,87,1316,5,7,0,10,1622
17115002100,1270,888,64,208,3,3,0,4,382
17115002200,5293,4202,150,597,6,37,0,30,1091
17115002300,2898,2709,39,32,3,21,6,4,189
17115002401,2464,2064,70,200,2,31,3,8,400
17115002402,5327,4693,120,230,5,91,0,14,634
17115002500,7213,6661,112,60,9,83,2,23,552
17115002601,3938,3602,97,82,1,16,0,19,336
17115002602,1990,1910,24,10,1,0,0,5,80
17115002700,2233,2095,40,10,10,0,1,2,138
17115002800,4090,3855,48,15,7,12,1,11,235
17115002901,4242,3473,95,101,3,415,0,7,769
17115002902,4597,3302,145,743,8,167,2,22,1295
17115002904,5120,4120,178,526,4,64,1,22,1000
17115002905,1549,1045,94,264,4,66,0,18,504
17115002906,2721,1369,161,932,3,66,0,9,1352
17115003000,3230,3030,38,16,8,15,1,0,200
17115003100,1741,458,40,1155,3,5,0,1,1283
17117956000,3064,2890,41,20,0,19,0,10,174
17117956100,3099,2897,38,20,7,7,0,3,202
17117956200,2333,2226,26,6,11,5,0,0,107
17117956300,3073,2864,34,25,7,35,0,2,209
17117956400,5329,4831,64,104,14,33,0,9,498
17117956500,2506,2361,23,15,6,1,0,7,145
17117956600,4575,4327,42,29,6,7,0,7,248
17117956700,4011,3558,68,108,10,16,0,4,453
17117956800,2664,2519,23,5,12,3,0,2,145
17117956900,3579,3360,33,8,13,16,0,4,219
17117957000,3474,3237,53,10,14,10,0,1,237
17117957100,2584,2452,35,5,1,4,0,2,132
17117957200,4676,4328,90,13,8,23,0,3,348
17119400101,2510,2013,181,163,7,14,0,11,497
17119400102,5137,3450,416,884,16,27,1,18,1687
17119400200,3815,2539,364,673,25,14,0,13,1276
17119400600,2378,519,109,1655,5,8,1,4,1859
17119400700,1498,39,10,1421,2,0,0,0,1459
17119400801,1784,1511,104,76,8,18,0,4,273
17119400802,5869,4555,471,492,8,28,0,10,1314
17119400903,5201,3402,877,645,5,47,0,13,1799
17119400904,3162,2771,131,84,2,20,0,6,391
17119400951,5001,4154,274,272,10,39,0,20,847
17119400952,3127,2302,271,355,5,34,0,7,825
17119401000,2314,2021,63,66,15,14,2,4,293
17119401101,2739,2362,64,155,7,14,1,6,377
17119401102,3520,3187,72,97,6,7,0,9,333
17119401200,1853,1664,26,43,2,18,3,7,189
17119401300,4715,3887,104,359,20,23,0,16,828
17119401400,3032,2367,70,337,29,21,0,8,665
17119401500,2440,1770,84,388,12,3,3,5,670
17119401701,2556,2009,82,254,20,31,7,21,547
17119401721,5532,5008,124,63,3,26,0,15,524
17119401722,2796,2550,81,41,3,8,0,7,246
17119401800,5977,5371,126,145,8,29,7,14,606
17119401901,1830,1683,43,29,3,4,0,12,147
17119401905,4748,4115,181,155,16,37,2,5,633
17119402000,4086,2602,110,1059,9,56,0,28,1484
17119402100,3061,1468,47,1385,8,16,0,16,1593
17119402200,3228,1918,97,997,7,18,2,20,1310
17119402300,1664,1291,53,199,3,7,0,3,373
17119402400,1538,999,54,366,4,10,1,4,539
17119402500,1822,797,38,851,4,3,0,14,1025
17119402600,2555,1525,58,734,5,7,1,16,1030
17119402701,7191,5832,147,781,22,55,0,33,1359
17119402721,7722,6685,187,436,15,65,0,35,1037
17119402722,2828,2537,103,85,3,21,0,3,291
17119402801,3587,3262,80,97,6,20,0,17,325
17119402803,3371,2944,85,113,3,29,0,12,427
17119402804,2540,2385,26,9,2,14,1,5,155
17119402805,5592,5153,118,39,11,31,0,5,439
17119402900,5283,4227,167,530,11,81,22,16,1056
17119403001,5216,4059,122,590,9,177,2,9,1157
17119403002,7212,6022,242,458,8,171,1,13,1190
17119403101,6944,4930,408,1009,10,263,3,32,2014
17119403121,9528,7650,654,529,17,236,4,37,1878
17119403122,6486,5074,249,575,8,201,7,22,1412
17119403200,4466,3460,263,427,5,35,0,16,1006
17119403300,2800,1971,263,340,13,25,0,15,829
17119403401,3846,2548,177,863,2,34,0,19,1298
17119403403,2807,1938,173,514,7,27,3,5,869
17119403404,3093,2066,177,616,0,30,3,6,1027
17119403502,5870,4808,251,481,18,41,0,24,1062
17119403531,8319,7278,276,222,20,79,1,22,1041
17119403532,5611,5089,177,38,4,40,1,16,522
17119403533,10554,9078,371,458,15,170,3,19,1476
17119403534,3965,3352,216,137,5,47,2,5,613
17119403601,3646,3361,71,24,7,28,0,7,285
17119403603,1866,1739,38,3,3,33,0,6,127
17119403604,6247,5816,111,14,9,45,0,18,431
17119403701,6759,6145,162,96,14,35,3,20,614
17119403702,6271,5837,127,26,10,20,3,15,434
17119403801,5198,4841,99,33,7,18,2,15,357
17119403802,4431,4065,149,15,9,18,0,11,366
17119404000,2289,1337,189,619,1,4,0,5,952
17119404100,2833,2455,134,51,8,24,0,6,378
17121951600,3371,3207,34,9,11,7,0,1,164
17121951700,2478,2330,29,9,4,3,0,5,148
17121951800,2288,2088,27,25,11,11,0,5,200
17121951900,2817,2612,39,40,17,1,0,5,205
17121952000,4413,4020,73,22,10,40,0,6,393
17121952100,3175,2795,83,73,3,30,0,7,380
17121952200,3985,3832,36,5,2,9,0,8,153
17121952300,3454,3199,41,36,13,17,1,13,255
17121952400,3717,3088,121,224,10,61,0,11,629
17121952500,2538,2116,66,182,0,9,0,10,422
17121952600,2148,1446,88,282,3,148,0,12,702
17121952700,3345,2417,75,602,10,13,0,14,928
17123961100,2412,2205,86,31,5,10,0,8,207
17123961200,2426,2275,32,6,3,12,0,9,151
17123961300,2092,1920,56,11,4,6,0,6,172
17123961400,2766,2614,48,15,6,4,0,0,152
17123961500,2046,1844,101,23,0,11,0,2,202
17125956300,2695,2546,38,4,3,4,0,2,149
17125956400,1858,1747,28,0,4,3,0,7,111
17125956500,2990,2758,45,23,7,6,0,1,232
17125956600,1762,1681,22,4,3,5,0,0,81
17125956700,1650,1583,24,7,4,0,1,1,67
17125956800,2131,2024,27,11,3,8,0,0,107
17127970100,4965,4477,89,144,5,15,2,19,488
17127970200,3726,2979,117,355,17,12,4,18,747
17127970300,3248,2812,67,171,8,4,0,7,436
17127970400,2230,1809,60,205,5,12,0,17,421
17129010100,6004,5601,71,41,9,23,2,8,403
17129010200,3988,3690,78,24,7,26,0,11,298
17129010300,2305,2211,11,15,2,0,0,6,94
17131040100,4518,4130,171,25,10,11,0,10,388
17131040200,3518,3306,87,5,4,0,0,5,212
17131040300,3783,3523,102,38,3,12,0,1,260
17131040400,3880,3619,108,0,9,14,2,1,261
17133600102,4892,4584,98,31,4,27,0,3,308
17133600103,3687,3391,105,18,11,17,0,13,296
17133600104,4315,4025,70,19,5,34,0,15,290
17133600401,7144,6652,142,16,10,47,0,12,492
17133600402,4880,4584,75,10,3,29,0,6,296
17133600501,6872,6435,113,21,11,27,2,15,437
17133600502,3172,3009,43,3,9,5,0,2,163
17135957300,3286,3118,45,13,4,8,1,0,168
17135957400,2236,2129,40,9,7,7,0,0,107
17135957500,2990,2815,42,13,8,7,1,2,175
17135957600,3455,3256,67,6,3,22,2,1,199
17135957700,2935,2688,71,27,2,46,0,0,247
17135957800,3217,3022,55,20,5,9,1,3,195
17135957900,4590,4251,82,34,6,20,2,6,339
17135958000,5579,4430,185,794,14,12,0,14,1149
17137951400,2400,2293,25,4,0,1,5,2,107
17137951500,2894,2765,36,17,1,3,0,1,129
17137951600,3146,2388,113,417,12,34,1,6,758
17137951700,2888,2276,95,323,8,19,0,25,612
17137951800,3453,2829,151,254,3,40,4,6,624
17137951900,4620,4189,75,137,11,75,2,7,431
17137952000,3786,2713,193,694,7,42,2,4,1073
17137952100,3538,3191,90,81,7,20,0,17,347
17137952200,2980,2812,33,20,0,15,0,8,168
17137952300,3210,3033,27,14,5,17,2,8,177
17139976900,4973,4799,67,14,0,14,0,8,174
17139977000,2356,2204,19,17,7,8,0,4,152
17139977100,3127,2941,37,16,12,4,0,7,186
17139977200,4070,3803,71,37,7,23,0,6,267
17141960700,4328,3960,146,12,6,40,0,11,368
17141960800,3412,3205,65,13,3,10,0,2,207
17141960900,4604,4087,313,33,0,13,0,0,517
17141961001,3190,2752,288,16,5,6,0,11,438
17141961002,3664,3123,292,40,1,20,0,4,541
17141961100,3791,2648,840,105,8,29,0,10,1143
17141961200,7183,4987,1774,88,9,51,0,11,2196
17141961301,2483,2313,83,5,1,11,0,4,170
17141961302,2588,2363,88,20,2,12,0,9,225
17141961400,3975,3555,173,39,11,24,0,17,420
17141961500,4310,3977,166,19,4,7,0,13,333
17141961600,3295,1765,1297,108,8,16,0,4,1530
17141961700,4965,4385,272,45,14,20,0,8,580
17143000200,1513,492,184,752,3,3,0,4,1021
17143000300,1792,473,301,925,0,0,4,4,1319
17143000600,2560,599,194,1595,9,7,0,24,1961
17143000900,2723,588,63,1918,3,21,0,17,2135
17143001200,1467,647,163,524,2,68,2,14,820
17143001300,1745,460,408,726,9,16,0,3,1285
17143001500,1628,688,270,529,1,7,0,15,940
17143001600,3444,1121,490,1475,6,117,0,13,2323
17143001800,3130,1293,287,1200,20,67,2,24,1837
17143001900,1021,727,72,121,3,36,0,11,294
17143002000,2889,2121,298,253,19,132,0,10,768
17143002100,4377,1232,431,2341,7,42,0,18,3145
17143002200,4082,1870,339,1536,5,59,4,22,2212
17143002300,4618,3544,169,584,11,100,1,14,1074
17143002400,4545,2317,497,1369,8,50,3,16,2228
17143002500,3399,822,489,1829,5,14,0,25,2577
17143002600,1716,1308,74,195,6,23,0,10,408
17143002701,3757,1478,228,1754,3,60,4,24,2279
17143002702,3901,2046,146,1358,10,121,1,37,1855
17143002800,3280,2078,181,710,3,108,3,10,1202
17143002900,3810,2836,141,547,11,92,2,10,974
17143003000,4662,3136,269,756,16,222,0,23,1526
17143003101,5432,3073,294,1258,8,473,0,19,2359
17143003103,2783,1722,115,406,3,384,0,22,1061
17143003104,3467,2573,144,330,11,266,0,12,894
17143003200,4142,2688,174,749,5,248,9,22,1454
17143003300,3021,2650,61,120,7,71,0,0,371
17143003402,4276,3631,113,185,3,158,1,12,645
17143003403,3395,2812,174,138,5,108,0,30,583
17143003404,8402,4881,301,315,12,2511,0,39,3521
17143003601,2815,2586,103,8,4,6,0,16,229
17143003602,5345,4785,238,30,2,12,2,13,560
17143003700,3757,3527,56,10,13,27,2,3,230
17143003800,3050,2779,130,22,4,13,0,16,271
17143003900,9246,7449,245,170,10,1014,5,36,1797
17143004000,4443,4176,78,15,4,11,1,6,267
17143004101,7350,5532,256,493,7,784,1,29,1818
17143004102,3086,1804,111,975,2,42,4,14,1282
17143004200,3570,2967,140,223,6,38,0,13,603
17143004300,2275,1720,113,249,3,20,0,14,555
17143004400,4365,2866,176,1013,9,29,0,15,1499
17143004500,4892,3958,256,354,13,35,1,16,934
17143004600,5052,4517,160,77,14,22,2,19,535
17143004801,4355,4001,125,52,7,26,0,7,354
17143004802,4210,3393,194,323,6,27,4,12,817
17143004901,3436,3236,43,17,6,11,0,8,200
17143004902,4961,4655,93,23,10,23,0,11,306
17143005000,1994,203,207,1476,2,4,2,9,1791
17143005100,2651,569,297,1607,6,2,1,22,2082
17145030100,2902,2769,32,9,4,8,0,6,133
17145030200,7114,5281,377,1247,8,43,0,6,1833
17145030300,2061,1881,81,11,4,6,0,3,180
17145030400,2432,2025,74,198,7,12,0,4,407
17145030500,2526,2306,70,71,5,23,0,6,220
17145030600,3910,3517,80,117,6,33,1,9,393
17147954500,4426,4135,80,12,7,13,0,18,291
17147954600,6310,5900,85,43,6,49,0,12,410
17147954700,3174,2980,48,13,1,15,1,9,194
17147954800,2763,2585,34,15,9,3,0,12,178
17149952400,2937,2762,43,10,6,6,5,5,175
17149952500,2431,2266,44,4,4,8,0,6,165
17149952600,2915,2771,38,8,2,3,1,4,144
17149952700,4362,4038,128,41,14,19,0,5,324
17149952800,2094,2037,9,0,7,7,0,0,57
17151971200,1991,1859,38,20,1,6,0,0,132
17151971300,1772,1632,33,18,0,10,0,0,140
17153971000,2678,1978,43,513,14,2,0,10,700
17153971100,2515,1267,161,949,22,11,0,4,1248
17155954500,2814,2452,242,19,2,11,4,3,362
17155954600,2823,2621,106,7,5,7,0,5,202
17157950500,2063,1933,21,46,0,12,4,5,130
17157950600,4181,3069,112,708,7,14,1,27,1112
17157950700,2424,2245,43,4,3,0,0,6,179
17157950800,4681,4379,69,24,8,20,0,12,302
17157950900,3193,2974,35,2,14,6,0,6,219
17157951000,2587,2488,14,9,0,1,0,8,99
17157951100,3358,2986,210,18,5,16,2,1,372
17157951201,1783,1605,108,22,3,0,0,1,178
17157951202,3082,1265,288,1494,3,8,0,2,1817
17157951300,2811,2516,131,54,5,9,0,4,295
17159977900,3784,3614,39,8,4,7,0,10,170
17159978000,2033,1880,49,19,4,18,3,4,153
17159978100,4009,3668,106,25,8,71,1,3,341
17159978200,2672,2424,67,20,9,15,1,5,248
17159978300,3315,3227,12,3,3,12,2,0,88
17161020101,2545,2291,114,23,2,6,0,3,254
17161020102,3609,3335,123,14,2,14,0,17,274
17161020103,934,875,25,4,2,0,0,5,59
17161020200,3624,2607,411,392,7,34,3,12,1017
17161020301,4358,3039,558,429,12,151,0,16,1319
17161020302,2426,1409,657,214,7,2,0,6,1017
17161020400,5967,3644,913,1151,5,30,0,22,2323
17161020600,2267,839,944,365,4,17,0,9,1428
17161020700,1615,717,578,199,3,31,0,5,898
17161020800,5110,3497,938,355,7,117,0,12,1613
17161020900,5715,3457,787,829,8,427,0,12,2258
17161021000,3812,2131,356,936,6,178,0,17,1681
17161021100,3862,2516,449,452,10,223,0,12,1346
17161021200,4634,3081,399,495,9,478,1,11,1553
17161021300,4772,3199,527,690,2,127,0,13,1573
17161021400,1175,744,270,81,3,9,0,15,431
17161021500,4358,3198,634,192,4,127,1,17,1160
17161021600,2687,1685,580,243,5,33,1,8,1002
17161021700,3676,2018,1117,346,7,17,2,11,1658
17161021800,4837,3682,605,288,3,81,6,5,1155
17161021900,1594,1271,161,73,3,17,0,4,323
17161022000,4077,2997,661,165,8,84,1,16,1080
17161022100,2553,1914,382,114,6,34,0,5,639
17161022200,4006,2140,1357,297,12,32,0,12,1866
17161022300,2081,717,1020,240,0,23,0,3,1364
17161022600,2014,731,255,846,6,60,0,12,1283
17161022800,5335,3398,788,581,4,240,3,31,1937
17161022900,2815,1964,346,217,9,140,0,9,851
17161023000,3998,3189,271,211,2,147,2,16,809
17161023100,2745,2127,186,186,4,119,0,15,618
17161023200,4931,3519,416,618,8,159,0,15,1412
17161023300,3254,1872,511,632,2,51,3,14,1382
17161023500,1943,633,280,805,8,46,0,7,1310
17161023600,1609,231,178,1055,5,68,0,4,1378
17161023700,2322,761,303,848,6,228,1,12,1561
17161024000,4186,3682,262,35,4,32,3,9,504
17161024101,3590,3251,109,45,0,18,3,11,339
17161024102,5383,4669,235,204,18,28,0,16,714
17161024103,3777,3563,101,12,7,12,0,6,214
17161024200,4045,3232,278,269,4,38,2,6,813
17161024300,2566,2172,156,74,11,18,0,10,394
17161024400,1896,834,138,518,3,292,2,7,1062
17161024500,1969,858,463,426,2,45,1,14,1111
17163500400,1046,26,9,982,2,1,0,3,1020
17163500500,1464,7,4,1415,0,3,0,16,1457
17163500900,2485,18,33,2353,6,4,0,1,2467
17163501100,1216,4,17,1157,0,0,0,8,1212
17163501200,2626,21,14,2534,5,0,2,0,2605
17163501300,2568,37,19,2431,4,1,0,1,2531
17163501400,2167,19,16,2082,2,0,1,5,2148
17163501501,1580,544,28,913,0,12,0,14,1036
17163501502,2613,1499,80,847,6,23,1,13,1114
17163501602,4980,2783,178,1735,22,42,8,11,2197
17163501604,4323,1609,114,2373,6,30,3,10,2714
17163501605,2535,1605,94,661,2,10,0,9,930
17163501606,3605,2204,152,978,2,23,2,31,1401
17163501607,2332,1040,83,1090,0,23,0,10,1292
17163501700,3185,1801,176,991,4,26,1,9,1384
17163501801,3045,1942,96,754,10,29,0,13,1103
17163501802,2481,1582,80,619,7,27,0,10,899
17163501900,3269,2342,122,570,7,19,4,13,927
17163502100,2246,417,1782,1,2,11,0,3,1829
17163502200,1171,53,40,1043,0,1,0,10,1118
17163502300,5205,1327,102,3537,17,2,5,30,3878
17163502401,832,25,20,763,0,0,0,0,807
17163502404,3702,1502,1200,860,5,16,1,12,2200
17163502500,1004,21,11,935,0,1,0,1,983
17163502602,4809,1105,120,3332,22,8,1,15,3704
17163502603,2915,559,78,2153,8,0,0,9,2356
17163502700,975,10,5,918,0,1,3,7,965
17163502800,2155,30,25,2022,1,1,0,6,2125
17163502900,1634,43,14,1516,0,6,0,4,1591
17163503101,2525,2304,62,13,6,0,0,7,221
17163503102,4653,3942,134,246,17,21,2,15,711
17163503202,5461,4194,117,889,15,23,0,26,1267
17163503203,6756,6290,121,34,3,26,3,17,466
17163503211,4146,2620,189,1042,7,42,0,44,1526
17163503301,3588,2240,200,882,19,35,7,33,1348
17163503304,6759,4225,260,1786,17,72,12,18,2534
17163503322,7555,5020,232,1682,16,200,5,30,2535
17163503323,6399,4418,231,1192,11,199,9,14,1981
17163503324,6109,2732,264,2582,14,132,7,36,3377
17163503332,5109,2467,206,1949,12,89,3,26,2642
17163503334,6153,3392,232,2004,15,138,1,29,2761
17163503404,7971,5639,449,1053,8,264,14,72,2332
17163503411,3419,2354,467,390,10,9,3,17,1065
17163503412,6082,4627,295,650,10,134,1,44,1455
17163503413,5683,2762,292,2019,10,178,0,37,2921
17163503414,5969,3444,386,1525,5,195,1,33,2525
17163503415,3079,1841,116,853,9,33,7,21,1238
17163503416,3767,1996,171,1295,7,62,4,10,1771
17163503800,1280,850,106,148,3,61,5,15,430
17163503903,3853,3200,122,265,4,67,1,23,653
17163503905,2996,2771,73,17,8,7,6,3,225
17163503906,5295,4909,92,33,10,28,3,24,386
17163503907,5444,3889,257,755,9,175,0,31,1555
17163503908,6429,3853,690,1089,12,220,24,30,2576
17163504001,5184,4832,97,28,5,18,1,16,352
17163504002,5511,5112,131,33,10,9,4,1,399
17163504351,3529,2570,91,557,0,76,2,15,959
17163504352,4203,3128,201,497,12,93,4,19,1075
17163504353,4362,3350,218,419,6,119,0,12,1012
17163504354,6321,3907,298,1479,8,156,10,35,2414
17163504355,5300,3881,251,649,2,169,0,23,1419
17163504356,4519,3609,226,254,16,83,6,24,910
17163504357,4408,3570,219,246,4,57,0,36,838
17163504358,3883,3003,153,412,11,54,2,15,880
17163504359,4137,3292,151,434,6,53,2,9,845
17163504501,2329,48,36,2166,4,2,0,0,2281
17163504502,1301,31,25,1197,2,0,0,4,1270
17163504600,1765,9,9,1684,7,4,0,14,1756
17165955100,2143,1970,59,13,0,4,0,0,173
17165955500,2199,2052,32,17,4,4,0,9,147
17165955600,2489,2378,29,4,12,8,0,6,111
17165955700,2663,2492,26,15,10,16,0,4,171
17165955800,3022,2611,77,155,10,32,0,12,411
17165955900,2344,1965,93,121,5,11,0,23,379
17165956000,2730,2325,57,102,8,34,0,8,405
17165956100,2622,2204,58,211,12,5,0,13,418
17165956200,3556,3312,42,54,8,8,0,19,244
17167000100,3517,3038,72,211,6,13,0,9,479
17167000201,2296,1810,75,255,3,42,0,13,486
17167000202,3330,2143,88,747,10,34,0,19,1187
17167000300,2405,1540,119,551,10,36,0,12,865
17167000400,2640,1934,77,422,2,13,0,10,706
17167000501,2130,1713,48,214,2,24,0,18,417
17167000503,3667,2718,85,556,8,25,0,24,949
17167000504,2802,2145,96,372,4,14,1,14,657
17167000600,4791,3606,128,606,21,25,1,13,1185
17167000700,2077,1548,56,303,12,12,0,5,529
17167000800,1889,531,51,1174,0,4,0,16,1358
17167000900,2183,1116,110,749,10,19,2,5,1067
17167001001,2151,1665,60,254,2,72,0,10,486
17167001003,1377,1039,46,175,2,43,0,9,338
17167001004,4729,3152,173,974,11,131,0,18,1577
17167001100,2358,1944,74,190,0,32,0,2,414
17167001200,3377,2465,133,506,2,44,5,18,912
17167001300,1724,938,109,502,2,58,0,12,786
17167001400,1183,658,43,356,1,73,2,9,525
17167001600,2930,594,56,2077,1,8,5,20,2336
17167001800,1982,1149,70,560,4,24,0,10,833
17167001900,3066,1824,136,783,3,43,0,18,1242
17167002001,3711,3130,81,188,0,200,0,8,581
17167002002,2450,2035,57,177,7,107,0,1,415
17167002100,3582,2996,131,228,0,72,0,4,586
17167002200,3212,2560,89,312,5,33,4,15,652
17167002300,2184,914,85,1015,3,8,2,11,1270
17167002400,3310,896,76,2122,16,12,1,26,2414
17167002500,5104,3104,130,1551,14,25,0,15,2000
17167002600,2514,1615,116,546,8,25,0,30,899
17167002700,3044,2420,108,255,8,39,7,16,624
17167002801,2974,1983,119,619,10,65,1,12,991
17167002802,3174,1284,172,1174,2,313,0,20,1890
17167002900,4921,3582,118,741,6,223,2,19,1339
17167003000,5798,4080,306,919,18,236,8,11,1718
17167003100,7518,6689,149,203,7,204,0,17,829
17167003201,5125,4143,176,268,12,283,0,19,982
17167003202,5052,4214,155,194,5,233,0,27,838
17167003203,6535,5827,118,126,14,155,0,12,708
17167003300,4845,4536,47,29,9,14,0,22,309
17167003400,5930,5484,104,37,18,14,0,21,446
17167003500,5175,4852,74,41,6,11,2,22,323
17167003601,2720,2548,49,5,0,16,0,3,172
17167003602,4703,4212,87,133,4,108,1,1,491
17167003603,5693,4854,157,156,3,340,0,0,839
17167003604,5750,4525,138,372,9,569,0,13,1225
17167003701,4575,4296,81,30,2,17,0,3,279
17167003702,4234,3947,63,30,7,47,1,14,287
17167003801,2559,2226,45,104,14,15,2,13,333
17167003802,5864,5312,121,66,11,29,3,24,552
17167003901,5325,4895,74,79,2,59,2,10,430
17167003902,3953,3625,71,29,2,31,0,18,328
17167004000,4212,3970,43,10,6,7,0,7,242
17167004200,1993,443,64,1390,5,1,3,9,1550
17169970100,2087,1780,47,132,19,2,0,6,307
17169970200,3068,2741,61,148,5,20,0,9,327
17169970300,1747,1636,44,3,4,3,2,2,111
17171970600,1685,1602,18,0,0,4,0,3,83
17171970700,3264,3145,30,5,1,7,1,2,119
17173959100,3444,3305,35,25,11,11,0,4,139
17173959200,2775,2691,15,7,0,7,0,4,84
17173959300,4935,4650,88,15,9,33,0,7,285
17173959400,3333,3231,19,5,6,6,1,2,102
17173959500,3463,3339,31,6,4,16,0,5,124
17173959600,3040,2900,25,7,5,10,0,18,140
17175951400,2981,2804,79,7,4,4,0,3,177
17175951500,2419,2266,53,10,4,19,0,2,153
17177000100,4500,4203,94,20,8,15,0,21,297
17177000200,3132,2920,92,18,2,1,0,2,212
17177000300,3841,3640,93,11,3,5,0,5,201
17177000400,2733,2539,108,18,0,7,1,0,194
17177000500,2929,2744,51,39,1,23,1,4,185
17177000600,3091,2856,89,27,7,5,0,1,235
17177000700,1474,739,92,493,11,9,0,7,735
17177000800,3134,1631,296,936,12,16,0,18,1503
17177000900,4844,3822,172,569,5,63,3,13,1022
17177001000,4354,3498,164,404,3,58,0,21,856
17177001100,3224,2398,212,390,5,49,0,16,826
17177001200,3622,2203,439,632,9,34,2,26,1419
17177001300,3752,2212,352,817,14,21,4,21,1540
17179020100,2458,2093,120,30,9,19,4,7,365
17179020301,4544,4074,147,53,1,27,2,18,470
17179020302,4929,4349,169,106,13,44,0,15,580
17179020400,4979,4432,180,63,15,15,2,8,547
17179020500,4267,3902,85,19,13,27,4,5,365
17179020600,1984,1833,60,6,1,7,0,6,151
17179020700,4281,3984,82,23,3,41,7,7,297
17179020800,2909,2649,49,20,4,18,0,10,260
17179020900,1934,1779,30,1,10,5,0,2,155
17179021000,5251,4838,137,43,13,20,0,7,413
17179021101,6352,5748,143,65,21,65,2,10,604
17179021102,5730,5380,85,34,12,40,1,10,350
17179021201,4919,4428,119,59,5,82,0,13,491
17179021202,3139,2815,99,52,6,34,4,7,324
17179021203,4866,4406,145,67,7,39,0,20,460
17179021500,6940,6424,154,31,10,75,3,28,516
17179021603,5752,5328,112,40,7,95,2,11,424
17179021604,1921,1722,58,31,1,38,0,3,199
17179021605,2642,2435,81,23,0,28,3,7,207
17179021606,6158,5719,139,47,1,79,0,7,439
17179021701,5916,5520,95,42,8,23,0,15,396
17179021702,5547,5184,104,48,9,25,1,11,363
17179021801,5040,4058,197,540,70,32,2,8,982
17179021802,1939,1829,32,4,0,5,1,4,110
17179021900,4351,4056,59,26,8,8,0,18,295
17179022000,4090,3876,53,16,8,13,0,5,214
17179022100,3352,3144,58,16,0,23,0,6,208
17179022200,4449,4093,90,42,12,47,0,15,356
17179022300,6033,5546,135,51,3,87,3,25,487
17179022400,4671,4238,144,31,9,19,0,16,433
17181950100,4158,3536,398,30,11,12,3,8,622
17181950200,2374,2138,147,4,3,11,0,4,236
17181950300,1911,1746,67,12,4,7,0,4,165
17181950400,5224,4575,198,169,20,30,8,9,649
17181950500,3577,3336,57,11,8,7,0,3,241
17183000100,1534,784,121,516,3,14,0,10,750
17183000200,1367,517,112,643,2,2,3,8,850
17183000300,1955,791,240,799,8,11,2,5,1164
17183000400,3077,831,207,1845,0,6,0,24,2246
17183000500,3693,1935,228,1224,9,47,0,15,1758
17183000600,2216,876,172,1050,11,10,0,6,1340
17183000700,3572,2529,184,580,0,89,1,13,1043
17183000800,2241,1731,105,256,1,32,0,9,510
17183000900,2149,1791,102,143,4,4,0,7,358
17183001200,3036,2367,152,359,2,57,0,5,669
17183001300,3593,2951,104,241,12,153,0,7,642
17183010100,3068,2825,118,21,3,8,0,2,243
17183010200,5007,4161,605,54,7,14,0,10,846
17183010300,4459,4094,130,24,5,19,0,20,365
17183010400,2282,2096,82,18,2,14,0,1,186
17183010500,3432,3078,124,51,17,16,0,17,354
17183010600,4139,3860,83,41,4,12,0,14,279
17183010701,2894,2613,87,56,2,5,0,5,281
17183010702,2963,2781,45,13,8,10,0,6,182
17183010800,3209,2952,76,23,6,6,0,9,257
17183010900,2836,2697,30,14,11,5,0,2,139
17183011000,3767,3417,78,96,8,6,0,8,350
17183011100,2428,2274,46,17,6,2,4,9,154
17183011200,5271,2235,585,2163,9,26,0,37,3036
17185957200,3649,3521,33,4,6,7,0,7,128
17185957300,3051,2705,39,20,3,216,4,0,346
17185957400,1986,1834,37,11,1,8,1,1,152
17185957500,2675,2460,69,18,5,20,1,7,215
17187870100,2087,1936,60,9,4,8,0,0,151
17187870200,2573,2416,48,12,11,5,6,10,157
17187870300,2561,2398,51,7,4,8,0,9,163
17187870400,4804,3538,719,233,4,162,3,14,1266
17187870500,4810,3206,911,316,8,146,6,13,1604
17189950100,3082,2897,54,27,4,7,0,3,185
17189950200,3684,3488,56,8,9,9,14,1,196
17189950300,3077,2855,61,35,9,31,6,0,222
17189950400,3918,3736,53,15,3,18,0,11,182
17191954900,3266,3134,44,12,5,12,2,0,132
17191955000,4335,4156,29,3,1,9,1,11,179
17191955100,2714,2571,47,14,6,15,0,8,143
17191955200,3032,2825,35,56,13,7,0,7,207
17191955300,2832,2714,27,5,1,6,2,3,118
17193958000,1999,1850,45,21,0,7,2,1,149
17193958100,3294,3070,44,7,4,35,5,3,224
17193958200,2651,2499,25,18,10,11,4,10,152
17193958300,2846,2647,55,40,8,10,0,1,199
17193958400,3087,2941,19,5,0,2,7,0,146
17195000100,3527,3109,278,11,0,10,0,11,418
17195000200,3008,2759,140,34,3,15,0,4,249
17195000300,3249,2992,119,24,0,12,0,7,257
17195000400,3031,2924,39,5,1,10,0,4,107
17195000500,3645,3334,142,20,6,20,0,19,311
17195000600,4012,3765,98,4,7,13,0,11,247
17195000700,2736,2490,94,25,2,11,0,8,246
17195000800,1946,1814,55,6,5,1,0,1,132
17195000900,3623,2982,462,51,3,34,1,12,641
17195001000,2939,1590,1107,96,4,0,0,24,1349
17195001101,2639,1917,548,62,2,10,0,5,722
17195001102,2108,1133,768,80,4,10,0,0,975
17195001200,3842,2696,851,91,3,29,6,5,1146
17195001300,2417,1633,567,52,2,89,0,2,784
17195001400,2243,1921,201,19,3,5,2,0,322
17195001500,3218,2430,534,59,5,13,0,15,788
17195001600,2538,1907,447,41,1,9,0,10,631
17195001700,2892,2081,525,56,9,12,0,8,811
17195001800,2078,1864,156,5,0,3,0,3,214
17197880105,7471,2665,1983,1413,9,1073,0,28,4806
17197880106,4494,1449,1828,853,4,202,0,12,3045
17197880107,5101,1677,1783,1036,13,378,0,27,3424
17197880109,5283,2252,1136,1206,0,488,0,17,3031
17197880111,3683,1173,1576,576,9,239,0,7,2510
17197880112,2031,690,860,255,7,163,0,5,1341
17197880113,3725,743,1890,687,5,285,8,20,2982
17197880114,2896,545,1178,758,0,304,0,16,2351
17197880115,3276,849,1317,752,1,228,0,21,2427
17197880116,2913,1123,858,633,3,197,0,10,1790
17197880117,3649,1490,810,786,8,427,1,14,2159
17197880118,4676,3453,218,83,0,727,0,20,1223
17197880119,4445,3222,264,74,1,715,0,29,1223
17197880122,5914,2191,1028,1129,6,1286,0,22,3723
17197880123,3709,1380,592,826,10,735,0,11,2329
17197880124,3940,1264,964,1068,2,446,0,18,2676
17197880125,5463,2604,923,903,3,807,2,27,2859
17197880202,4716,2300,1575,460,3,212,3,19,2416
17197880203,3813,1957,1573,117,9,20,0,14,1856
17197880204,6150,3387,1655,664,0,281,0,16,2763
17197880303,4117,2930,272,114,6,595,0,11,1187
17197880304,5018,3555,271,95,1,895,2,17,1463
17197880305,5410,3547,293,151,4,1206,0,25,1863
17197880307,6448,3094,410,515,1,2172,3,17,3354
17197880309,4959,2971,273,174,2,1415,2,12,1988
17197880314,7478,5245,811,454,10,618,8,11,2233
17197880315,3846,1445,389,360,3,1470,0,19,2401
17197880316,3824,1717,202,240,4,1533,0,9,2107
17197880317,6383,3261,657,836,6,1317,1,31,3122
17197880318,3718,2357,272,210,2,736,0,12,1361
17197880319,5010,2726,461,244,10,1387,0,25,2284
17197880320,3481,2492,336,163,1,348,0,10,989
17197880321,3941,2478,430,312,1,573,0,23,1463
17197880322,6727,2869,322,316,7,2925,3,31,3858
17197880323,6782,3564,299,321,8,2358,0,13,3218
17197880324,5198,2459,731,587,3,1182,1,16,2739
17197880325,3273,1724,482,363,1,525,0,24,1549
17197880326,3281,1658,517,343,2,567,2,6,1623
17197880408,5050,2279,1576,741,2,249,0,13,2771
17197880411,3328,2621,325,95,2,146,0,17,707
17197880412,4189,2671,937,318,2,59,0,9,1518
17197880414,4281,3005,779,195,9,101,1,17,1276
17197880416,3158,2085,694,204,3,67,0,5,1073
17197880417,2553,1800,414,155,1,103,0,12,753
17197880418,4933,3227,983,394,7,155,0,2,1706
17197880421,6407,4597,874,423,8,257,0,16,1810
17197880422,3788,3150,393,58,4,44,0,16,638
17197880423,3763,2343,511,418,1,342,3,6,1420
17197880424,5131,3392,674,377,11,476,0,16,1739
17197880425,4649,1709,1635,647,2,521,0,14,2940
17197880426,4181,1671,1316,664,7,391,0,10,2510
17197880427,2733,1769,605,164,16,64,0,4,964
17197880428,4879,2413,1402,554,5,344,0,16,2466
17197880429,4953,3007,1023,579,0,131,0,16,1946
17197880430,3723,2075,970,378,4,123,1,19,1648
17197880431,6262,3655,1591,674,3,109,0,15,2607
17197880432,4275,2073,1319,531,7,134,0,17,2202
17197880502,4998,4157,539,24,9,29,0,20,841
17197880503,4350,2800,797,415,0,228,1,2,1550
17197880508,3775,1708,1378,384,0,204,0,7,2067
17197880509,3908,1562,1942,216,7,45,0,6,2346
17197880510,3187,803,992,975,7,297,0,16,2384
17197880511,3997,1185,1258,790,0,609,0,15,2812
17197880601,3069,2619,282,11,0,37,0,11,450
17197880602,3389,2789,384,61,1,19,0,6,600
17197880701,4405,3630,439,104,0,86,0,8,775
17197880702,2712,803,945,842,7,5,0,14,1909
17197880901,6156,4033,1325,425,7,159,0,13,2123
17197880903,3068,1505,697,679,6,70,1,1,1563
17197880905,2705,1485,954,144,0,18,0,12,1220
17197881001,5411,4661,459,43,3,75,1,26,750
17197881002,5056,4558,328,17,0,53,0,10,498
17197881005,3589,3104,260,21,3,104,0,8,485
17197881006,2473,2174,184,21,4,33,0,3,299
17197881007,5843,5028,404,93,0,126,1,5,815
17197881009,7972,6857,680,91,6,149,0,9,1115
17197881010,4056,3382,392,44,4,104,0,12,674
17197881011,3401,3059,211,8,3,51,0,0,342
17197881012,2953,2585,180,30,3,60,0,3,368
17197881105,7543,6583,565,56,15,100,0,15,960
17197881107,2857,2473,203,46,6,15,0,6,384
17197881108,6746,5462,759,202,6,64,0,33,1284
17197881109,4398,3830,333,64,1,36,0,0,568
17197881111,2971,2678,164,28,2,17,0,4,293
17197881112,5581,4989,395,33,4,37,0,8,592
17197881113,5493,4761,370,77,7,79,3,4,732
17197881115,4311,3730,333,53,2,36,0,6,581
17197881116,3809,3471,204,19,3,26,0,12,338
17197881201,2460,129,1100,1185,3,0,0,7,2331
17197881202,2095,422,882,730,0,15,1,7,1673
17197881301,3040,108,2721,180,3,7,0,4,2932
17197881302,1307,56,1129,107,3,0,0,0,1251
17197881401,3413,1078,1961,253,4,23,0,10,2335
17197881402,3295,1560,1294,294,8,41,0,5,1735
17197881500,3558,1998,1206,216,3,24,1,9,1560
17197881601,1979,1156,510,218,1,24,0,11,823
17197881603,3301,979,877,1262,6,70,0,16,2322
17197881604,2617,951,614,881,5,83,0,12,1666
17197881700,3170,2258,612,167,4,20,0,0,912
17197881800,4057,1321,2038,514,4,51,0,3,2736
17197881900,3770,515,1689,1452,2,20,0,9,3255
17197882000,3152,412,1412,1263,7,11,0,12,2740
17197882100,2377,101,2047,205,0,0,2,3,2276
17197882200,4824,881,3405,426,12,14,0,8,3943
17197882300,3891,1495,1819,397,3,23,0,20,2396
17197882400,3811,353,2260,1091,5,11,7,3,3458
17197882500,2090,106,841,1084,3,5,0,5,1984
17197882601,3301,1436,1398,305,4,29,0,7,1865
17197882602,2809,517,1581,600,3,13,2,8,2292
17197882701,2499,1273,858,247,7,22,0,11,1226
17197882702,3095,1113,1042,816,2,13,0,7,1982
17197882801,2722,1162,1019,371,3,71,0,8,1560
17197882802,3018,1118,877,849,6,47,0,19,1900
17197882900,2387,1189,898,171,2,13,0,13,1198
17197883000,3428,1099,1187,1022,10,17,0,8,2329
17197883100,3961,951,1129,1703,7,14,0,33,3010
17197883206,4211,2402,998,571,3,66,0,10,1809
17197883208,3165,1917,653,403,3,78,0,8,1248
17197883209,2901,1986,600,141,2,53,2,16,915
17197883210,2735,2093,316,194,2,38,0,4,642
17197883211,6584,3376,1572,1198,7,157,2,32,3208
17197883212,6239,4919,656,297,3,107,0,17,1320
17197883213,5872,4846,512,226,2,70,0,24,1026
17197883214,2375,1577,414,170,0,152,0,3,798
17197883216,3249,2247,597,236,2,68,0,5,1002
17197883217,4103,2212,1103,515,1,122,1,22,1891
17197883218,4279,2100,1321,590,1,119,0,12,2179
17197883219,3766,2435,678,354,0,161,0,17,1331
17197883303,3907,3387,273,53,0,24,0,28,520
17197883304,1721,1573,108,2,3,1,0,2,148
17197883305,3045,2691,223,15,1,5,0,10,354
17197883306,3567,2970,390,14,7,15,0,10,597
17197883307,3898,3296,380,105,6,17,2,16,602
17197883401,4018,3529,213,58,13,21,1,15,489
17197883402,1940,1733,96,13,3,3,2,5,207
17197883504,5594,4797,303,279,5,108,0,9,797
17197883505,8769,6375,660,1101,5,309,2,26,2394
17197883507,3878,3334,280,125,3,14,0,5,544
17197883509,4521,3963,327,62,7,24,0,8,558
17197883510,7057,6143,519,101,8,26,0,17,914
17197883511,4854,4019,470,144,6,77,0,12,835
17197883513,5641,4609,450,158,5,233,0,4,1032
17197883514,7214,5539,568,418,0,492,1,20,1675
17197883515,4183,3602,244,90,0,112,0,0,581
17197883516,8095,6826,390,376,3,229,0,17,1269
17197883517,3266,2873,217,43,2,55,0,1,393
17197883519,5601,4869,389,106,8,96,1,15,732
17197883521,3304,2844,243,54,4,50,0,9,460
17197883522,3275,2902,165,46,0,75,0,0,373
17197883602,5508,3414,622,1204,9,68,4,20,2094
17197883603,3012,638,262,1903,9,29,0,10,2374
17197883605,2891,100,83,2624,0,2,0,19,2791
17197883606,4138,652,315,2878,13,65,0,30,3486
17197883700,3255,1736,703,659,2,2,0,15,1519
17197883803,2500,362,161,1876,4,11,0,24,2138
17197883804,2859,1563,521,619,2,9,0,14,1296
17197883806,3281,1631,400,1117,4,20,0,3,1650
17197883808,1414,958,164,248,0,1,0,1,456
17197883809,3630,2278,451,719,9,11,0,18,1352
17197883810,3795,1344,316,1904,7,40,0,30,2451
17197883811,3025,1929,394,525,8,29,1,6,1096
17197883902,6495,5356,694,202,6,59,0,9,1139
17197883903,1793,1468,214,20,2,16,2,7,325
17197883904,4365,3807,334,46,2,16,0,9,558
17197884003,4400,3739,348,54,5,14,0,4,661
17197884004,2464,2214,128,8,6,7,0,0,250
17197884005,1367,1236,61,6,2,0,0,1,131
17197884006,2124,1913,118,3,4,8,0,4,211
17197884101,3744,2304,674,494,1,168,0,8,1440
17197884103,2642,1055,928,395,0,151,0,16,1587
17197980000,0,0,0,0,0,0,0,0,0
17197980100,2739,488,410,1823,6,10,0,0,2251
17199020100,3483,2997,72,199,13,8,0,14,486
17199020201,5552,4848,153,138,10,104,4,20,704
17199020202,3150,2555,141,151,8,121,0,7,595
17199020300,5067,4536,102,78,14,101,2,12,531
17199020400,3496,3017,107,138,7,39,2,5,479
17199020500,3400,2964,77,125,5,62,0,8,436
17199020600,3798,3442,76,60,4,11,0,8,356
17199020700,4791,4340,113,39,12,3,0,16,451
17199020801,2806,2653,48,11,8,4,0,7,153
17199020802,4131,3888,41,5,5,10,0,0,243
17199020900,4704,4220,89,115,9,70,0,22,484
17199021001,2594,2112,57,244,1,40,0,10,482
17199021002,1509,1195,128,79,2,54,0,3,314
17199021003,1120,840,50,110,4,16,0,20,280
17199021100,2958,2301,142,306,10,12,0,12,657
17199021200,4404,3565,169,332,14,44,1,14,839
17199021300,4688,4205,76,148,11,29,0,13,483
17199021400,5502,4515,138,531,93,43,0,16,987
17201000101,4727,3823,397,140,18,49,1,16,904
17201000103,2729,2235,246,48,12,20,0,5,494
17201000104,2665,2117,228,101,4,45,5,13,548
17201000105,4161,3338,368,140,12,68,0,6,823
17201000200,3152,2545,287,103,9,37,4,3,607
17201000300,3786,3066,294,136,7,30,0,25,720
17201000401,2191,1653,232,100,6,85,1,5,538
17201000402,3009,2242,351,219,0,72,0,6,767
17201000403,4438,3076,447,553,10,157,0,12,1362
17201000501,4916,2834,916,644,10,252,0,28,2082
17201000502,3862,1967,860,673,2,176,0,28,1895
17201000506,4166,3148,473,215,2,124,0,4,1018
17201000507,3996,2320,549,753,0,163,1,13,1676
17201000510,3155,2238,284,262,0,250,1,7,917
17201000511,2511,1550,411,156,2,283,0,8,961
17201000512,5366,3789,466,453,8,450,0,13,1577
17201000513,4022,2872,415,311,20,243,0,2,1150
17201000514,3368,2521,388,162,2,155,1,8,847
17201000515,2727,1891,295,293,0,135,0,19,836
17201000516,4071,3076,393,292,0,136,0,14,995
17201000600,4259,2858,601,436,12,122,0,8,1401
17201000700,3065,2309,328,223,0,51,3,13,756
17201000800,2860,1312,596,738,2,36,0,22,1548
17201001000,2065,528,522,875,5,35,0,8,1537
17201001100,1243,602,141,371,5,65,1,3,641
17201001200,2191,598,582,580,2,312,0,10,1593
17201001300,2110,723,488,655,5,95,0,6,1387
17201001400,4122,1840,1014,916,18,54,0,34,2282
17201001500,5454,2915,1377,649,4,264,3,18,2539
17201001600,5556,2609,1362,957,6,277,4,56,2947
17201001700,3117,1565,883,413,14,60,0,13,1552
17201001800,4762,1749,1317,1196,18,218,0,24,3013
17201001900,3463,1798,1022,345,10,158,0,8,1665
17201002000,2366,1259,791,154,11,16,1,18,1107
17201002100,1780,553,424,639,11,62,0,2,1227
17201002200,3508,1060,1295,983,16,9,0,8,2448
17201002301,2410,1017,429,791,6,10,0,5,1393
17201002302,1249,776,250,133,6,4,1,3,473
17201002400,2464,424,460,1465,3,6,0,5,2040
17201002500,2626,390,656,1390,11,7,4,9,2236
17201002600,2736,499,424,1620,7,12,3,20,2237
17201002700,2993,280,1642,979,12,4,0,7,2713
17201002800,1388,113,768,451,0,2,0,1,1275
17201002900,1117,663,64,334,3,15,0,5,454
17201003000,1689,1226,139,200,2,42,0,12,463
17201003100,3788,1344,616,1582,4,18,0,41,2444
17201003200,3092,463,595,1858,12,6,0,19,2629
17201003300,3542,1180,837,1316,11,6,3,15,2362
17201003400,4579,2110,833,1237,6,27,0,17,2469
17201003500,2323,1734,238,214,4,15,0,10,589
17201003601,1565,1210,191,89,0,8,2,6,355
17201003602,3963,2064,476,1205,4,25,1,21,1899
17201003604,3080,1395,575,887,14,22,0,18,1685
17201003605,1963,1072,175,619,4,16,0,10,891
17201003606,2670,1204,456,822,5,32,1,17,1466
17201003705,4749,3850,480,91,5,144,3,12,899
17201003706,6474,4107,1296,419,12,343,0,22,2367
17201003707,3579,1970,613,659,3,117,0,20,1609
17201003708,3086,1158,826,668,10,246,0,23,1928
17201003709,1907,729,513,495,7,40,0,15,1178
17201003710,2551,1772,355,100,1,163,0,9,779
17201003711,4078,3179,407,212,16,23,1,24,899
17201003801,6457,5240,460,284,16,107,4,23,1217
17201003805,7284,6177,366,187,9,206,5,23,1107
17201003806,5090,4096,385,183,5,155,0,21,994
17201003808,3578,2921,237,125,3,68,0,11,657
17201003809,4649,3438,489,334,11,135,0,17,1211
17201003810,6495,4781,560,450,4,446,0,13,1714
17201003811,1360,1070,129,67,0,34,0,1,290
17201003901,4983,4256,276,96,8,91,4,19,727
17201003903,6095,5406,217,76,8,140,2,11,689
17201003904,4762,4072,266,80,11,104,0,25,690
17201004002,6613,5748,390,111,12,60,1,17,865
17201004003,2102,1402,474,96,4,5,0,9,700
17201004004,5870,4510,646,241,13,112,0,21,1360
17201004005,3155,2773,152,32,2,60,0,4,382
17201004100,5153,4784,148,18,11,17,5,16,369
17201004200,6095,5464,234,85,5,51,0,15,631
17201004300,5007,4589,166,55,6,30,0,1,418
17201980000,2,0,0,0,0,0,0,0,2
17203030100,2430,2282,23,13,2,8,1,13,148
17203030200,2760,2621,35,15,3,2,1,9,139
17203030300,2813,2693,41,11,1,4,2,6,120
17203030400,5782,5388,120,10,16,30,1,10,394
17203030501,7842,7194,200,55,3,94,2,19,648
17203030502,2387,2176,57,9,5,12,2,0,211
17203030601,6324,5835,132,93,2,33,1,15,489
17203030602,3597,3426,45,9,8,22,0,14,171
17203030700,4532,4229,87,54,2,12,0,3,303
18001030100,4589,4266,194,11,17,14,0,4,323
18001030200,5103,4406,430,52,20,34,2,7,697
18001030300,5246,4564,425,77,12,18,1,6,682
18001030400,3674,3458,103,9,1,7,0,8,216
18001030500,6718,6532,93,9,16,10,1,9,186
18001030600,3412,3044,212,5,5,33,0,16,368
18001030700,7067,6810,180,8,9,19,0,0,257
18003000100,2407,1909,185,138,6,40,1,5,498
18003000300,3396,2687,242,191,7,54,1,14,709
18003000400,2559,1892,210,260,9,30,2,19,667
18003000500,2853,1692,291,324,12,319,3,27,1161
18003000600,1885,1274,329,141,3,11,0,16,611
18003000701,3152,2158,413,236,8,44,13,25,994
18003000704,2432,1693,241,246,4,110,4,12,739
18003000800,4044,3112,381,250,11,30,3,16,932
18003000900,3350,2422,429,264,6,36,0,8,928
18003001000,1181,820,163,108,12,4,0,8,361
18003001100,1481,1207,92,92,1,10,0,11,274
18003001200,1473,1115,80,151,7,42,2,5,358
18003001300,1972,1024,177,642,1,57,4,7,948
18003001600,2021,749,513,472,9,100,2,35,1272
18003001700,2625,400,516,1481,8,20,2,27,2225
18003002000,3105,1457,808,554,8,57,3,6,1648
18003002100,2192,1143,577,334,19,11,0,9,1049
18003002200,4246,2467,742,619,27,80,0,31,1779
18003002300,5751,769,1179,2275,6,1259,0,41,4982
18003002500,3231,2118,458,331,13,36,4,26,1113
18003002600,3474,1554,806,596,6,217,0,21,1920
18003002800,2488,300,870,1133,2,38,4,17,2188
18003002900,2561,358,736,1175,3,88,0,35,2203
18003003000,3953,487,1220,1826,8,223,1,22,3466
18003003100,3076,776,938,867,7,330,0,28,2300
18003003200,5459,3401,771,648,12,301,0,32,2058
18003003301,2728,1790,269,217,5,253,0,12,938
18003003304,4143,2265,503,627,17,483,0,22,1878
18003003400,4335,3327,277,312,4,157,1,16,1008
18003003500,4229,2338,217,936,8,487,3,23,1891
18003003600,6678,1874,1044,2538,11,873,4,67,4804
18003003700,2727,1986,216,347,12,19,0,15,741
18003003800,3130,2315,222,370,15,20,6,9,815
18003003901,3463,2500,314,379,18,62,0,6,963
18003003902,2914,1680,237,748,7,60,0,27,1234
18003004000,3513,322,510,1654,4,867,3,6,3191
18003004101,2708,2003,185,264,9,123,0,16,705
18003004103,5524,3583,428,790,26,382,3,33,1941
18003004300,2358,622,507,1013,2,51,1,31,1736
18003004400,3291,440,1246,1322,12,62,0,15,2851
18003010100,4953,4751,93,16,3,8,0,7,202
18003010201,7467,6828,188,111,10,81,0,33,639
18003010202,6217,5795,166,45,8,18,1,8,422
18003010304,8338,7211,373,201,10,200,0,38,1127
18003010305,7811,6722,261,174,7,339,0,39,1089
18003010306,8233,7061,295,185,7,334,3,19,1172
18003010307,5369,4363,237,206,15,274,2,29,1006
18003010308,7841,6657,307,202,7,319,2,20,1184
18003010400,4199,3828,106,36,15,53,0,15,371
18003010500,2789,2490,98,31,26,31,2,11,299
18003010601,4269,3214,342,360,7,150,2,18,1055
18003010602,4560,3422,295,385,24,148,0,17,1138
18003010603,1778,1485,117,72,5,20,0,3,293
18003010604,2768,1940,529,72,22,37,3,29,828
18003010705,4992,3835,303,390,15,171,10,37,1157
18003010706,4833,3438,322,428,7,405,0,24,1395
18003010707,5318,4142,255,377,5,265,1,33,1176
18003010803,5464,4185,402,401,19,174,1,29,1279
18003010804,3975,3124,229,261,14,113,1,15,851
18003010807,4521,3740,258,217,5,62,3,19,781
18003010808,5348,4487,242,255,10,106,0,29,861
18003010809,5634,4190,261,673,9,159,0,38,1444
18003010811,5729,4232,294,666,7,128,2,39,1497
18003010812,4397,3632,191,310,6,50,0,16,765
18003010813,4065,3162,407,203,13,78,0,20,903
18003010815,5583,4596,286,318,28,103,1,15,987
18003010816,5598,4613,200,382,9,134,0,34,985
18003010817,4127,3150,241,361,8,154,0,25,977
18003010819,4699,3530,274,517,9,121,0,30,1169
18003010821,4860,3187,358,645,8,359,0,40,1673
18003010900,6538,6202,100,18,5,15,1,24,336
18003011000,2560,2419,53,9,6,19,0,8,141
18003011100,2736,2448,114,49,3,13,4,2,288
18003011201,2064,1688,131,108,9,3,3,10,376
18003011202,3337,2852,173,119,15,21,1,7,485
18003011204,3452,2854,172,261,8,12,0,9,598
18003011205,3297,2937,117,77,9,16,0,3,360
18003011302,5633,783,431,1657,6,2548,0,48,4850
18003011303,2141,413,296,703,0,631,0,10,1728
18003011304,5296,1763,634,2008,10,539,0,35,3533
18003011501,3883,2736,304,499,16,107,2,25,1147
18003011502,2663,2089,184,173,8,63,0,6,574
18003011603,6358,5464,292,177,6,176,3,24,894
18003011604,4356,3673,223,178,6,95,4,7,683
18003011605,3693,3004,200,151,8,200,3,22,689
18003011606,5000,3938,191,397,5,231,0,36,1062
18003011607,5687,4639,327,280,6,212,1,3,1048
18003011608,9270,6847,459,666,12,762,2,50,2423
18003011609,7718,6481,337,218,12,354,6,16,1237
18003011701,4247,3740,180,115,9,51,0,14,507
18003011702,2964,2360,221,208,13,24,0,6,604
18003011801,3838,3444,145,56,5,27,2,12,394
18003011802,1659,1601,18,4,2,0,0,1,58
18003011900,1960,1835,44,4,0,4,2,9,125
18003980001,1084,818,86,106,0,28,0,22,266
18003980002,133,82,19,17,1,0,0,1,51
18005010100,5275,3982,536,304,8,114,8,32,1293
18005010200,4344,3707,309,110,9,42,0,11,637
18005010300,3551,3015,154,70,0,170,3,29,536
18005010400,6958,4400,1449,168,9,640,4,31,2558
18005010500,5525,4690,346,108,6,200,1,11,835
18005010600,5310,4335,332,182,10,228,7,17,975
18005010700,3695,2494,271,125,13,629,2,27,1201
18005010800,4147,2796,521,114,11,521,3,16,1351
18005010900,6955,4387,440,167,10,1720,4,18,2568
18005011000,5084,4501,172,72,4,126,4,9,583
18005011101,5380,4017,1017,82,16,66,5,7,1363
18005011102,2772,2258,397,10,5,3,0,15,514
18005011200,5314,4976,104,21,4,17,0,14,338
18005011300,4812,4439,126,47,6,47,0,11,373
18005011400,3872,3214,441,46,8,19,0,18,658
18005011500,9214,7184,642,142,13,841,4,24,2030
18007100100,3336,3114,113,18,9,4,0,5,222
18007100200,3094,2859,106,17,5,6,5,12,235
18007100300,2289,1816,410,9,1,3,2,11,473
18009975100,3111,2893,62,11,10,6,0,3,218
18009975200,2708,2490,63,17,11,3,0,3,218
18009975300,2912,2647,89,15,14,3,0,19,265
18009975400,3381,3248,38,11,3,12,0,5,133
18011810100,3573,3323,85,11,4,19,0,1,250
18011810200,3657,3446,67,11,5,5,3,13,211
18011810300,6028,5435,295,69,13,40,3,6,593
18011810400,6004,5351,328,56,25,22,2,10,653
18011810500,6814,6080,290,90,12,31,0,20,734
18011810601,8163,6879,345,268,11,239,5,45,1284
18011810604,6486,5650,181,119,12,298,0,13,836
18011810605,7083,5897,366,209,8,336,3,33,1186
18011810606,8339,7331,241,78,5,314,2,31,1008
18011810607,9651,7206,487,415,11,1019,1,42,2445
18011810700,5014,4537,90,100,22,66,0,27,477
18013974600,2948,2809,37,10,1,10,0,10,139
18013974700,3337,3100,52,13,9,12,3,9,237
18013974800,4295,4005,69,18,9,20,2,13,290
18013974901,1750,1624,39,5,8,13,0,0,126
18013974902,3145,2925,73,9,3,10,0,16,220
18015959300,2982,2851,62,6,9,7,0,0,131
18015959400,2584,2401,62,6,0,5,0,13,183
18015959500,2563,2379,86,12,6,7,0,6,184
18015959600,3381,2836,358,57,18,15,0,14,545
18015959700,3327,3116,101,6,0,6,0,10,211
18015959800,2823,2632,100,39,0,3,0,5,191
18015959900,2646,2512,54,2,0,5,0,9,134
18017950900,4796,4245,310,42,23,48,3,5,551
18017951000,2283,1996,193,2,3,22,0,9,287
18017951100,2823,2632,66,11,10,8,0,1,191
18017951200,2244,1470,612,51,6,25,1,6,774
18017951300,3054,1689,1167,67,14,24,0,9,1365
18017951400,2416,1604,634,60,4,31,1,4,812
18017951500,4503,2206,1852,160,7,123,0,8,2297
18017951600,5790,4052,1272,96,10,198,1,5,1738
18017951700,2650,2334,162,11,8,27,2,6,316
18017951800,3641,3090,314,53,9,55,0,4,551
18017951900,3670,3426,93,7,15,12,0,19,244
18019050100,1390,1081,42,152,3,20,0,4,309
18019050200,3404,2045,239,807,12,8,5,22,1359
18019050303,2652,1863,204,375,9,13,15,19,789
18019050304,5918,3719,436,1073,13,137,5,49,2199
18019050305,2716,2079,129,289,7,22,0,11,637
18019050306,2169,1520,134,312,1,11,2,14,649
18019050401,2763,2310,133,124,10,13,0,12,453
18019050403,2926,1941,452,325,0,38,0,6,985
18019050404,4129,3319,289,222,15,22,0,17,810
18019050503,5338,3406,962,588,10,42,3,25,1932
18019050504,3068,2019,683,223,3,22,0,1,1049
18019050505,1809,1500,115,60,12,18,3,7,309
18019050603,7357,4696,532,1423,27,94,55,33,2661
18019050604,6420,4838,348,766,8,64,5,25,1582
18019050605,5873,4361,351,692,8,126,1,35,1512
18019050606,3980,3079,239,354,6,100,2,25,901
18019050703,6697,5393,732,152,22,45,2,25,1304
18019050704,7062,6280,179,113,8,144,5,18,782
18019050705,2030,1649,90,160,4,20,4,8,381
18019050706,5685,4522,266,480,9,107,3,36,1163
18019050801,7596,6973,210,51,15,70,1,14,623
18019050803,6069,5536,140,91,16,33,6,8,533
18019050804,4093,3778,76,25,1,7,3,17,315
18019050902,5206,4351,390,91,8,33,5,21,855
18019050903,2972,2465,199,107,6,31,1,7,507
18019050904,7013,6207,221,187,13,54,0,30,806
18019051000,4758,4473,100,23,3,11,1,2,285
18021040100,5557,5114,106,53,12,38,4,13,443
18021040200,6096,5656,155,42,11,23,2,8,440
18021040300,3302,3190,25,10,4,10,0,0,112
18021040400,4446,4177,80,18,6,8,0,7,269
18021040500,3528,3387,31,2,3,9,0,4,141
18021040600,3537,3356,63,4,7,3,0,15,181
18023950100,2923,2739,65,2,8,5,1,5,184
18023950200,5548,4791,550,29,6,6,2,8,757
18023950300,5116,4737,154,27,4,11,5,12,379
18023950400,4191,3812,277,7,7,3,0,0,379
18023950500,4826,2896,1771,26,14,7,1,2,1930
18023950600,3614,2414,1050,37,8,5,0,11,1200
18023950700,3402,2588,683,36,9,16,4,0,814
18023950800,3570,1831,1592,32,6,17,0,8,1739
18025951900,3843,3635,33,16,7,4,0,7,208
18025952000,3938,3746,38,7,7,9,0,0,192
18025952100,2745,2608,50,3,9,4,1,1,137
18027954300,3956,3798,40,10,14,15,2,6,158
18027954400,2749,2584,81,16,2,6,0,16,165
18027954501,5992,5936,18,1,0,4,0,5,56
18027954502,4138,4058,15,10,1,11,0,6,80
18027954600,4731,4375,224,27,0,16,3,11,356
18027954700,4030,2628,958,242,9,13,2,8,1402
18027954800,3406,2531,467,205,7,28,1,19,875
18027954900,4379,3798,300,108,5,39,0,5,581
18029080101,2846,2732,37,8,3,4,0,5,114
18029080103,5962,5586,87,15,2,30,0,29,376
18029080104,3969,3725,37,15,5,9,3,8,244
18029080201,2469,2354,13,1,1,5,0,5,115
18029080203,5279,4987,72,15,5,16,0,8,292
18029080204,1949,1818,7,3,3,14,1,19,131
18029080301,3149,2861,42,44,4,33,0,21,288
18029080302,2006,1743,54,71,0,11,0,12,263
18029080400,6103,5593,119,54,12,35,1,14,510
18029080500,3805,3475,90,38,8,8,1,10,330
18029080601,3674,3499,52,7,4,14,0,12,175
18029080602,3277,3095,35,14,9,7,1,1,182
18029080700,6191,5851,79,7,10,25,2,18,340
18031969000,5292,4960,125,14,6,42,0,11,332
18031969100,3145,2972,68,8,0,5,1,10,173
18031969200,5393,4818,229,26,7,76,5,10,575
18031969300,3177,2981,66,25,2,7,1,2,196
18031969400,5748,5487,71,12,9,21,0,5,261
18031969500,3717,3551,55,5,11,3,1,1,166
18033020100,4506,4251,93,18,3,9,1,8,255
18033020200,4346,4055,96,11,16,10,6,12,291
18033020300,4173,3889,141,18,12,11,0,4,284
18033020400,7842,7290,232,29,4,86,0,22,552
18033020500,5987,5436,236,48,14,38,8,12,551
18033020601,3095,2821,88,12,9,16,0,4,274
18033020602,4685,4298,157,20,3,16,24,7,387
18033020700,4254,4018,70,12,5,32,0,4,236
18033020800,4377,4174,72,15,1,7,0,6,203
18035000300,1398,331,52,925,0,0,0,10,1067
18035000400,1658,1180,50,299,1,3,0,0,478
18035000500,3895,3292,93,243,5,8,3,20,603
18035000600,1648,1237,53,202,5,2,0,11,411
18035000700,2844,2289,161,154,9,40,10,14,555
18035000800,4048,3374,178,271,6,32,3,20,674
18035000902,5358,4099,389,591,5,143,2,12,1259
18035000903,2442,1789,87,308,0,109,1,12,653
18035000904,5520,4489,321,271,5,159,2,27,1031
18035001000,4914,3920,270,396,7,97,2,26,994
18035001100,2924,2223,127,318,4,50,0,23,701
18035001200,2305,797,69,1209,13,8,0,31,1508
18035001300,2768,2226,87,264,13,7,0,14,542
18035001400,1801,1459,47,155,4,2,0,21,342
18035001500,2621,2181,59,226,6,5,1,14,440
18035001600,2180,1792,51,152,16,0,0,6,388
18035001700,1283,1034,35,83,6,3,0,1,249
18035002000,4793,3860,223,377,11,39,0,8,933
18035002100,3024,2563,92,194,12,8,2,7,461
18035002201,4545,4285,56,43,11,10,1,4,260
18035002202,1388,1335,10,6,1,3,0,3,53
18035002301,3500,3290,50,31,4,12,0,14,210
18035002302,3978,3691,61,59,2,18,1,6,287
18035002401,5304,4829,115,88,17,41,6,22,475
18035002403,4543,4060,95,82,0,153,2,12,483
18035002404,4225,3507,87,224,4,199,5,12,718
18035002501,2142,2035,47,3,5,2,0,2,107
18035002502,3170,2969,61,33,2,21,3,2,201
18035002602,2540,2436,27,7,7,3,0,0,104
18035002603,3301,3047,70,47,5,5,1,6,254
18035002604,3868,3500,82,107,3,64,0,9,368
18035002700,4850,4611,55,25,19,15,2,10,239
18035002800,2181,1563,80,387,6,18,4,27,618
18035002900,4944,4040,193,361,4,109,7,11,904
18037953200,7036,6711,201,8,11,33,1,5,325
18037953301,3718,2545,968,33,7,69,2,10,1173
18037953302,4306,3735,373,44,6,25,1,15,571
18037953400,5503,4704,571,32,9,52,0,15,799
18037953500,5053,4776,168,12,5,8,0,6,277
18037953600,5096,4893,97,0,1,15,0,11,203
18037953701,2699,2520,98,6,3,6,0,5,179
18037953702,4499,4364,82,3,5,12,1,4,135
18037953800,5727,3889,1588,52,8,27,0,18,1838
18039000100,2862,1831,771,89,3,19,0,20,1031
18039000201,3448,1496,1741,50,13,17,1,8,1952
18039000202,3731,2177,1333,80,0,20,2,13,1554
18039000301,4500,2682,1567,69,0,52,1,3,1818
18039000302,6365,4722,1287,111,3,75,2,24,1643
18039000400,5158,3767,983,93,4,137,2,15,1391
18039000501,6924,3402,3005,207,14,75,0,22,3522
18039000502,5207,3034,1747,119,6,122,1,9,2173
18039000601,6003,5263,404,49,0,90,1,16,740
18039000602,4986,3917,802,45,13,47,3,27,1069
18039000701,3543,3026,221,70,9,61,0,7,517
18039000702,3349,2574,496,69,13,35,0,12,775
18039000801,3707,3508,71,12,5,12,3,1,199
18039000803,4278,3925,146,13,14,36,1,20,353
18039000804,5211,4756,201,38,0,47,0,12,455
18039000901,5008,4710,191,13,0,3,0,17,298
18039000902,3062,3021,14,0,3,0,0,3,41
18039001000,4996,4459,370,19,14,19,0,7,537
18039001100,4997,4714,191,18,0,11,0,4,283
18039001200,5581,4866,454,34,10,24,0,11,715
18039001301,3388,3141,86,40,3,23,0,11,247
18039001302,3740,3204,320,87,2,17,2,16,536
18039001401,4992,4301,298,103,16,46,0,15,691
18039001402,4481,3584,460,121,11,23,0,21,897
18039001501,5745,3765,759,713,7,77,4,25,1980
18039001502,7113,5714,607,212,16,124,4,15,1399
18039001601,4886,3009,1117,328,11,111,0,19,1877
18039001602,4809,3484,619,236,5,196,4,31,1325
18039001701,3450,2657,290,269,15,36,0,5,793
18039001702,5319,3412,1246,295,14,34,1,12,1907
18039001801,4297,3311,516,179,15,42,0,20,986
18039001802,6548,5165,660,313,22,100,0,24,1383
18039001901,6687,3300,2169,794,8,74,2,44,3387
18039001902,4109,2833,907,114,6,57,1,18,1276
18039002001,3172,2188,513,285,7,12,5,12,984
18039002002,4308,3148,800,100,12,90,1,13,1160
18039002101,4255,2962,904,161,10,42,0,15,1293
18039002102,5293,1913,2293,758,6,43,2,37,3380
18039002201,3662,1822,1177,462,11,20,4,7,1840
18039002202,5148,1248,2692,951,5,50,1,19,3900
18039002300,2511,1071,878,427,6,11,0,9,1440
18039002400,4299,2805,828,352,14,25,0,19,1494
18039002600,5022,1103,1991,1645,9,8,3,34,3919
18039002700,2357,893,808,481,7,19,0,12,1464
18039002900,4540,3156,661,427,11,54,3,12,1384
18041954000,3688,3526,28,4,0,8,0,7,162
18041954100,2878,2730,36,32,4,5,0,6,148
18041954200,2991,2884,20,20,5,11,0,5,107
18041954300,2582,2378,27,56,4,7,0,9,204
18041954400,4641,4269,76,102,10,15,0,5,372
18041954500,3445,3169,64,41,4,10,2,14,276
18041954600,3173,3058,22,20,5,2,0,2,115
18043070200,1770,1220,83,258,5,12,0,1,550
18043070301,2995,2623,104,97,5,12,0,15,372
18043070302,3258,2714,144,163,6,25,0,8,544
18043070400,2828,2316,109,214,17,13,0,2,512
18043070500,3061,2294,176,328,11,12,0,6,767
18043070600,2401,2160,74,36,6,13,2,16,241
18043070700,2427,1678,171,372,4,14,0,6,749
18043070801,3389,2172,176,682,25,34,2,16,1217
18043070802,4770,3720,279,406,22,57,3,26,1050
18043070901,6011,4885,375,359,7,98,0,14,1126
18043070902,1723,1290,85,217,10,5,0,3,433
18043071003,7692,7027,191,69,9,110,1,23,665
18043071004,4842,4455,101,49,7,40,0,10,387
18043071005,5571,4894,118,179,1,166,4,17,677
18043071006,4548,3430,301,460,5,96,2,18,1118
18043071007,5195,4445,169,273,9,87,0,21,750
18043071101,6250,5802,127,31,9,46,0,17,448
18043071103,4632,4295,129,18,2,56,0,12,337
18043071104,5083,4631,127,60,7,72,1,12,452
18043071200,2038,1919,43,5,2,5,6,3,119
18045957600,2763,2576,68,1,11,6,1,1,187
18045957700,2161,1967,50,23,7,3,2,2,194
18045957800,3921,3686,78,20,5,18,1,5,235
18045957900,4272,3927,171,6,10,7,1,14,345
18045958000,3362,3193,45,6,5,9,1,1,169
18047960100,5154,4835,84,11,5,67,0,8,319
18047969600,6003,5778,31,10,2,3,0,10,225
18047969700,2649,2513,42,0,6,17,0,0,136
18047969800,5390,5217,44,0,3,1,0,11,173
18047969900,3589,3447,18,2,9,3,1,3,142
18049953000,3188,2966,96,7,13,13,0,3,222
18049953100,6089,5418,327,54,17,34,0,16,671
18049953200,3648,3360,85,28,17,16,0,5,288
18049953300,1852,1720,28,29,3,4,0,11,132
18049953400,2621,2506,28,14,8,6,0,4,115
18049953500,3082,2482,504,9,6,3,0,4,600
18051050100,4072,3726,102,39,3,22,0,7,346
18051050201,3805,3538,64,24,8,25,8,15,267
18051050202,5061,4863,67,17,9,11,0,4,198
18051050300,5026,4706,86,54,12,11,1,24,320
18051050401,3240,3040,35,37,9,21,0,17,200
18051050402,4092,3757,70,88,11,25,0,6,335
18051050501,3325,2838,89,167,7,22,6,11,487
18051050502,4390,3691,167,211,2,77,1,31,699
18053000100,3788,2633,355,495,13,21,5,20,1155
18053000200,3706,1897,442,1055,11,6,0,28,1809
18053000400,3405,2625,217,333,8,17,3,8,780
18053000500,4971,4068,203,308,10,122,1,9,903
18053000600,2917,2170,206,323,8,21,0,15,747
18053000700,3433,2353,246,513,11,14,3,14,1080
18053000800,6319,4472,540,860,4,80,3,45,1847
18053000900,2686,2012,149,312,12,5,0,8,674
18053010100,5407,4914,196,41,2,45,0,10,493
18053010200,4554,4148,120,96,15,46,0,7,406
18053010300,3949,3645,92,20,4,4,5,10,304
18053010400,2763,2518,87,20,4,13,0,6,245
18053010500,5329,4770,208,54,24,10,0,17,559
18053010600,3451,3096,91,48,13,26,1,20,355
18053010700,5564,5047,132,47,8,86,1,16,517
18053010800,4432,4132,128,41,10,8,0,7,300
18055954701,4167,3904,62,10,17,11,0,14,263
18055954702,3522,3289,38,10,8,8,0,15,233
18055954800,3436,3249,74,3,13,4,0,0,187
18055954900,4992,4776,65,3,11,33,0,2,216
18055955000,2707,2581,45,3,4,3,0,8,126
18055955100,2710,2541,72,4,1,4,4,0,169
18055955200,2267,2124,55,4,2,2,0,0,143
18055955300,3800,3565,86,5,11,18,0,6,235
18055955400,3202,3006,54,11,1,21,0,6,196
18057110101,9078,6436,1052,768,12,256,11,42,2642
18057110102,4271,3977,108,18,5,19,0,12,294
18057110201,4231,3907,103,18,13,7,1,13,324
18057110202,6632,6112,176,47,6,35,0,19,520
18057110301,9332,7738,492,319,2,400,1,34,1594
18057110302,5716,4457,467,343,9,190,3,24,1259
18057110303,5218,4804,174,34,7,34,4,9,414
18057110401,4443,3534,633,53,11,39,10,18,909
18057110404,5309,4625,185,119,8,143,0,22,684
18057110405,5018,3882,536,193,10,187,5,21,1136
18057110406,6395,5426,285,174,18,211,2,20,969
18057110505,7344,6210,513,150,11,140,3,31,1134
18057110509,5469,4606,430,125,7,68,9,29,863
18057110511,5688,5180,191,50,4,49,1,19,508
18057110512,4863,4439,100,92,0,41,3,17,424
18057110513,11255,8533,799,724,12,618,1,55,2722
18057110514,3181,2895,64,61,2,34,1,10,286
18057110515,9520,8338,315,252,5,265,4,20,1182
18057110516,10257,8808,501,245,15,257,7,30,1449
18057110517,6811,5602,415,286,1,191,2,35,1209
18057110518,5151,4582,204,125,8,67,2,17,569
18057110600,4175,3450,218,272,5,53,1,6,725
18057110700,3402,2851,219,79,11,19,4,28,551
18057110805,7793,6521,254,254,6,407,5,60,1272
18057110807,6481,4332,446,458,14,925,3,28,2149
18057110810,6832,5558,281,410,1,259,0,38,1274
18057110811,4492,3475,260,336,7,217,2,8,1017
18057110812,6686,5215,486,219,6,439,0,37,1471
18057110813,13901,10939,525,785,36,997,5,43,2962
18057110814,11281,8401,521,687,7,1126,2,37,2880
18057110815,7888,5690,418,648,6,660,5,43,2198
18057110816,4346,2817,324,587,9,412,9,34,1529
18057110817,7395,5416,381,568,7,624,1,23,1979
18057110818,7656,5409,514,691,25,621,1,43,2247
18057110819,6086,5109,218,234,4,238,2,26,977
18057110820,4146,2869,355,354,14,335,4,28,1277
18057110821,5000,3751,300,349,6,399,0,13,1249
18057110822,5632,4232,174,351,8,548,0,43,1400
18057110904,4652,3993,162,74,3,250,0,12,659
18057110905,3819,2963,332,118,1,219,1,7,856
18057110906,6774,5789,232,146,3,328,2,48,985
18057110907,5358,4553,139,97,0,350,1,11,805
18057110909,6468,4495,253,242,3,1185,1,46,1973
18057110910,7040,3803,238,342,1,2333,4,33,3237
18057110911,7308,5147,311,229,2,1304,0,20,2161
18057110912,5547,4354,181,105,5,704,2,22,1193
18057111003,4726,4255,108,48,5,95,2,16,471
18057111004,3014,2474,113,101,0,189,0,17,540
18057111006,4171,3315,260,106,5,240,0,28,856
18057111007,4030,2841,510,225,3,273,0,14,1189
18057111009,7816,6255,303,167,3,752,1,32,1561
18057111010,7044,4558,229,291,2,1633,0,42,2486
18057111011,3377,2519,331,137,8,259,3,21,858
18057111012,4564,2970,243,278,5,866,2,24,1594
18057111101,3852,3197,135,116,7,231,0,13,655
18057111103,4013,2953,170,196,5,486,0,18,1060
18057111104,5520,4625,219,178,3,232,1,24,895
18059410100,4151,3928,49,9,5,16,0,6,223
18059410201,9321,7221,472,914,11,236,1,43,2100
18059410202,6294,5642,172,80,21,54,9,38,652
18059410301,5026,4654,103,38,4,36,8,22,372
18059410302,8152,7490,171,93,13,60,2,14,662
18059410401,2372,2095,88,32,4,29,1,1,277
18059410402,4708,4376,107,24,0,23,3,18,332
18059410500,3007,2725,94,54,7,22,0,2,282
18059410600,5370,4933,141,38,4,38,0,11,437
18059410700,5640,5373,123,8,6,14,0,0,267
18059410801,4823,4327,146,85,11,35,9,19,496
18059410802,4609,4361,63,17,4,22,0,9,248
18059410901,4394,2990,222,807,7,57,5,21,1404
18059410902,4910,4449,103,102,4,59,0,13,461
18059411000,7063,6542,148,45,20,33,4,2,521
18061060100,6010,5648,115,20,15,14,2,12,362
18061060201,3574,3382,44,18,12,9,0,9,192
18061060202,4186,3952,64,16,12,15,0,9,234
18061060300,5731,5122,269,49,8,35,3,26,609
18061060401,5456,4915,185,33,16,48,4,16,541
18061060402,2282,2096,62,10,6,10,0,1,186
18061060500,5864,5510,77,16,9,45,0,12,354
18061060601,3782,3531,47,8,4,10,0,14,251
18061060602,2769,2546,65,15,10,3,8,8,223
18063210103,4832,4428,90,87,3,52,3,13,404
18063210105,8622,7010,402,560,8,250,8,44,1612
18063210106,8087,5917,361,1163,8,249,3,37,2170
18063210107,1796,1660,64,16,0,5,1,6,136
18063210108,6848,4063,434,1506,2,516,5,40,2785
18063210109,5979,4618,291,598,14,152,2,41,1361
18063210201,4591,3547,262,403,4,149,3,6,1044
18063210203,3420,3066,171,30,3,13,0,8,354
18063210204,5210,4550,193,139,7,70,4,20,660
18063210300,6579,5986,157,94,5,66,0,26,593
18063210400,5035,4782,41,12,16,9,0,10,253
18063210501,7056,6565,125,83,10,33,2,10,491
18063210502,6095,5535,145,109,8,43,2,13,560
18063210607,6508,4455,518,793,6,363,0,51,2053
18063210608,3649,3030,145,196,8,79,5,23,619
18063210609,5359,4471,194,273,9,178,2,15,888
18063210610,5520,4768,154,143,4,223,0,19,752
18063210611,12767,8368,1034,1853,11,785,8,78,4399
18063210612,5073,4508,133,115,2,99,2,15,565
18063210613,6439,5335,286,280,12,146,0,14,1104
18063210614,7558,4151,785,1572,22,605,5,52,3407
18063210615,6166,4314,347,636,24,499,2,28,1852
18063210616,4277,2383,416,883,3,344,2,19,1894
18063210617,2391,1537,261,407,8,40,2,6,854
18063210701,6763,5336,201,949,5,103,0,20,1427
18063210702,7097,6096,205,170,6,283,0,30,1001
18063210801,3447,2882,142,90,15,139,0,21,565
18063210802,4566,4004,203,65,12,67,0,11,562
18063210900,3393,3020,119,69,18,11,3,21,373
18063211000,6055,5608,109,45,7,82,1,15,447
18063211100,3610,3381,68,11,4,14,1,17,229
18065975500,6040,5059,198,661,5,23,1,10,981
18065975600,4055,3868,53,9,3,11,0,8,187
18065975700,4517,4338,51,4,0,21,0,0,179
18065975800,4647,4379,82,24,11,12,0,6,268
18065975900,4452,4142,78,34,5,18,0,23,310
18065976000,3257,2941,102,67,1,18,0,9,316
18065976100,2655,2429,67,49,7,7,0,11,226
18065976300,1787,1581,45,70,9,5,0,2,206
18065976400,4549,4286,40,46,8,47,3,14,263
18065976500,2396,2113,101,39,8,9,0,5,283
18065976600,2058,1867,56,27,4,5,0,9,191
18065976700,4421,4202,48,22,0,11,0,6,219
18065976800,4080,3900,56,14,6,10,1,3,180
18067000200,3619,1774,206,1321,7,15,0,26,1845
18067000300,2812,2250,156,209,6,9,0,19,562
18067000400,3718,2739,177,490,22,29,0,27,979
18067000500,3526,2776,159,303,18,8,0,14,750
18067000600,3032,2448,164,246,11,8,0,15,584
18067000700,5456,4660,123,407,5,52,0,19,796
18067000800,5462,4462,224,396,11,96,0,14,1000
18067000900,4015,3161,196,313,14,20,1,16,854
18067001000,1703,1419,90,84,0,9,0,7,284
18067001100,5489,3970,233,814,12,117,3,28,1519
18067001200,3598,2642,151,505,10,32,0,14,956
18067001300,2581,1992,109,223,6,95,1,1,589
18067001400,4693,3661,187,413,19,174,2,25,1032
18067001500,3881,3158,159,243,13,37,1,8,723
18067010100,6355,5953,118,41,11,22,0,12,402
18067010201,3395,3073,81,69,9,25,0,11,322
18067010202,2176,2004,50,22,5,12,0,1,172
18067010300,4327,3829,151,136,6,44,1,22,498
18067010400,3692,3454,64,27,3,14,3,13,238
18067010500,5111,4680,114,39,16,33,5,8,431
18067010600,5017,4365,148,115,5,176,2,6,652
18069961300,4705,4447,100,14,20,15,0,12,258
18069961400,3749,3326,173,20,11,43,0,7,423
18069961500,4583,4193,148,50,17,25,0,15,390
18069961600,3853,3493,133,42,12,31,1,5,360
18069961700,4449,4196,65,18,16,10,0,12,253
18069961800,3074,2796,119,22,34,13,1,3,278
18069961900,4678,4310,129,30,12,5,4,18,368
18069962000,4104,3815,121,14,15,10,0,4,289
18069962100,3467,3298,62,11,3,11,1,7,169
18071967501,2661,2477,77,10,0,18,0,4,184
18071967502,5595,4969,341,43,4,83,0,18,626
18071967600,5196,3627,1149,137,7,137,3,23,1569
18071967700,3999,3445,299,69,12,48,1,2,554
18071967800,2515,1744,625,31,3,25,0,3,771
18071967901,6138,2696,3063,97,16,77,1,28,3442
18071967902,3250,2679,372,59,6,43,0,3,571
18071968000,5219,5001,61,7,9,7,0,9,218
18071968100,4348,4057,109,20,5,10,0,1,291
18071968200,4105,3908,68,10,1,11,0,0,197
18071968300,3402,3212,87,2,5,10,0,3,190
18073100400,1412,1087,237,4,0,2,0,0,325
18073100800,4843,4306,266,13,16,9,3,0,537
18073100901,3214,2871,206,8,8,6,2,2,343
18073100902,6754,6007,426,43,3,26,0,11,747
18073101000,6312,5527,537,12,7,12,0,17,785
18073101100,3605,3175,283,20,8,13,0,3,430
18073101200,3670,3249,280,17,9,6,0,7,421
18073101300,3108,2862,107,12,2,16,5,3,246
18075962700,3117,3002,48,5,4,9,2,0,115
18075962800,3379,3240,81,2,0,2,2,2,139
18075962900,2812,2695,52,0,5,2,0,7,117
18075963000,2315,2002,226,5,4,14,0,4,313
18075963100,4306,3658,462,23,4,26,4,13,648
18075963200,2284,2178,31,5,3,11,2,0,106
18075963300,2265,2117,44,13,4,0,2,0,148
18077966000,3893,3714,48,26,6,10,0,9,179
18077966100,6653,5906,355,67,16,41,2,16,747
18077966200,4670,4393,115,18,14,6,0,4,277
18077966300,4124,3575,213,130,14,27,4,32,549
18077966400,5828,5254,202,121,6,57,2,15,574
18077966500,5730,5144,119,100,17,127,2,21,586
18077966600,2249,2037,59,48,6,22,0,9,212
18079960200,5154,4915,70,29,7,5,1,10,239
18079960301,3815,3618,56,13,6,10,0,6,197
18079960302,4645,4017,399,25,10,0,0,16,628
18079960400,6745,6308,163,52,4,24,0,4,437
18079960500,2393,2146,93,36,9,6,1,6,247
18079960600,4861,4661,78,20,3,4,0,2,200
18081610101,6598,3885,293,342,16,1773,3,28,2713
18081610102,13043,9951,680,556,18,1171,5,75,3092
18081610201,4504,3714,294,97,6,173,1,15,790
18081610203,6325,4860,320,284,17,546,14,33,1465
18081610204,5385,4004,318,228,4,547,0,31,1381
18081610300,3540,3116,179,39,9,55,1,29,424
18081610401,6076,4761,349,347,10,294,2,31,1315
18081610403,6096,4950,363,212,9,188,8,20,1146
18081610404,5036,4264,305,99,5,116,3,13,772
18081610501,2805,2542,89,23,16,26,0,7,263
18081610502,5565,5031,168,54,11,34,6,17,534
18081610603,7137,6407,189,54,7,172,6,17,730
18081610605,6067,5069,265,260,11,195,0,24,998
18081610606,6068,5298,249,66,10,188,2,25,770
18081610607,6990,6096,193,112,4,238,1,24,894
18081610608,1911,1791,34,5,4,33,0,3,120
18081610703,6136,5584,132,56,2,176,1,27,552
18081610704,9238,7585,233,239,12,763,3,34,1653
18081610705,7034,5976,223,188,9,392,0,17,1058
18081610706,2554,2401,53,7,6,1,0,2,153
18081610801,6873,6301,177,83,6,43,0,17,572
18081610802,7591,6549,317,161,22,113,7,40,1042
18081610900,4908,4446,200,87,14,24,0,4,462
18081611000,3682,3343,133,49,11,8,0,29,339
18081611100,3369,3120,70,19,14,23,0,13,249
18081611200,5480,4834,235,76,16,94,0,27,646
18081611300,3810,3464,210,31,7,5,0,2,346
18081611400,7944,7406,123,76,4,29,6,19,538
18083955000,3182,2960,70,16,10,9,1,13,222
18083955100,2814,2713,46,6,1,2,0,6,101
18083955201,1953,1834,44,9,3,1,0,5,119
18083955202,3968,3589,153,29,2,68,1,5,379
18083955300,2906,2369,182,224,7,24,3,37,537
18083955400,2091,1769,84,114,6,15,0,10,322
18083955500,2962,2689,76,66,13,11,0,7,273
18083955600,2840,2521,87,73,7,24,2,6,319
18083955700,4768,4354,116,65,10,95,0,8,414
18083955800,3376,3239,31,8,0,3,2,0,137
18083955900,5422,4990,116,86,8,31,4,7,432
18085960900,2774,2450,192,10,11,11,3,7,324
18085961001,2348,2148,104,15,1,9,3,5,200
18085961002,2452,2167,172,9,1,26,0,6,285
18085961100,6162,5457,503,24,19,30,0,2,705
18085961200,6279,5170,675,50,10,196,4,13,1109
18085961300,3328,2999,185,8,10,16,1,9,329
18085961400,2931,2687,85,10,7,22,0,5,244
18085961500,2588,2410,72,8,3,8,2,0,178
18085961600,1579,1455,55,2,1,6,0,8,124
18085961700,4597,3389,1017,24,1,50,0,17,1208
18085961800,6384,4836,1033,79,11,217,1,19,1548
18085961900,2498,1853,422,53,11,32,1,17,645
18085962000,5038,3875,654,104,7,205,1,25,1163
18085962101,3619,2814,362,69,11,234,0,16,805
18085962102,4907,4163,447,84,11,51,0,6,744
18085962200,4770,4135,360,23,13,41,0,13,635
18085962300,5576,4673,465,70,11,144,0,18,903
18085962400,3659,3168,353,14,7,16,0,11,491
18085962500,2717,2499,129,8,5,5,0,0,218
18085962600,2721,2562,75,11,0,8,0,4,159
18085962700,3313,3080,132,7,9,9,0,4,233
18087970100,6445,5581,667,33,15,12,0,3,864
18087970200,5447,4667,609,22,8,13,0,2,780
18087970301,3358,3233,64,3,4,4,0,4,125
18087970302,5322,5151,90,7,1,12,0,3,171
18087970401,4922,4875,18,1,0,1,0,0,47
18087970402,5607,5434,90,7,4,17,0,5,173
18087970500,3804,3658,73,4,9,10,0,1,146
18087970600,2559,2424,54,6,7,0,0,5,135
18087970700,2982,2811,68,9,2,5,1,10,171
18089010100,4013,1306,199,2298,3,13,0,35,2707
18089010203,2440,39,132,2209,4,0,0,6,2401
18089010205,1249,58,107,1053,1,0,0,7,1191
18089010206,2330,326,106,1776,0,12,0,27,2004
18089010207,3126,305,262,2393,0,13,0,4,2821
18089010302,3175,63,221,2780,3,0,2,17,3112
18089010304,3048,112,473,2367,0,1,0,11,2936
18089010400,2939,47,119,2705,7,0,0,4,2892
18089010500,764,10,45,673,2,1,1,4,754
18089010600,1152,37,61,1009,0,3,0,11,1115
18089010900,668,8,33,591,2,2,0,6,660
18089011000,1573,17,102,1389,1,7,0,4,1556
18089011100,4148,63,135,3827,1,2,2,13,4085
18089011200,3880,45,136,3592,14,0,0,19,3835
18089011300,1479,37,45,1323,2,7,1,5,1442
18089011400,1223,31,43,1095,0,0,0,3,1192
18089011500,2250,149,273,1731,3,4,0,2,2101
18089011600,1881,51,72,1693,3,0,0,7,1830
18089011700,588,9,17,550,0,0,0,2,579
18089011800,1373,17,47,1236,0,3,0,15,1356
18089011900,1262,49,70,1092,0,3,0,15,1213
18089012000,703,5,25,645,0,1,0,8,698
18089012100,537,16,22,476,5,0,0,4,521
18089012200,1272,15,36,1186,0,0,0,13,1257
18089012300,2279,161,212,1834,0,0,2,18,2118
18089012400,3991,238,266,3282,8,13,0,70,3753
18089012500,4635,274,449,3702,29,11,0,29,4361
18089012600,2194,159,137,1790,0,0,0,7,2035
18089012700,2898,180,272,2359,7,2,0,2,2718
18089012800,2011,58,150,1713,2,1,0,12,1953
18089020100,4669,2129,2155,225,8,47,0,8,2540
18089020200,2497,1266,1039,96,2,18,0,5,1231
18089020300,6414,1930,3595,725,8,22,7,23,4484
18089020400,4732,764,3265,574,8,20,1,7,3968
18089020500,3550,584,2107,770,7,2,0,14,2966
18089020600,2004,373,418,1092,2,3,1,14,1631
18089020700,4874,771,1595,2286,11,20,2,36,4103
18089020800,4272,267,1275,2612,7,10,0,13,4005
18089020900,4154,1370,1140,1245,9,202,0,30,2784
18089021000,5081,1722,2247,896,2,31,1,26,3359
18089021100,3135,1214,1224,524,2,28,2,12,1921
18089021300,3661,1291,1172,1042,2,33,0,7,2370
18089021400,4865,1355,2021,1310,11,23,0,18,3510
18089021500,2459,1020,863,466,8,22,0,11,1439
18089021600,2997,1133,1229,517,5,4,2,12,1864
18089021700,4683,1669,1692,1115,1,34,0,9,3014
18089021800,3568,1278,938,1195,5,33,2,5,2290
18089021900,5286,1860,1952,1215,10,33,0,26,3426
18089022000,4996,1686,1423,1681,4,26,3,11,3310
18089030100,1338,34,98,1169,1,0,0,5,1304
18089030200,1092,32,496,541,1,0,0,2,1060
18089030300,1402,57,316,985,0,4,0,0,1345
18089030400,2844,191,1976,618,10,7,0,4,2653
18089030500,3845,278,2642,870,4,4,1,7,3567
18089030600,4811,531,3130,1063,9,8,4,17,4280
18089030700,1932,94,897,909,4,4,0,0,1838
18089030800,3932,170,2244,1437,7,14,0,21,3762
18089030900,3647,184,1623,1763,3,10,0,17,3463
18089031000,1509,21,434,1018,0,6,2,0,1488
18089040100,1318,613,620,40,0,4,1,0,705
18089040200,3241,1414,1618,104,0,19,1,13,1827
18089040301,3841,2609,538,246,6,303,1,7,1232
18089040302,4267,2711,886,421,6,75,3,6,1556
18089040401,5317,3856,955,204,3,117,0,10,1461
18089040402,4493,2908,380,335,1,736,0,16,1585
18089040403,5976,4259,963,250,9,286,1,17,1717
18089040501,4061,2225,679,872,1,113,1,24,1836
18089040502,3576,2358,660,311,2,138,0,9,1218
18089040600,3726,2638,720,199,2,47,1,0,1088
18089040700,4993,3576,969,168,4,45,0,13,1417
18089040801,3809,2871,658,124,7,45,0,5,938
18089040802,3819,2743,783,119,6,27,0,16,1076
18089040900,6343,4773,1102,145,5,44,0,28,1570
18089041001,5343,1902,928,2223,8,37,1,10,3441
18089041002,4502,2905,969,388,5,45,0,16,1597
18089041100,1847,1136,519,85,5,8,3,2,711
18089041200,2165,1353,435,206,10,17,0,8,812
18089041302,2514,1547,529,276,7,16,0,15,967
18089041400,2666,1768,474,243,11,17,0,8,898
18089041500,1582,343,192,970,5,8,0,7,1239
18089041600,5086,2987,1513,224,12,29,2,39,2099
18089041700,4774,2556,1748,250,11,13,0,20,2218
18089041800,6438,3904,1846,297,8,19,0,25,2534
18089041900,5031,3804,853,135,6,26,0,15,1227
18089042000,6922,5089,1126,370,7,76,0,9,1833
18089042100,5698,3289,1300,720,20,62,0,22,2409
18089042200,6630,4555,1370,365,9,33,9,13,2075
18089042301,4301,2839,736,506,4,53,0,10,1462
18089042302,2509,1010,359,882,5,123,1,8,1499
18089042401,6334,1309,945,3787,4,56,1,19,5025
18089042403,4399,711,535,2916,13,28,0,14,3688
18089042404,2765,981,484,1135,3,16,0,15,1784
18089042405,4304,931,629,2568,10,20,0,20,3373
18089042501,6332,2190,1248,2503,10,84,0,15,4142
18089042503,3296,1101,503,1529,1,32,4,18,2195
18089042506,3256,1943,424,725,4,78,0,8,1313
18089042507,3487,1894,541,825,4,91,0,9,1593
18089042508,3813,1267,465,1850,12,76,0,8,2546
18089042509,3733,1332,377,1764,4,146,0,3,2401
18089042602,7061,4889,1151,529,12,232,0,12,2172
18089042606,3327,1932,533,653,6,65,7,6,1395
18089042607,6248,4919,845,183,6,79,0,20,1329
18089042608,4604,3750,528,120,2,66,0,8,854
18089042610,4300,3440,505,105,3,102,0,4,860
18089042611,5347,4193,654,176,19,122,0,22,1154
18089042612,4426,3551,541,106,11,94,2,2,875
18089042613,4184,3557,370,59,3,25,0,14,627
18089042702,5482,3918,634,485,2,202,0,22,1564
18089042703,4675,3383,557,331,3,257,0,14,1292
18089042704,4150,3096,572,196,5,100,4,16,1054
18089042802,5183,4168,675,99,1,80,1,5,1015
18089042803,5738,4305,864,205,5,160,0,23,1433
18089042804,4247,2927,526,250,6,411,0,13,1320
18089042901,8269,7036,732,50,14,34,0,18,1233
18089042903,4173,3386,459,135,5,38,0,27,787
18089042904,5772,4554,702,242,6,88,0,8,1218
18089043001,4663,3894,432,100,6,80,1,14,769
18089043003,2555,2003,284,54,4,109,0,15,552
18089043004,2939,2361,337,69,6,30,0,2,578
18089043101,2876,2449,251,5,5,15,4,9,427
18089043103,4205,3582,328,54,4,78,0,13,623
18089043104,6528,5445,620,91,0,100,0,14,1083
18089043201,3585,3063,287,2,4,24,0,7,522
18089043203,6412,4743,780,328,10,299,3,8,1669
18089043204,4867,3987,465,117,2,127,0,16,880
18089043301,5306,4100,572,232,6,130,2,22,1206
18089043302,7621,5797,1048,322,10,147,3,11,1824
18089043401,7676,6783,531,59,8,18,1,22,893
18089043403,7276,6235,597,45,11,35,1,18,1041
18089043404,1719,1484,151,15,3,2,0,2,235
18089043405,5449,4817,344,23,5,10,0,15,632
18089990000,0,0,0,0,0,0,0,0,0
18091040100,4032,1853,267,1705,18,8,0,18,2179
18091040300,2576,1451,304,594,24,9,0,16,1125
18091040400,3158,2324,280,308,7,33,1,14,834
18091040500,3493,2651,259,331,2,96,0,10,842
18091040600,4941,3200,297,1091,8,41,0,9,1741
18091040700,1532,966,156,275,6,7,0,9,566
18091040800,2968,1989,243,512,6,11,1,6,979
18091040900,2604,715,173,1492,5,5,1,38,1889
18091041100,2286,1932,73,186,2,33,0,6,354
18091041200,1024,936,27,7,0,6,0,7,88
18091041300,2752,1834,138,535,2,14,0,16,918
18091041400,4688,2303,381,1676,23,29,2,8,2385
18091041500,4907,4319,242,89,15,28,1,23,588
18091041600,6262,5324,286,204,10,85,7,29,938
18091041700,3411,3053,147,34,2,18,0,8,358
18091041800,5933,5208,414,25,9,20,0,19,725
18091041900,5305,4815,224,23,2,5,0,7,490
18091042000,2548,2132,214,97,1,2,0,10,416
18091042100,6455,4773,1156,130,21,39,0,28,1682
18091042200,3385,2879,234,55,3,50,0,13,506
18091042300,2297,1593,361,217,4,24,0,3,704
18091042401,2910,2359,315,81,5,6,3,19,551
18091042402,4890,4051,337,267,9,37,0,24,839
18091042500,5433,4783,318,79,21,26,0,31,650
18091042601,5010,4367,291,69,12,37,0,18,643
18091042602,3110,1839,210,1015,3,6,0,22,1271
18091042700,5249,4571,241,115,8,17,0,7,678
18091042800,3056,2851,82,6,8,7,0,5,205
18091042900,3810,3483,151,18,8,11,2,18,327
18091043000,2392,1403,164,638,6,33,0,26,989
18091990000,0,0,0,0,0,0,0,0,0
18093950400,3598,3455,42,4,12,7,0,5,143
18093950500,4809,4559,59,9,21,18,0,8,250
18093950601,3114,2894,55,7,15,16,0,8,220
18093950602,4075,3825,52,33,12,36,0,10,250
18093950701,3955,3759,31,9,10,21,0,4,196
18093950702,2508,2354,39,2,11,8,0,12,154
18093950800,3967,3737,84,19,1,25,4,0,230
18093950900,2903,2636,82,25,8,14,0,11,267
18093951000,3505,3251,79,37,8,12,0,6,254
18093951100,3172,2878,79,24,18,20,0,17,294
18093951201,3589,3425,40,9,8,1,0,2,164
18093951202,2528,2395,25,4,2,13,0,8,133
18093951300,3288,3056,98,9,5,16,0,2,232
18095000300,2812,2063,242,289,12,17,1,8,749
18095000400,2307,1010,210,938,9,12,1,11,1297
18095000500,2826,1352,434,866,3,2,3,14,1474
18095000800,1916,1259,355,187,8,1,0,9,657
18095000900,1600,1084,253,139,9,2,0,15,516
18095001000,2627,1929,257,257,9,8,0,24,698
18095001100,2449,1860,165,263,8,17,1,32,589
18095001200,2906,2447,138,160,3,19,0,8,459
18095001300,4695,3892,134,381,10,48,3,11,803
18095001400,3811,3094,174,276,5,23,0,8,717
18095001500,3941,3231,142,365,2,12,2,9,710
18095001600,2874,2531,83,130,8,15,0,2,343
18095001700,3861,2168,285,1115,9,22,1,31,1693
18095001801,3577,2730,250,377,9,32,0,18,847
18095001802,1647,1314,52,152,3,45,0,2,333
18095001901,3159,2493,183,283,9,11,0,24,666
18095001902,2661,1878,208,414,6,3,0,5,783
18095002000,4101,3207,232,423,12,42,3,15,894
18095010100,2934,2811,39,4,3,2,0,4,123
18095010200,4655,4232,196,3,5,22,0,10,423
18095010300,3094,2813,122,5,12,17,5,7,281
18095010400,2918,2740,57,8,0,10,7,8,178
18095010500,3392,3222,70,21,0,3,0,4,170
18095010600,5385,4930,150,31,3,12,0,10,455
18095010700,3277,2959,77,53,11,15,5,23,318
18095010800,3293,3011,119,60,4,9,0,4,282
18095010900,2165,2014,45,9,0,6,0,4,151
18095011000,1954,1803,44,7,0,12,0,3,151
18095011100,3908,3682,55,20,11,13,0,10,226
18095011200,6291,5663,155,187,9,33,1,19,628
18095011300,2596,2354,61,34,0,15,0,13,242
18095011400,3957,3704,81,16,10,8,2,19,253
18095011501,5598,4960,119,318,5,21,0,19,638
18095011502,4261,3837,114,90,12,36,2,21,424
18095011600,2523,1418,102,980,2,4,1,7,1105
18095011700,2569,2407,43,8,0,19,3,9,162
18095011800,7243,6319,316,215,18,41,1,19,924
18095011900,1687,1145,156,255,9,7,0,10,542
18095012000,2659,1362,345,777,11,13,0,14,1297
18097310104,3576,2252,245,771,0,157,0,18,1324
18097310105,3830,1493,435,1555,8,106,0,40,2337
18097310106,4161,1496,619,1659,11,169,1,38,2665
18097310108,3597,2700,152,483,3,108,0,21,897
18097310110,3125,1033,350,1520,3,74,0,18,2092
18097310111,3771,1102,514,1903,10,65,2,25,2669
18097310112,6264,3543,340,1727,6,318,3,45,2721
18097310113,1228,860,32,253,2,26,0,2,368
18097310201,4603,1368,755,2064,4,178,0,21,3235
18097310203,5939,1554,1299,2707,10,114,2,28,4385
18097310204,5281,891,782,3121,7,194,3,39,4390
18097310305,6588,754,1761,3662,11,163,7,30,5834
18097310306,6924,564,1982,4084,0,109,0,33,6360
18097310308,3679,752,495,2162,2,114,0,38,2927
18097310309,3880,562,414,2599,5,89,0,52,3318
18097310310,4550,1151,758,2230,9,133,5,52,3399
18097310311,5831,1341,742,3319,5,173,0,38,4490
18097310312,6203,859,1201,3711,6,170,6,44,5344
18097320105,4528,2525,454,1178,1,141,0,35,2003
18097320106,2526,1454,183,734,3,34,0,18,1072
18097320107,1808,1464,84,153,1,45,0,5,344
18097320108,5546,1618,793,2725,22,151,0,17,3928
18097320109,2578,1902,124,245,3,196,2,20,676
18097320202,4708,4095,150,177,2,80,2,15,613
18097320203,3087,1904,374,495,5,144,2,29,1183
18097320205,2492,1556,332,343,4,140,5,19,936
18097320206,2915,1240,560,674,6,297,0,22,1675
18097320301,3413,2986,108,188,2,41,0,8,427
18097320303,3585,1856,384,967,2,119,1,49,1729
18097320305,2963,2500,107,188,0,45,0,11,463
18097320306,3997,3165,168,333,18,136,2,14,832
18097320400,3228,1905,228,879,3,53,0,15,1323
18097320500,3121,2368,169,396,6,62,0,13,753
18097320600,2554,2147,168,90,11,31,0,14,407
18097320700,2353,2006,97,66,3,77,6,16,347
18097320800,3225,2905,75,73,7,74,0,14,320
18097320901,5883,3467,374,1571,6,175,0,55,2416
18097320902,4644,1243,647,2239,5,274,8,43,3401
18097320903,4922,550,1435,2580,6,178,0,14,4372
18097321001,2860,760,775,1091,3,85,0,19,2100
18097321002,4657,2307,271,1697,4,132,1,25,2350
18097321100,3631,2053,208,1144,2,70,0,21,1578
18097321200,5071,4454,166,124,1,83,4,18,617
18097321300,2619,2309,104,79,1,35,2,8,310
18097321400,5364,3914,242,880,2,95,0,22,1450
18097321600,5024,2201,270,2164,7,97,0,50,2823
18097321700,4183,3386,215,314,7,52,1,33,797
18097321800,3556,3095,130,122,4,50,3,21,461
18097321900,6431,5280,312,462,7,151,0,24,1151
18097322000,3422,1467,187,1537,4,34,0,14,1955
18097322100,2706,1433,121,983,0,24,2,23,1273
18097322200,2139,1506,73,407,1,35,0,16,633
18097322300,2528,2091,82,187,0,32,0,9,437
18097322400,2964,1757,239,705,6,46,0,33,1207
18097322500,1651,576,209,742,8,22,0,23,1075
18097322601,2438,99,143,2065,8,7,0,15,2339
18097322602,1356,304,95,856,6,14,0,10,1052
18097322700,2002,328,181,1420,5,14,2,12,1674
18097330103,4436,2879,469,737,9,151,3,34,1557
18097330105,5344,3014,471,1359,11,161,0,38,2330
18097330106,4354,2008,472,1504,7,157,1,24,2346
18097330107,5683,4562,291,436,0,154,1,16,1121
18097330108,3665,3085,86,249,3,106,0,16,580
18097330109,4907,3600,388,461,1,148,2,16,1307
18097330203,5418,4447,166,434,0,140,2,10,971
18097330204,6133,3111,500,1993,4,125,1,22,3022
18097330206,4695,3100,273,912,6,129,4,13,1595
18097330208,2879,2094,192,384,1,74,5,17,785
18097330210,6309,1283,689,3931,5,82,3,51,5026
18097330211,6010,1108,922,3673,10,40,7,25,4902
18097330212,5032,2039,548,2051,10,67,5,30,2993
18097330213,4063,3010,207,554,2,71,0,10,1053
18097330401,5985,3881,297,1419,10,72,1,33,2104
18097330500,6329,1553,646,3777,16,67,2,47,4776
18097330600,5267,2155,855,1879,10,31,0,48,3112
18097330701,2123,674,1127,219,2,22,1,13,1449
18097330702,5026,1555,3183,112,3,21,3,20,3471
18097330803,3638,369,726,2375,4,7,0,24,3269
18097330804,3671,295,1545,1722,7,16,3,16,3376
18097330805,3089,752,612,1599,4,13,0,12,2337
18097330806,4269,501,1497,2066,1,18,1,40,3768
18097330900,5686,548,800,4040,13,49,3,11,5138
18097331000,4194,194,357,3477,3,12,0,33,4000
18097340101,4066,2812,530,461,5,47,1,28,1254
18097340102,4666,1494,463,2448,13,43,0,14,3172
18097340108,3761,428,1010,2174,3,39,0,17,3333
18097340111,3870,1639,434,1537,6,62,0,28,2231
18097340112,5108,2307,422,2028,8,53,0,25,2801
18097340113,4422,2826,575,691,22,60,1,46,1596
18097340114,4440,2886,387,920,7,52,2,10,1554
18097340115,6601,1557,1194,3454,9,66,3,53,5044
18097340201,3676,781,1697,1021,10,61,2,25,2895
18097340202,4830,1927,729,1762,15,167,1,18,2903
18097340301,3190,477,1574,1001,6,55,0,6,2713
18097340302,4968,625,2556,1457,9,197,0,19,4343
18097340400,4024,707,2179,931,5,39,2,37,3317
18097340500,4932,1473,416,2761,7,82,3,16,3459
18097340600,5274,1060,1313,2649,7,71,3,28,4214
18097340700,4219,1045,1851,1135,13,17,0,26,3174
18097340800,1751,1420,77,46,3,108,0,8,331
18097340901,4034,1964,688,1091,4,69,1,11,2070
18097340903,1742,534,225,831,10,41,4,14,1208
18097340904,5235,2459,396,2108,11,55,0,27,2776
18097341000,1817,1597,97,39,2,12,0,9,220
18097341100,2239,824,773,556,3,19,0,7,1415
18097341200,2535,212,984,1207,7,17,0,14,2323
18097341600,2375,305,848,1140,4,4,0,3,2070
18097341701,2906,952,1102,695,10,11,0,15,1954
18097341702,1962,1237,498,111,4,6,0,17,725
18097341902,3957,2302,643,776,1,61,2,16,1655
18097341903,4839,1011,1130,2486,3,61,1,16,3828
18097341904,2411,602,693,963,7,48,0,10,1809
18097342000,6690,2930,1087,2049,19,230,3,51,3760
18097342101,5575,2461,1216,1483,6,111,4,23,3114
18097342200,5454,2655,1353,1138,14,25,3,32,2799
18097342300,6860,4667,1375,493,17,37,1,11,2193
18097342400,1575,1132,330,53,0,7,0,3,443
18097342500,5004,2867,1578,274,21,21,0,11,2137
18097342600,3490,1768,1296,276,2,6,2,5,1722
18097350100,1390,202,164,924,3,19,1,7,1188
18097350300,2511,592,193,1538,6,10,3,17,1919
18097350400,2490,826,187,1288,9,21,0,27,1664
18097350500,2395,109,280,1907,1,1,0,20,2286
18097350600,4406,246,508,3459,11,12,3,14,4160
18097350700,1566,103,292,1078,12,2,0,8,1463
18097350800,2375,121,197,1943,7,3,1,14,2254
18097350900,1687,468,102,1004,4,9,0,13,1219
18097351000,2555,777,181,1453,6,16,0,12,1778
18097351200,2381,125,254,1868,9,3,6,24,2256
18097351500,2023,620,192,1071,0,31,0,15,1403
18097351600,2293,1364,129,585,0,76,2,17,929
18097351700,2642,995,134,1357,2,28,0,11,1647
18097351900,2140,74,173,1807,3,8,0,11,2066
18097352100,2121,185,420,1371,0,2,0,32,1936
18097352300,1604,129,288,1118,4,5,0,23,1475
18097352400,3056,1095,609,1191,3,5,0,13,1961
18097352500,3003,1884,334,590,9,21,0,7,1119
18097352600,3739,1386,848,1221,11,22,0,29,2353
18097352700,2423,1188,345,685,8,16,6,11,1235
18097352800,1480,260,66,1082,5,10,0,6,1220
18097353300,2717,1758,162,562,6,103,0,20,959
18097353500,2480,894,163,688,7,621,0,16,1586
18097353600,2708,626,431,1439,9,66,0,20,2082
18097354201,4538,2987,259,797,3,291,2,23,1551
18097354202,3206,2246,135,440,5,195,0,22,960
18097354400,1514,1126,55,245,0,12,1,3,388
18097354500,2237,1389,208,442,9,18,2,20,848
18097354700,1559,691,320,427,2,11,0,7,868
18097354800,1765,659,484,532,4,1,0,4,1106
18097354900,2651,1054,732,708,7,19,0,13,1597
18097355000,2325,964,642,551,10,13,2,11,1361
18097355100,1986,779,400,644,8,4,0,14,1207
18097355300,2588,1468,308,655,19,17,1,16,1120
18097355400,2639,1469,362,629,7,7,0,20,1170
18097355500,3809,2617,792,204,14,13,0,19,1192
18097355600,2283,1257,561,342,5,12,2,8,1026
18097355700,2420,1434,627,228,6,7,0,12,986
18097355900,2258,1746,229,138,1,33,0,8,512
18097356200,2783,1991,95,460,0,134,0,7,792
18097356400,3746,1770,1104,599,8,116,0,23,1976
18097356900,2188,1512,249,240,7,11,0,18,676
18097357000,2018,1551,219,98,2,22,1,18,467
18097357100,2111,1498,269,170,15,33,0,14,613
18097357200,3153,1794,710,413,17,27,2,13,1359
18097357300,1970,1006,453,417,10,0,0,13,964
18097357400,4345,2309,727,1061,12,20,0,24,2036
18097357500,3917,3348,247,133,8,10,0,9,569
18097357601,5132,3211,1180,405,25,25,2,25,1921
18097357602,1694,835,208,549,3,4,2,16,859
18097357800,1909,1270,245,227,1,8,3,30,639
18097357900,3840,2729,517,331,13,24,1,26,1111
18097358000,1363,933,183,128,2,23,4,8,430
18097358100,2910,1554,776,413,15,11,0,18,1356
18097360101,2571,633,356,1445,4,10,2,17,1938
18097360102,2826,305,333,2047,6,5,0,32,2521
18097360201,4162,974,624,2285,4,15,1,42,3188
18097360202,3179,654,547,1790,15,12,0,19,2525
18097360301,4167,1243,1033,1617,5,24,1,36,2924
18097360302,2706,489,762,1345,7,6,0,5,2217
18097360401,6205,997,871,3976,9,42,13,38,5208
18097360402,2088,336,367,1304,13,3,0,1,1752
18097360405,6760,1643,753,3918,8,62,5,43,5117
18097360406,4865,421,1123,3067,4,39,0,35,4444
18097360407,3020,639,400,1813,6,29,5,17,2381
18097360501,6289,2724,698,2424,11,76,4,38,3565
18097360502,5902,2556,712,2180,16,59,12,34,3346
18097360601,4889,2929,691,971,14,54,1,36,1960
18097360602,5585,3004,689,1589,11,44,2,24,2581
18097360700,1850,1455,153,119,4,12,0,10,395
18097360800,2485,1316,215,809,7,12,3,8,1169
18097360900,5570,2899,661,1666,31,24,1,30,2671
18097361000,2113,1881,79,59,0,17,0,5,232
18097361100,3131,2520,141,215,3,31,0,25,611
18097361200,3137,2426,293,205,4,24,1,32,711
18097361300,2710,2020,297,159,7,9,3,18,690
18097361401,5451,2406,595,1982,7,117,0,35,3045
18097361402,5600,4063,720,464,15,37,0,16,1537
18097361601,5290,2713,386,1760,1,118,3,25,2577
18097361602,3640,2280,197,902,13,73,0,9,1360
18097370201,4102,3004,355,446,4,35,0,24,1098
18097370203,4006,2277,510,960,15,8,0,18,1729
18097370204,4035,3197,493,132,5,10,4,5,838
18097370303,7217,4989,610,1146,18,87,0,53,2228
18097370304,3440,2614,220,439,11,18,0,9,826
18097370305,3589,2580,228,496,8,27,3,18,1009
18097370306,5664,4409,491,374,15,55,0,27,1255
18097380101,7112,5270,264,132,7,1165,3,13,1842
18097380102,3238,1660,231,269,15,942,0,18,1578
18097380103,9056,5948,685,676,10,1185,6,60,3108
18097380200,3291,2353,348,296,12,123,0,22,938
18097380301,1849,1141,478,125,5,11,1,3,708
18097380302,4141,2624,576,629,10,92,1,14,1517
18097380402,4867,3049,772,504,7,300,3,25,1818
18097380403,4026,3423,233,87,4,41,1,3,603
18097380404,4247,3246,453,221,17,71,1,23,1001
18097380501,2639,1657,524,88,5,212,1,14,982
18097380502,4695,2644,703,855,8,207,1,14,2051
18097380600,5383,2821,999,779,10,511,4,32,2562
18097380700,6221,3333,578,536,10,1558,2,22,2888
18097380800,2947,2244,341,59,1,152,2,16,703
18097380901,5538,3579,214,79,8,1472,0,15,1959
18097380902,6133,4916,266,184,13,524,2,13,1217
18097381002,3258,2455,159,53,7,464,5,6,803
18097381003,4005,1696,198,121,1,1848,1,7,2309
18097381004,4045,1878,373,558,6,1020,3,22,2167
18097381101,5939,4190,264,231,4,1005,8,38,1749
18097381102,7356,4182,320,215,7,2368,6,27,3174
18097381203,3101,1131,504,498,1,805,0,23,1970
18097381204,3539,2093,343,273,9,665,0,29,1446
18097381205,7687,4539,519,417,7,1866,14,37,3148
18097381206,4395,2911,183,161,5,953,0,24,1484
18097381207,3060,2405,81,29,2,418,0,5,655
18097390102,5712,3640,378,1123,10,222,0,21,2072
18097390103,3437,2643,212,180,11,203,0,12,794
18097390104,7020,4766,613,1008,14,194,5,38,2254
18097390200,6766,4914,316,779,5,469,0,3,1852
18097390300,6844,5756,285,267,16,197,3,40,1088
18097390405,4561,2807,204,198,2,1163,3,26,1754
18097390406,5870,4407,310,279,15,577,4,30,1463
18097390407,5632,4914,165,75,3,235,0,56,718
18097390408,5703,4485,355,247,6,338,5,19,1218
18097390409,8018,6069,337,277,15,929,3,20,1949
18097390410,2313,1916,87,99,0,126,7,9,397
18097390411,4395,3201,406,267,8,213,1,20,1194
18097390500,2450,302,240,1788,1,9,1,20,2148
18097390601,959,553,95,245,0,16,4,3,406
18097390602,3157,1410,267,1229,2,77,2,28,1747
18097390700,3951,1214,1726,818,14,34,0,21,2737
18097390801,1,0,1,0,0,0,0,0,1
18097390802,4892,3595,410,555,21,63,0,31,1297
18097390900,3395,2025,181,926,2,100,0,27,1370
18097391001,2731,1774,222,384,2,255,1,17,957
18097391002,5931,3855,365,470,11,980,0,32,2076
18099020101,5429,4054,1202,17,4,30,1,11,1375
18099020102,3602,3405,126,1,6,15,0,2,197
18099020201,3960,3546,238,15,5,14,0,5,414
18099020202,2781,2578,76,9,2,5,1,3,203
18099020301,3849,3529,146,14,4,25,1,11,320
18099020302,2771,2484,79,27,7,28,2,24,287
18099020400,3210,2531,548,21,7,22,0,0,679
18099020500,3644,2217,1252,40,13,18,1,8,1427
18099020600,5146,3925,965,27,1,52,1,18,1221
18099020701,3601,3229,245,9,2,29,0,5,372
18099020702,2861,2601,128,12,0,29,0,6,260
18099020800,5241,4811,246,12,12,7,0,19,430
18101950100,2559,2441,28,4,8,11,0,1,118
18101950200,3740,3590,12,7,5,14,1,0,150
18101950300,3513,3304,52,9,7,8,5,10,209
18103952000,4423,4101,84,4,45,11,0,5,322
18103952100,4355,4005,73,55,53,16,0,12,350
18103952200,2740,2470,76,46,24,8,1,16,270
18103952300,2753,2389,114,65,22,5,0,4,364
18103952400,2673,2352,69,55,45,0,1,5,321
18103952500,2196,1948,47,58,18,15,0,5,248
18103952600,3480,3270,83,19,14,11,0,0,210
18103952700,4603,4267,100,52,27,19,0,8,336
18103952800,2676,2389,115,25,10,21,0,5,287
18103952900,6063,3932,425,1413,23,24,2,42,2131
18105000100,5268,3912,441,232,5,427,1,17,1356
18105000201,3070,2326,124,93,2,447,0,6,744
18105000202,7349,5391,480,404,9,791,5,37,1958
18105000301,4008,3224,233,149,3,173,0,17,784
18105000302,2911,2398,129,50,0,178,1,3,513
18105000401,4628,3510,269,347,18,251,1,17,1118
18105000402,4950,3771,321,339,7,194,1,35,1179
18105000501,5131,3969,243,362,6,233,2,20,1162
18105000502,3320,2719,244,137,9,37,1,1,601
18105000601,3559,2659,270,282,10,46,2,20,900
18105000602,3134,2240,259,245,3,177,4,31,894
18105000700,2990,2706,64,35,1,32,0,13,284
18105000801,2460,2124,78,62,2,67,1,7,336
18105000802,3028,2061,119,86,6,587,1,9,967
18105000901,2410,1725,154,71,11,295,0,17,685
18105000903,5229,3569,290,329,8,694,0,22,1660
18105000904,5470,3639,294,220,0,1023,0,22,1831
18105001001,5464,4308,219,134,9,509,1,24,1156
18105001002,6521,5129,212,159,11,701,2,35,1392
18105001101,5216,3874,387,346,20,281,0,25,1342
18105001102,4538,3510,177,232,17,249,4,27,1028
18105001103,3080,2700,110,58,5,31,0,11,380
18105001200,5910,5419,115,52,7,44,0,14,491
18105001301,5646,5216,105,36,12,14,0,17,430
18105001303,6125,5558,123,77,6,66,2,19,567
18105001304,3919,3542,110,40,4,34,5,8,377
18105001305,2418,2157,93,30,8,33,0,6,261
18105001401,1977,1832,42,9,1,13,1,12,145
18105001403,3340,3030,78,37,3,36,0,12,310
18105001404,1651,1556,25,6,6,9,0,1,95
18105001501,5675,5104,115,50,6,165,2,18,571
18105001502,3051,2802,69,25,2,26,0,6,249
18105001600,6272,4810,366,282,5,487,0,9,1462
18107956700,3150,2963,43,15,3,8,0,19,187
18107956800,3033,2810,62,17,6,11,0,9,223
18107956900,5473,4933,276,27,9,64,0,1,540
18107957000,4907,4209,368,84,13,51,4,7,698
18107957100,4925,4204,402,98,8,36,2,20,721
18107957200,4409,3346,828,52,6,23,0,3,1063
18107957300,4027,3775,81,16,13,6,0,9,252
18107957400,4645,4278,162,19,5,32,2,9,367
18107957500,3367,3230,59,15,10,5,5,0,137
18109510101,5331,4811,174,110,16,21,0,14,520
18109510102,4860,4535,80,12,9,13,0,6,325
18109510201,4191,3889,67,11,6,41,0,22,302
18109510202,4304,3988,79,22,10,11,0,13,316
18109510300,4921,4587,91,17,17,23,3,8,334
18109510401,3966,3725,51,10,12,5,0,10,241
18109510402,5795,5376,111,44,27,20,2,18,419
18109510500,4243,3997,84,5,14,11,0,2,246
18109510601,5249,4958,56,8,14,26,2,17,291
18109510602,3605,3396,53,20,6,5,1,8,209
18109510701,3431,3207,78,6,9,28,1,0,224
18109510703,3893,3599,87,46,6,26,1,9,294
18109510704,3032,2811,85,5,3,20,0,1,221
18109510800,3632,3373,54,13,12,7,0,30,259
18109510900,3669,3483,49,6,8,2,0,6,186
18109511001,5623,5291,71,2,25,13,0,12,332
18109511002,2035,1946,4,2,1,4,1,2,89
18111100400,5974,5267,359,20,6,11,2,10,707
18111100500,3215,2791,246,10,7,12,0,6,424
18111100600,2494,2129,246,4,4,3,0,12,365
18111100700,2147,1866,188,8,8,8,0,6,281
18113971700,6212,5675,218,31,13,47,0,26,537
18113971800,3213,2828,202,25,3,10,0,6,385
18113971900,5572,4876,312,32,9,44,0,13,696
18113972000,3096,2929,70,4,3,12,0,0,167
18113972100,4486,3776,632,8,3,8,0,11,710
18113972200,4904,1935,2803,25,3,34,0,2,2969
18113972300,4702,3950,625,8,14,23,1,5,752
18113972400,4769,4393,186,19,5,19,0,15,376
18113972500,6567,6145,142,56,12,16,0,20,422
18113972600,3936,3728,60,9,6,10,0,6,208
18115965700,2542,2399,37,14,1,24,0,8,143
18115965800,3398,3230,42,2,3,5,0,8,168
18117951300,3553,3413,46,9,9,2,0,3,140
18117951400,3162,2992,24,22,2,6,0,7,170
18117951500,2903,2506,75,120,8,23,6,9,397
18117951600,3434,3219,35,18,13,4,2,8,215
18117951700,3212,2949,77,27,2,22,1,5,263
18117951800,3603,3448,48,4,3,3,2,2,155
18119955500,3586,3335,56,22,5,6,0,3,251
18119955600,3613,3348,39,22,11,7,0,17,265
18119955701,3070,2822,49,10,7,13,0,7,248
18119955702,1884,1810,8,4,8,4,0,5,74
18119955800,4247,3945,75,9,3,20,0,7,302
18119955900,4921,4614,70,12,13,12,0,11,307
18121030100,3884,3729,32,1,11,4,0,0,155
18121030200,2940,2774,74,11,7,11,0,3,166
18121030300,4613,4259,75,176,11,6,0,5,354
18121030401,2459,2390,22,4,9,3,0,3,69
18121030402,2260,2177,22,6,17,6,0,1,83
18123952200,5246,4696,51,334,3,12,0,17,550
18123952300,3371,3221,29,1,8,11,1,9,150
18123952400,4002,3802,61,26,8,14,0,0,200
18123952500,4260,3985,59,21,11,58,2,10,275
18123952600,2291,2149,20,15,3,4,0,10,142
18125953900,3374,3218,55,7,1,5,0,5,156
18125954000,2928,2793,45,18,11,7,0,5,135
18125954100,3125,2991,31,3,12,3,0,0,134
18125954200,2823,2664,49,3,15,0,0,1,159
18127050104,5710,4837,438,56,6,123,1,9,873
18127050105,5198,4260,574,61,9,71,0,15,938
18127050106,4098,3622,242,34,2,17,2,23,476
18127050107,3958,3485,219,32,0,47,0,22,473
18127050202,6184,5131,548,152,7,56,0,20,1053
18127050203,6635,5577,551,84,12,110,1,24,1058
18127050301,3742,3017,425,116,5,45,0,16,725
18127050302,4074,3417,377,83,12,38,2,18,657
18127050405,1168,1030,60,24,3,15,0,1,138
18127050407,3541,2376,591,378,9,39,5,0,1165
18127050408,3917,2688,706,294,13,18,1,10,1229
18127050409,4339,2876,861,321,8,64,4,15,1463
18127050501,6015,4129,993,503,33,38,1,27,1886
18127050503,5021,3855,666,237,3,19,0,25,1166
18127050505,2364,1818,300,86,0,21,5,9,546
18127050506,6198,3835,1267,748,12,78,0,11,2363
18127050507,4016,2122,727,880,7,54,1,14,1894
18127050508,6127,3740,1169,845,11,54,4,22,2387
18127050509,5218,3515,1082,346,7,52,0,6,1703
18127050602,4804,3949,413,84,14,129,0,15,855
18127050603,4068,3530,276,44,1,56,4,23,538
18127050605,4606,3966,358,51,1,71,4,15,640
18127050606,4615,3849,370,103,5,107,4,14,766
18127050703,3424,2912,269,38,3,47,0,6,512
18127050704,5797,4779,478,150,10,160,4,20,1018
18127050705,3929,3022,378,260,7,51,0,17,907
18127050706,4567,3568,450,228,0,98,2,31,999
18127050801,2921,2456,276,49,4,26,1,7,465
18127050802,3646,2669,460,223,10,106,1,3,977
18127050901,2226,1629,316,105,7,61,0,19,597
18127050902,1669,1235,176,124,2,66,0,47,434
18127051005,5203,4450,362,108,5,67,1,1,753
18127051006,4200,3489,444,56,4,27,0,6,711
18127051008,2185,1932,164,4,0,3,0,5,253
18127051009,5799,4916,418,102,10,66,1,11,883
18127051010,3988,3594,212,30,5,11,2,11,394
18127051011,3688,2998,416,68,0,43,0,25,690
18127051012,3753,3279,243,46,4,20,0,11,474
18127051101,6104,5323,444,83,7,15,0,10,781
18127051102,4478,4097,185,9,1,8,0,18,381
18127980001,22,21,0,1,0,0,0,0,1
18127980002,0,0,0,0,0,0,0,0,0
18127990000,0,0,0,0,0,0,0,0,0
18129040100,5563,5297,64,22,11,25,2,11,266
18129040200,2160,2083,15,5,5,6,1,4,77
18129040300,2436,2341,10,6,5,2,0,6,95
18129040400,5860,5543,72,25,7,31,0,14,317
18129040500,3061,2903,36,20,6,16,0,1,158
18129040600,3287,2959,78,50,4,13,0,4,328
18129040700,2855,2514,100,83,6,14,0,17,341
18131958900,2535,2298,89,24,4,12,0,5,237
18131959000,3514,3213,118,22,3,19,0,5,301
18131959100,3521,3201,146,14,7,8,1,4,320
18131959200,2944,2730,105,5,10,5,2,0,214
18133956000,3109,2981,40,3,15,3,1,7,128
18133956100,2658,2540,27,9,2,5,0,2,118
18133956200,4805,4175,174,132,3,118,2,35,630
18133956301,4982,4311,199,116,12,119,0,36,671
18133956302,2327,2128,39,20,8,62,0,3,199
18133956401,3226,3029,52,14,3,4,3,11,197
18133956402,3938,3654,76,7,10,10,1,5,284
18133956500,6024,5638,83,40,10,15,7,15,386
18133956600,5657,4694,94,683,7,19,0,12,963
18135951400,2445,2301,59,9,5,5,0,6,144
18135951500,2903,2756,37,3,10,6,0,6,147
18135951600,3627,2758,710,33,14,1,0,14,869
18135951700,3171,2909,93,24,4,19,0,5,262
18135951800,2376,2204,55,12,4,20,0,1,172
18135951900,4160,3945,64,17,3,4,0,2,215
18135952000,3069,2883,51,19,4,1,0,16,186
18135952100,2751,2569,87,2,8,11,0,10,182
18137968401,2156,2048,29,6,1,4,0,3,108
18137968402,5129,4701,145,17,9,76,0,20,428
18137968500,5028,4566,223,17,10,49,0,6,462
18137968600,4854,4688,30,9,6,14,0,8,166
18137968700,3540,3407,32,2,5,10,0,2,133
18137968800,3363,3156,45,11,6,11,0,3,207
18137968900,4925,4647,37,11,8,19,0,11,278
18139974100,2877,2802,22,0,6,3,2,2,75
18139974200,3487,3317,59,11,6,0,1,7,170
18139974300,3533,3279,56,24,4,25,0,4,254
18139974400,2768,2571,59,42,0,12,0,13,197
18139974500,4087,3907,56,13,3,14,0,10,180
18141000100,2191,779,395,866,1,18,0,3,1412
18141000200,3552,1100,469,1742,7,10,4,15,2452
18141000301,2617,1613,213,579,12,26,0,15,1004
18141000302,2641,963,158,1314,17,46,0,31,1678
18141000400,2464,608,405,1271,21,16,0,12,1856
18141000500,1707,319,243,1034,7,6,0,11,1388
18141000600,2199,762,375,844,0,19,0,18,1437
18141000700,1612,1084,130,246,4,32,0,8,528
18141000800,1510,1246,107,53,1,31,0,9,264
18141000900,1358,899,95,208,0,57,6,14,459
18141001000,3549,1819,391,920,5,177,0,29,1730
18141001100,4330,2590,394,865,20,150,6,15,1740
18141001200,2195,1799,109,165,5,30,1,13,396
18141001300,2363,1250,275,618,8,52,1,18,1113
18141001400,3632,2354,260,646,22,29,3,16,1278
18141001500,3079,2033,304,403,15,48,1,36,1046
18141001600,2318,1915,139,146,0,35,0,5,403
18141001700,1697,862,131,568,12,14,0,15,835
18141001900,1393,492,185,616,3,10,3,7,901
18141002000,1698,387,226,951,1,9,0,11,1311
18141002100,1256,199,201,770,0,11,0,10,1057
18141002200,3006,496,1862,529,2,19,0,8,2510
18141002300,1406,105,409,816,3,2,0,7,1301
18141002400,2857,547,1480,712,11,2,1,5,2310
18141002500,2213,669,835,599,4,12,0,8,1544
18141002600,3401,1196,1201,813,16,23,3,11,2205
18141002700,1592,440,648,438,0,3,1,2,1152
18141002800,2195,587,701,746,9,18,2,9,1608
18141002900,1308,312,323,585,0,3,0,6,996
18141003000,1864,681,478,471,6,9,4,22,1183
18141003100,3879,2043,592,907,9,24,4,23,1836
18141003200,5084,3824,447,431,17,72,0,53,1260
18141003300,2963,1772,422,531,9,23,3,34,1191
18141003400,3855,1256,1186,1127,22,16,2,32,2599
18141003500,2670,1708,289,435,3,26,1,17,962
18141010100,2848,2247,156,181,12,31,3,9,601
18141010201,3889,3096,191,284,7,27,0,20,793
18141010202,1678,1318,80,160,7,9,0,5,360
18141010300,5799,4427,382,500,29,75,1,38,1372
18141010400,3111,2652,148,103,6,5,0,7,459
18141010500,3017,2605,150,53,10,30,0,8,412
18141010600,3969,3010,242,336,21,56,5,28,959
18141010700,3989,3175,267,247,13,34,3,13,814
18141010800,4302,3919,130,38,6,7,0,6,383
18141010901,4056,3505,247,130,5,34,0,16,551
18141010902,3911,3163,222,273,7,69,0,12,748
18141011001,2690,2018,154,300,3,71,5,8,672
18141011002,4362,3313,274,460,8,104,2,17,1049
18141011100,4341,2906,691,459,21,15,3,20,1435
18141011203,10008,7468,955,446,32,679,18,41,2540
18141011303,6157,4801,311,575,28,54,2,32,1356
18141011304,2456,2015,105,120,15,109,0,17,441
18141011305,4286,3404,244,285,4,108,1,30,882
18141011306,3301,2751,124,189,6,109,5,10,550
18141011307,3014,1938,235,523,14,76,0,64,1076
18141011308,3924,3102,187,294,15,148,2,20,822
18141011309,3096,2209,241,387,5,109,0,13,887
18141011310,2877,1913,292,233,6,271,0,38,964
18141011403,6117,5008,258,180,15,421,3,28,1109
18141011404,6634,5032,225,146,5,923,4,33,1602
18141011405,3718,3173,142,58,9,144,2,8,545
18141011406,5231,4431,185,137,9,178,9,34,800
18141011501,3926,2206,291,1038,17,129,0,11,1720
18141011503,1855,1609,77,40,11,25,2,17,246
18141011504,1572,1325,77,46,0,41,0,0,247
18141011505,3931,2732,242,240,15,546,4,5,1199
18141011506,5309,3584,368,835,9,230,0,16,1725
18141011602,7695,6700,277,183,17,127,14,12,995
18141011603,4993,4431,211,59,11,75,3,11,562
18141011604,3279,2874,93,66,13,67,6,4,405
18141011701,4105,3478,198,150,16,43,0,14,627
18141011703,3631,2559,205,618,4,57,5,19,1072
18141011704,4986,4015,303,351,6,97,0,28,971
18141011801,1244,1088,57,29,2,6,0,5,156
18141011803,4077,3247,330,287,2,37,3,20,830
18141011804,2444,2045,152,115,1,36,3,7,399
18141011900,4212,3560,230,177,21,32,0,11,652
18141012000,3670,3264,175,51,3,17,2,11,406
18141012100,3402,3116,119,6,12,12,0,20,286
18141012200,2873,2578,117,21,10,17,0,0,295
18141012300,3482,3168,109,42,12,11,0,5,314
18141012400,1791,1669,29,4,1,7,3,11,122
18143966700,4398,4187,70,5,1,9,2,5,211
18143966800,3777,3443,109,28,4,10,1,8,334
18143966900,4775,4481,83,11,4,23,3,10,294
18143967000,5882,5460,138,28,12,29,2,15,422
18143967100,5552,5258,135,20,6,16,3,6,294
18145710100,3678,3477,59,16,8,11,0,8,201
18145710200,5702,5321,149,35,5,20,0,23,381
18145710300,4753,4456,128,38,10,29,0,10,297
18145710400,3198,2409,553,55,4,102,2,7,789
18145710500,5343,4322,627,79,16,110,1,11,1021
18145710601,3277,2819,232,45,2,5,0,24,458
18145710602,3188,2751,173,86,9,6,0,0,437
18145710700,6453,5755,312,147,4,36,0,10,698
18145710800,4869,4633,73,21,2,10,0,10,236
18145710900,4594,4362,71,15,0,10,0,24,232
18147952701,4500,4223,77,36,9,43,0,8,277
18147952702,3126,2639,408,16,7,4,0,0,487
18147952800,3058,2909,48,17,2,7,1,1,149
18147952900,2417,2293,36,13,12,6,0,2,124
18147953000,3870,3681,40,9,9,4,0,16,189
18147953100,2839,2623,67,38,5,9,0,1,216
18149953600,2611,2402,65,3,14,9,0,5,209
18149953700,3561,3285,144,3,0,5,2,1,276
18149953800,3675,3351,136,29,5,0,0,8,324
18149953900,2172,1975,106,5,1,3,0,4,197
18149954000,3711,3412,128,9,21,10,0,0,299
18149954100,3592,3273,120,11,8,6,2,19,319
18149954200,4049,3697,203,7,11,7,0,4,352
18151970800,3652,3452,83,9,1,12,0,4,200
18151970900,2310,2171,59,7,0,13,0,9,139
18151971000,3812,3556,142,9,13,7,1,1,256
18151971100,2982,2773,69,9,1,20,0,32,209
18151971200,3211,3059,42,12,10,5,0,8,152
18151971300,5565,4749,519,55,17,57,0,11,816
18151971400,5251,4547,297,109,10,60,0,13,704
18151971500,3252,3028,107,8,4,7,0,16,224
18151971600,4400,4103,109,16,8,6,1,0,297
18153050101,3026,2903,35,4,2,0,3,0,123
18153050102,2584,2455,22,11,5,2,1,5,129
18153050200,2917,2789,31,10,14,1,0,6,128
18153050301,3317,3062,49,7,8,20,0,0,255
18153050302,2727,2504,46,3,6,1,0,9,223
18153050400,2217,2138,26,5,0,5,1,1,79
18153050501,2993,2016,99,837,4,4,3,5,977
18153050502,1036,989,26,0,4,0,0,2,47
18155965700,3968,3786,33,5,12,8,0,7,182
18155965800,3039,2892,52,0,12,2,0,1,147
18155965900,2730,2584,29,9,2,10,0,3,146
18157000100,2719,1869,371,255,6,90,1,14,850
18157000200,1931,1406,221,183,7,5,0,6,525
18157000300,3299,2294,628,186,16,26,2,4,1005
18157000400,4500,2828,476,704,15,174,0,46,1672
18157000700,3168,2099,505,330,14,39,0,19,1069
18157000800,1933,1421,260,113,5,17,0,17,512
18157001000,1362,1111,55,82,3,27,0,15,251
18157001100,3048,2459,272,158,3,30,0,15,589
18157001200,3152,2283,411,274,12,10,1,17,869
18157001300,4741,3190,956,329,6,50,0,19,1551
18157001400,3352,2128,874,163,9,12,0,5,1224
18157001501,4891,3103,450,1016,11,90,0,30,1788
18157001502,6120,4183,976,586,12,73,5,20,1937
18157001601,2161,1895,117,40,4,25,0,10,266
18157001602,3012,2324,453,58,0,22,0,7,688
18157001603,6733,5251,688,353,11,132,0,15,1482
18157001701,3936,1886,563,1131,4,99,1,39,2050
18157001702,2606,1515,738,185,7,48,0,5,1091
18157001800,3733,2101,1047,390,2,57,0,18,1632
18157001900,4080,3082,427,348,8,55,0,9,998
18157005101,3229,1500,141,233,5,1254,0,7,1729
18157005102,4959,3261,270,143,0,1043,2,38,1698
18157005200,4881,3375,297,228,5,708,1,24,1506
18157005401,2271,1485,139,64,0,477,1,23,786
18157005402,2205,1125,141,135,1,722,0,12,1080
18157005500,5684,2931,389,169,5,1681,0,16,2753
18157010100,6162,5621,197,51,13,39,0,18,541
18157010201,5500,4790,298,101,13,76,0,6,710
18157010205,4612,3177,402,302,12,456,0,25,1435
18157010206,6135,3828,655,319,19,1051,2,25,2307
18157010207,4392,3475,209,120,2,406,0,15,917
18157010208,6484,3530,451,299,21,1788,10,35,2954
18157010209,3562,2239,480,192,9,454,1,9,1323
18157010400,8044,5258,513,281,10,120,6,27,2786
18157010500,1649,558,168,87,6,524,0,6,1091
18157010600,5687,5156,204,34,6,92,0,18,531
18157010700,6695,5009,871,360,11,110,2,12,1686
18157010800,5693,4741,303,235,12,143,0,32,952
18157010901,9070,7420,762,166,8,350,0,25,1650
18157010902,3883,3421,233,22,1,11,0,14,462
18157011000,3998,3589,216,18,11,9,0,15,409
18157011100,4429,3169,431,464,11,120,0,24,1260
18157011200,6550,4379,389,173,10,898,3,35,2171
18159020100,2546,2365,116,1,3,6,0,3,181
18159020200,3393,3175,74,12,2,7,0,19,218
18159020300,2685,2546,42,13,4,8,0,2,139
18159020401,4198,3939,110,14,4,13,1,20,259
18159020402,2537,2342,92,6,0,12,1,12,195
18161960700,4134,3938,52,15,10,22,2,5,196
18161960800,2953,2827,22,6,12,11,6,7,126
18163000100,1981,1638,107,113,4,5,16,5,343
18163000203,2985,2449,162,155,3,70,4,3,536
18163000204,4822,3779,281,342,10,176,15,21,1043
18163000205,2135,1808,64,135,3,18,1,2,327
18163000300,3657,2787,197,331,8,76,21,14,870
18163000400,2213,1941,49,96,6,27,2,8,272
18163000500,2048,1742,60,103,0,19,9,12,306
18163000600,1913,1525,55,153,5,18,23,11,388
18163000800,2689,1708,144,572,7,10,46,20,981
18163000900,5767,3883,345,1010,9,40,65,19,1884
18163001000,4239,2402,234,1105,12,15,165,40,1837
18163001101,2429,974,122,1046,9,8,39,22,1455
18163001200,1612,777,86,608,7,5,14,12,835
18163001300,1725,695,157,733,0,2,3,20,1030
18163001400,1765,797,104,727,11,13,14,15,968
18163001500,1842,656,117,920,6,7,2,16,1186
18163001700,2127,1376,62,541,4,18,2,12,751
18163001800,501,388,10,64,5,14,0,0,113
18163001900,1009,728,30,150,2,5,4,13,281
18163002000,901,639,42,174,3,0,7,2,262
18163002100,2056,1506,112,302,4,7,10,6,550
18163002300,2421,1853,104,267,7,8,12,17,568
18163002400,3091,2634,85,161,7,19,8,4,457
18163002500,1722,1247,85,227,10,5,14,4,475
18163002600,3319,2256,159,585,4,15,9,27,1063
18163003000,4742,4270,100,105,10,27,1,9,472
18163003100,2440,2124,58,84,10,12,2,18,316
18163003200,3732,3318,87,118,4,23,0,7,414
18163003300,3685,3084,158,199,7,10,0,6,601
18163003400,2798,2545,55,51,6,9,3,5,253
18163003500,3219,2741,60,254,6,31,1,8,478
18163003600,4576,3188,281,722,13,31,4,21,1388
18163003701,1974,1551,83,165,0,46,2,9,423
18163003702,4556,2872,256,1057,22,27,7,28,1684
18163003801,5283,4032,210,597,5,95,11,26,1251
18163003803,5432,4535,178,283,5,148,12,22,897
18163003805,6597,4870,275,922,18,74,60,34,1727
18163003900,3223,2784,73,170,2,35,2,9,439
18163010101,3032,1868,162,555,19,201,23,17,1164
18163010102,4245,3239,210,452,9,128,0,23,1006
18163010204,6798,6070,125,95,8,182,3,28,728
18163010205,3459,3090,85,47,0,13,14,15,369
18163010206,5508,5084,71,105,3,70,0,10,424
18163010207,3298,2954,59,97,7,34,0,5,344
18163010208,5344,4639,109,170,11,238,1,8,705
18163010404,6767,6260,127,61,0,99,1,18,507
18163010405,4141,3528,151,234,1,100,10,5,613
18163010406,1972,1893,11,18,2,3,0,5,79
18163010501,3382,3182,47,17,1,15,0,8,200
18163010502,3785,3606,45,18,4,7,1,3,179
18163010600,1563,1496,23,0,0,7,1,0,67
18163010701,4150,3788,73,67,3,49,9,18,362
18163010702,6099,5661,74,79,4,80,2,7,438
18163010800,3357,2978,93,97,5,17,1,12,379
18163980100,8,4,1,0,0,0,1,0,4
18163980200,0,0,0,0,0,0,0,0,0
18163980300,0,0,0,0,0,0,0,0,0
18163980500,2,2,0,0,0,0,0,0,0
18163980600,0,0,0,0,0,0,0,0,0
18165020100,3034,2885,44,3,7,10,0,4,149
18165020200,2622,2532,18,3,0,5,0,5,90
18165020300,3035,2917,18,7,4,8,0,0,118
18165020400,1913,1820,15,2,4,4,1,0,93
18165020500,4835,4538,73,22,12,19,10,9,297
18167000300,2105,1668,94,175,2,58,4,23,437
18167000400,2976,2230,126,311,11,5,1,18,746
18167000500,1576,989,48,402,7,8,0,22,587
18167000600,1796,1251,65,275,8,25,1,18,545
18167000700,1942,1261,114,387,2,3,0,17,681
18167000900,2159,1792,38,153,8,11,0,5,367
18167001000,3310,2979,56,83,11,16,0,12,331
18167001100,2701,2220,80,200,4,2,0,26,481
18167001200,2364,1947,43,202,13,8,2,16,417
18167001300,2423,2052,57,86,12,85,0,5,371
18167001400,3046,2619,71,196,5,19,0,7,427
18167001500,3392,2884,95,181,8,8,3,22,508
18167001600,5436,4834,149,151,0,114,0,19,602
18167001700,4700,3758,158,379,9,31,2,40,942
18167001800,2621,2039,95,201,6,32,2,19,582
18167001900,1711,1297,78,203,1,14,0,8,414
18167010100,5835,5128,129,138,0,174,0,17,707
18167010201,4707,4367,65,81,5,24,0,11,340
18167010202,3240,3018,47,44,4,12,0,16,222
18167010300,3899,3686,48,24,15,15,0,21,213
18167010400,3710,3517,43,12,6,7,0,4,193
18167010500,2287,2124,37,6,11,0,0,7,163
18167010601,3868,3498,103,38,8,61,4,5,370
18167010602,2550,2031,85,95,7,222,0,7,519
18167010702,6001,5241,137,145,14,202,4,28,760
18167010703,4534,3850,133,203,13,142,0,22,684
18167010704,2612,2267,49,38,3,136,0,12,345
18167011000,3364,3098,68,13,6,41,1,15,266
18167011101,2453,1839,129,274,16,58,1,9,614
18167011102,4080,2647,245,917,0,95,0,147,1433
18167011201,6224,4074,454,1345,90,120,0,7,2150
18167011202,2531,1932,100,121,6,255,0,11,599
18169102200,5277,4725,293,35,7,47,2,11,552
18169102300,4112,3837,125,19,16,10,3,2,275
18169102400,3245,3054,53,4,11,32,0,8,191
18169102500,4204,3986,72,11,20,8,3,3,218
18169102600,3036,2807,74,16,9,14,0,15,229
18169102700,4132,3796,105,33,30,14,0,9,336
18169102800,3463,3143,104,26,23,18,1,16,320
18169102900,3507,3286,71,14,10,18,0,2,221
18171951001,2841,2705,80,0,1,5,0,6,136
18171951002,1930,1822,27,4,0,9,0,3,108
18171951100,3669,3491,86,3,6,12,0,2,178
18173030100,3396,3296,30,2,1,10,0,7,100
18173030200,3401,3212,38,8,7,5,0,7,189
18173030300,6131,5518,140,66,14,176,1,24,613
18173030400,2897,2657,41,15,4,11,2,6,240
18173030501,3747,3434,62,22,5,101,1,9,313
18173030502,4178,3975,62,28,5,11,0,12,203
18173030601,2554,2410,38,24,1,4,1,2,144
18173030602,3472,3199,63,31,12,13,0,3,273
18173030703,5652,4920,133,200,10,85,0,27,732
18173030704,5335,4680,175,111,8,125,3,27,655
18173030706,3922,3273,79,63,1,359,1,4,649
18173030707,4985,4401,109,76,2,232,0,12,584
18173030708,2676,2312,47,84,2,146,1,7,364
18173030709,4737,3971,208,152,3,236,1,15,766
18173030801,3859,3450,102,70,8,86,0,12,409
18173030802,2956,2638,56,86,9,39,0,9,318
18175967200,4626,4373,66,11,12,16,2,19,253
18175967300,4439,4225,54,15,14,17,2,6,214
18175967400,4595,4336,78,15,10,11,0,14,259
18175967500,3173,2965,29,12,12,25,1,4,208
18175967600,4288,4063,63,23,2,13,2,11,225
18175967701,3213,3025,47,10,5,7,2,7,188
18175967702,3848,3613,63,27,11,6,1,6,235
18177000200,3890,2931,328,301,23,7,0,8,959
18177000400,4022,3466,165,153,5,63,1,25,556
18177000500,3963,2908,290,456,15,7,0,26,1055
18177000600,1818,1570,65,72,9,2,0,10,248
18177000700,5962,5307,114,167,6,56,0,29,655
18177000800,4151,3216,219,282,5,168,0,28,935
18177000900,5359,3967,279,627,12,23,0,61,1392
18177001000,4651,3372,436,406,23,34,5,36,1279
18177001101,3865,3229,116,199,1,169,1,27,636
18177001102,2693,2086,133,209,5,87,1,22,607
18177010100,2685,2528,39,26,0,1,0,1,157
18177010200,3272,3123,22,30,0,5,0,6,149
18177010300,3559,3410,34,8,6,7,0,7,149
18177010400,3207,3014,46,14,7,22,0,4,193
18177010500,2248,2086,34,10,10,20,0,4,162
18177010600,4349,4092,69,23,4,13,0,12,257
18177010700,3758,3555,25,24,5,6,4,12,203
18177010800,3101,2829,81,20,6,17,0,12,272
18179040100,5841,5352,267,32,6,24,0,10,489
18179040200,3668,3498,58,8,6,11,0,3,170
18179040300,3239,3070,95,3,13,9,0,2,169
18179040400,4486,4070,142,72,6,47,1,9,416
18179040500,3048,2805,103,25,1,18,0,5,243
18179040600,4186,3645,298,79,9,16,4,8,541
18179040700,3712,3560,56,1,9,5,0,3,152
18181958100,2351,2192,87,4,2,3,2,4,159
18181958200,2903,1685,1126,11,4,2,0,4,1218
18181958300,2344,2195,65,11,10,12,1,2,149
18181958400,2358,2166,66,11,0,16,0,0,192
18181958501,1439,1317,63,7,8,1,0,1,122
18181958502,1987,1795,123,10,9,10,0,0,192
18181958600,5243,4241,728,30,9,25,0,6,1002
18181958700,2678,2437,123,14,0,12,1,6,241
18181958800,3385,3175,72,13,8,13,2,6,210
18183050100,5181,4836,146,14,10,17,0,10,345
18183050200,5433,5142,70,10,11,26,1,13,291
18183050300,5219,4915,94,17,15,16,1,9,304
18183050401,3635,3348,117,21,11,9,0,11,287
18183050402,4281,3828,177,35,10,66,0,13,453
18183050500,4940,4569,143,32,10,25,1,17,371
18183050600,2068,1941,40,6,9,3,0,0,127
18183050700,3434,3253,54,15,15,11,0,5,181
19001960100,2776,2552,100,25,8,8,0,1,224
19001960200,1611,1571,23,2,0,1,0,2,40
19001960300,3109,2943,63,18,8,14,1,1,166
19003950100,1587,1520,17,3,8,2,0,5,67
19003950200,2117,1998,25,9,7,11,0,10,119
19005960100,2083,1996,21,7,1,8,1,3,87
19005960200,2407,2329,38,1,5,0,3,4,78
19005960300,3989,3777,105,24,6,7,0,4,212
19005960400,2108,2058,23,0,0,5,0,5,50
19005960500,3474,2241,1034,114,2,21,1,8,1233
19007950100,2568,2461,26,1,0,7,0,0,107
19007950200,1723,1670,16,1,5,3,0,0,53
19007950300,2975,2693,109,41,6,33,0,4,282
19007950400,2887,2677,62,32,3,22,0,9,210
19007950500,2164,2085,18,0,5,4,0,1,79
19009070100,1800,1740,20,5,0,1,1,1,60
19009070200,2248,2121,57,9,1,1,0,3,127
19009070300,1626,1582,9,3,4,2,0,0,44
19011960100,3100,2946,36,17,2,13,1,1,154
19011960200,3184,3035,69,10,2,4,0,7,149
19011960300,5122,4789,90,34,13,20,0,22,333
19011960400,3257,3041,48,12,0,11,0,12,216
19011960500,5774,5477,66,19,6,13,1,5,297
19011960600,2617,2434,107,7,6,3,0,5,183
19011960700,2521,2355,46,13,0,15,0,5,166
19013000100,1773,809,122,652,4,36,38,14,964
19013000200,2855,1319,409,644,26,195,79,14,1536
19013000300,2857,1272,237,775,14,242,110,16,1585
19013000400,1590,1281,82,115,1,18,7,1,309
19013000500,1577,679,196,500,4,42,49,0,898
19013000700,1377,461,306,455,5,32,17,5,916
19013000800,3613,2252,644,463,8,12,41,2,1361
19013000900,2384,1534,155,430,0,78,59,13,850
19013001000,3732,2703,277,304,6,264,22,6,1029
19013001100,2861,1881,298,350,2,163,32,13,980
19013001200,2282,1787,107,205,0,117,5,2,495
19013001301,4153,2702,138,882,5,241,48,10,1451
19013001302,3688,2804,99,544,3,110,19,21,884
19013001400,4542,3755,213,242,7,84,30,12,787
19013001501,3064,2409,114,325,5,48,22,6,655
19013001502,3786,3050,163,297,16,36,32,31,736
19013001503,3645,3183,123,158,1,34,1,6,462
19013001600,2700,1784,190,490,6,26,25,12,916
19013001701,1973,477,180,1115,3,13,46,5,1496
19013001702,2516,1013,162,1152,7,65,1,4,1503
19013001800,1493,214,109,1073,6,18,8,10,1279
19013001900,2094,1040,261,641,1,27,10,1,1054
19013002000,5171,4545,166,134,14,29,30,15,626
19013002200,4229,3747,126,114,4,66,13,18,482
19013002301,2071,1785,67,78,1,68,2,1,286
19013002303,3801,2947,117,379,21,108,24,8,854
19013002304,2450,2129,94,83,3,58,0,10,321
19013002400,3941,3575,94,59,3,39,15,11,366
19013002500,5849,5141,160,129,6,169,3,24,708
19013002601,6032,5174,193,120,6,333,40,17,858
19013002604,3985,3633,99,74,4,40,5,12,352
19013002605,6557,5571,151,204,4,298,5,17,986
19013002606,5172,4689,119,62,1,173,2,11,483
19013002700,3826,3627,59,37,1,5,0,5,199
19013002800,2901,2786,32,1,0,6,0,3,115
19013002901,1265,1147,35,14,0,9,0,6,118
19013002902,3854,3667,85,24,2,4,0,1,187
19013003001,5485,4809,177,177,17,90,7,7,676
19013003002,4000,3769,89,28,2,16,1,7,231
19015020100,3245,2976,122,23,6,10,0,8,269
19015020200,3889,3555,128,59,8,17,0,7,334
19015020300,6051,5555,126,72,14,44,0,14,496
19015020400,2464,2302,66,18,4,7,1,2,162
19015020500,5075,4748,111,28,4,13,1,1,327
19015020600,2234,1972,105,79,3,5,0,8,262
19015020700,3757,3612,51,10,12,4,1,2,145
19017004000,2406,2064,94,105,4,62,1,0,342
19017004100,3819,3571,85,48,6,23,0,5,248
19017004200,4463,4060,113,73,8,76,1,13,403
19017004300,1839,1782,31,2,1,0,0,3,57
19017004400,2679,2575,39,0,0,2,0,8,104
19017004500,2362,2283,15,3,3,5,0,0,79
19017004600,5353,5113,81,6,1,22,0,1,240
19017004700,2067,1955,53,2,3,6,0,2,112
19019950100,2374,2263,44,0,2,0,4,4,111
19019950200,3887,3735,51,6,5,7,0,2,152
19019950300,3078,2943,47,10,3,4,2,0,135
19019950400,2925,2765,56,29,3,22,1,0,160
19019950500,3743,3480,85,12,4,15,1,4,263
19019950600,4558,4379,55,13,1,4,3,7,179
19021960100,1445,1288,110,4,2,3,0,0,157
19021960200,1849,1579,216,8,3,0,0,3,270
19021960300,1939,1686,151,1,6,10,35,9,253
19021960400,6745,1759,3043,349,8,1087,385,22,4986
19021960500,5111,2161,1814,164,7,730,123,40,2950
19021960600,3734,2904,591,34,3,59,71,3,830
19023070100,2997,2893,27,2,1,10,0,1,104
19023070200,1892,1780,52,7,0,1,0,0,112
19023070300,2582,2510,22,3,6,5,0,4,72
19023070400,3885,3731,38,10,5,6,0,6,154
19023070500,2978,2837,44,4,4,6,0,8,141
19025950100,2345,2249,45,8,3,7,0,1,96
19025950200,2981,2780,104,7,8,9,2,12,201
19025950300,2247,1980,56,128,10,3,6,6,267
19025950400,2354,2252,31,8,1,5,0,0,102
19027960100,3801,3680,55,1,6,8,0,10,121
19027960200,2393,2319,17,6,3,3,0,0,74
19027960300,6247,5773,184,134,0,30,0,5,474
19027960400,4202,3698,257,117,4,22,0,3,504
19027960500,1897,1804,59,2,0,0,0,0,93
19027960600,2220,2135,22,2,6,12,0,0,85
19029190100,2433,2334,17,1,6,5,6,0,99
19029190200,2186,2048,75,3,3,3,2,9,138
19029190300,1537,1458,13,2,4,6,2,7,79
19029190400,4073,3810,113,7,2,9,30,9,263
19029190500,2898,2667,88,15,2,12,38,3,231
19031450100,2873,2747,34,9,6,6,0,1,126
19031450200,3671,3462,73,21,11,17,1,9,209
19031450300,3377,3162,87,17,10,7,0,11,215
19031450400,2853,2680,61,10,11,9,0,13,173
19031450500,5731,5283,207,22,2,22,1,20,448
19033950102,4374,3553,379,150,31,30,44,15,821
19033950201,2737,2295,221,61,7,52,5,4,442
19033950202,3664,3102,216,88,10,82,29,0,562
19033950300,4422,3614,391,133,12,73,18,3,808
19033950402,4146,3578,244,81,18,27,27,11,568
19033950600,2145,2029,39,10,3,4,0,7,116
19033950700,4030,3666,146,36,7,43,4,0,364
19033950800,4785,4443,112,56,0,66,2,3,342
19033950900,1659,1562,35,4,0,6,0,4,97
19033951000,2763,2599,81,11,3,7,0,6,164
19033951400,3900,3457,141,106,2,80,4,14,443
19033951600,4502,3921,238,112,3,65,4,15,581
19035080101,2983,2647,202,22,6,22,5,8,336
19035080102,2619,2315,168,44,9,27,1,7,304
19035080200,2393,2243,58,18,5,4,0,4,150
19035080300,1603,1546,21,0,1,2,1,2,57
19035080400,2060,1917,81,0,3,2,7,7,143
19037070100,3194,3035,95,15,4,9,0,3,159
19037070200,2362,2263,22,9,1,1,0,2,99
19037070300,2689,2531,84,10,2,4,0,2,158
19037070400,3767,3344,280,41,0,14,0,0,423
19039960100,5454,3774,1411,35,6,64,33,9,1680
19039960200,1990,1866,71,1,1,9,3,6,124
19039960300,2304,2197,52,7,0,8,4,13,107
19041080100,1912,1823,52,3,2,0,0,0,89
19041080200,5217,4576,348,48,17,56,0,7,641
19041080301,3985,3679,150,20,3,18,0,3,306
19041080302,2379,2203,81,20,7,23,2,2,176
19041080400,2891,2744,73,8,8,8,0,0,147
19043070100,2864,2734,37,6,16,9,0,3,130
19043070200,3409,3074,141,118,0,17,0,0,335
19043070300,3152,3013,74,14,2,1,2,0,139
19043070400,2452,2353,19,10,9,4,1,10,99
19043070500,2085,2026,13,2,0,7,0,1,59
19043070600,3081,2911,59,8,7,9,3,2,170
19045000100,2641,2054,163,225,9,13,0,6,587
19045000200,1621,1339,117,73,5,5,1,2,282
19045000300,4725,3724,288,356,14,7,0,29,1001
19045000400,3857,3375,138,152,8,37,1,4,482
19045000500,4376,3784,125,189,14,55,7,7,592
19045000600,3597,3141,110,139,6,42,0,13,456
19045000700,3644,3245,110,76,12,30,0,7,399
19045000800,5322,4930,122,34,10,21,1,12,392
19045000900,6633,6122,194,103,8,23,0,10,511
19045001000,3840,3625,72,9,6,11,0,3,215
19045001100,2293,2160,30,32,5,5,0,5,133
19045001200,3911,3727,70,4,6,3,0,6,184
19047070100,1690,1474,177,10,0,3,0,4,216
19047070200,2032,1777,182,18,7,18,1,1,255
19047070300,2033,1867,124,4,1,0,2,4,166
19047070401,3666,1982,1382,135,20,104,0,7,1684
19047070402,5285,1839,2960,215,3,170,0,11,3446
19047070500,1819,1686,87,1,0,8,1,0,133
19049050100,7480,6781,207,36,10,207,0,11,699
19049050200,3953,3709,84,13,3,16,1,12,244
19049050300,4630,2844,1407,188,7,47,0,15,1786
19049050400,3284,1575,1503,70,4,37,4,6,1709
19049050500,2080,1928,69,0,3,5,0,11,152
19049050600,3132,2920,73,22,1,12,0,9,212
19049050700,6575,6125,175,45,9,24,0,22,450
19049050803,13572,11517,489,287,13,755,3,35,2055
19049050805,6715,5795,222,115,7,366,0,17,920
19049050807,8483,6640,591,522,13,384,13,23,1843
19049050812,4149,3557,148,54,2,207,0,10,592
19049050813,1776,1278,122,127,2,170,4,10,498
19049050814,5453,4095,236,281,7,601,0,31,1358
19049050815,4257,3166,196,118,9,608,0,11,1091
19049050816,5097,3779,227,165,12,729,0,17,1318
19049050817,6471,5314,247,170,13,450,0,24,1157
19049050818,4073,3020,235,346,0,258,1,19,1053
19049050901,3403,2994,162,72,5,39,2,22,409
19049050902,5095,4671,122,26,17,72,4,35,424
19051080100,4137,3923,87,6,10,4,0,7,214
19051080200,4973,4812,57,2,1,11,0,3,161
19053960100,2313,2219,11,14,0,2,0,4,94
19053960200,3325,2897,166,73,16,32,19,13,428
19053960300,2007,1894,34,10,1,5,2,9,113
19055950100,3637,3488,69,4,4,7,0,3,149
19055950200,3193,3110,20,0,3,9,0,7,83
19055950300,5207,4811,112,93,14,20,0,13,396
19055950400,5451,5297,43,25,3,3,0,7,154
19057000200,2840,2142,123,320,13,19,1,7,698
19057000300,3655,2691,156,541,4,48,1,11,964
19057000400,3728,2541,206,680,10,5,4,22,1187
19057000500,4437,3558,169,388,13,32,2,11,879
19057000600,3564,3120,111,138,7,25,0,14,444
19057000700,3018,2633,80,131,8,42,2,20,385
19057000800,3456,2820,162,167,3,139,0,5,636
19057000900,3337,3028,77,61,3,41,0,6,309
19057001000,4657,4383,69,43,1,11,0,6,274
19057001100,3582,3367,53,13,5,16,9,17,215
19057001200,2636,2470,39,19,0,20,2,9,166
19059450200,2300,2201,32,6,4,5,0,2,99
19059450501,2361,2182,64,24,2,15,0,0,179
19059450502,3171,3002,76,5,5,10,0,11,169
19059450800,3511,3219,149,28,1,9,1,5,292
19059451000,2446,2363,22,5,0,10,0,3,83
19059451100,3914,3742,63,8,2,31,0,4,172
19061000100,2661,1807,145,439,11,34,112,3,854
19061000300,2073,1766,64,116,7,13,27,7,307
19061000400,3966,3520,89,199,6,16,6,5,446
19061000500,3759,2537,164,645,9,26,139,8,1222
19061000600,3175,2341,215,376,6,47,26,10,834
19061000701,3436,2406,283,549,10,18,49,9,1030
19061000702,3194,2570,101,263,4,30,60,15,624
19061000801,4244,3922,124,41,4,12,5,20,322
19061000802,3492,3261,87,27,1,30,10,3,231
19061000900,3759,3120,211,217,1,53,7,32,639
19061001101,3598,3282,96,72,2,45,3,4,316
19061001103,2261,2067,55,45,2,34,10,0,194
19061001104,4648,4106,100,181,8,32,63,9,542
19061001201,3847,3516,83,87,13,61,0,5,331
19061001202,2226,1809,60,138,4,42,71,22,417
19061001204,2672,2385,48,74,0,88,1,7,287
19061001205,4133,3396,164,155,5,95,169,18,737
19061010101,2500,2331,87,6,11,15,0,2,169
19061010103,3550,3218,93,81,3,24,23,10,332
19061010104,5995,5493,135,71,4,106,19,5,502
19061010105,3701,3546,49,7,8,7,0,10,155
19061010201,6666,6301,66,68,6,63,0,8,365
19061010202,4490,4189,112,50,2,94,0,15,301
19061010300,3270,3126,70,13,1,6,4,9,144
19061010400,3887,3754,77,7,0,5,0,0,133
19061010500,4741,4358,162,104,3,13,9,14,383
19061010600,3322,3222,37,4,0,9,0,5,100
19063070100,1728,1660,29,1,2,2,0,3,68
19063070200,1566,1516,39,2,3,2,0,0,50
19063070300,3028,2415,443,52,14,14,3,6,613
19063070400,3066,2543,376,34,12,14,0,2,523
19065080100,2655,2433,93,42,6,17,0,4,222
19065080200,3280,3030,74,61,9,28,0,7,250
19065080300,2333,2244,31,2,3,2,0,6,89
19065080400,2811,2476,111,50,7,17,1,2,335
19065080500,3371,3033,147,36,9,7,0,4,338
19065080600,2360,2273,31,5,6,7,0,0,87
19065080700,2699,2564,33,4,0,0,0,8,135
19067480100,2753,2636,49,11,7,4,4,1,117
19067480200,2575,2365,91,25,4,8,1,7,210
19067480300,2403,2301,18,11,2,7,6,0,102
19067480400,2985,2489,145,157,3,95,1,4,496
19067480500,4911,4116,247,211,13,179,0,2,795
19069360100,3086,2905,59,10,2,14,0,14,181
19069360200,4565,3140,1260,22,11,32,0,11,1425
19069360300,2368,1989,315,0,5,3,0,1,379
19071970100,2015,1918,31,6,0,3,0,6,97
19071970200,2695,2468,108,1,9,3,3,12,227
19071970300,1895,1759,51,3,10,2,2,2,136
19073080100,1754,1647,44,0,9,6,0,3,107
19073080200,2422,2230,81,10,5,15,1,9,192
19073080300,2825,2643,92,5,0,19,0,0,182
19073080500,1770,1668,39,7,1,8,0,0,102
19075960100,4486,4274,57,15,3,8,0,2,212
19075960200,2775,2673,18,6,0,2,0,6,102
19075960300,3051,2917,38,17,5,11,0,3,134
19075960400,2017,1927,32,5,2,3,0,4,90
19077950100,4057,3850,107,10,4,1,0,25,207
19077950200,2125,1998,33,0,10,6,8,7,127
19077950300,4441,4112,134,17,7,30,8,19,329
19079960100,1762,1655,37,9,3,1,0,1,107
19079960200,3439,3139,163,12,7,11,0,4,300
19079960300,2975,2195,494,25,7,164,0,4,780
19079960400,5019,3999,702,35,5,138,0,17,1020
19079960500,1844,1714,69,7,3,0,0,1,130
19081270100,3788,3498,132,31,8,9,0,1,290
19081270200,2377,2193,114,9,4,5,0,2,184
19081270300,2649,2365,202,28,0,8,0,0,284
19081270400,1981,1757,166,8,10,3,0,0,224
19083480100,2483,2230,180,4,0,8,0,7,253
19083480200,2114,1895,137,14,4,11,0,5,219
19083480300,3819,3392,218,42,10,34,0,5,427
19083480400,2768,2577,100,8,3,6,2,3,191
19083480500,2814,2649,77,11,2,8,0,7,165
19083480600,2880,2549,106,65,6,19,0,5,331
19085290100,2459,2357,32,5,7,7,0,5,102
19085290200,3499,3328,67,7,2,10,0,10,171
19085290300,2871,2743,35,7,3,8,0,0,128
19085290400,3181,2957,101,4,12,15,0,8,224
19085290500,2572,2433,58,4,1,9,0,1,139
19087970100,3729,3414,135,16,12,28,0,14,315
19087970200,3024,2893,38,4,3,11,3,15,131
19087970300,4697,3764,405,124,7,177,1,5,933
19087970400,5328,4127,445,328,31,223,3,34,1201
19087970500,3704,3445,60,29,7,12,1,5,259
19089960100,4026,3728,114,23,15,21,1,4,298
19089960200,2816,2638,94,0,13,5,0,2,178
19089960300,2627,2524,50,0,5,1,6,8,103
19091970100,2063,1909,37,11,1,4,6,9,154
19091970200,1736,1632,59,1,5,0,0,10,104
19091970300,2829,2592,151,15,6,7,0,2,237
19091970400,2969,2690,183,26,4,10,0,1,279
19093090100,2614,2350,163,23,0,15,2,4,264
19093090200,2110,2033,36,0,0,0,5,12,77
19093090300,2281,2171,56,5,0,3,4,0,110
19095960100,3808,3584,77,17,2,9,0,18,224
19095960200,3904,3621,127,10,2,10,0,21,283
19095960300,3445,3170,116,42,12,16,0,3,275
19095960400,5505,5019,175,42,13,49,1,15,486
19097950100,2552,2454,14,3,0,2,0,16,98
19097950200,3540,3375,32,38,4,4,0,6,165
19097950300,3213,3109,41,9,10,0,0,5,104
19097950400,3808,3678,41,9,4,9,0,8,130
19097950500,4057,3700,59,37,10,25,137,7,357
19097950600,2315,2053,50,44,5,6,53,9,262
19099040100,3692,3417,73,5,7,27,1,31,275
19099040200,3989,3787,40,11,4,15,0,16,202
19099040300,2676,2393,84,87,5,11,1,4,283
19099040400,5392,4790,206,130,18,35,4,12,602
19099040500,5122,4502,201,146,30,37,8,10,620
19099040600,3059,2713,118,71,2,44,0,0,346
19099040700,5390,5016,138,20,1,35,12,21,374
19099040800,4186,3971,82,10,6,6,4,9,215
19099040900,2967,2836,43,9,6,5,0,1,131
19099980000,1340,1020,102,194,12,0,0,0,320
19101090100,2634,2502,27,2,7,4,0,14,132
19101090200,3093,2893,56,25,6,18,4,13,200
19101090301,2077,1777,114,30,13,45,0,9,300
19101090302,2972,2363,187,131,9,149,4,20,609
19101090400,4887,3890,226,221,8,284,1,28,997
19103000100,7035,5338,496,422,12,432,1,35,1697
19103000200,4426,2723,408,564,7,508,3,13,1703
19103000303,2818,2073,286,274,12,104,0,0,745
19103000304,2776,1363,234,849,9,179,0,9,1413
19103000305,4297,3262,212,240,0,412,0,14,1035
19103000306,3398,2622,144,187,2,300,0,17,776
19103000307,2946,1513,217,924,2,140,0,9,1433
19103000401,3519,1341,139,1385,3,497,0,12,2178
19103000402,4937,3548,154,145,6,847,0,16,1389
19103000501,4606,3163,256,551,9,398,1,22,1443
19103000502,3007,1995,116,444,3,315,4,10,1012
19103000600,3326,2214,168,299,1,457,4,21,1112
19103001100,3549,2734,257,148,4,190,0,28,815
19103001200,2015,1712,82,44,0,87,1,11,303
19103001300,3148,2706,124,103,3,75,0,13,442
19103001400,4927,3683,290,605,7,102,0,15,1244
19103001500,2492,2076,122,133,3,36,0,13,416
19103001601,4165,3031,300,146,4,449,1,27,1134
19103001602,3286,2608,229,160,6,131,1,16,678
19103001700,2985,2331,213,202,2,60,0,22,654
19103001801,5570,3106,845,1095,8,253,0,33,2464
19103001802,4498,2028,649,1362,7,288,0,14,2470
19103002100,4888,4062,313,96,0,294,0,7,826
19103002300,4420,3385,284,83,0,443,0,8,1035
19103010100,8022,7592,103,16,3,51,3,11,430
19103010200,4882,4562,72,30,8,44,0,10,320
19103010303,7145,6009,354,276,17,145,4,20,1136
19103010304,6503,5012,502,284,2,355,0,19,1491
19103010305,5666,4409,350,399,3,183,12,12,1257
19103010306,3045,2542,112,174,8,64,1,5,503
19103010307,3770,3106,166,275,8,46,0,22,664
19103010308,5013,4171,182,145,3,281,0,18,842
19103010401,3467,2203,819,272,5,67,1,14,1264
19103010402,3638,3483,45,18,1,3,0,4,155
19103010501,5677,4257,631,269,20,302,4,10,1420
19103010502,2992,2528,324,24,5,17,0,4,464
19105070100,4010,3863,67,11,2,4,0,6,147
19105070301,1879,1717,45,13,4,7,2,5,162
19105070302,2862,2267,175,317,24,6,0,9,595
19105070401,2603,2460,51,9,1,1,0,5,143
19105070402,2479,2329,17,28,1,20,0,10,150
19105070500,2377,2244,27,15,15,0,0,3,133
19105070600,4436,4122,115,44,6,20,0,25,314
19107080100,2253,2122,55,10,3,3,0,2,131
19107080200,2403,2275,44,11,0,8,0,4,128
19107080300,2612,2452,52,18,1,5,0,1,160
19107080400,2765,2627,64,8,0,0,0,0,138
19109950100,2236,2091,79,6,4,9,0,5,145
19109950200,2407,2298,46,9,1,8,2,4,109
19109950300,2081,1936,73,10,0,3,1,0,145
19109950400,2602,2296,185,30,1,24,0,1,306
19109950500,3421,3138,173,12,2,24,0,2,283
19109950600,2081,1999,47,4,1,3,0,3,82
19111490100,3990,3477,242,74,7,25,0,6,513
19111490200,4340,3484,292,301,18,30,0,14,856
19111490300,2239,2122,73,10,2,2,0,0,117
19111490400,2703,2597,24,6,0,1,0,5,106
19111490500,3352,3189,52,9,1,3,0,5,163
19111490600,3299,3156,44,8,5,6,2,3,143
19111490700,4298,3855,97,100,1,44,4,5,443
19111490800,2106,1868,37,74,7,10,0,6,238
19111490900,2091,1756,54,100,5,4,0,4,335
19111491000,1944,1661,44,93,0,6,0,5,283
19111491100,3193,2723,151,121,2,8,2,16,470
19113000101,6372,5727,191,76,5,155,2,15,645
19113000102,6663,5905,191,159,6,151,2,20,758
19113000103,2316,1949,92,98,5,30,3,9,367
19113000201,5398,4108,219,451,3,284,14,26,1290
19113000205,4984,4576,86,62,3,78,0,13,408
19113000208,4884,4250,153,100,7,183,2,6,634
19113000209,4971,4181,167,114,3,306,1,9,790
19113000210,3418,3150,67,27,0,52,1,11,268
19113000211,5672,4488,165,129,6,636,0,27,1184
19113000212,3206,2174,88,355,6,433,0,9,1032
19113000213,2661,1568,165,328,7,464,14,2,1093
19113000300,5714,4801,200,264,13,145,1,10,913
19113000400,5351,4720,154,145,11,45,0,13,631
19113000500,6501,5653,173,287,5,64,2,13,848
19113000600,3173,2785,91,107,2,46,1,14,388
19113000700,2262,1755,152,179,0,47,0,5,507
19113000800,4319,3162,270,431,12,170,42,23,1157
19113000901,5637,4559,371,285,6,118,5,19,1078
19113000902,6608,5915,138,108,7,194,6,10,693
19113001001,4724,3859,148,408,5,117,9,8,865
19113001002,3272,2605,185,285,9,42,25,4,667
19113001004,4148,2496,170,1154,12,53,45,3,1652
19113001005,2639,1354,227,794,3,42,76,26,1285
19113001101,4608,3927,146,275,2,41,7,17,681
19113001102,3502,2888,132,258,9,44,8,9,614
19113001200,1836,1403,89,167,7,12,0,13,433
19113001300,3720,2853,162,387,9,50,2,8,867
19113001400,3375,2722,138,256,5,29,21,8,653
19113001500,2799,2419,65,150,0,53,11,9,380
19113001600,5826,5133,199,165,8,44,5,22,693
19113001700,6155,4183,291,1039,37,45,8,20,1972
19113001800,3275,2408,165,434,7,39,11,8,867
19113001900,2700,1598,365,532,11,81,0,2,1102
19113002200,2735,1587,192,673,7,43,14,9,1148
19113002300,4301,3361,170,453,16,45,10,7,940
19113002400,4119,3147,187,388,5,76,49,13,972
19113002500,3058,2357,123,320,9,15,7,15,701
19113002600,2612,1906,111,354,8,19,7,6,706
19113002700,1850,1197,83,377,3,31,4,4,653
19113002800,4185,3458,132,309,5,35,1,5,727
19113002900,4930,3549,229,808,18,47,25,15,1381
19113003003,5216,4217,334,360,8,95,6,3,999
19113003004,4052,2854,129,754,7,70,45,24,1198
19113003005,6263,4530,517,640,11,219,18,27,1733
19113003006,5303,4374,274,383,8,60,2,6,929
19113010100,2850,2729,22,8,4,0,0,6,121
19113010200,4715,4454,50,14,4,14,2,13,261
19113010300,3686,3471,58,12,3,15,0,14,215
19113010400,2891,2682,61,7,10,15,3,0,209
19113010500,3810,3418,123,70,6,20,0,12,392
19113010600,6749,6232,150,70,0,91,1,13,517
19113010700,6787,6275,131,106,6,43,2,36,512
19113010801,1318,1227,36,6,0,5,0,8,91
19113010802,6180,5612,184,79,13,94,2,12,568
19115450100,2919,2466,302,15,3,55,0,1,453
19115450200,3858,2416,1141,38,3,203,0,9,1442
19115450300,4060,3603,285,20,5,7,0,4,457
19117950100,2033,1954,19,4,0,4,0,0,79
19117950200,2223,2149,22,0,0,2,0,2,74
19117950300,1970,1827,68,5,6,5,0,0,143
19117950400,2408,2224,89,9,0,18,0,4,184
19119950100,2637,2454,64,7,6,4,43,0,183
19119950200,3429,3224,102,13,8,8,0,0,205
19119950300,5868,5497,241,18,6,12,0,5,371
19121060101,3565,3325,64,26,3,15,3,22,240
19121060102,3549,3310,44,7,2,21,5,7,239
19121060200,5243,4879,149,5,3,33,1,10,364
19121060300,4191,3990,59,6,7,14,0,18,201
19123950100,3141,3005,36,10,3,1,0,11,136
19123950200,3353,3221,36,12,7,8,0,1,132
19123950300,3614,3448,32,4,3,35,6,3,166
19123950400,2960,2668,85,45,7,37,0,4,292
19123950500,3226,2888,59,78,12,53,0,6,338
19123950600,3323,2822,112,160,8,66,7,6,501
19123950700,2573,2207,120,75,1,50,2,3,366
19125030101,5025,4719,70,36,5,85,3,10,306
19125030102,2815,2635,67,17,3,5,0,1,180
19125030201,3811,3505,53,23,0,116,4,19,306
19125030202,3166,2826,95,29,2,98,5,22,340
19125030300,2930,2650,113,39,9,34,6,4,280
19125030401,4855,4491,118,56,15,16,0,8,364
19125030402,3758,3505,69,16,3,13,0,4,253
19125030500,2000,1797,34,42,20,15,1,8,203
19125030600,2527,2398,37,12,5,2,2,1,129
19125030700,2527,2392,44,11,2,17,0,9,135
19127950100,2750,2580,87,10,10,10,1,0,170
19127950200,2942,2745,119,3,2,7,1,0,197
19127950300,3384,3114,115,46,1,12,1,2,270
19127950400,3004,2713,155,17,8,14,0,6,291
19127950500,3945,1266,2104,148,25,315,2,6,2679
19127950600,4592,2311,1740,165,13,211,5,4,2281
19127950700,4309,2878,1047,104,22,133,0,14,1431
19127950801,3471,2492,667,46,9,175,4,3,979
19127950802,3586,2865,504,38,20,61,6,8,721
19127950900,3393,1503,1454,53,19,276,10,3,1890
19127951000,4729,2971,1148,155,24,300,3,13,1758
19129040100,2777,2620,47,7,4,6,2,11,157
19129040201,1828,1651,76,14,0,6,2,2,177
19129040202,3750,3444,108,20,7,24,1,14,306
19129040301,2792,2524,142,11,1,2,5,1,268
19129040302,3337,3091,88,25,9,10,0,3,246
19131560100,3137,3020,64,0,1,7,0,9,117
19131560200,3574,3450,45,14,0,15,1,6,124
19131560300,3854,3610,84,28,2,23,3,8,244
19133960100,2141,2034,35,8,5,0,0,5,107
19133960200,2016,1793,130,4,36,8,0,6,223
19133960300,2927,2612,55,11,103,14,2,6,315
19133960400,1667,1612,16,5,2,5,0,8,55
19135070100,3052,2885,52,0,0,9,1,26,167
19135070200,2696,2563,52,18,0,4,0,0,133
19135070300,1829,1744,13,0,12,3,1,5,85
19137960100,1953,1891,27,1,0,1,0,0,62
19137960200,2412,2255,67,2,8,10,1,1,157
19137960300,3262,2876,240,17,5,9,1,6,386
19137960400,2703,2581,37,5,5,1,0,0,122
19139050100,3586,3279,178,9,5,17,0,13,307
19139050200,5330,4857,233,28,6,21,0,4,473
19139050300,5382,2791,2375,26,4,87,0,10,2591
19139050400,3903,3323,412,37,0,20,0,12,580
19139050500,4683,3512,786,228,6,24,0,13,1171
19139050600,5458,4723,398,98,10,89,0,16,735
19139050700,5635,4051,1052,231,6,127,0,13,1584
19139050800,3063,2004,838,113,3,17,0,8,1059
19139050900,3085,1959,737,264,7,2,0,11,1126
19139051000,3110,2134,760,52,11,0,0,4,976
19141490100,2711,2438,160,30,5,10,0,10,273
19141490200,3859,3572,150,41,18,16,0,1,287
19141490300,5194,4296,626,73,15,53,11,7,898
19141490400,2418,2303,49,15,1,0,0,8,115
19143460100,3515,2875,471,21,12,16,36,4,640
19143460200,2677,2466,132,7,6,5,0,7,211
19145490100,2463,2357,21,10,10,10,0,1,106
19145490200,2266,2004,133,7,9,15,0,8,262
19145490300,2812,2598,93,10,5,24,0,1,214
19145490400,3189,2597,128,304,30,34,0,0,592
19145490500,2319,2082,63,27,3,26,0,2,237
19145490600,2162,2048,26,7,3,8,0,3,114
19147960100,1907,1783,75,6,4,5,1,0,124
19147960200,1727,1635,42,2,0,0,3,2,92
19147960300,3845,3538,122,34,11,22,2,11,307
19147960400,1517,1435,35,10,0,10,0,8,82
19149970100,6973,6027,480,194,11,44,49,20,946
19149970200,3824,2984,539,114,8,40,33,6,840
19149970300,3333,3102,131,4,3,0,1,13,231
19149970400,3052,2886,73,10,3,5,11,0,166
19149970500,3097,2922,84,17,5,9,2,3,175
19149970600,5419,5020,189,15,18,13,21,12,399
19151780100,1916,1653,122,26,4,17,0,12,263
19151780200,3059,2896,57,26,4,7,0,5,163
19151780300,2103,1834,175,14,2,5,23,7,269
19153000101,3569,2140,429,695,5,79,1,17,1429
19153000102,3971,2926,543,169,6,121,7,14,1045
19153000103,2087,1507,313,81,10,83,0,8,580
19153000201,2676,1784,398,210,2,177,0,10,892
19153000202,3743,2534,646,232,7,141,0,18,1209
19153000300,4440,2699,685,499,17,327,4,42,1741
19153000400,4754,2675,966,344,11,487,2,16,2079
19153000500,4641,2415,997,591,12,378,14,18,2226
19153000600,4023,2411,635,489,11,266,2,18,1612
19153000701,3537,1220,347,965,11,808,1,20,2317
19153000702,3397,2075,173,399,13,596,1,9,1322
19153000703,3134,2531,147,161,6,172,0,6,603
19153000704,3197,2111,225,297,11,412,0,6,1086
19153000801,6094,3865,500,785,19,632,3,30,2229
19153000802,3453,2978,140,115,7,78,2,6,475
19153000803,3998,2826,432,318,8,240,4,16,1172
19153000901,3417,2586,305,207,7,106,0,13,831
19153000902,3303,2814,146,110,5,75,0,17,489
19153001000,4688,3380,340,460,0,222,0,25,1308
19153001100,4744,2279,972,1011,10,246,10,10,2465
19153001200,3494,787,879,1307,12,379,5,4,2707
19153001500,2865,1602,530,310,4,260,4,13,1263
19153001700,2824,526,949,871,6,346,0,10,2298
19153001800,1985,1258,428,115,6,90,0,8,727
19153001900,4371,2978,758,269,14,137,3,8,1393
19153002100,4718,2757,1215,264,21,169,4,24,1961
19153002600,2208,873,395,691,4,124,0,7,1335
19153002700,3857,2134,236,1133,14,133,11,16,1723
19153002800,3210,2379,192,315,4,99,0,18,831
19153002900,4045,3205,227,241,4,137,3,26,840
19153003001,2105,1824,94,57,2,36,1,9,281
19153003002,3354,3025,97,39,2,59,1,7,329
19153003100,1826,1616,58,25,3,28,1,8,210
19153003200,2902,2548,69,85,48,48,3,8,354
19153003901,3784,1345,1394,520,15,340,1,3,2439
19153003902,5481,2364,1143,632,22,1079,2,16,3117
19153004001,3809,2080,520,854,12,134,0,11,1729
19153004004,3245,2693,185,131,8,97,1,17,552
19153004100,3135,2486,304,123,3,75,3,9,649
19153004200,3147,1924,668,261,5,87,1,13,1223
19153004300,4723,3241,749,277,15,200,4,9,1482
19153004400,4170,2063,1102,434,15,338,2,21,2107
19153004501,4092,2320,707,341,16,491,3,17,1772
19153004502,2577,1918,285,154,9,55,3,10,659
19153004602,6661,3618,1437,787,10,423,5,28,3043
19153004603,3667,2639,539,195,17,103,2,13,1028
19153004701,4272,2729,975,224,9,110,0,17,1543
19153004702,2990,1691,535,470,18,131,0,12,1299
19153004800,3055,879,1363,459,12,228,0,3,2176
19153004900,1687,502,471,469,10,173,0,2,1185
19153005000,3717,865,846,1314,18,511,6,19,2852
19153005101,7040,5194,375,781,11,357,2,43,1846
19153005102,1331,879,146,161,6,79,0,4,452
19153005200,3207,1275,1170,462,5,132,1,13,1932
19153005300,2633,1463,606,252,14,154,0,11,1170
19153010101,5925,5397,183,53,4,96,1,26,528
19153010102,11046,9884,443,149,21,184,2,15,1162
19153010205,7864,6827,330,191,9,159,7,79,1037
19153010207,4531,3971,149,120,14,91,0,17,560
19153010208,4379,3821,167,147,7,40,2,5,558
19153010209,6225,5278,324,184,15,170,0,19,947
19153010211,3871,3341,131,119,7,64,0,17,530
19153010212,4190,3573,270,85,9,62,1,26,617
19153010213,4744,4340,101,56,4,74,3,9,404
19153010214,9299,7836,481,250,17,309,7,47,1463
19153010215,7047,6376,197,92,6,127,3,15,671
19153010216,16172,14053,618,409,27,409,12,56,2119
19153010404,4682,3754,246,290,8,196,0,17,928
19153010406,3870,3093,249,192,12,192,1,7,777
19153010407,4418,3782,174,173,5,149,2,2,636
19153010408,3943,2889,343,275,10,273,1,9,1054
19153010409,4248,3353,187,182,0,338,5,19,895
19153010410,2535,2022,135,114,1,168,0,14,513
19153010411,4501,3295,374,309,5,325,3,12,1206
19153010500,6297,5143,546,328,25,88,2,10,1154
19153010601,2622,2259,182,33,10,18,4,11,363
19153010602,7142,5618,407,458,15,322,2,14,1524
19153010702,6600,5952,213,134,51,52,6,25,648
19153010703,5264,4335,317,246,15,100,14,18,929
19153010707,3892,3196,194,220,8,92,3,6,696
19153010708,5990,5198,289,208,6,78,3,5,792
19153010709,4423,3928,165,98,6,59,4,2,495
19153010803,5021,4048,343,228,14,137,7,17,973
19153010804,5390,4683,323,85,0,102,0,10,707
19153010805,7148,4200,1054,639,9,933,1,30,2948
19153010806,4389,2505,1076,334,18,244,0,10,1884
19153011001,3527,2421,530,273,3,106,6,12,1106
19153011021,4705,3963,226,149,5,166,3,17,742
19153011025,3791,3155,221,132,6,141,1,14,636
19153011026,5644,4803,205,131,7,287,4,17,841
19153011027,6809,5306,328,419,4,438,1,26,1503
19153011028,5322,4219,429,267,1,166,1,18,1103
19153011111,5205,3642,490,460,8,350,7,19,1563
19153011112,4217,3318,356,167,14,146,3,20,899
19153011113,2397,1607,181,240,4,241,0,18,790
19153011114,4048,2782,480,351,11,217,0,28,1266
19153011201,5332,4144,356,240,7,279,3,18,1188
19153011203,3628,3104,108,36,5,226,1,15,524
19153011205,3669,1614,836,473,9,597,6,20,2055
19153011206,3657,3115,178,97,2,107,0,12,542
19153011301,4278,3868,126,43,4,86,0,17,410
19153011302,3128,2760,113,61,3,65,0,4,368
19153011303,7426,6260,439,306,15,129,7,14,1166
19153011304,4972,4310,129,97,3,257,0,4,662
19153011305,3193,2143,220,511,4,212,0,14,1050
19153011405,2970,2544,76,32,3,211,0,4,426
19153011406,6751,5405,256,597,14,229,5,14,1346
19153011500,7785,7303,143,39,8,46,6,17,482
19153011600,0,0,0,0,0,0,0,0,0
19153011702,3906,3216,142,89,3,312,0,6,690
19153011703,6601,5496,211,174,4,537,4,12,1105
19153011704,2719,2376,79,44,4,123,3,8,343
19155021200,3791,3055,409,86,25,23,0,15,736
19155021400,3530,3359,55,7,6,12,0,3,171
19155021501,2391,2271,49,6,0,4,0,8,120
19155021502,2930,2713,85,12,11,18,0,8,217
19155021602,2808,2658,46,5,0,6,1,12,150
19155021603,2549,2404,61,2,12,17,0,8,145
19155021701,2275,2005,169,6,11,12,1,8,270
19155021702,2046,1939,47,7,5,4,0,1,107
19155030100,6067,5354,314,86,30,41,9,12,713
19155030200,3494,2761,301,193,17,32,15,7,733
19155030300,3341,2800,307,44,10,30,0,11,541
19155030401,4051,3049,465,209,34,37,15,21,1002
19155030402,2768,2218,320,62,2,62,1,10,550
19155030501,2271,1843,240,49,9,10,0,7,428
19155030502,2400,1770,451,41,15,12,4,4,630
19155030601,2054,1651,242,38,13,22,2,11,403
19155030602,2567,1821,478,54,13,50,1,7,746
19155030700,2686,1916,492,90,23,16,1,4,770
19155030800,3403,2594,564,38,12,58,4,10,809
19155030900,1417,1089,166,62,12,17,0,7,328
19155031000,2217,1861,156,29,25,35,0,17,356
19155031100,2586,2175,192,53,19,14,2,13,411
19155031200,3282,2854,241,28,16,30,3,9,428
19155031300,3058,2209,579,60,2,51,5,12,849
19155031400,3742,2870,491,96,29,30,0,18,872
19155031601,5282,4939,152,26,4,24,2,13,343
19155031602,2494,2303,92,7,4,20,0,0,191
19155031700,4973,4180,205,367,10,42,5,5,793
19155031800,3462,3116,157,50,8,18,2,8,346
19155031900,3732,3404,134,23,14,26,3,9,328
19157370100,3062,2899,72,11,11,6,0,3,163
19157370200,2863,2706,40,5,13,11,0,3,157
19157370300,5374,4613,226,218,17,129,18,21,761
19157370400,4270,3821,128,86,6,70,3,2,449
19157370500,3093,2965,63,0,6,5,0,0,128
19159950100,1961,1898,17,0,2,1,0,3,63
19159950200,2702,2549,54,2,5,7,0,0,153
19161080100,2525,2173,221,22,5,26,5,10,352
19161080200,2617,2529,32,6,4,2,1,2,88
19161080300,2188,2111,34,8,1,1,0,6,77
19161080400,2484,2348,67,10,1,2,0,5,136
19163010101,3695,3451,80,16,3,5,2,11,244
19163010103,4863,4200,148,76,3,274,0,18,663
19163010104,4022,3595,139,76,6,33,0,15,427
19163010201,6843,6245,254,68,11,49,3,22,598
19163010202,5866,5255,176,201,5,15,1,15,611
19163010300,2393,2208,59,9,0,2,2,14,185
19163010401,5324,4925,163,28,6,18,0,15,399
19163010402,3153,2913,104,16,2,12,0,3,240
19163010600,2679,1423,265,689,8,34,0,5,1256
19163010700,1320,570,194,436,8,13,2,7,750
19163010800,2871,1496,580,540,12,44,1,4,1375
19163010900,1912,1160,168,453,7,24,0,7,752
19163011000,2545,1692,381,282,18,13,0,7,853
19163011100,3215,2550,242,186,4,24,5,21,665
19163011200,2228,1297,374,366,3,43,0,7,931
19163011300,4025,2600,439,522,10,133,3,2,1425
19163011400,2642,1392,370,620,5,27,0,5,1250
19163011500,2252,1307,245,491,7,6,2,11,945
19163011600,3459,2617,296,291,6,44,0,12,842
19163011700,3290,2536,278,230,3,20,0,7,754
19163011800,2306,1876,196,89,4,26,0,0,430
19163011900,2638,2071,219,156,6,43,3,7,567
19163012000,3527,2705,326,230,13,71,0,4,822
19163012100,3482,2686,269,209,13,109,0,10,796
19163012200,2073,1525,236,122,6,7,1,3,548
19163012300,1546,1262,149,43,9,1,0,1,284
19163012400,1281,1097,60,28,4,3,0,10,184
19163012501,4089,2823,299,554,1,162,6,3,1266
19163012502,4079,3061,305,388,9,112,5,6,1018
19163012601,5484,3859,508,581,7,136,2,10,1625
19163012602,4202,2733,338,650,16,137,0,23,1469
19163012701,3083,2206,228,357,7,127,0,5,877
19163012702,3335,2725,182,198,4,70,0,17,610
19163012801,5062,3192,388,1010,3,155,3,17,1870
19163012802,4832,3210,359,822,18,96,0,11,1622
19163012901,5596,4148,306,660,1,247,0,29,1448
19163012902,5555,4634,262,277,4,126,2,23,921
19163013000,5242,4200,358,323,2,154,0,13,1042
19163013100,1857,1574,161,29,5,16,1,6,283
19163013200,1715,1454,100,67,5,12,2,6,261
19163013300,3676,2979,248,185,4,55,0,10,697
19163013400,2975,2437,216,132,7,37,1,4,538
19163013500,3481,2553,246,399,11,82,1,14,928
19163013600,2597,2146,192,49,10,56,0,7,451
19163013702,6507,5413,226,102,11,489,2,11,1094
19163013703,2857,2425,167,52,2,81,3,9,432
19163013705,5165,4084,295,193,8,385,1,21,1081
19163013706,7830,6068,298,200,7,996,3,35,1762
19165960100,2927,2768,85,8,6,4,0,0,159
19165960200,3083,2931,64,4,7,2,0,1,152
19165960300,3327,3040,109,31,6,41,3,6,287
19165960400,2409,2151,154,10,10,2,0,2,258
19167070100,3646,3403,171,8,5,11,0,0,243
19167070200,4704,4175,410,21,4,26,0,12,529
19167070300,6644,5490,1024,25,4,13,0,8,1154
19167070400,4129,3245,762,8,33,2,0,5,884
19167070500,2868,2547,224,29,5,7,5,0,321
19167070601,2547,2218,231,19,5,36,0,6,329
19167070602,3715,3195,389,21,17,42,0,2,520
19167070701,3850,3016,717,18,2,35,0,2,834
19167070702,3769,2630,986,35,12,47,0,7,1139
19169000101,2165,1934,96,13,4,29,1,13,231
19169000102,4044,3340,92,57,3,395,0,22,704
19169000103,1630,1451,72,22,3,11,0,2,179
19169000104,1408,1246,25,16,8,30,0,7,162
19169000105,3606,2409,143,92,3,797,0,12,1197
19169000200,3454,2869,166,84,5,184,0,15,585
19169000300,2953,2283,149,96,7,301,4,11,670
19169000400,2505,2099,99,95,5,101,0,4,406
19169000500,3741,2206,361,302,23,248,0,9,1535
19169000600,4653,3653,252,211,8,283,2,16,1000
19169000700,3104,2349,157,84,4,367,5,13,755
19169000800,5247,4245,375,190,22,7,0,0,1002
19169000900,3501,2912,164,114,10,127,2,22,589
19169001000,5281,3622,394,379,13,620,0,19,1659
19169001101,3353,2751,201,73,7,180,3,4,602
19169001102,4837,3774,450,156,13,164,2,5,1063
19169001200,273,169,34,24,1,3,0,6,104
19169001302,5352,4508,249,165,10,195,4,19,844
19169001303,5007,3678,247,211,2,628,5,9,1329
19169001304,5509,3872,368,397,10,626,0,20,1637
19169010101,3613,3370,82,23,10,12,0,13,243
19169010102,4622,4242,115,51,14,25,0,17,380
19169010200,3963,3678,114,3,4,9,0,20,285
19169010300,4601,4108,224,49,5,51,0,17,493
19169010400,2777,2354,221,38,7,19,0,13,423
19169010500,1852,1740,27,5,1,3,0,3,112
19169010600,5486,5082,155,30,24,29,1,24,404
19171290100,2820,2690,38,7,0,14,0,4,130
19171290200,2645,2494,48,15,11,6,1,6,151
19171290300,2446,2286,53,11,32,9,0,5,160
19171290400,2973,1905,418,44,453,19,1,2,1068
19171290500,3851,1916,1122,45,575,21,0,3,1935
19171290600,2400,1993,125,3,187,11,0,8,407
19173180100,2168,1757,363,0,1,4,1,4,411
19173180200,2062,1952,27,1,3,4,0,10,110
19173180300,1666,1595,9,0,9,7,0,7,71
19175190100,2217,2094,57,3,3,12,0,1,123
19175190200,3858,3478,163,47,15,26,0,5,380
19175190300,2093,2039,24,0,1,3,0,0,54
19175190400,3970,3612,155,64,6,24,7,4,358
19177950100,3926,3731,58,20,5,14,0,2,195
19177950200,3277,3147,56,6,1,10,0,1,130
19179960100,2879,2585,122,73,10,14,3,10,294
19179960200,2614,1615,508,280,1,19,61,10,999
19179960300,4420,3647,289,208,4,74,35,12,773
19179960400,3910,2690,678,226,5,98,72,11,1220
19179960500,2404,1382,457,317,1,79,75,16,1022
19179960600,3138,2246,558,101,16,87,42,7,892
19179960700,3229,3059,73,2,1,20,0,0,170
19179960800,3517,2921,386,63,9,48,0,16,596
19179960900,3225,2133,685,101,7,116,93,1,1092
19179961000,3341,2434,493,68,10,64,135,2,907
19179961100,2760,2583,83,4,2,3,2,3,177
19181020101,1854,1537,182,28,9,20,0,7,317
19181020201,4557,4197,127,37,13,33,0,16,360
19181020202,8296,7421,297,140,6,96,5,46,875
19181020300,3612,3263,129,13,10,40,0,11,349
19181020400,4646,4271,161,35,1,22,1,14,375
19181020500,2341,2154,58,11,5,15,0,10,187
19181020600,3736,3522,56,13,3,23,1,15,214
19181020701,1035,911,55,23,5,7,1,1,124
19181020702,3698,3376,113,29,7,31,4,0,322
19181020800,3496,3221,98,41,3,20,0,7,275
19181020900,3538,3235,87,42,2,29,2,3,303
19181021000,2785,2573,68,13,7,18,0,7,212
19181021100,4988,4647,141,19,3,18,0,17,341
19181021200,3821,3569,86,8,6,8,3,13,252
19183960101,3755,3447,161,40,1,12,0,12,308
19183960102,3230,3043,81,12,0,9,1,4,187
19183960200,4867,4565,122,13,11,4,0,23,302
19183960300,3473,2748,503,46,1,41,1,18,725
19183960400,4033,3273,548,46,6,39,1,11,760
19183960500,3207,2882,197,20,0,8,0,14,325
19185070100,2534,2451,16,6,4,4,1,5,83
19185070200,1582,1500,25,3,7,7,0,5,82
19185070300,2381,2277,20,1,6,13,0,1,104
19187000101,4108,3682,168,70,0,62,2,4,426
19187000102,3044,2478,241,155,6,28,0,13,566
19187000200,3617,3258,122,82,2,46,1,13,359
19187000300,1372,1155,113,41,1,6,4,0,217
19187000400,2237,1732,194,143,13,13,1,4,505
19187000500,1523,1219,108,123,4,4,2,2,304
19187000600,4342,3506,342,224,16,37,2,3,836
19187000700,1450,1018,141,157,12,23,0,2,432
19187000900,5293,3947,355,734,44,42,3,15,1346
19187010100,2353,2196,76,8,4,11,1,5,157
19187010200,1721,1615,45,5,4,10,0,2,106
19187010300,3081,2853,106,23,3,9,0,10,228
19187010400,2858,2713,52,8,3,4,0,6,145
19189680100,4119,3738,225,26,4,17,0,22,381
19189680200,2534,2344,110,20,0,9,0,5,190
19189680300,4026,3390,259,158,9,68,3,10,636
19191950100,3424,3236,90,1,4,4,0,9,188
19191950200,5220,4728,185,70,8,87,9,4,492
19191950300,3572,3278,99,35,1,67,0,14,294
19191950400,4542,4309,133,3,5,11,3,2,233
19191950500,3312,3154,78,10,1,9,0,4,158
19193000100,4760,3216,940,163,94,117,2,16,1544
19193000201,3445,2486,653,68,17,50,5,8,959
19193000202,3385,2610,352,174,40,140,2,7,775
19193000300,6653,4436,1030,597,62,207,32,34,2217
19193000400,4799,3821,457,146,37,141,12,27,978
19193000500,3196,2231,531,98,51,123,9,8,965
19193000600,2742,2149,359,55,31,30,2,8,593
19193000700,3311,2119,596,151,116,123,2,14,1192
19193000800,3912,1810,1237,274,114,228,58,2,2102
19193000900,2078,1486,384,48,33,46,0,6,592
19193001000,1833,814,456,244,94,118,31,6,1019
19193001100,4578,1876,1721,353,119,282,30,18,2702
19193001200,3545,581,2143,264,117,266,58,7,2964
19193001300,1799,432,528,538,109,90,22,9,1367
19193001400,4125,1625,1775,170,140,156,54,8,2500
19193001500,1968,634,713,170,176,111,78,4,1334
19193001801,4714,3451,663,167,58,57,38,40,1263
19193001802,2363,1470,490,171,37,39,40,50,893
19193001900,3310,2437,521,101,44,34,18,0,873
19193002000,5577,3970,772,317,69,76,103,23,1607
19193002101,3118,2645,242,35,13,46,0,10,473
19193002102,6591,5447,583,89,36,143,20,15,1144
19193003100,3660,3448,82,8,17,7,2,0,212
19193003200,4829,4494,147,25,8,11,0,3,335
19193003301,5046,4280,320,78,46,142,5,13,766
19193003302,3492,3229,100,24,17,48,0,4,263
19193003500,3860,3570,121,16,37,13,9,6,290
19193003600,3252,1470,830,532,161,113,19,12,1782
19193940200,0,0,0,0,0,0,0,0,0
19195690100,2530,2365,71,26,2,7,1,5,165
19195690200,2220,2047,83,21,0,11,0,3,173
19195690300,2693,2534,57,13,5,8,0,6,159
19197680100,3450,2822,501,26,4,13,0,14,628
19197680200,1454,1331,79,4,2,5,3,0,123
19197680300,3202,2344,754,6,2,34,2,0,858
19197680400,1158,960,167,6,3,8,2,1,198
19197680500,3679,2650,893,31,4,7,1,0,1029
20001952600,1791,1651,35,4,10,9,1,11,140
20001952700,2009,1833,45,7,26,9,1,6,176
20001952800,3813,3237,175,119,38,26,0,17,576
20001952900,2230,1914,103,18,35,20,0,2,316
20001953000,2683,2356,144,25,26,3,0,3,327
20003953600,4951,4537,125,13,33,43,0,15,414
20003953700,2885,2722,30,13,13,4,0,11,163
20005081600,4217,3942,50,37,23,3,0,10,275
20005081701,3786,3215,121,214,17,23,1,16,571
20005081702,2602,2073,203,176,17,28,4,10,529
20005081800,2705,2258,104,119,8,10,0,9,447
20005081900,3038,2437,105,239,13,16,1,4,601
20007968100,2724,2445,120,7,30,9,1,9,279
20007968200,1504,1369,42,0,4,7,4,2,135
20009971100,3716,3425,135,8,9,10,0,14,291
20009971200,1512,1406,53,1,2,1,0,7,106
20009971300,3087,2666,211,28,25,9,0,8,421
20009971400,2447,1684,564,65,3,7,0,4,763
20009971500,3343,2878,265,26,11,23,0,7,465
20009971600,3927,3114,563,54,12,13,1,5,813
20009971700,2665,1441,1084,51,9,7,0,5,1224
20009971801,4796,3297,1252,60,19,10,2,13,1499
20011955600,2647,2386,78,22,12,4,0,4,261
20011955700,2205,1997,42,7,18,9,0,4,208
20011955800,3533,2985,77,209,26,42,1,18,548
20011955900,3324,2888,89,138,23,11,1,7,436
20011956000,2651,2195,100,78,9,32,0,7,456
20013480600,2786,1994,78,8,558,1,2,10,792
20013480700,3585,3047,148,61,65,29,0,10,538
20013480800,3137,2642,126,28,172,12,4,5,495
20015020101,2272,2091,49,13,5,12,1,15,181
20015020102,3495,2565,269,450,19,11,0,21,930
20015020204,3314,2925,124,8,16,30,0,18,389
20015020205,4160,3364,246,273,40,23,12,12,796
20015020206,4460,3539,332,123,20,115,1,29,921
20015020207,3897,3108,262,86,31,130,4,15,789
20015020208,3292,2557,246,85,17,209,7,3,735
20015020209,1913,1680,98,4,9,38,0,6,233
20015020210,3263,2590,204,47,11,197,1,12,673
20015020300,3739,3245,192,23,30,35,0,9,494
20015020400,2225,1902,120,35,15,3,2,2,323
20015020500,5313,4497,273,98,49,26,0,11,816
20015020601,4438,3919,181,41,34,24,1,9,519
20015020602,3110,2767,130,18,23,4,0,13,343
20015020700,3999,3464,206,22,34,17,5,3,535
20015020800,2913,2411,220,16,31,19,0,13,502
20015020901,4143,3658,156,21,37,46,3,8,485
20015020902,3994,3481,162,28,34,30,0,21,513
20015020903,3440,3083,108,7,34,27,0,2,357
20017960600,2572,2228,222,18,8,8,1,9,344
20019964600,3379,2822,138,23,185,18,0,2,557
20021958100,2597,2312,62,1,29,5,2,0,285
20021958200,1901,1657,38,8,60,8,0,4,244
20021958300,3585,3065,114,14,111,7,0,7,520
20021958400,3606,2987,74,18,161,11,0,2,619
20021958500,3479,2941,103,23,115,8,6,16,538
20021958600,4194,3279,123,15,295,26,18,5,915
20023950200,2616,2223,238,6,7,12,0,4,393
20025967100,1991,1668,203,1,20,24,1,7,323
20027458100,3632,3363,88,13,12,16,0,5,269
20027458200,4485,4123,130,37,22,33,0,5,362
20029977100,2245,2122,20,25,9,2,3,0,123
20029977200,2215,1945,127,25,9,16,1,5,270
20029977300,3177,2839,159,72,18,17,0,4,338
20029977400,1395,1329,13,1,4,5,0,2,66
20031966100,2553,2382,42,10,9,14,0,8,171
20031966200,2854,2652,79,8,15,6,1,1,202
20031966300,2953,2636,100,27,12,24,0,10,317
20033967600,1689,1520,98,10,2,0,1,3,169
20035493100,2535,2297,40,0,46,5,0,2,238
20035493200,2921,2559,108,2,58,6,4,15,362
20035493300,2710,2339,111,26,38,60,0,7,371
20035493400,2419,1881,154,69,31,115,14,7,538
20035493500,5017,3799,428,292,78,121,31,9,1218
20035493600,4094,3191,327,98,52,131,34,11,903
20035493700,3450,2306,752,90,78,13,34,6,1144
20035493800,4454,2836,978,184,82,21,34,8,1618
20035493900,3216,2739,191,22,60,14,0,5,477
20035494000,2277,1435,478,65,66,8,8,0,842
20035494100,1456,845,404,17,37,5,20,3,611
20037956600,4115,3696,116,23,37,8,1,25,419
20037956700,3458,3176,76,8,26,8,2,0,282
20037956800,3304,2970,77,47,26,11,0,7,334
20037956900,4161,3701,150,36,31,45,30,4,460
20037957000,3459,2756,321,99,26,26,17,10,703
20037957100,2811,1936,444,102,18,21,41,12,875
20037957200,2189,1593,313,82,11,13,3,5,596
20037957300,3061,2552,143,62,29,52,7,11,509
20037957400,2129,1646,220,44,13,11,24,0,483
20037957500,2513,1676,433,121,34,34,21,3,837
20037957601,4406,3607,187,104,37,173,5,26,799
20037957602,3366,2628,236,171,32,59,40,17,738
20039951300,2764,2565,76,9,7,10,0,3,199
20041084100,3974,3560,168,27,12,23,5,9,414
20041084200,2390,2172,89,5,8,12,2,12,218
20041084300,2279,2030,127,12,8,6,0,4,249
20041084400,4805,4311,267,42,11,14,8,6,494
20041084500,2798,2505,129,8,19,7,2,19,293
20041084600,2156,1873,125,11,16,12,3,18,283
20043020100,2059,1717,58,144,44,10,0,7,342
20043020200,2121,1985,45,12,1,7,3,6,136
20043020300,3330,2912,101,110,21,15,16,15,418
20045000100,2775,2129,226,121,56,18,12,26,646
20045000201,2118,1419,220,113,79,72,6,10,699
20045000202,4971,3676,418,260,141,90,7,28,1295
20045000301,4470,3565,307,158,38,121,6,33,905
20045000302,1881,1429,142,62,27,111,0,2,452
20045000400,4884,3438,370,361,26,403,5,19,1446
20045000501,3130,2201,329,233,52,56,4,7,929
20045000502,5014,3844,327,205,80,253,2,15,1170
20045000602,6515,5142,366,199,44,412,1,13,1373
20045000603,10171,7707,666,524,115,508,1,57,2464
20045000604,5331,4192,283,255,60,145,1,24,1139
20045000701,4061,3284,191,140,37,191,4,9,777
20045000703,2973,2213,226,167,64,108,0,16,760
20045000704,3435,2353,274,129,33,405,5,28,1082
20045000797,4944,3872,294,172,99,224,3,7,1072
20045000801,5900,4150,509,309,140,346,5,34,1750
20045000802,5859,4039,554,405,129,308,0,16,1820
20045000902,2400,1650,249,180,60,109,2,10,750
20045000903,1790,1299,115,54,54,118,0,9,491
20045000904,3921,2208,627,348,211,240,0,23,1713
20045001001,2654,1671,134,58,617,32,0,9,983
20045001002,5885,4110,502,395,170,236,3,27,1775
20045001201,1787,1599,42,7,25,15,0,6,188
20045001202,7613,6571,413,56,87,39,8,17,1042
20045001203,7161,6264,262,94,62,42,9,42,897
20045001400,4759,4234,154,50,37,32,0,27,525
20045001500,2383,2022,95,49,36,23,0,9,361
20047969600,1392,1004,333,3,9,0,1,2,388
20047969700,1515,1153,290,11,6,1,0,0,362
20049965100,2483,2214,101,1,43,3,0,0,269
20051072600,2609,2471,64,7,6,0,0,9,138
20051072701,5253,4715,233,47,5,48,0,11,538
20051072702,3156,2627,383,23,4,17,0,0,529
20051072801,4805,4345,214,46,11,49,0,1,460
20051072802,3369,2913,207,45,5,82,0,0,456
20051072901,2769,2329,251,42,9,11,0,3,440
20051072902,3694,2690,564,106,12,39,0,58,1004
20051073000,3279,3019,100,2,13,19,0,0,260
20053086600,1978,1788,103,5,2,8,0,1,190
20053086700,4398,3667,262,249,37,15,0,7,731
20055960100,4496,2876,1354,31,43,10,0,11,1620
20055960200,6839,1871,4112,349,16,307,0,58,4968
20055960300,2952,1518,1187,64,13,71,0,3,1434
20055960401,1985,1195,619,13,11,75,0,12,790
20055960403,2619,1247,1090,53,11,152,0,12,1372
20055960404,4197,1920,1471,480,15,195,0,5,2277
20055960501,2501,655,1739,10,10,38,0,8,1846
20055960503,1148,717,377,13,8,6,0,0,431
20055960505,1594,388,1007,60,0,95,0,2,1206
20055960507,1784,495,969,154,5,108,3,22,1289
20055960508,3202,413,2351,12,2,384,0,9,2789
20055960600,5153,1219,3607,123,30,71,0,13,3934
20057961600,1973,1710,182,14,12,3,0,1,263
20057961700,1872,1621,143,6,11,6,0,14,251
20057961801,4478,1885,2354,82,8,56,0,8,2593
20057961802,4806,2094,2264,256,16,41,0,16,2712
20057961901,4529,980,3208,166,18,58,0,18,3549
20057961902,3877,1857,1705,143,10,54,2,11,2020
20057962000,4938,1154,3538,86,8,57,0,8,3784
20057962101,4564,609,3675,112,8,85,2,10,3955
20057962102,3250,545,2597,20,10,34,2,4,2705
20059954101,3847,3451,105,21,22,5,1,14,396
20059954102,3095,2817,87,10,18,9,0,14,278
20059954200,2892,2482,161,47,22,12,4,6,410
20059954300,5441,4687,295,74,43,22,0,19,754
20059954400,4774,3967,327,131,39,20,2,18,807
20059954500,5947,5414,172,20,46,35,0,7,533
20061000100,2103,850,450,512,13,62,17,22,1253
20061000200,2682,1104,475,646,12,91,39,16,1578
20061000300,4952,2443,762,1001,36,152,74,29,2509
20061000401,4200,2292,621,694,26,205,34,22,1908
20061000402,1651,953,193,255,11,54,35,7,698
20061000500,2669,1466,428,436,21,69,28,17,1203
20061000601,5659,3018,1110,862,16,145,98,19,2641
20061000602,2908,1635,590,351,11,117,19,23,1273
20061000700,2753,1841,294,298,17,50,44,4,912
20061000801,2405,1263,377,420,9,90,10,4,1142
20061000802,4757,3092,476,587,35,148,54,26,1665
20063955300,2718,2486,83,3,3,15,1,16,232
20065952300,2415,2179,62,55,8,14,0,14,236
20067963600,1377,889,441,2,12,0,1,0,488
20067963700,5975,2322,3421,8,43,8,2,10,3653
20069962600,2769,2105,540,18,5,13,0,2,664
20069962700,2884,2524,299,1,0,1,0,6,360
20071958100,1284,1036,199,0,4,5,0,10,248
20073965600,1975,1802,56,10,13,13,0,5,173
20073965700,2455,2158,109,13,11,23,0,6,297
20073965800,1586,1446,39,5,8,0,1,4,140
20075958600,2518,1361,1084,10,12,5,0,2,1157
20077961600,1970,1582,278,3,18,3,0,1,388
20077961700,1296,1172,37,0,20,3,2,3,124
20077961800,2219,1960,110,13,36,9,0,0,259
20079030100,4511,3392,702,164,25,32,1,10,1119
20079030200,5277,4116,717,112,40,31,0,12,1161
20079030300,5726,4009,1150,129,36,67,3,19,1717
20079030400,5003,3695,884,89,36,52,0,11,1308
20079030500,6130,5563,230,68,24,64,0,8,567
20079030601,3520,3145,194,10,15,9,4,15,375
20079030602,3857,3429,178,24,7,5,2,7,428
20081463100,3780,2578,1119,9,8,1,0,7,1202
20083461100,1723,1546,96,14,7,10,1,2,177
20085082600,5152,4483,162,22,173,10,7,20,669
20085082700,4052,3356,315,63,98,19,4,4,696
20085082800,4028,2695,153,10,827,0,7,13,1333
20087020101,6017,5364,204,34,67,12,23,9,653
20087020102,2981,2716,81,21,12,11,1,3,265
20087020200,3751,3401,110,26,22,2,0,2,350
20087020300,5619,5068,172,18,23,16,3,15,551
20089576300,2932,2743,62,4,10,10,0,8,189
20091050000,5065,4247,412,45,6,126,1,12,818
20091050100,4389,3244,579,216,15,92,11,39,1145
20091050200,3759,2968,414,116,10,47,0,12,791
20091050301,4127,2714,542,299,13,304,4,11,1413
20091050302,1799,1435,168,51,1,39,4,10,364
20091050400,4896,3235,913,361,4,86,5,29,1661
20091050500,2507,1930,288,120,3,42,2,4,577
20091050600,4565,3819,343,58,13,80,4,22,746
20091050700,4821,4263,223,34,4,79,1,20,558
20091050800,2699,2430,72,6,4,77,1,6,269
20091050900,4728,4178,210,39,4,92,0,5,550
20091051000,3763,3351,166,27,11,39,0,10,412
20091051100,3525,2708,459,130,17,60,0,16,817
20091051200,4190,3090,561,192,7,126,0,10,1100
20091051300,4526,3631,392,157,11,86,5,14,895
20091051400,3238,2904,145,25,7,39,0,17,334
20091051500,4115,3529,243,61,9,91,0,17,586
20091051600,5640,5099,148,18,9,78,2,12,541
20091051700,4754,4300,140,47,0,71,0,12,454
20091051801,4159,3696,162,37,2,91,0,18,463
20091051803,4331,3141,634,174,15,141,0,20,1190
20091051804,5173,3943,589,229,24,156,9,45,1230
20091051805,5577,4714,293,158,12,145,0,11,863
20091051806,5390,4509,264,142,11,230,2,8,881
20091051807,3867,3266,222,79,8,113,0,7,601
20091051808,2642,1596,338,387,11,154,3,17,1046
20091051902,4326,3166,441,229,18,142,1,33,1160
20091051904,6318,4913,572,283,6,232,2,23,1405
20091051907,3825,1945,892,623,8,79,0,25,1880
20091051908,1715,1183,171,219,3,43,0,8,532
20091051909,5547,4216,502,286,16,194,3,48,1331
20091051910,2169,1275,459,239,2,87,1,12,894
20091051911,3408,1902,908,349,22,57,0,23,1506
20091051912,2471,1693,402,172,2,41,4,12,778
20091052001,2257,1726,229,117,8,59,1,6,531
20091052004,1701,1241,145,164,6,48,2,4,460
20091052005,2884,1958,495,145,7,72,4,12,926
20091052006,3614,2279,668,364,13,76,1,15,1335
20091052101,1751,1290,201,110,5,25,3,16,461
20091052102,2669,1944,319,119,14,64,2,5,725
20091052201,3598,2350,598,288,14,132,0,9,1248
20091052202,3433,2769,348,68,9,35,0,19,664
20091052304,4943,3713,547,209,24,160,7,19,1230
20091052305,4856,4006,372,106,29,85,2,4,850
20091052306,3571,3044,132,70,9,132,0,11,527
20091052307,3860,2821,301,360,21,130,3,9,1039
20091052308,3521,2201,288,561,9,200,0,28,1320
20091052410,5222,4108,306,302,18,205,4,38,1114
20091052411,3087,2504,169,71,15,183,0,2,583
20091052414,4018,3430,176,99,13,107,4,19,588
20091052415,3542,2623,245,266,11,190,0,23,919
20091052416,4492,3688,358,143,2,104,3,12,804
20091052417,3389,2005,493,551,18,118,10,10,1384
20091052418,3483,1476,1014,653,12,133,2,9,2007
20091052419,4785,3241,580,474,8,201,3,14,1544
20091052421,4788,3894,339,185,11,143,0,23,894
20091052422,4758,3647,443,267,16,177,1,17,1111
20091052423,2856,1322,728,482,14,157,4,1,1534
20091052502,1641,1408,104,35,1,27,0,7,233
20091052505,3073,2325,188,134,10,202,2,19,748
20091052506,1489,1247,62,70,3,55,0,0,242
20091052507,3186,2279,248,321,7,160,3,4,907
20091052604,2254,1941,110,29,7,54,0,9,313
20091052606,1992,1632,134,74,8,51,1,1,360
20091052607,2651,2237,129,75,10,70,0,16,414
20091052608,6418,5428,260,136,5,342,0,11,990
20091052609,5982,4951,350,131,10,277,3,19,1031
20091052610,6246,4932,399,348,8,180,3,9,1314
20091052611,2443,2042,125,93,13,61,1,3,401
20091052612,3115,2589,149,100,16,73,0,14,526
20091052613,7250,5933,388,234,15,291,2,4,1317
20091052701,5383,4156,845,37,34,33,0,15,1227
20091052702,2239,1806,285,22,8,8,0,11,433
20091052803,4137,2126,896,663,14,167,5,26,2011
20091052804,4831,4237,175,58,9,141,0,11,594
20091052805,8151,6409,658,392,23,259,3,26,1742
20091052806,6063,4742,380,323,20,285,1,30,1321
20091052807,4830,3902,220,114,6,311,4,8,928
20091052904,3474,2542,330,234,17,159,2,10,932
20091052905,4589,1916,1741,495,19,155,1,16,2673
20091052906,4954,3107,966,423,12,97,3,11,1847
20091052907,4545,2684,752,531,19,234,6,23,1861
20091052908,5692,3656,862,543,27,223,30,36,2036
20091052910,4318,3475,263,158,15,221,2,14,843
20091053004,3656,2882,232,167,7,194,4,7,774
20091053005,1794,1275,165,169,5,63,4,14,519
20091053006,3744,2973,251,177,4,129,5,23,771
20091053007,4908,3658,368,311,12,287,1,27,1250
20091053008,4863,3560,353,300,7,364,1,17,1303
20091053009,5206,4183,191,117,13,455,3,8,1023
20091053010,6081,4857,284,148,12,517,3,19,1224
20091053011,2233,1703,92,98,4,231,5,2,530
20091053012,3242,2418,217,198,18,225,0,11,824
20091053013,2339,1570,203,133,5,248,0,20,769
20091053101,4163,3172,239,146,13,339,10,7,991
20091053102,4647,3250,258,195,6,714,1,37,1397
20091053105,3306,2027,291,270,7,535,1,10,1279
20091053108,4204,3151,259,133,10,411,9,22,1053
20091053109,2950,1597,169,140,0,923,0,9,1353
20091053110,3845,2845,205,93,6,532,0,18,1000
20091053201,2468,1967,96,91,10,179,0,17,501
20091053202,3942,3255,152,130,3,270,1,9,687
20091053203,5649,4396,218,165,5,654,0,31,1253
20091053301,5193,4467,185,58,3,286,1,23,726
20091053302,7138,6319,187,74,13,249,2,13,819
20091053403,3998,2860,286,188,4,428,2,34,1138
20091053409,3810,3007,191,148,2,270,0,8,803
20091053411,5452,4302,310,186,10,359,0,11,1150
20091053413,4082,2818,216,147,6,717,1,8,1264
20091053414,4907,2543,211,223,10,1744,0,29,2364
20091053415,4267,2892,231,249,8,672,4,12,1375
20091053417,3978,2677,191,165,4,768,1,18,1301
20091053418,4832,3141,285,167,18,992,0,9,1691
20091053419,1656,1313,84,44,1,134,0,6,343
20091053421,4173,2963,208,188,1,605,0,14,1210
20091053422,2247,1708,118,82,9,220,1,9,539
20091053423,5436,3906,190,110,7,959,0,25,1530
20091053425,3207,2474,154,125,4,315,0,3,733
20091053426,5435,4090,311,221,19,461,0,8,1345
20091053427,6759,5486,200,87,11,662,0,23,1273
20091053428,4293,3104,147,83,5,747,2,14,1189
20091053429,4712,3596,169,92,3,612,0,17,1116
20091053430,4896,3886,182,68,4,551,4,21,1010
20091053431,2638,2125,93,61,6,215,0,7,513
20091053502,3667,1938,1034,323,16,78,9,35,1729
20091053506,3790,2889,328,196,4,148,2,18,901
20091053507,5530,4402,460,231,18,137,2,8,1128
20091053508,6072,4541,590,336,19,173,1,30,1531
20091053509,6878,5122,579,406,20,325,1,25,1756
20091053510,5506,4197,372,287,6,325,6,37,1309
20091053555,2112,1230,487,230,9,27,8,14,882
20091053556,2597,1358,939,109,9,29,0,10,1239
20091053557,2313,1233,793,119,7,27,0,20,1080
20091053558,3425,2539,265,203,6,189,2,12,886
20091053559,3605,2762,254,147,10,215,0,21,843
20091053560,4444,3867,177,75,9,158,2,8,577
20091053601,2098,1070,826,56,2,19,2,27,1028
20091053603,2977,2321,338,84,9,93,3,7,656
20091053604,5454,3295,1264,348,26,155,7,37,2159
20091053701,2706,2342,151,25,16,5,3,8,364
20091053703,3376,2642,288,159,12,48,7,24,734
20091053705,3315,2266,511,132,15,106,9,19,1049
20091053707,5214,3813,675,237,23,87,5,22,1401
20091053709,6376,5077,554,189,19,93,7,25,1299
20091053711,5066,4119,284,291,30,92,1,9,947
20091053712,4722,3786,323,163,16,64,4,22,936
20091053801,7613,6542,410,133,33,78,0,43,1071
20091053803,4079,3664,152,30,7,44,3,5,415
20091053804,4504,3744,157,80,9,273,3,21,760
20091980001,18,9,3,0,0,1,0,0,9
20091980003,1,0,0,0,0,0,0,0,1
20091980004,7,0,3,1,0,0,0,0,7
20091980005,1,0,0,0,0,0,0,0,1
20091980100,0,0,0,0,0,0,0,0,0
20093959100,3983,2378,1396,34,10,5,1,2,1605
20095961100,2344,2156,58,7,11,2,2,4,188
20095961200,3419,3061,175,16,12,28,1,3,358
20095961300,1707,1612,35,5,4,3,1,9,95
20097969100,2460,2158,87,43,10,16,4,6,302
20099950100,2861,2169,207,146,40,17,0,1,692
20099950200,2002,1360,152,232,42,19,0,3,642
20099950300,2776,2142,181,141,41,22,0,18,634
20099950400,3214,2372,186,256,34,14,2,4,842
20099950500,3964,3461,99,22,76,4,2,8,503
20099950600,2229,1876,35,5,95,1,0,4,353
20099950700,1973,1687,71,23,54,3,3,4,286
20099950800,1165,1010,8,13,43,10,2,1,155
20101956600,1574,1375,143,0,8,0,2,0,199
20103070100,2074,1346,148,324,14,32,0,20,728
20103070200,2785,1856,264,332,25,32,15,9,929
20103070300,5828,4329,352,604,25,47,7,16,1499
20103070400,3381,2425,263,337,22,43,15,16,956
20103070500,5757,3485,523,1182,37,63,13,19,2272
20103070700,4887,3565,361,463,18,105,18,17,1322
20103070900,2834,2613,68,13,23,7,1,5,221
20103071000,4168,3486,197,147,22,48,1,20,682
20103071102,4797,3405,311,757,43,32,5,8,1392
20103071103,2952,2215,208,238,6,88,1,3,737
20103071104,2616,2015,166,146,2,76,2,14,601
20103071105,4855,3624,371,385,26,87,14,28,1231
20103071202,4418,3910,204,50,18,29,0,3,508
20103071204,4701,4067,258,83,16,34,0,12,634
20103071205,3844,3307,180,87,20,63,2,9,537
20103071400,4030,3547,205,40,16,19,0,2,483
20103071600,2948,2662,74,14,18,8,0,5,286
20103071800,6570,5589,386,95,44,39,3,9,981
20103981900,8436,5057,1063,1359,194,208,41,38,3379
20105086100,2939,2691,130,6,13,8,0,12,248
20107955101,2780,2566,56,20,11,14,4,6,214
20107955102,2595,2351,84,21,21,3,2,6,244
20107955200,4216,3865,98,21,14,3,2,4,351
20109954600,2762,2457,195,4,0,10,2,10,305
20111000101,3429,2076,852,151,21,80,0,102,1353
20111000102,284,195,9,17,1,0,1,59,89
20111000103,1431,920,367,35,4,23,0,2,511
20111000201,3530,2698,560,68,9,66,0,0,832
20111000202,2425,1859,305,42,10,109,0,4,566
20111000203,934,726,153,7,3,23,0,5,208
20111000300,4982,2473,2112,87,27,91,0,8,2509
20111000400,2888,2012,523,90,8,96,2,8,876
20111000500,4299,2056,1941,85,8,51,2,12,2243
20111000600,2227,1996,128,3,12,12,0,20,231
20111000700,2341,2104,140,4,5,5,0,4,237
20111000800,3409,3104,166,10,14,10,0,1,305
20113788100,2848,2677,66,18,5,4,0,0,171
20113788200,3978,3455,227,96,12,16,1,11,523
20113788300,2775,2613,61,3,4,0,2,1,162
20113788400,6440,5623,296,77,20,110,0,15,817
20113788500,1707,1398,149,34,14,5,0,1,309
20113788600,6400,5107,622,213,29,66,3,76,1293
20113788700,6075,5646,171,34,9,12,2,36,429
20115489500,1514,1405,57,4,5,1,0,4,109
20115489600,3808,3339,176,93,15,28,1,39,469
20115489700,2799,2622,86,2,8,4,3,2,177
20115489800,3702,3384,123,19,7,6,3,22,318
20117040701,1839,1788,16,4,3,3,0,7,51
20117060510,3755,3408,141,25,8,27,0,0,347
20117070182,2218,2115,37,3,4,0,0,5,103
20117090186,2226,2099,33,7,8,11,0,1,127
20119966600,2461,1722,654,17,4,0,0,4,739
20119966700,1594,1331,143,20,5,13,0,2,263
20121100100,3621,3301,87,20,21,29,0,12,320
20121100200,5293,4716,222,67,14,26,1,11,577
20121100300,3168,2840,128,19,5,19,1,14,328
20121100400,4483,4036,138,20,13,27,0,12,447
20121100500,4197,3830,142,21,16,10,0,7,367
20121100601,6273,5466,222,133,28,24,5,25,807
20121100602,1805,1653,33,7,11,9,0,0,152
20121100700,5351,4630,224,143,44,17,1,5,721
20123176600,4035,3758,140,15,12,8,0,0,277
20123176700,1761,1678,17,4,0,5,0,2,83
20125950100,1944,1698,40,8,51,3,4,6,246
20125950200,2507,2151,125,17,34,5,0,1,356
20125950300,4083,3249,281,135,63,55,1,4,834
20125950400,2150,1602,179,138,45,17,0,10,548
20125950500,1466,1001,174,113,26,8,0,5,465
20125950600,2810,2242,187,123,42,6,7,10,568
20125950700,3699,3017,111,11,167,7,0,0,682
20125950800,4441,3390,253,203,166,38,3,7,1051
20125951000,1898,1007,315,324,76,10,4,11,891
20125951100,2323,1503,247,199,90,12,0,3,820
20125951300,2099,1639,95,5,102,7,5,10,460
20125951400,2066,1072,407,257,84,23,0,5,994
20127963600,2921,2700,67,11,5,13,0,7,221
20127963700,2465,2197,160,5,5,5,1,5,268
20129964600,2701,1940,591,17,10,31,9,12,761
20131480100,3474,3195,80,40,13,32,2,8,279
20131480200,4250,4020,133,22,6,0,1,2,230
20131480300,2549,2407,53,2,7,3,4,0,142
20133951600,3709,3350,119,12,13,16,0,16,359
20133951700,2366,2010,180,28,18,14,4,0,356
20133951800,3991,3339,284,67,30,36,2,5,652
20133951900,3073,2548,263,19,27,15,0,0,525
20133952000,2765,2520,64,5,39,3,0,4,245
20135956300,2687,2305,305,2,9,2,0,6,382
20137951700,5459,4690,311,199,33,35,2,9,769
20139010100,4219,3831,144,10,15,26,0,6,388
20139010200,2837,2606,89,2,6,3,0,2,231
20139010300,2006,1891,34,2,5,5,0,6,115
20139010400,2970,2699,111,14,11,11,0,8,271
20139010500,3734,3478,79,5,6,7,3,2,256
20141474100,3500,3285,66,1,19,18,0,3,215
20143085600,2008,1878,39,3,6,1,0,1,130
20143085700,3727,3390,105,27,16,9,0,14,337
20145970200,4805,3855,441,246,17,25,0,23,950
20145970300,1448,1299,81,0,7,3,0,4,149
20147475100,1045,972,24,2,8,0,0,0,73
20147475200,1362,1270,47,2,6,3,0,0,92
20147475300,2574,2378,71,15,8,12,1,0,196
20149000101,2497,2283,73,17,6,9,2,5,214
20149000102,7973,6703,491,179,25,105,12,20,1270
20149000200,5991,5357,255,45,27,35,5,10,634
20149000300,4745,3891,505,16,30,33,7,7,854
20149000400,4142,3831,105,14,21,12,1,28,311
20151968600,1917,1771,92,1,3,1,0,5,146
20151968700,3565,2928,360,77,23,20,1,22,637
20151968800,3675,3173,289,28,14,24,6,9,502
20153950600,2561,2242,159,18,3,11,0,12,319
20155000100,3362,2803,242,73,9,35,3,10,559
20155000200,4034,3147,393,248,12,56,3,17,887
20155000300,6918,5837,564,97,46,62,5,12,1081
20155000400,3421,2732,373,72,33,13,3,10,689
20155000500,5358,4112,753,112,38,15,0,26,1246
20155000600,2613,1763,560,136,9,9,1,9,850
20155000700,5143,3461,993,235,59,24,6,10,1682
20155000800,3114,1825,730,382,30,13,1,7,1289
20155001000,2076,1594,274,50,15,24,0,7,482
20155001100,5368,4608,317,179,38,23,1,7,760
20155001200,3377,2998,172,42,19,14,6,9,379
20155001300,2753,2375,185,54,18,12,1,9,378
20155001400,4893,4538,133,32,15,16,5,14,355
20155001500,3291,2968,147,16,22,8,1,7,323
20155001600,1769,1584,91,2,6,0,5,0,185
20155001700,2258,2001,110,7,17,1,0,19,257
20155001800,2150,1970,59,7,11,8,0,0,180
20157978100,1072,1044,6,0,3,0,0,0,28
20157978200,1429,1343,29,10,0,1,4,0,86
20157978300,2173,2015,56,5,10,10,5,0,158
20159967100,2170,1934,120,4,10,1,0,0,236
20159967200,3787,2589,966,34,12,8,0,14,1198
20159967300,3470,2997,204,92,19,21,0,0,473
20161000201,3188,2283,388,211,16,53,9,17,905
20161000202,6814,4706,845,486,25,203,72,32,2108
20161000303,2951,2208,179,105,8,318,1,73,743
20161000304,4435,3415,321,154,13,288,5,20,1020
20161000500,4277,3300,386,162,21,170,3,15,977
20161000601,3773,2948,249,144,16,218,1,7,825
20161000602,6439,4672,493,407,18,404,8,33,1767
20161000700,3811,2776,544,132,16,92,10,22,1035
20161000801,3786,2800,397,172,16,130,32,13,986
20161000802,2084,1428,204,209,8,45,2,21,656
20161000900,5130,3868,493,280,24,115,8,7,1262
20161001002,8279,4125,1861,1464,72,390,61,23,4154
20161001101,4271,2928,398,343,18,435,0,91,1343
20161001102,3733,2844,276,257,2,147,1,2,889
20161001301,4037,3057,257,205,13,302,9,12,980
20161001302,4950,4449,178,28,19,15,2,25,501
20161980000,1,0,1,0,0,0,0,0,1
20163974600,2282,2089,60,17,2,0,5,2,193
20163974700,2637,2469,56,11,0,5,4,5,168
20165972300,2956,2745,132,6,3,14,0,0,211
20167973800,4550,4046,187,52,27,20,0,5,504
20167973900,2141,1993,49,8,2,8,0,8,148
20169000101,2826,2111,325,130,36,24,0,7,715
20169000102,2252,1749,207,126,10,16,1,3,503
20169000200,2076,1412,308,162,13,40,0,5,664
20169000300,5230,3647,763,328,42,51,2,17,1583
20169000400,2941,2257,408,66,13,25,3,7,684
20169000500,5687,3052,1799,173,20,254,4,13,2635
20169000600,2876,1938,488,127,15,122,4,15,938
20169000700,6170,4793,644,163,30,242,1,24,1377
20169000800,4460,3676,376,83,8,108,3,8,784
20169000900,6718,5220,703,226,15,102,6,22,1498
20169001000,5727,5010,317,104,12,81,1,13,717
20169001100,3819,3423,194,13,17,28,0,19,396
20169001200,3521,3218,110,31,2,16,1,9,303
20171957100,5151,3895,1027,13,20,15,2,3,1256
20173000100,3231,356,2659,120,14,30,0,6,2875
20173000200,3032,1427,1309,87,22,19,7,11,1605
20173000300,4728,1213,2930,245,42,70,2,15,3515
20173000400,2847,674,1413,518,24,64,3,14,2173
20173000600,1970,154,415,1237,13,27,3,13,1816
20173000700,3414,341,863,1959,16,40,8,9,3073
20173000800,2214,235,549,1215,19,20,9,9,1979
20173000900,3511,1477,558,1015,35,232,3,47,2034
20173001000,3841,1534,809,989,51,87,13,31,2307
20173001100,2102,681,533,673,22,23,0,4,1421
20173001400,3824,3039,377,87,32,43,0,16,785
20173001500,2999,1773,778,146,50,64,4,7,1226
20173001800,1850,445,620,440,9,211,1,5,1405
20173001900,2063,1282,390,185,16,47,4,4,781
20173002000,2055,1710,131,51,6,15,1,19,345
20173002200,1626,1407,92,43,9,11,0,2,219
20173002300,1974,1381,288,116,22,11,0,12,593
20173002400,1462,714,373,232,8,34,1,7,748
20173002600,1275,530,467,121,28,26,4,10,745
20173002700,1572,779,540,89,34,12,2,7,793
20173002800,3211,2162,539,184,47,47,5,40,1049
20173002900,2909,1790,680,190,25,38,2,6,1119
20173003000,2159,1243,560,161,39,17,0,4,916
20173003100,2206,1192,516,224,49,17,2,25,1014
20173003200,2780,1312,970,223,29,87,0,29,1468
20173003400,3051,1489,998,231,24,74,0,21,1562
20173003500,2097,1261,480,149,20,24,0,8,836
20173003600,3269,1420,882,572,35,69,6,14,1849
20173003700,2022,775,672,208,21,209,34,12,1247
20173003800,2602,1298,656,334,22,118,2,7,1304
20173003900,4428,1902,1601,461,71,140,2,15,2526
20173004000,4461,2201,1229,542,58,100,5,27,2260
20173004301,4041,2475,447,814,37,71,13,11,1566
20173004302,2036,1157,406,211,31,59,3,19,879
20173005100,4704,2778,1014,414,72,87,2,15,1926
20173005200,4329,2386,1049,406,53,136,0,9,1943
20173005300,5843,3706,1288,296,41,129,1,20,2137
20173005401,3601,2344,549,99,34,332,14,9,1257
20173005402,5054,3347,688,386,83,75,2,52,1707
20173005501,4830,3923,369,49,47,62,0,9,907
20173005502,5574,4619,417,50,78,40,6,19,955
20173005600,4853,3499,658,105,57,144,18,5,1354
20173005700,5681,3800,854,182,71,285,2,35,1881
20173005800,4050,2065,1044,150,74,433,5,19,1985
20173005900,4497,2608,894,357,57,198,6,20,1889
20173006000,4499,1861,1294,587,60,366,3,19,2638
20173006100,3096,1372,1006,320,52,155,10,14,1724
20173006200,3523,1515,872,537,28,316,7,14,2008
20173006300,2085,1182,368,252,23,103,2,10,903
20173006400,1792,981,337,216,19,100,0,9,811
20173006500,3429,781,1462,365,24,602,24,10,2648
20173006600,2521,1270,420,489,12,86,22,16,1251
20173006700,2362,989,574,466,37,155,0,9,1373
20173006800,4375,1619,1030,1176,24,201,5,19,2756
20173006900,2817,1133,714,579,30,118,12,4,1684
20173007000,3682,1431,677,1115,39,146,9,26,2251
20173007101,2142,1032,399,399,27,146,0,4,1110
20173007102,4896,2259,797,1004,43,375,14,12,2637
20173007201,4242,2736,602,256,18,359,7,21,1506
20173007205,3334,1703,442,670,24,227,18,7,1631
20173007206,2976,1274,334,501,24,642,2,18,1702
20173007207,3572,1722,388,247,18,964,2,15,1850
20173007208,6062,2280,665,884,19,1787,3,23,3782
20173007301,3774,3017,222,169,11,163,2,3,757
20173007302,3580,2669,231,350,20,79,0,9,911
20173007500,2576,417,437,1415,14,100,0,17,2159
20173007600,4082,2636,309,751,16,168,5,11,1446
20173007701,3087,1094,286,1270,34,188,3,15,1993
20173007702,5292,1908,464,1694,28,852,6,20,3384
20173007800,2598,170,333,1856,34,35,1,0,2428
20173008000,6155,4673,695,222,54,66,0,27,1482
20173008100,4718,3521,782,40,45,66,0,9,1197
20173008200,6857,1979,4159,345,59,99,7,30,4878
20173008300,4169,2744,1000,137,25,39,1,14,1425
20173008400,3337,2027,967,95,26,48,0,13,1310
20173008500,2400,1738,347,105,34,52,0,9,662
20173008600,3620,2628,607,127,33,70,1,3,992
20173008700,3960,2387,931,310,39,57,0,17,1573
20173008800,4615,2983,973,175,69,76,5,17,1632
20173008900,3430,2142,809,154,35,52,8,11,1288
20173009000,2940,1777,710,170,39,46,3,12,1163
20173009100,6648,3683,1406,549,69,404,0,29,2965
20173009200,2873,2123,335,131,23,93,7,0,750
20173009301,5945,4164,818,290,67,225,2,16,1781
20173009303,3035,2260,321,172,34,73,0,23,775
20173009304,2489,1550,377,262,16,72,5,7,939
20173009401,3823,3034,376,94,35,38,1,18,789
20173009402,2383,1927,194,95,15,28,1,4,456
20173009504,4444,3398,510,137,36,109,1,8,1046
20173009505,2973,2480,241,47,13,52,3,8,493
20173009506,4719,3693,503,97,37,87,1,10,1026
20173009507,6657,5687,474,62,37,122,2,13,970
20173009508,3470,2912,247,37,28,23,0,11,558
20173009509,7450,6267,523,80,32,160,1,17,1183
20173009510,4929,4047,426,62,18,139,0,12,882
20173009511,7393,5660,824,160,42,236,4,36,1733
20173009512,4092,3295,398,69,27,74,3,14,797
20173009513,4648,3460,581,138,43,119,7,28,1188
20173009514,3810,3185,209,29,12,199,0,11,625
20173009515,6247,4714,730,121,31,290,6,10,1533
20173009603,2765,1979,276,57,22,234,8,9,786
20173009604,2859,2566,102,5,24,6,0,12,293
20173009605,6133,5032,491,72,38,163,3,15,1101
20173009700,5988,4947,410,35,73,70,1,23,1041
20173009801,4426,3599,374,54,32,41,5,8,827
20173009803,4428,3651,323,83,44,48,1,30,777
20173009804,3573,2994,218,66,22,43,6,9,579
20173009901,5124,4274,305,74,26,82,2,11,850
20173009902,5911,5148,289,22,62,36,8,12,763
20173010001,4598,3697,204,151,21,266,0,6,901
20173010002,5132,3389,293,330,13,835,0,31,1743
20173010003,2171,1099,306,244,3,340,0,5,1072
20173010005,3989,3175,329,65,39,89,4,13,814
20173010006,1611,1206,134,34,20,127,0,1,405
20173010007,7308,5704,595,251,42,224,3,17,1604
20173010106,3051,2156,230,258,17,205,0,23,895
20173010107,3575,2455,266,463,19,175,1,13,1120
20173010108,2158,1705,93,92,9,164,0,6,453
20173010109,2347,1418,208,418,14,168,0,6,929
20173010110,1579,1315,70,43,11,54,1,0,264
20173010111,7896,5815,576,637,40,392,3,30,2081
20173010113,4806,3437,385,446,41,192,7,11,1369
20173010115,8791,6693,441,320,31,874,5,30,2098
20173010116,4682,3398,304,350,29,329,3,20,1284
20173010201,5318,4464,378,75,47,26,1,12,854
20173010202,4898,4071,393,69,34,59,0,20,827
20173010301,8928,7113,673,193,40,469,1,31,1815
20173010302,9246,7367,890,206,82,168,6,32,1879
20173010400,2210,1887,149,9,29,7,2,10,323
20173010500,4586,4256,163,8,18,9,0,5,330
20173010600,4243,3891,147,17,18,15,0,19,352
20173010700,3408,3117,107,2,21,9,3,4,291
20173010801,2808,1553,302,480,27,217,12,11,1255
20173010802,2996,1426,310,680,27,279,5,18,1570
20173010900,3781,3181,206,121,17,66,1,16,600
20175965600,2070,1101,875,12,3,15,0,8,969
20175965700,4760,2096,2163,191,24,165,0,9,2664
20175965800,4418,1139,2845,126,14,198,0,10,3279
20175965900,6445,1175,4945,129,17,72,0,10,5270
20175966000,4271,417,3578,153,8,67,1,5,3854
20177000400,4038,2002,919,683,57,50,26,26,2036
20177000500,2143,1015,456,433,42,8,4,13,1128
20177000600,2141,1159,562,193,22,7,1,11,982
20177000700,2757,2104,266,112,41,15,5,4,653
20177000800,3340,2486,401,156,48,15,4,11,854
20177000900,3105,2091,620,117,42,21,3,12,1014
20177001000,3160,1603,1209,90,31,4,5,10,1557
20177001100,3038,765,1668,330,49,13,16,12,2273
20177001200,2226,541,916,562,23,12,11,21,1685
20177001300,4081,1634,1481,600,41,29,2,8,2447
20177001500,2137,1007,461,441,19,12,0,3,1130
20177001601,2617,1888,243,249,20,33,3,7,729
20177001603,2871,1883,312,356,25,55,6,6,988
20177001604,3539,2483,383,250,16,173,0,9,1056
20177001800,4078,2982,489,282,28,38,9,34,1096
20177001900,3149,2652,189,87,8,30,0,14,497
20177002100,3200,2084,493,275,38,16,4,13,1116
20177002200,2531,1930,301,104,24,8,0,0,601
20177002401,3282,2694,233,176,14,51,2,8,588
20177002402,2638,1861,226,261,22,52,5,18,777
20177002500,2824,2098,303,198,20,22,0,5,726
20177002601,3972,2879,393,298,27,64,7,12,1093
20177002602,6204,4732,565,432,27,117,10,21,1472
20177002701,4516,3182,551,328,51,51,0,17,1334
20177002702,4306,3200,404,324,25,125,2,0,1106
20177002800,4005,2543,483,589,26,26,5,19,1462
20177002900,3231,1207,1026,661,55,20,0,13,2024
20177003001,3376,1361,1000,646,55,21,0,6,2015
20177003002,5475,3787,739,490,39,36,1,18,1688
20177003100,6626,3338,1367,1340,73,36,3,24,3288
20177003301,2617,2181,153,54,27,26,2,0,436
20177003302,3635,3203,172,19,21,22,0,26,432
20177003401,5062,4399,266,40,45,31,3,23,663
20177003402,4819,4233,203,62,33,44,0,13,586
20177003500,6203,5526,233,15,72,26,7,5,677
20177003601,4989,4458,219,46,27,32,0,8,531
20177003604,4110,3548,210,69,31,67,0,5,562
20177003605,4761,3900,263,164,38,169,0,18,861
20177003606,4563,3409,322,264,32,279,0,10,1154
20177003607,6814,5343,482,214,40,444,2,9,1471
20177003701,4987,3843,412,295,44,68,0,30,1144
20177003702,3737,2711,342,278,19,21,4,13,1026
20177003901,7255,5941,673,186,52,23,8,17,1314
20177003902,4494,3959,234,45,31,22,2,15,535
20177004000,2481,1128,623,526,36,15,0,9,1353
20177004100,3776,2900,395,191,19,31,0,21,876
20179952800,2447,2212,145,0,7,12,2,1,235
20181453600,1551,1355,126,6,0,0,0,3,196
20181453700,4376,3443,647,97,12,13,1,12,933
20183475800,1742,1639,41,2,8,3,0,1,103
20183475900,1828,1731,26,10,7,6,0,4,97
20185470600,1815,1612,112,9,9,7,0,0,203
20185470700,2257,1752,391,5,12,5,0,2,505
20187964100,2084,1074,909,7,21,2,0,0,1010
20189965100,1335,960,305,2,3,0,0,8,375
20189965200,3915,2047,1715,18,17,22,0,8,1868
20191962100,4748,4160,240,23,53,9,0,15,588
20191962200,4841,4416,117,12,43,9,0,6,425
20191962300,2433,2161,101,5,23,7,0,8,272
20191962400,4264,3568,329,47,39,20,0,24,696
20191962500,3905,3134,370,98,43,23,0,30,771
20191962600,2191,1908,97,15,14,5,0,10,283
20193953100,6078,5281,476,97,12,35,0,15,797
20193953400,1852,1629,156,9,0,12,0,9,223
20195955800,2808,2627,64,4,4,12,0,2,181
20197483100,4532,4050,237,21,18,5,3,12,482
20197483200,2345,2135,80,10,11,7,1,9,210
20199954100,1512,1344,80,3,1,0,2,3,168
20201978600,3017,2814,85,13,1,4,2,5,203
20201978700,2513,2270,190,0,1,0,0,1,243
20203957600,2152,1412,636,1,8,0,2,6,740
20205097100,1863,1712,33,4,15,3,1,1,151
20205097200,1452,1329,41,1,5,7,0,12,123
20205097300,2440,2185,91,1,14,18,1,6,255
20205097400,2869,2453,96,15,45,7,0,8,416
20207096600,1559,1430,31,1,19,0,0,4,129
20207096700,1556,1434,40,7,8,0,0,3,122
20209040100,2909,130,1044,1592,3,39,2,9,2779
20209040200,1422,143,450,725,4,54,0,4,1279
20209040500,2064,390,819,583,10,161,9,10,1674
20209040600,2855,182,1296,1209,19,43,0,15,2673
20209040700,1791,62,732,897,8,8,0,2,1729
20209040900,1282,264,522,401,2,22,0,10,1018
20209041100,1440,112,206,951,0,93,20,4,1328
20209041200,1789,76,961,676,2,28,8,6,1713
20209041300,5369,505,3305,1262,14,110,9,21,4864
20209041400,1579,72,464,916,10,10,10,7,1507
20209041500,2787,488,1428,282,0,479,18,5,2299
20209041600,4266,850,2408,608,24,274,3,5,3416
20209041900,1707,711,758,100,4,67,3,1,996
20209042001,1691,297,980,295,8,62,11,0,1394
20209042002,1728,240,1205,165,6,67,0,2,1488
20209042100,2944,472,2015,209,5,155,12,4,2472
20209042200,1853,378,1309,76,5,20,0,10,1475
20209042300,3270,494,2366,227,5,93,0,15,2776
20209042400,2596,357,1695,359,3,101,4,7,2239
20209042600,2771,589,2045,38,11,25,0,2,2182
20209042700,3509,812,1996,525,12,39,12,6,2697
20209042800,3286,900,1560,597,4,68,0,9,2386
20209042900,4808,1259,1880,1001,32,450,43,23,3549
20209043000,3525,1409,1797,101,27,43,0,7,2116
20209043301,3445,1591,1178,441,15,64,7,16,1854
20209043400,2196,1140,783,109,5,41,0,0,1056
20209043500,1684,950,557,45,5,33,0,2,734
20209043600,6648,3228,2533,299,33,257,1,25,3420
20209043700,2473,1259,823,181,7,52,0,10,1214
20209043802,1305,1012,201,13,6,13,0,4,293
20209043803,2959,1694,917,117,12,51,0,9,1265
20209043903,3134,690,1484,644,6,177,3,17,2444
20209043904,3606,667,911,1511,19,303,18,9,2939
20209043905,1764,603,335,661,13,59,0,7,1161
20209044001,3592,1915,682,717,26,73,25,15,1677
20209044002,3247,1997,654,378,25,33,5,5,1250
20209044101,1125,251,176,576,1,27,1,3,874
20209044102,2878,1159,854,559,6,110,18,6,1719
20209044103,3049,928,269,1194,10,494,4,22,2121
20209044104,3504,788,495,1554,20,426,54,28,2716
20209044201,4209,1810,574,1122,24,459,0,17,2399
20209044202,3873,1283,643,1212,13,534,8,6,2590
20209044301,2452,950,468,696,10,184,0,19,1502
20209044302,2032,676,599,536,6,116,0,6,1356
20209044303,2484,504,650,990,4,235,0,7,1980
20209044400,3080,791,933,948,7,270,8,17,2289
20209044500,2309,678,617,811,11,85,8,4,1631
20209044601,2761,1628,442,409,15,96,1,18,1133
20209044602,0,0,0,0,0,0,0,0,0
20209044603,0,0,0,0,0,0,0,0,0
20209044702,4717,3357,614,330,37,55,3,10,1360
20209044703,3470,2315,343,461,12,136,0,5,1155
20209044704,1705,854,198,478,4,73,0,5,851
20209044803,6835,4759,630,925,24,124,2,11,2076
20209044804,5152,3318,536,833,31,111,5,23,1834
20209044807,3069,2348,293,216,20,30,10,8,721
20209044900,4799,3380,746,293,49,24,4,18,1419
20209045100,1985,822,458,448,7,146,4,10,1163
20209045200,4330,2472,948,426,24,216,4,27,1858
20209980000,0,0,0,0,0,0,0,0,0
20209980500,15,10,2,0,0,2,0,0,5
20209980900,98,50,19,17,0,0,7,0,48
20209981200,11,10,0,0,0,0,0,0,1
20209981500,9,0,8,0,0,1,0,0,9
21001970100,1621,1525,36,6,1,0,0,2,96
21001970200,1755,1616,54,35,6,0,0,1,139
21001970300,3005,2818,103,9,3,9,0,0,187
21001970401,4346,3835,171,196,2,9,3,4,511
21001970402,4535,3894,199,226,6,37,2,39,641
21001970500,2334,2122,55,19,8,8,1,24,212
21001970600,1307,1234,25,7,0,0,0,0,73
21003920100,3295,3070,93,31,4,0,2,10,225
21003920200,2868,2697,64,3,2,3,0,3,171
21003920300,5101,4660,138,85,11,26,1,4,441
21003920400,4563,4156,128,63,13,9,3,16,407
21003920500,1413,1313,46,7,0,5,0,3,100
21003920600,3348,3091,105,15,8,5,1,5,257
21005950101,1987,1841,45,38,0,5,0,0,146
21005950102,6988,6171,178,262,15,31,3,18,817
21005950201,5681,5132,140,115,7,35,0,16,549
21005950202,3966,3624,72,40,7,19,1,23,342
21005950300,2382,2218,47,12,2,13,0,2,164
21005950400,2848,2668,39,15,19,1,0,9,180
21007950100,3975,3629,38,130,2,14,0,5,346
21007950200,1420,1291,15,50,0,5,0,0,129
21007950300,2333,2154,40,28,5,10,0,0,179
21009950100,3590,3278,111,72,1,30,0,14,312
21009950200,3537,3087,115,150,5,29,0,10,450
21009950300,3507,3053,143,130,4,8,7,10,454
21009950401,2637,1877,252,270,11,58,3,29,760
21009950402,3612,2777,222,374,4,9,19,15,835
21009950500,4033,3405,212,198,3,30,5,13,628
21009950601,3048,2440,183,233,7,11,11,10,608
21009950602,3318,2786,246,135,8,51,0,13,532
21009950701,2269,2126,37,33,0,5,0,3,143
21009950702,4046,3765,75,48,18,15,6,8,281
21009950800,3497,3279,102,24,6,6,0,3,218
21009950900,3913,3709,104,4,0,0,2,14,204
21009951000,3478,3222,87,26,6,3,0,18,256
21011970100,1932,1777,48,55,1,3,0,4,155
21011970201,2646,2512,21,41,1,5,0,6,134
21011970202,4610,4404,82,29,0,3,1,1,206
21011970300,3562,3432,31,2,2,5,0,4,130
21013960100,1825,1759,5,5,5,0,0,0,66
21013960200,4129,3902,31,52,3,8,0,18,227
21013960300,1865,1797,7,6,2,2,0,1,68
21013960400,1292,1238,6,3,0,0,0,1,54
21013960500,2096,1915,69,40,0,6,2,0,181
21013960600,4478,3976,32,236,5,43,0,14,502
21013960700,2655,2320,46,106,5,41,0,11,335
21013960800,3223,3029,34,20,7,21,0,10,194
21013961100,2534,2375,14,84,5,1,2,3,159
21015070101,4045,2902,490,403,6,54,5,3,1143
21015070102,2868,1873,310,425,7,21,23,16,995
21015070201,3863,2681,514,425,6,36,7,11,1182
21015070202,2961,2077,341,337,7,26,0,15,884
21015070301,5992,3622,1328,565,11,44,1,22,2370
21015070305,6572,5588,306,261,16,90,16,17,984
21015070309,6546,5650,225,104,8,272,10,21,896
21015070311,2711,2146,187,125,2,14,83,7,565
21015070312,3131,2404,242,194,0,129,27,8,727
21015070313,3296,2866,128,86,2,78,0,14,430
21015070314,4997,4083,270,132,8,239,16,28,914
21015070315,5914,4529,474,465,8,167,14,20,1385
21015070316,6903,5588,309,235,12,487,4,20,1315
21015070317,5254,4413,179,216,8,176,15,25,841
21015070318,8353,7212,286,257,14,168,2,26,1141
21015070403,6820,5945,232,102,10,166,19,23,875
21015070404,3772,3274,126,103,1,84,0,22,498
21015070405,2336,2173,41,6,1,12,0,10,163
21015070406,2647,2234,161,72,2,32,5,9,413
21015070407,3548,2896,168,200,5,22,6,23,652
21015070502,4327,4058,77,14,7,8,0,9,269
21015070503,6614,5518,357,217,15,129,26,21,1096
21015070505,3708,3308,90,87,7,32,4,1,400
21015070506,4245,3509,203,279,3,42,15,13,736
21015070601,2936,2732,59,7,1,33,0,9,204
21015070604,3454,3220,74,9,4,23,0,20,234
21015070605,7985,7051,176,145,10,325,1,9,934
21015070606,5660,5048,188,63,9,59,8,15,612
21015070607,4453,3951,164,74,3,80,0,27,502
21015980100,57,51,2,1,1,0,0,1,6
21017030101,2175,1431,212,393,3,2,0,13,744
21017030102,1726,1495,113,49,4,9,0,3,231
21017030201,4348,3422,388,291,7,23,1,16,926
21017030202,1949,1476,162,154,0,3,3,11,473
21017030300,3170,2683,307,50,5,18,0,6,487
21017030400,2443,2230,105,38,0,11,1,6,213
21017030500,2331,2128,95,37,6,9,0,11,203
21017030600,2110,1905,104,21,3,2,3,4,205
21019030200,1438,1236,25,73,11,22,0,3,202
21019030300,2053,1654,99,119,10,24,0,9,399
21019030400,2163,1923,51,67,0,9,0,7,240
21019030500,4409,4030,87,78,11,27,0,20,379
21019030600,4361,3988,64,98,4,37,0,8,373
21019030700,3364,3074,49,77,2,23,0,3,290
21019030800,3913,3466,53,127,15,7,4,10,447
21019030900,5187,4841,46,53,4,35,1,22,346
21019031001,1283,1224,10,10,2,5,0,8,59
21019031003,3139,2474,80,490,11,32,0,0,665
21019031004,3518,3343,30,22,5,5,0,0,175
21019031101,5723,5466,63,34,9,25,1,7,257
21019031102,2106,1987,20,19,2,2,0,5,119
21019031200,3254,3099,19,9,3,11,0,8,155
21019031300,2350,2230,18,30,0,13,0,6,120
21021930100,6415,5002,403,656,3,44,1,34,1413
21021930200,4762,4039,161,264,5,59,1,14,723
21021930300,3293,2422,169,359,10,152,1,4,871
21021930400,4344,2998,450,571,1,33,0,24,1346
21021930500,3506,3048,81,181,6,37,0,5,458
21021930600,3751,3470,64,46,10,9,0,7,281
21021930700,4543,4095,162,78,3,27,0,9,448
21023950100,2464,2306,46,24,5,6,0,0,158
21023950200,1793,1706,12,6,1,3,0,4,87
21023950300,4143,3952,32,18,8,4,0,2,191
21025920200,2170,2077,18,26,0,6,3,0,93
21025920301,1893,1822,10,10,0,14,1,0,71
21025920302,1668,1577,8,8,5,17,2,0,91
21025920500,1692,1656,6,1,4,0,2,0,36
21025920600,1950,1895,11,2,0,0,1,0,55
21025920700,1986,1737,24,4,1,0,1,0,249
21025920800,2359,2274,16,6,1,0,1,0,85
21027960100,5019,4486,81,189,17,7,2,20,533
21027960200,5202,4739,63,175,8,20,0,5,463
21027960300,3028,2812,36,26,4,0,1,4,216
21027960400,1375,1304,3,1,3,0,0,6,71
21027960501,2056,1845,52,14,3,3,0,26,211
21027960502,3752,3557,49,17,8,8,0,3,195
21029020101,4388,4049,91,34,9,17,1,4,339
21029020102,3865,3564,80,36,13,20,4,2,301
21029020103,3310,3051,59,5,5,19,0,7,259
21029020201,7459,6894,125,106,9,39,2,17,565
21029020202,4769,4405,99,60,8,31,2,18,364
21029020300,5661,5207,117,57,14,33,0,14,454
21029020401,1693,1574,25,10,3,12,3,3,119
21029020402,5206,4693,152,80,9,35,0,15,513
21029020501,3197,2799,134,62,1,29,0,6,398
21029020502,2213,1932,94,61,2,15,0,8,281
21029020601,5541,4959,187,88,6,16,0,28,582
21029020602,1289,1221,18,6,0,11,0,2,68
21029020702,2546,2261,81,41,11,14,0,1,285
21029020703,4405,3914,101,122,6,50,0,6,491
21029020704,3639,3166,135,79,5,34,5,13,473
21029020800,5005,4471,229,51,22,24,3,2,534
21029020900,2792,2614,59,10,8,6,0,8,178
21029021102,4442,4126,96,21,13,6,1,4,316
21029021103,1384,1273,28,7,11,3,0,0,111
21029021104,4625,4165,141,73,8,17,2,5,460
21029021200,4786,4447,66,22,14,14,0,9,339
21029980100,2,2,0,0,0,0,0,0,0
21031930100,3101,2951,49,5,10,0,0,3,150
21031930200,1616,1556,12,1,5,1,0,6,60
21031930301,1415,1342,32,0,0,3,0,2,73
21031930302,3199,2598,458,8,3,7,3,9,601
21031930400,1764,1679,34,0,1,5,0,3,85
21031930500,1276,1244,7,1,3,5,0,0,32
21033920100,1944,1836,20,27,1,3,2,7,108
21033920200,5027,4218,91,455,11,29,0,16,809
21033920301,3216,2822,52,157,0,14,0,4,394
21033920302,2462,2314,35,15,9,7,0,2,148
21035010100,4303,3960,164,20,5,18,0,6,343
21035010200,4516,4101,132,56,9,9,0,8,415
21035010301,2492,1981,78,239,1,78,1,14,511
21035010303,2930,2336,186,203,7,41,0,4,594
21035010304,3617,3069,142,114,7,59,2,26,548
21035010400,2424,1852,159,214,5,30,5,9,572
21035010500,3263,2681,157,195,0,38,0,16,582
21035010601,3029,2600,116,117,3,63,0,11,429
21035010602,4063,3679,82,83,4,75,2,12,384
21035010700,3209,2952,76,36,1,15,0,3,257
21035010800,3257,3024,61,16,11,7,1,1,233
21037050100,1202,731,87,279,0,30,0,6,471
21037050400,1729,1499,66,62,1,13,4,10,230
21037050500,2177,1577,222,171,3,5,2,14,600
21037050600,1783,1258,147,221,2,4,0,9,525
21037051101,2183,1941,91,40,8,9,0,11,242
21037051102,1571,1401,33,30,9,12,0,5,170
21037051200,1538,1353,76,25,7,5,1,3,185
21037051300,4933,4586,91,53,4,37,0,6,347
21037051901,4942,4677,39,20,5,21,0,27,265
21037051903,6834,6393,77,59,18,73,0,20,441
21037051904,5079,4679,76,43,3,30,1,22,400
21037052001,5253,4981,39,8,1,31,0,13,272
21037052002,2775,2661,25,2,0,4,0,3,114
21037052100,3259,2933,101,65,6,13,1,18,326
21037052200,2225,2043,53,27,1,16,1,1,182
21037052301,4793,4231,92,122,2,129,1,13,562
21037052302,5148,4707,115,40,7,97,2,23,441
21037052400,2596,2289,73,87,1,24,3,17,307
21037052500,5313,4385,143,419,0,67,0,14,928
21037052800,3620,3220,112,62,3,48,0,6,400
21037052900,5283,4877,74,75,10,37,3,19,406
21037053100,5765,5344,79,75,9,58,1,15,421
21037053200,2905,2268,165,315,4,39,2,5,637
21037053301,5763,4952,127,258,13,147,4,55,811
21037053302,4407,3757,106,238,0,75,4,35,650
21039960100,1554,1450,49,2,22,3,0,0,104
21039960200,1784,1611,57,27,2,6,0,0,173
21039960300,1488,1382,27,30,3,1,0,0,106
21041950100,2344,2130,74,33,0,17,0,10,214
21041950200,6267,5206,671,119,18,26,2,1,1061
21041950300,2199,2065,50,17,2,1,1,0,134
21043960100,3311,3203,23,5,4,4,0,6,108
21043960200,3860,3763,20,6,0,0,0,2,97
21043960300,2818,2708,19,3,8,3,0,0,110
21043960400,1806,1753,8,2,7,0,1,1,53
21043960500,4246,3884,87,164,4,14,0,10,362
21043960601,1635,1581,5,5,2,3,0,2,54
21043960602,4759,4498,54,21,11,24,0,3,261
21043960700,4192,4035,38,3,9,10,0,7,157
21045950100,1243,1192,20,0,2,2,0,0,51
21045950200,2442,2222,131,5,8,6,0,7,220
21045950301,3067,2765,162,25,11,19,1,12,302
21045950302,3315,3081,109,21,5,10,0,9,234
21045950400,3217,3093,31,10,15,7,0,5,124
21045950500,2657,2483,86,20,1,8,0,7,174
21047200100,3788,1506,192,1861,11,6,0,20,2282
21047200200,3186,1573,146,1236,6,21,4,19,1613
21047200300,3112,1604,126,1156,12,12,5,10,1508
21047200400,2199,506,137,1414,4,4,2,12,1693
21047200500,4654,3048,332,860,21,164,3,10,1606
21047200600,4934,3464,225,925,9,81,1,16,1470
21047200700,6326,4650,337,1033,10,35,0,24,1676
21047200800,2640,1026,78,1371,13,5,5,7,1614
21047200901,2840,2137,79,456,16,36,2,3,703
21047200902,3407,2947,91,195,5,29,4,9,460
21047201000,2074,1928,48,21,4,4,1,8,146
21047201100,3643,3337,52,109,9,7,0,0,306
21047201200,2758,2459,51,123,14,8,4,8,299
21047201301,3336,2697,149,367,10,4,2,11,639
21047201303,4202,2185,540,991,31,55,18,29,2017
21047201304,3686,1660,497,1110,24,65,7,36,2026
21047201400,3138,2680,98,154,9,60,0,8,458
21047201501,4834,2593,1053,591,14,84,95,18,2241
21047201502,3847,2056,759,562,21,110,46,23,1791
21047201503,4144,2344,762,686,29,149,12,9,1800
21047980100,0,0,0,0,0,0,0,0,0
21049020101,5443,4539,430,242,12,19,7,12,904
21049020103,3648,3351,77,76,3,20,0,7,297
21049020105,3686,3299,120,143,4,14,1,16,387
21049020106,3330,2929,124,98,7,8,1,1,401
21049020201,3198,2199,144,740,5,5,2,2,999
21049020202,4089,3527,188,158,7,7,1,9,562
21049020300,2507,2367,55,5,5,8,0,5,140
21049020400,3281,3088,67,9,7,10,0,11,193
21049020500,2866,2709,42,31,7,11,0,6,157
21049020600,4924,4259,230,133,6,107,2,10,665
21051950100,1671,1577,30,24,1,2,5,5,94
21051950201,2930,2814,16,8,7,5,0,6,116
21051950202,2973,2868,14,10,5,1,1,2,105
21051950301,2488,2311,37,80,0,0,3,2,177
21051950302,3656,2782,168,631,6,11,0,1,874
21051950400,2952,2898,8,3,0,0,1,0,54
21051950500,2420,2301,31,34,6,1,1,4,119
21051950600,1255,1135,49,26,1,1,0,1,120
21053970100,2752,2635,35,2,4,6,0,7,117
21053970202,3347,3105,134,11,5,1,2,3,242
21053970203,1561,1497,13,12,0,0,0,0,64
21053970204,1593,1443,63,14,1,3,1,5,150
21055930100,1840,1787,20,1,0,2,2,0,53
21055930200,4117,3832,66,67,7,3,3,15,285
21055930300,1395,1349,13,8,3,0,0,1,46
21055930400,1638,1556,14,6,5,0,0,1,82
21057950100,3713,3368,57,131,1,1,4,6,345
21057950200,2175,2077,20,19,0,1,2,0,98
21059000100,3335,2266,208,608,7,32,10,16,1069
21059000200,3477,2263,234,682,9,20,0,22,1214
21059000300,2018,1392,193,231,0,84,2,8,626
21059000401,5546,4430,341,265,10,129,2,20,1116
21059000402,2247,1713,136,204,1,13,0,13,534
21059000500,1938,1479,192,120,8,5,4,21,459
21059000600,5810,4876,254,407,5,66,0,13,934
21059000700,4497,3997,101,130,0,137,0,7,500
21059000800,3823,3063,150,154,8,254,1,11,760
21059000900,5247,4519,137,177,4,171,0,12,728
21059001000,3240,2431,239,136,2,292,1,7,809
21059001100,2493,2100,74,164,4,51,10,13,393
21059001200,3308,2802,104,138,6,117,2,6,506
21059001300,6283,5349,181,330,9,109,2,15,934
21059001401,5470,4811,255,171,9,43,2,17,659
21059001402,5514,5042,154,70,12,34,1,21,472
21059001501,3717,3296,246,43,9,9,0,8,421
21059001502,3490,3382,38,6,0,7,0,0,108
21059001601,5030,4489,92,89,2,181,0,15,541
21059001602,4783,4566,66,17,3,8,1,5,217
21059001701,6297,4672,347,443,4,473,19,22,1625
21059001702,3507,3062,71,95,2,128,1,12,445
21059001703,5363,4981,110,61,10,34,1,16,382
21059001800,6879,6346,222,86,6,20,0,11,533
21061920200,4123,3944,45,7,11,13,0,0,179
21061920300,1286,1231,12,5,3,4,3,0,55
21061920401,2804,2642,51,22,10,7,0,1,162
21061920402,3809,3632,44,15,7,2,3,4,177
21061980100,104,37,4,49,0,6,1,2,67
21063920101,2850,2515,40,243,7,7,0,10,335
21063920102,2638,2554,29,3,4,2,0,5,84
21063920200,1866,1806,22,0,3,1,0,0,60
21065920100,1306,1245,21,2,0,0,0,0,61
21065920201,1861,1806,8,1,1,0,0,0,55
21065920202,4175,4010,50,8,10,0,0,5,165
21065920301,1807,1727,16,5,7,1,0,0,80
21065920302,3532,3396,31,7,4,6,0,2,136
21065920400,1482,1435,5,7,1,0,0,4,47
21067000101,3000,1933,187,606,6,70,2,14,1067
21067000102,1447,1054,43,265,3,15,0,9,393
21067000200,3181,1906,173,921,5,27,2,11,1275
21067000300,2822,1089,255,1273,9,5,0,12,1733
21067000400,1847,621,202,906,4,6,1,5,1226
21067000500,3355,2934,124,114,10,38,0,10,421
21067000600,4331,3980,106,44,5,59,0,8,351
21067000700,2316,1949,92,64,1,122,0,4,367
21067000801,3931,3028,242,325,3,141,1,176,903
21067000802,4211,3317,221,303,7,195,4,108,894
21067000900,6074,4008,420,931,5,430,1,61,2066
21067001000,1585,924,147,345,2,87,3,0,661
21067001100,5150,971,1788,2185,10,20,4,38,4179
21067001300,1951,906,450,487,11,6,1,8,1045
21067001400,2373,1448,342,403,13,16,0,16,925
21067001500,2116,1341,326,310,7,8,0,10,775
21067001600,2596,1629,244,538,3,40,0,14,967
21067001700,2147,1746,147,135,3,19,0,13,401
21067001800,2424,1720,145,170,4,250,3,7,704
21067001900,4794,2389,828,1119,8,182,11,16,2405
21067002001,5587,2078,2294,897,16,41,0,13,3509
21067002002,2346,980,948,326,1,16,0,11,1366
21067002200,1548,1110,93,142,4,105,2,9,438
21067002302,5348,4553,182,213,2,176,2,5,795
21067002303,4269,3181,217,493,3,200,0,19,1088
21067002304,2028,1888,47,3,2,27,0,6,140
21067002400,4203,3164,196,123,5,552,2,44,1039
21067002500,3345,2885,173,87,2,60,0,14,460
21067002600,5102,3736,620,424,7,92,3,20,1366
21067002700,4111,2912,518,268,9,201,1,22,1199
21067002800,3842,3195,180,132,5,152,3,24,647
21067002900,4282,3776,156,74,2,71,0,21,506
21067003000,5928,4247,774,520,3,99,7,23,1681
21067003101,2899,1730,397,592,8,13,3,32,1169
21067003102,2547,1041,264,1092,5,15,1,20,1506
21067003201,1703,1182,186,244,0,5,0,5,521
21067003202,6408,3907,800,1302,19,57,3,26,2501
21067003300,2926,1862,275,566,5,50,5,21,1064
21067003402,4805,2859,443,1021,22,162,2,35,1946
21067003404,4676,2416,360,1541,7,70,4,33,2260
21067003405,6076,3715,472,1315,22,120,2,27,2361
21067003406,6754,4734,594,871,13,62,7,28,2020
21067003407,3847,2539,230,518,6,312,0,25,1308
21067003501,3872,2590,364,582,7,125,2,7,1282
21067003503,2646,1770,201,421,6,107,1,14,876
21067003504,3770,1941,393,997,7,146,3,42,1829
21067003600,4427,3988,88,87,0,111,0,16,439
21067003701,2895,1858,294,654,11,27,0,6,1037
21067003702,4697,2630,563,1108,1,119,0,15,2067
21067003703,5309,3443,409,1046,4,123,5,26,1866
21067003704,7431,4146,686,1852,0,335,1,36,3285
21067003802,2048,1342,543,80,6,14,0,2,706
21067003803,3494,1793,406,1027,11,44,2,26,1701
21067003804,6479,813,1958,3462,11,26,8,38,5666
21067003906,4583,3785,138,264,0,188,0,16,798
21067003908,6983,4909,381,772,8,551,0,39,2074
21067003909,3207,1735,439,721,2,90,1,22,1472
21067003910,2863,939,575,1103,2,78,1,8,1924
21067003911,3815,1749,622,1056,0,111,0,21,2066
21067003912,4352,2878,205,767,2,281,0,18,1474
21067003913,8762,6426,308,549,2,1047,2,20,2336
21067003914,2482,1447,115,544,0,241,1,19,1035
21067003915,4734,3538,172,455,11,312,1,22,1196
21067003916,591,512,21,12,0,28,0,0,79
21067003917,1751,1043,232,344,0,52,1,3,708
21067003918,3065,2480,208,179,4,65,0,16,585
21067004001,6633,3733,627,1597,11,194,1,20,2900
21067004003,5331,4141,241,538,7,97,4,26,1190
21067004005,1636,1424,53,64,0,19,0,1,212
21067004006,1326,1183,34,37,0,29,2,2,143
21067004007,1808,1617,80,24,5,16,0,9,191
21067004103,1923,1337,128,158,4,204,1,3,586
21067004104,4399,2938,439,700,14,65,0,12,1461
21067004105,5364,4328,223,301,5,249,0,25,1036
21067004106,4541,3649,136,267,12,261,1,24,892
21067004107,5374,4360,167,307,5,287,7,8,1014
21067004204,5883,4722,320,222,5,348,0,13,1161
21067004205,7062,5942,269,224,5,328,1,9,1120
21067004207,3873,3221,111,114,2,270,2,25,652
21067004208,7565,5309,248,169,14,1532,4,11,2256
21067004209,3954,3351,146,152,2,138,0,9,603
21067004210,5411,3750,306,337,7,722,1,15,1661
21069920100,4443,4115,112,85,2,5,3,14,328
21069920200,3278,3149,31,23,3,2,0,19,129
21069920300,2698,2572,17,28,6,0,0,4,126
21069920400,4663,4478,58,12,11,10,0,5,185
21071920100,3481,3288,59,15,2,44,0,3,193
21071920200,1863,1805,14,2,4,1,0,2,58
21071920301,2325,2231,22,9,0,8,0,2,94
21071920302,2276,2216,19,12,0,3,0,5,60
21071920401,2719,2657,15,6,3,2,0,0,62
21071920402,1704,1632,30,5,3,3,0,3,72
21071920500,2599,2485,14,20,2,3,0,6,114
21071920600,2706,2613,10,13,1,8,0,1,93
21071920700,2622,2513,24,2,3,0,0,2,109
21071920801,2593,2495,30,11,3,3,0,5,98
21071920802,2374,2292,11,7,0,1,0,4,82
21071920900,1830,1787,11,1,0,1,1,0,43
21071921001,3518,3404,28,13,5,9,0,0,114
21071921002,3332,3236,21,5,2,10,0,1,96
21073070101,3127,2138,231,535,6,21,0,21,989
21073070102,3324,2375,170,523,7,61,0,18,949
21073070401,2639,2090,95,261,3,61,0,12,549
21073070403,1766,1299,135,168,6,34,0,3,467
21073070404,2772,2260,89,255,4,12,1,6,512
21073070405,1814,1192,91,154,2,275,0,15,622
21073070500,2070,1608,53,243,1,11,2,20,462
21073070601,2107,1455,131,404,3,6,0,5,652
21073070602,2268,1575,122,377,7,15,0,19,693
21073070703,2226,1647,93,189,1,225,1,2,579
21073070704,2227,1731,96,235,6,34,0,16,496
21073070705,2142,1928,47,48,2,48,0,3,214
21073070706,3168,2378,182,349,13,62,0,12,790
21073070801,2755,2558,46,40,3,9,4,0,197
21073070802,2033,1782,55,81,1,30,1,5,251
21073071001,3112,2807,58,79,4,32,1,10,305
21073071002,2705,2367,82,130,3,10,0,9,338
21073071101,2516,2356,35,14,8,7,0,14,160
21073071102,3875,3456,97,103,4,74,3,8,419
21073071200,2895,2280,139,256,7,4,1,14,615
21075960100,3567,2590,71,660,7,16,6,24,977
21075960200,2948,1976,80,773,6,1,5,3,972
21077960102,2468,2250,91,11,2,3,5,3,218
21077960103,2381,1986,252,32,1,5,2,5,395
21077960104,3841,3526,149,31,1,5,0,3,315
21079970101,2929,2715,68,15,5,7,0,1,214
21079970102,3306,3069,78,19,3,17,2,4,237
21079970201,3046,2701,79,82,5,14,1,10,345
21079970202,1208,1124,30,6,0,1,0,0,84
21079970300,3310,2885,123,163,14,7,5,12,425
21079970400,3154,2939,73,16,0,5,0,10,215
21081920101,5550,5083,170,50,12,17,0,4,467
21081920102,2922,2567,152,18,8,9,9,24,355
21081920201,2947,2787,43,14,5,13,2,7,160
21081920202,4249,3766,203,29,10,7,20,9,483
21081920301,1886,1790,27,4,4,1,0,2,96
21081920302,5218,4792,129,48,8,12,2,7,426
21081920400,2169,2038,17,16,4,7,0,3,131
21083020100,4050,2896,500,395,5,24,0,16,1154
21083020200,4391,3261,409,434,10,53,0,7,1130
21083020301,4721,3453,720,284,13,29,3,16,1268
21083020302,1857,1119,409,229,4,3,0,4,738
21083020400,2709,2492,102,16,10,4,0,2,217
21083020500,3708,3354,106,77,8,14,0,4,354
21083020600,2307,2197,36,16,3,4,0,0,110
21083020700,4969,4460,267,56,24,22,0,11,509
21083020800,4915,4560,113,24,14,13,0,10,355
21083020900,3022,2735,111,20,5,7,0,6,287
21085950101,811,784,2,3,0,0,0,1,27
21085950102,2281,2202,17,3,0,3,0,0,79
21085950200,2944,2772,46,5,5,11,0,12,172
21085950300,4089,3723,75,196,4,7,1,19,366
21085950401,2327,2136,50,26,18,21,0,3,191
21085950402,4870,4515,79,41,13,29,0,18,355
21085950500,2788,2651,21,7,13,7,1,12,137
21085950600,3823,3633,41,13,11,7,0,5,190
21085950700,2487,2340,33,14,7,11,0,5,147
21087930100,2999,2823,56,31,0,11,0,6,176
21087930200,4120,3776,74,100,4,12,1,5,344
21087930300,2406,2273,39,9,8,2,1,13,133
21087930400,1582,1489,30,20,5,3,0,4,93
21089040100,4495,4169,56,29,7,108,0,4,326
21089040201,3050,2878,21,23,3,14,0,10,172
21089040202,4447,4127,44,21,9,34,0,17,320
21089040300,4275,4048,27,31,7,18,0,9,227
21089040400,5647,5406,49,21,14,20,0,9,241
21089040501,3233,3073,11,6,2,20,0,16,160
21089040502,4677,4425,43,80,14,5,0,8,252
21089040600,2728,2579,18,6,8,6,5,6,149
21089040700,3410,3269,48,2,4,5,0,4,141
21091960100,2746,2605,33,23,1,10,0,4,141
21091960200,3732,3460,100,54,3,15,0,9,272
21091960300,2617,2521,29,2,0,9,0,1,96
21093000100,978,879,21,19,0,1,0,4,99
21093000201,1737,974,327,220,16,84,13,1,763
21093000202,3399,1722,605,610,23,100,56,17,1677
21093000300,4630,2539,431,1046,10,141,19,47,2091
21093000400,5045,2654,500,1204,31,115,19,44,2391
21093000500,2168,1246,187,432,22,55,27,9,922
21093000600,3536,1834,286,901,14,88,26,46,1702
21093000700,4888,2971,382,1000,19,91,36,38,1917
21093000800,5673,3555,386,1017,21,191,15,55,2118
21093000902,4744,2770,380,1007,14,140,67,38,1974
21093000903,5045,4079,249,318,8,61,14,35,966
21093000904,7019,5524,335,610,15,104,10,43,1495
21093001003,4965,4426,153,91,18,45,9,9,539
21093001004,3872,3449,105,110,10,25,0,0,423
21093001005,3326,2376,249,396,8,94,5,27,950
21093001006,3606,3013,138,146,4,120,13,24,593
21093001100,4117,2933,239,482,22,136,8,4,1184
21093001200,5568,4218,278,533,16,191,7,25,1350
21093001300,5255,4014,276,457,15,168,16,21,1241
21093001401,4163,3349,151,304,12,98,16,13,814
21093001402,4421,3279,255,467,17,37,8,16,1142
21093001500,2954,1790,229,625,6,62,3,30,1164
21093001601,2948,2424,137,205,8,10,0,11,524
21093001602,3899,3691,44,20,6,6,0,8,208
21093001603,2800,2494,62,80,5,17,1,8,306
21093001701,5208,4728,129,85,6,31,8,11,480
21093001702,4260,3909,69,27,27,15,0,13,351
21093980100,478,245,92,98,5,17,4,0,233
21095970100,1521,1326,29,109,1,1,0,5,195
21095970200,3175,2885,29,107,6,12,0,7,290
21095970300,1414,1351,11,5,6,4,0,0,63
21095970400,1035,977,13,1,2,4,0,3,58
21095970500,1284,1230,9,4,0,0,0,0,54
21095970600,2712,2596,12,3,6,1,0,0,116
21095970700,3611,3422,36,38,9,9,0,6,189
21095970800,1111,984,14,36,3,13,0,3,127
21095970900,4195,3799,62,143,10,36,0,12,396
21095971000,4249,3986,35,88,8,4,0,12,263
21095971300,2524,2445,15,7,3,1,0,0,79
21097950100,2671,2498,32,0,8,0,0,5,173
21097950200,2390,2227,51,2,4,5,0,16,163
21097950300,5713,5326,102,98,7,17,0,14,387
21097950400,3063,2709,108,108,2,6,0,1,354
21097950500,4855,4456,94,99,5,18,1,11,399
21099970100,1939,1814,35,4,4,2,0,6,125
21099970200,3161,2968,48,45,12,11,0,3,193
21099970301,1574,1506,19,1,0,2,0,0,68
21099970302,3633,3289,69,158,0,11,0,0,344
21099970400,5061,4286,106,385,12,18,2,20,775
21099970500,3920,3629,57,112,5,1,4,1,291
21101020101,1645,1230,64,242,3,2,0,17,415
21101020200,1702,1223,135,210,0,6,2,4,479
21101020300,1589,922,130,397,8,12,3,12,667
21101020401,2297,1574,117,404,3,13,1,8,723
21101020501,2516,1889,122,350,4,11,8,9,627
21101020602,4998,3895,160,674,5,28,20,22,1103
21101020603,2123,1936,21,95,3,12,0,8,187
21101020604,4170,3285,177,410,14,35,0,12,885
21101020701,5575,4695,174,384,13,52,1,15,880
21101020703,3288,2957,43,108,2,38,0,9,331
21101020704,3307,3091,40,43,2,6,4,16,216
21101020800,4393,4125,82,42,9,14,0,9,268
21101020901,3892,3529,65,112,9,3,1,16,363
21101020902,3298,2972,38,161,3,7,1,10,326
21103090100,2772,2548,68,25,7,3,0,13,224
21103090200,3206,2951,67,56,8,7,0,0,255
21103090301,2991,2730,102,35,15,10,0,8,261
21103090302,3818,3129,239,221,8,12,0,16,689
21103090400,2891,2707,69,12,7,3,0,8,184
21105970100,4521,3866,102,380,6,11,0,1,655
21107970100,3008,2803,47,26,8,8,0,8,205
21107970200,3455,3221,57,48,13,13,0,10,234
21107970301,1885,1547,50,167,0,15,2,3,338
21107970302,5226,4368,114,430,10,74,2,8,858
21107970400,2062,1400,69,442,6,5,3,2,662
21107970500,5071,4120,189,447,7,18,5,32,951
21107970600,3205,2217,189,584,7,13,3,13,988
21107970700,4798,4208,79,230,5,64,6,7,590
21107970800,2949,2512,111,157,3,8,4,10,437
21107970900,3205,2713,75,289,0,4,1,7,492
21107971000,2674,2549,38,11,0,0,0,5,125
21107971100,3068,2872,53,18,4,3,0,5,196
21107971300,4817,4524,55,53,7,5,3,9,293
21109960101,3091,3001,23,6,8,1,0,0,90
21109960102,1666,1625,8,0,8,3,0,0,41
21109960200,2729,2610,33,0,3,6,0,3,119
21109960301,3336,3218,16,6,10,5,3,8,118
21109960302,2133,2055,16,0,7,4,1,0,78
21111000201,1392,854,36,415,3,2,1,16,538
21111000202,1141,794,7,288,9,1,0,3,347
21111000300,2437,1001,50,1243,6,3,2,3,1436
21111000400,4360,923,54,3193,10,0,0,28,3437
21111000600,1671,98,40,1461,8,2,0,8,1573
21111000700,2414,148,55,2124,0,11,0,15,2266
21111000800,2019,111,33,1764,2,0,0,16,1908
21111000900,2003,89,46,1801,0,1,0,15,1914
21111001000,2481,152,41,2159,9,2,1,15,2329
21111001100,3216,172,70,2801,9,2,0,31,3044
21111001200,2769,104,50,2498,7,3,7,16,2665
21111001400,2669,35,26,2515,2,9,0,5,2634
21111001500,2988,155,62,2631,8,5,0,22,2833
21111001600,2711,207,97,2248,4,8,0,13,2504
21111001700,2234,120,45,1974,1,1,0,14,2114
21111001800,1201,72,21,1059,0,0,0,9,1129
21111002100,2193,1250,38,748,5,3,0,26,943
21111002300,2086,1036,23,863,10,12,0,3,1050
21111002401,2042,224,46,1689,15,0,0,9,1818
21111002402,2567,310,19,2132,2,0,0,17,2257
21111002700,2723,387,92,2097,8,3,3,24,2336
21111002800,1894,310,54,1438,3,16,3,5,1584
21111003000,1782,454,95,1176,3,4,0,11,1328
21111003501,3104,2142,132,545,2,130,2,6,962
21111003502,1727,211,33,1399,2,11,0,2,1516
21111003600,4771,1965,309,2152,20,41,0,13,2806
21111003700,2187,978,151,828,5,51,4,11,1209
21111003800,3665,2007,450,940,20,32,0,15,1658
21111003900,3786,1781,419,1328,9,29,2,29,2005
21111004000,1737,941,269,380,2,20,2,11,796
21111004100,2412,1415,266,538,3,28,3,35,997
21111004301,4345,926,180,2711,20,273,4,30,3419
21111004302,1247,560,115,477,0,11,2,0,687
21111004400,4368,2752,549,638,16,147,9,21,1616
21111004500,3329,1730,337,895,9,150,2,12,1599
21111004600,3840,2140,513,539,5,408,9,26,1700
21111004900,3941,1809,191,1610,10,191,1,19,2132
21111005000,1754,645,86,865,8,49,2,24,1109
21111005100,3107,1599,124,1179,11,43,2,7,1508
21111005200,3358,2226,169,642,10,64,1,17,1132
21111005300,3541,2173,198,791,13,164,6,37,1368
21111005600,3524,1120,416,1358,11,446,0,20,2404
21111005901,2361,610,79,1478,1,88,0,14,1751
21111005902,2875,1518,113,912,20,163,2,41,1357
21111006200,2422,653,56,1582,16,15,2,13,1769
21111006300,1663,1405,68,82,9,13,3,10,258
21111006400,1801,1485,88,76,3,59,0,12,316
21111006500,2763,1214,113,1218,14,25,4,24,1549
21111006600,1956,1244,84,467,7,26,0,27,712
21111006800,2143,1839,86,90,2,19,0,10,304
21111006900,2231,1895,72,127,19,29,1,11,336
21111007000,2096,1855,48,78,2,28,0,5,241
21111007101,149,115,5,15,1,1,0,0,34
21111007102,5182,3587,213,742,5,367,1,18,1595
21111007400,2436,1990,103,172,6,52,1,5,446
21111007501,6750,6239,143,53,1,123,1,17,511
21111007502,5602,4739,123,275,4,221,2,39,863
21111007601,1939,1611,47,128,6,49,0,13,328
21111007602,3739,2267,375,779,11,83,1,22,1472
21111007603,2530,1730,127,458,0,93,0,13,800
21111007700,2335,1885,78,213,0,62,0,9,450
21111007800,3157,2864,82,51,4,43,1,9,293
21111007900,1788,1576,52,48,1,34,0,9,212
21111008100,3684,3045,159,197,11,93,6,18,639
21111008201,1823,1597,56,69,2,20,1,1,226
21111008202,2061,1736,74,82,3,51,0,3,325
21111008300,2482,2129,84,90,2,29,3,13,353
21111008400,2891,2503,90,103,3,46,0,7,388
21111008500,1927,1649,67,51,6,39,0,19,278
21111008700,4188,3622,112,113,2,221,0,14,566
21111008800,3809,3440,101,97,5,40,1,5,369
21111008900,4691,4081,163,141,5,81,0,53,610
21111009001,3700,1616,617,769,13,474,6,26,2084
21111009002,3571,1955,544,721,9,172,1,12,1616
21111009103,1646,727,262,369,3,197,1,6,919
21111009105,2805,1347,937,321,3,117,0,12,1458
21111009106,5208,2896,859,751,10,490,4,20,2312
21111009300,4989,4432,97,186,13,42,1,12,557
21111009401,3027,2560,123,138,3,29,10,11,467
21111009402,3312,2927,101,88,8,40,0,9,385
21111009600,4735,4217,148,130,3,53,2,18,518
21111009700,2751,2398,114,80,4,28,0,17,353
21111009800,2622,2372,54,60,0,31,0,6,250
21111009900,2793,2460,102,77,1,49,1,14,333
21111010001,4717,4294,115,116,2,60,7,13,423
21111010004,4472,2954,418,719,8,127,4,21,1518
21111010005,4367,3385,313,353,7,87,2,13,982
21111010006,3668,2687,187,574,8,59,0,6,981
21111010007,4128,3599,177,125,0,102,0,7,529
21111010008,4301,3169,211,540,6,137,0,24,1132
21111010102,4172,3682,111,123,4,85,0,10,490
21111010103,3797,2782,284,411,10,99,0,21,1015
21111010104,2813,2189,242,161,5,66,0,21,624
21111010309,4703,3673,148,251,4,480,3,20,1030
21111010312,3064,2656,98,103,1,96,0,16,408
21111010313,6246,5025,213,261,3,466,7,22,1221
21111010314,6474,4936,253,493,11,489,0,25,1538
21111010315,3957,2986,191,318,0,295,1,17,971
21111010316,4978,4049,138,216,8,382,1,20,929
21111010317,4938,4183,127,169,2,293,1,20,755
21111010318,5654,4691,156,263,1,312,0,17,963
21111010319,4453,2833,338,738,5,300,1,22,1620
21111010320,3855,1910,334,1052,9,263,13,26,1945
21111010321,5965,4348,263,452,8,602,1,18,1617
21111010322,3167,2437,92,271,1,231,3,5,730
21111010323,3022,2001,143,334,7,361,0,14,1021
21111010324,5141,2774,404,1294,3,335,0,29,2367
21111010403,4532,3606,193,291,5,245,0,16,926
21111010405,4467,3091,314,574,6,291,1,30,1376
21111010406,6226,4784,270,646,5,224,1,17,1442
21111010407,4473,3412,212,396,0,244,2,29,1061
21111010408,3486,2773,184,212,9,113,1,15,713
21111010500,3893,3328,154,149,9,91,2,17,565
21111010601,2976,2561,100,146,2,48,2,7,415
21111010602,3366,2221,371,460,3,166,3,3,1145
21111010701,5282,3790,161,264,13,884,0,34,1492
21111010702,6097,3955,370,578,9,951,2,17,2142
21111010706,3090,2725,106,101,4,45,0,9,365
21111010707,3688,2558,145,240,8,544,5,67,1130
21111010708,2692,1812,149,265,6,312,0,31,880
21111010800,3847,3082,158,370,11,82,3,13,765
21111010901,5021,2888,578,1078,8,230,3,24,2133
21111010902,4069,3078,270,357,4,126,0,24,991
21111011003,6449,3720,540,1117,10,762,7,41,2729
21111011005,2820,1638,315,634,6,66,0,22,1182
21111011006,2518,921,266,886,6,315,4,13,1597
21111011007,3639,952,488,1492,3,506,1,17,2687
21111011008,3182,1584,539,758,6,130,12,14,1598
21111011009,3279,2392,149,473,2,134,3,18,887
21111011109,2252,1600,135,340,1,54,0,16,652
21111011110,6570,5034,400,674,15,107,5,25,1536
21111011111,5328,3791,217,797,5,259,8,31,1537
21111011112,3477,2288,213,730,8,94,4,12,1189
21111011113,3013,2131,110,477,3,154,5,17,882
21111011114,5341,3205,260,1385,3,259,0,31,2136
21111011115,2823,2290,172,190,7,26,3,4,533
21111011116,3724,2848,257,334,5,116,1,4,876
21111011117,3491,2053,613,524,0,85,1,3,1438
21111011118,3893,3005,348,289,6,49,0,10,888
21111011201,1515,682,130,527,5,69,2,9,833
21111011202,4193,1346,769,1621,17,242,3,15,2847
21111011301,2425,564,484,1226,5,24,1,17,1861
21111011302,7086,784,1337,4509,12,89,2,45,6302
21111011403,1944,1468,200,155,10,10,3,7,476
21111011404,3967,1004,1789,977,1,51,7,19,2963
21111011405,5945,1297,1493,2693,16,160,8,33,4648
21111011406,5241,1929,1163,1804,9,81,4,36,3312
21111011506,5689,3850,590,815,2,104,1,29,1839
21111011508,6773,3468,482,1676,16,774,1,33,3305
21111011509,4204,2349,539,986,4,77,4,23,1855
21111011513,4434,2944,487,670,10,84,2,19,1490
21111011514,3720,2559,217,606,1,152,0,8,1161
21111011515,4849,3687,252,547,9,74,2,29,1162
21111011516,4064,2955,268,585,3,69,1,7,1109
21111011517,5560,4065,307,716,9,143,6,24,1495
21111011518,2292,1925,70,143,1,55,1,3,367
21111011519,6168,4499,355,762,9,174,2,35,1669
21111011520,5543,4305,233,672,2,103,2,18,1238
21111011521,4349,1984,1026,868,17,245,3,22,2365
21111011522,2747,1711,174,587,2,165,1,6,1036
21111011603,5257,4266,124,480,11,127,4,26,991
21111011604,2639,2403,69,36,5,17,0,16,236
21111011605,7534,5897,304,576,6,442,5,15,1637
21111011606,1797,1584,55,69,0,24,0,4,213
21111011706,3930,3055,394,259,1,51,2,15,875
21111011707,6383,4070,531,1228,7,179,4,25,2313
21111011708,6239,4225,785,794,3,159,6,19,2014
21111011709,6475,5014,268,654,20,216,4,40,1461
21111011710,2891,2020,307,326,7,42,5,7,871
21111011711,6490,4585,472,903,15,181,5,28,1905
21111011712,4795,3359,490,531,7,138,2,22,1436
21111011713,2744,1779,364,398,4,30,0,5,965
21111011800,2348,1300,408,482,9,23,3,25,1048
21111011901,1154,196,910,17,1,10,0,10,958
21111011904,2653,1329,769,373,3,35,2,14,1324
21111011906,3992,1631,1276,835,9,64,0,7,2361
21111011907,4505,3114,542,433,2,211,0,24,1391
21111011908,3670,1587,817,962,8,53,3,27,2083
21111011909,4119,2694,673,444,10,80,6,26,1425
21111012001,3378,2867,245,64,9,32,0,26,511
21111012003,3726,2846,572,129,7,13,8,8,880
21111012004,2417,1220,1046,42,7,6,0,9,1197
21111012005,3676,2656,349,414,3,59,3,8,1020
21111012103,3815,2987,179,406,13,18,3,17,828
21111012104,4072,3157,258,408,10,17,5,28,915
21111012105,5093,3790,230,691,10,66,4,25,1303
21111012107,5271,4313,309,253,6,23,1,16,958
21111012108,2106,1530,115,263,8,35,13,8,576
21111012109,5723,4369,304,667,9,48,0,11,1354
21111012203,6316,4839,272,686,28,107,82,25,1477
21111012204,4707,2842,367,1059,9,163,5,30,1865
21111012205,2053,1133,181,493,1,121,9,9,920
21111012206,4919,2772,570,993,4,339,42,14,2147
21111012301,3716,1829,520,813,11,428,1,7,1887
21111012302,5380,3234,374,1312,10,142,3,17,2146
21111012406,6034,4370,349,937,16,33,0,30,1664
21111012407,4992,3384,243,1047,4,33,6,18,1608
21111012408,2316,1718,178,297,6,5,0,12,598
21111012409,3268,2623,158,248,4,8,5,6,645
21111012410,4194,2914,213,892,2,51,0,16,1280
21111012412,3247,2295,140,598,6,46,0,8,952
21111012413,3176,2173,169,576,15,52,2,19,1003
21111012501,2588,1250,236,929,11,14,0,6,1338
21111012502,5224,3323,371,1209,8,55,1,31,1901
21111012503,4157,2451,315,1133,8,34,0,25,1706
21111012603,2899,1105,185,1480,2,11,1,7,1794
21111012604,5560,2184,367,2674,13,51,1,23,3376
21111012605,3277,781,181,2142,8,19,2,20,2496
21111012606,3818,921,228,2483,6,42,0,19,2897
21111012701,4284,1075,279,2708,8,9,0,32,3209
21111012702,1936,1304,122,377,6,0,0,20,632
21111012703,5855,3979,356,1129,17,42,2,16,1876
21111012801,3185,377,79,2554,7,11,0,15,2808
21111012802,2646,575,261,1631,19,19,4,7,2071
21111013100,1183,1060,37,11,0,15,2,13,123
21111980100,14,7,1,1,0,0,0,0,7
21113060102,7214,6022,312,402,13,72,6,34,1192
21113060103,3094,2419,168,290,9,13,0,10,675
21113060104,4976,4293,236,197,15,53,3,16,683
21113060200,5183,4428,415,77,9,49,3,13,755
21113060300,2492,2338,46,25,9,14,0,6,154
21113060401,4061,3488,160,119,13,125,1,9,573
21113060402,4495,4031,143,80,8,79,0,21,464
21113060502,7094,5834,351,503,5,27,3,28,1260
21113060503,4520,3880,179,183,3,30,7,9,640
21113060504,3230,2546,196,266,6,11,4,15,684
21113060600,6632,5912,178,105,16,185,0,12,720
21115960100,3227,3140,20,1,7,1,0,2,87
21115960200,2751,2680,24,4,0,0,0,3,71
21115960300,3325,3232,23,7,3,0,0,0,93
21115960401,3605,3414,50,22,2,46,3,0,191
21115960402,2692,2570,30,0,2,25,0,3,122
21115960500,2675,2577,27,3,8,5,0,2,98
21115960600,4405,4247,24,5,17,24,1,6,158
21117060300,1529,1265,85,99,3,8,4,6,264
21117060700,1430,983,137,202,3,11,3,8,447
21117060900,2356,1408,432,356,6,9,2,15,948
21117061000,2117,1466,117,338,2,8,0,15,651
21117061100,1422,1174,47,119,7,7,1,3,248
21117061200,2562,2233,65,93,3,9,8,10,329
21117061300,2447,2100,77,90,1,17,9,8,347
21117061400,3502,2973,131,148,9,9,7,17,529
21117061600,1343,880,235,112,12,15,0,1,463
21117063604,6741,5744,333,186,3,75,12,10,997
21117063606,4375,3992,106,58,0,26,2,11,383
21117063607,2747,2048,444,63,5,53,2,8,699
21117063608,6785,5877,249,205,12,123,6,8,908
21117063609,5827,5308,133,88,2,51,0,19,519
21117063610,6769,6086,164,100,11,59,2,28,683
21117063701,3589,3386,57,27,3,11,0,4,203
21117063702,4595,4367,44,10,0,9,0,0,228
21117063800,3011,2615,96,108,9,38,1,5,396
21117064001,3268,3037,71,19,0,38,0,15,231
21117064002,3298,2861,98,83,8,106,2,14,437
21117064300,3452,2886,140,135,11,63,13,8,566
21117064400,4083,3060,327,275,4,56,70,15,1023
21117064500,3595,3282,69,66,0,33,15,1,313
21117064600,5376,4697,193,253,9,50,8,11,679
21117064700,5646,5003,120,163,0,105,1,23,643
21117064800,3694,3153,253,96,0,62,0,8,541
21117064900,3186,2661,220,135,0,38,1,18,525
21117065000,3690,2452,466,482,7,18,1,21,1238
21117065100,3390,1873,129,1062,13,17,1,17,1517
21117065200,3986,3531,125,131,4,27,1,16,455
21117065300,10232,9095,272,222,22,114,6,36,1137
21117065400,1562,1259,62,130,2,33,2,7,303
21117065501,4314,3978,83,50,1,40,3,8,336
21117065502,3930,3633,93,12,2,54,0,4,297
21117065600,6360,4833,487,496,13,35,9,40,1527
21117065700,2101,1719,153,70,0,8,3,18,382
21117065800,3492,3199,61,54,6,18,0,6,293
21117065900,1438,1352,22,0,3,3,1,0,86
21117066801,3881,3420,96,81,12,27,0,5,461
21117066802,4884,4356,138,115,0,65,2,11,528
21117066900,4069,3669,88,78,4,13,2,4,400
21117067000,3392,2576,234,352,6,48,7,21,816
21117067100,2341,821,428,896,4,5,1,22,1520
21117067200,7257,5856,361,203,12,401,33,24,1401
21119960100,2023,1969,13,0,0,2,0,0,54
21119960200,2663,2580,5,2,0,1,0,5,83
21119960300,3627,3508,37,7,3,6,0,2,119
21119960400,2014,1989,3,1,0,2,0,0,25
21119960500,3924,3767,32,55,5,7,0,0,157
21121930100,1349,1304,12,3,3,0,0,0,45
21121930200,3452,3313,24,8,10,2,0,0,139
21121930300,2976,2790,31,4,12,5,0,3,186
21121930401,4417,4159,77,17,8,17,0,8,258
21121930402,3159,3000,41,3,0,24,0,4,159
21121930501,2112,2025,21,3,2,3,0,5,87
21121930502,3827,3515,51,127,15,15,1,3,312
21121930602,1719,1541,32,70,8,3,0,3,178
21121930603,2872,2690,43,25,16,16,0,3,182
21121930604,2492,2426,7,18,2,0,0,5,66
21121930700,1818,1746,8,3,6,0,0,0,72
21123960101,1684,1581,20,13,1,4,0,1,103
21123960103,3726,3223,145,156,15,15,0,9,503
21123960104,2686,2302,129,126,2,5,10,14,384
21123960200,2755,2500,75,27,8,1,5,11,255
21123960300,4016,3693,110,55,21,4,0,12,323
21125970100,3285,3137,31,7,11,9,0,0,148
21125970201,4169,3948,57,41,8,10,0,2,221
21125970202,2696,2552,19,25,11,3,0,2,144
21125970300,4474,4188,44,8,10,22,0,5,286
21125970400,3819,3482,65,33,2,92,0,11,337
21125970500,4588,4134,155,54,3,46,2,11,454
21125970600,3002,2742,52,69,4,31,0,4,260
21125970700,5862,5417,150,57,10,29,1,5,445
21125970800,5427,5086,88,26,10,64,0,11,341
21125970900,4141,3943,35,15,3,9,1,3,198
21125971001,4118,3918,46,30,7,13,0,10,200
21125971003,3823,3488,87,29,10,49,0,9,335
21125971004,2788,2639,31,9,13,19,0,14,149
21125971101,2583,2461,30,5,6,5,0,5,122
21125971103,4544,4291,65,18,16,9,0,3,253
21125971104,3294,3077,56,14,19,16,0,2,217
21127930101,2857,2768,24,1,0,2,1,5,89
21127930102,4658,4460,49,23,2,13,0,11,198
21127930200,1726,1652,18,1,0,2,1,2,74
21127930300,1511,1466,9,5,0,1,0,3,45
21127930400,2979,2902,11,3,0,2,1,0,77
21127930500,2562,2473,37,3,0,3,1,4,89
21129950100,4569,4179,39,269,1,0,0,4,390
21129950200,1440,1378,16,4,0,0,0,10,62
21129950300,1386,1330,5,7,0,0,0,5,56
21131920101,2881,2789,21,17,6,7,0,0,92
21131920102,2439,2346,15,13,4,1,0,2,93
21131920200,2490,2406,8,5,1,4,0,2,84
21131920300,2703,2629,28,4,4,3,0,0,74
21133950100,2588,2478,37,12,5,6,0,2,110
21133950201,2212,2139,7,10,0,2,0,5,73
21133950202,2283,2169,11,23,0,2,0,3,114
21133950300,1241,1219,2,2,0,0,0,0,22
21133950401,2679,2562,21,17,4,13,0,6,117
21133950403,2180,2122,14,4,4,3,0,0,58
21133950404,2284,2196,20,12,3,26,0,0,88
21133950500,1219,1165,9,1,1,2,0,3,54
21133950601,2198,2126,8,5,1,1,0,8,72
21133950602,2664,2597,4,1,12,2,0,0,67
21135930100,4098,3937,23,22,9,0,1,5,161
21135930200,3679,3539,19,9,5,3,1,0,140
21135930300,3462,3341,29,5,2,3,1,0,121
21135930400,1841,1782,12,0,2,3,1,1,59
21137920101,2016,1772,54,134,0,4,0,0,244
21137920102,4756,4272,124,175,10,29,0,7,484
21137920103,2423,2172,62,82,2,3,1,9,251
21137920200,5554,5226,96,37,2,14,1,9,328
21137920301,3065,2935,39,9,0,0,0,1,130
21137920302,2370,2212,40,9,0,4,0,10,158
21137920400,4091,3904,60,13,19,6,0,10,187
21139040100,2665,2489,43,7,4,3,5,3,176
21139040201,3351,3062,83,11,8,6,0,5,289
21139040202,2872,2681,60,7,7,3,1,6,191
21141960100,5888,5419,105,122,8,12,0,20,469
21141960200,3621,3401,74,19,5,6,1,3,220
21141960300,5797,4677,223,624,10,22,0,24,1120
21141960400,5003,4200,204,351,2,31,0,26,803
21141960500,4308,3641,94,369,10,20,1,13,667
21141960600,2815,2343,153,195,8,4,0,6,472
21143960101,3517,3058,48,293,10,12,0,14,459
21143960102,3365,2947,90,213,6,19,0,7,418
21143960200,1798,1728,14,1,9,3,0,0,70
21143980100,0,0,0,0,0,0,0,0,0
21145030100,1129,733,154,158,5,10,1,0,396
21145030200,1732,741,107,751,5,4,0,10,991
21145030300,1556,1160,42,270,5,5,0,3,396
21145030400,1596,496,29,957,1,4,1,4,1100
21145030500,2346,1352,152,646,33,20,1,20,994
21145030600,3571,2253,158,844,11,20,0,31,1318
21145030700,4398,2692,142,1186,14,48,0,27,1706
21145030800,4937,4298,131,230,8,64,0,14,639
21145030900,3398,2330,188,663,3,30,2,16,1068
21145031000,4250,3641,115,196,15,11,1,14,609
21145031100,5891,5238,119,168,14,48,2,6,653
21145031200,4482,4044,109,84,10,18,0,7,438
21145031301,5307,4217,183,506,3,81,6,25,1090
21145031302,6186,5557,122,198,11,87,0,5,629
21145031401,1759,1478,47,101,1,33,3,9,281
21145031402,5963,5098,138,369,7,125,0,10,865
21145031501,2213,1987,53,62,4,8,0,7,226
21145031502,4147,3728,78,91,12,31,1,7,419
21145031600,3014,2758,68,59,8,13,0,8,256
21147960100,2232,2133,41,8,9,5,0,1,99
21147960200,918,896,4,0,0,0,0,0,22
21147960301,3430,3282,32,6,10,4,1,7,148
21147960302,3115,2965,28,0,7,6,1,5,150
21147960401,3419,2234,221,844,25,12,0,4,1185
21147960402,3774,3562,39,50,7,5,1,0,212
21149970100,2929,2773,61,8,9,9,0,11,156
21149970200,3365,3217,46,8,1,4,0,10,148
21149970500,2858,2701,57,31,0,0,2,7,157
21151010101,2239,2068,74,11,2,7,1,7,171
21151010103,3676,3295,76,76,9,53,0,5,381
21151010104,4114,3700,144,77,11,17,2,10,414
21151010201,2213,1839,58,161,1,30,0,1,374
21151010202,1677,1382,69,121,0,7,0,4,295
21151010301,5325,4180,181,492,16,105,5,21,1145
21151010302,2670,2109,136,188,2,69,6,18,561
21151010303,1929,1475,90,206,7,24,10,2,454
21151010400,2098,1611,56,278,4,7,0,9,487
21151010500,2606,1680,114,167,13,9,5,7,926
21151010601,3207,2829,93,138,4,50,1,13,378
21151010602,2293,1994,70,77,9,11,1,11,299
21151010701,4890,3993,196,294,9,29,1,19,897
21151010702,4201,3604,147,145,7,113,1,12,597
21151010801,2428,2256,50,17,8,5,1,5,172
21151010802,2201,2000,38,42,3,36,0,2,201
21151010901,4191,3829,83,86,10,19,2,3,362
21151010902,4002,3306,232,174,6,104,0,16,696
21151010903,3905,3063,245,318,8,47,5,9,842
21151011001,3654,3367,62,46,8,28,0,5,287
21151011002,3170,2993,48,31,8,8,0,3,177
21151011101,3052,2847,54,40,3,14,0,4,205
21151011102,1915,1799,16,5,8,8,0,5,116
21151011103,2174,2050,41,14,1,1,0,2,124
21151011201,2483,2166,75,81,6,21,6,15,317
21151011202,4039,3599,81,149,12,20,7,16,440
21151011301,2391,2122,92,54,0,16,0,5,269
21151011303,3058,2339,220,252,2,58,2,4,719
21151011304,1953,1638,112,80,2,24,0,5,315
21151011401,3045,2751,76,28,6,39,0,9,294
21151011402,1902,1707,35,32,5,27,0,13,195
21153970100,1343,1300,10,3,0,0,0,5,43
21153970201,3033,2979,3,0,7,1,3,5,54
21153970202,2808,2731,26,1,2,2,1,1,77
21153970300,2720,2631,19,8,5,2,1,1,89
21153970400,1733,1694,8,2,0,0,1,1,39
21155970200,4857,3618,272,668,0,51,14,12,1239
21155970300,1968,1769,53,69,0,12,2,3,199
21155970400,3059,2932,38,13,0,5,0,3,127
21155970500,1990,1893,25,7,0,4,3,9,97
21155970700,5809,4777,270,444,0,46,28,24,1032
21155970800,1898,1790,23,8,0,5,0,2,108
21157950101,2691,2507,63,8,5,7,1,8,184
21157950102,2442,2293,43,5,6,11,0,1,149
21157950200,4792,4434,73,6,17,15,1,15,358
21157950300,4109,3848,63,5,10,21,1,4,261
21157950400,5562,5139,118,47,7,50,2,2,423
21157950501,2707,2608,30,5,0,14,1,0,99
21157950502,2936,2741,66,12,1,4,0,10,195
21157950601,2873,2751,40,4,6,6,3,4,122
21157950602,2583,2458,27,9,8,0,0,1,125
21157950603,964,918,16,0,0,1,0,0,46
21159950100,3126,3048,11,0,2,3,1,0,78
21159950201,3276,2168,260,774,34,9,0,0,1108
21159950202,3973,3897,19,6,2,4,0,1,76
21159950300,912,889,0,0,4,1,0,0,23
21161960100,3353,3093,76,57,2,4,0,8,260
21161960200,3305,2485,91,451,8,2,0,3,820
21161960300,4141,3420,101,342,13,47,0,21,721
21161960400,4640,4242,55,116,6,47,0,10,398
21161960500,1681,1537,33,51,0,7,0,1,144
21163970100,1040,869,46,49,10,5,0,0,171
21163970200,2141,1072,365,424,7,55,47,17,1069
21163970301,3249,2864,85,85,18,14,5,6,385
21163970302,6221,5436,195,138,35,46,12,21,785
21163970401,5543,5079,114,71,15,14,3,26,464
21163970403,4662,4150,141,102,11,45,4,13,512
21163970404,3607,3169,116,66,8,34,2,21,438
21163970500,3526,3269,69,14,28,2,0,17,257
21163980100,14,4,2,3,0,2,0,0,10
21165960100,3760,3607,38,17,6,2,2,1,153
21165960200,2353,2266,19,13,6,0,0,0,87
21167960100,4517,4221,86,24,13,10,1,16,296
21167960200,6123,5260,236,317,11,15,0,27,863
21167960300,3891,3324,155,188,5,25,3,28,567
21167960400,4574,4033,155,166,6,23,6,9,541
21167960500,3536,3262,71,53,5,1,4,2,274
21169960100,2308,2157,37,54,1,0,0,8,151
21169960200,3133,2951,63,30,2,0,0,11,182
21169960300,4845,4512,130,30,0,7,0,14,333
21171930100,1955,1890,47,1,0,0,0,5,65
21171930200,2225,2010,146,19,3,3,0,2,215
21171930300,2726,2433,94,136,0,1,0,11,293
21171930400,4432,4056,186,62,6,6,0,7,376
21173920100,3521,3231,83,36,4,31,0,8,290
21173920201,3490,2961,222,123,2,34,0,15,529
21173920202,4107,3467,201,248,8,11,1,10,640
21173920301,2992,2699,95,53,6,24,0,9,293
21173920302,5961,5404,158,128,4,30,0,9,557
21173920400,5203,4959,62,13,0,13,0,10,244
21173920500,2840,2642,104,13,2,2,0,4,198
21175950100,2508,2433,14,6,2,0,1,0,75
21175950200,2084,2009,12,2,5,1,0,0,75
21175950300,2313,2245,11,12,3,1,1,0,68
21175950400,4746,3793,364,465,6,15,2,10,953
21175950500,2075,2030,16,7,4,0,0,0,45
21177960100,1209,1138,18,18,1,2,0,0,71
21177960201,4000,3282,169,436,7,6,0,17,718
21177960202,3207,2883,83,129,13,19,1,6,324
21177960300,3603,3458,57,12,7,4,1,1,145
21177960400,5086,4655,77,194,10,10,1,20,431
21177960500,3417,3021,55,213,7,8,0,5,396
21177960600,3188,2938,25,127,1,5,0,0,250
21177960700,3703,3485,54,60,11,1,0,4,218
21177960800,2032,1921,22,10,4,0,0,3,111
21177960900,1483,1423,9,4,3,3,0,6,60
21179930100,3726,3423,95,84,0,13,0,4,303
21179930201,6330,5889,114,95,4,29,1,10,441
21179930202,2218,2029,65,35,7,10,0,5,189
21179930301,5380,4821,125,171,1,31,0,5,559
21179930303,3329,2560,113,423,7,10,0,28,769
21179930304,6825,5064,350,894,9,101,2,19,1761
21179930305,2120,1799,61,153,6,10,0,8,321
21179930400,3615,3136,94,225,5,19,1,17,479
21179930500,6895,6385,129,87,9,35,3,18,510
21179930600,2900,2760,25,8,11,4,0,4,140
21179930700,3400,3247,43,8,3,5,1,7,153
21181960100,2107,2007,36,0,4,3,0,6,100
21181960200,5430,5117,118,41,6,4,2,8,313
21183920100,3129,3027,29,18,5,0,0,4,102
21183920200,3797,3593,66,13,3,9,2,8,204
21183920300,4260,3862,180,39,5,25,0,17,398
21183920400,1839,1775,27,3,1,0,0,3,64
21183920501,3373,2860,361,41,1,9,0,10,513
21183920502,3938,3514,259,25,4,0,0,3,424
21183920600,2018,1917,38,6,4,1,0,5,101
21183920700,1418,1324,33,10,3,1,0,4,94
21185030100,2426,2238,71,21,2,13,0,9,188
21185030200,4681,3529,254,705,13,13,1,25,1152
21185030301,4030,2958,655,165,10,18,2,15,1072
21185030302,4986,4092,338,226,13,44,0,3,894
21185030401,7137,6226,264,161,18,81,0,20,911
21185030402,3337,2976,114,49,5,34,0,14,361
21185030501,4493,3781,284,141,3,46,3,15,712
21185030502,5048,4653,114,54,9,48,1,17,395
21185030601,6762,5749,245,259,8,154,2,20,1013
21185030602,5509,4887,229,102,9,62,3,12,622
21185030701,2775,2407,88,51,7,112,0,16,368
21185030703,4048,3594,167,74,5,32,2,12,454
21185030704,2962,2504,101,82,1,174,0,4,458
21185030801,4581,3925,156,62,1,267,0,17,656
21185030802,4832,4317,155,46,4,62,3,15,515
21187970100,3136,2837,126,32,8,8,0,0,299
21187970201,2345,2188,34,21,2,4,1,9,157
21187970202,2868,2675,47,26,6,6,1,3,193
21187970300,2929,2786,44,4,6,0,2,5,143
21189930100,2328,2249,21,11,0,0,3,4,79
21189930200,1723,1656,21,0,1,1,2,0,67
21191930101,3306,3164,24,1,4,4,1,6,142
21191930102,3617,3425,59,14,0,8,1,14,192
21191930200,2627,2484,29,8,9,2,1,7,143
21191930300,5094,4760,89,33,8,16,0,15,334
21193970300,2872,2774,21,6,10,4,0,0,98
21193970400,4425,4122,60,59,4,86,0,3,303
21193970501,3170,3022,21,31,9,12,0,2,148
21193970502,2461,2206,18,70,2,71,0,6,255
21193970601,2095,2005,10,22,5,1,0,0,90
21193970602,2595,2166,36,165,4,50,0,12,429
21193970700,1884,1808,4,11,1,10,0,0,76
21193970800,3174,3050,13,3,10,0,0,2,124
21193970900,1584,1535,5,0,1,4,0,0,49
21193971000,4213,4060,33,7,5,17,1,4,153
21195930100,2816,2719,23,6,2,3,0,3,97
21195930201,2991,2749,53,23,3,59,0,14,242
21195930202,3080,2869,72,15,5,51,0,1,211
21195930301,2138,1757,84,135,8,63,5,12,381
21195930302,1878,1603,75,114,4,17,2,3,275
21195930400,3014,2824,53,35,1,40,0,2,190
21195930500,2614,2435,38,21,6,34,0,0,179
21195930600,3350,3248,16,17,2,2,0,1,102
21195930700,2193,2122,16,0,2,5,0,0,71
21195930800,2858,2771,9,2,0,2,0,2,87
21195930900,1829,1788,9,10,0,1,0,2,41
21195931000,1950,1892,15,4,3,0,0,1,58
21195931101,1935,1866,27,6,0,19,0,2,69
21195931102,2358,2293,9,5,2,3,0,1,65
21195931200,3726,3577,46,0,2,3,0,8,149
21195931300,2478,2393,7,0,4,3,1,4,85
21195931400,2664,2492,31,22,7,41,0,15,172
21195931500,3743,3534,26,43,5,8,0,2,209
21195931600,1478,1417,13,4,0,7,0,4,61
21195931700,3858,3755,26,8,7,4,0,6,103
21195931800,2905,2803,37,8,2,3,3,0,102
21195931900,2813,2728,10,7,3,1,0,9,85
21197970101,1992,1916,25,0,0,1,0,5,76
21197970102,4742,4500,81,27,11,18,0,17,242
21197970201,3121,2965,61,17,6,5,0,0,156
21197970202,3274,3126,30,20,0,6,0,1,148
21199930101,3090,2920,74,6,0,8,0,4,170
21199930102,2925,2747,51,5,5,7,0,11,178
21199930200,5512,5137,157,34,11,14,2,3,375
21199930301,2230,2119,25,3,14,4,0,6,111
21199930302,2823,2696,17,9,5,12,2,4,127
21199930401,3474,3165,128,33,9,14,0,18,309
21199930403,2559,2307,126,23,1,29,0,5,252
21199930404,3401,3124,104,26,5,32,3,10,277
21199930503,3785,3478,83,31,9,35,0,13,307
21199930504,3169,2837,74,38,13,117,0,14,332
21199930505,4127,3805,94,43,9,46,0,2,322
21199930506,2701,2338,149,84,8,29,0,2,363
21199930600,4330,3757,210,161,19,16,1,6,573
21199930700,4830,4297,186,98,10,36,2,12,533
21199930801,3549,3114,205,46,11,11,0,10,435
21199930802,2533,2376,58,17,8,1,0,7,157
21199930900,2640,2482,39,4,1,11,0,2,158
21199931000,1620,1531,16,3,5,3,0,7,89
21199931101,2775,2569,50,9,10,7,0,6,206
21199931103,1255,1188,8,3,1,0,0,4,67
21199931104,1706,1613,23,1,6,4,0,4,93
21201970100,2193,2106,19,6,3,7,0,0,87
21203950100,3081,2944,39,9,6,7,0,4,137
21203950201,2997,2839,33,11,2,2,0,6,158
21203950202,3787,3572,43,22,12,15,0,8,215
21203950300,3880,3745,39,10,11,1,0,0,135
21203950400,2292,2216,18,0,2,3,0,6,76
21205950100,5965,5599,103,35,11,41,0,11,366
21205950201,3601,3373,88,24,5,16,0,4,228
21205950202,5687,5036,188,197,2,64,1,82,651
21205950301,2606,2334,51,88,1,26,0,6,272
21205950302,2897,2710,56,23,11,2,3,1,187
21205950400,3906,3721,55,5,2,8,1,1,185
21207960101,3723,3370,234,11,5,36,0,6,353
21207960102,5495,4926,334,33,29,41,1,6,569
21207960200,1512,1447,19,6,11,0,0,1,65
21207960300,3975,3658,97,53,10,18,2,8,317
21207960400,3286,3096,97,10,3,9,0,2,190
21209040101,2089,1418,179,341,6,22,0,5,671
21209040102,2469,1981,154,200,7,16,0,6,488
21209040203,4721,3927,268,238,6,48,2,9,794
21209040205,4946,3561,791,312,6,35,0,17,1385
21209040207,1260,1073,42,66,0,6,1,5,187
21209040208,2447,2081,73,134,2,17,0,14,366
21209040209,2597,2030,160,209,3,22,0,9,567
21209040210,2010,1555,153,147,0,4,1,6,455
21209040301,3458,2710,245,284,4,53,3,0,748
21209040302,2431,2186,59,69,0,31,0,7,245
21209040303,3555,2978,153,139,4,112,3,15,577
21209040400,3169,2868,98,43,3,15,0,8,301
21209040501,2706,2499,57,33,3,8,0,8,207
21209040502,4257,3874,89,72,4,25,0,15,383
21209040601,3527,3144,102,122,0,30,0,20,383
21209040604,2798,2481,68,111,2,34,1,10,317
21209040605,2604,2378,75,31,2,7,5,10,226
21209040606,2795,2259,93,233,3,18,2,10,536
21209040607,3316,2701,244,123,1,84,1,11,615
21211040101,3715,3444,73,42,2,10,0,11,271
21211040102,4512,4102,160,71,4,5,0,15,410
21211040201,3281,2615,427,80,7,16,1,11,666
21211040202,5168,4238,461,219,9,40,0,17,930
21211040301,6024,2973,1828,835,7,33,12,28,3051
21211040302,3314,1880,806,394,8,42,3,20,1434
21211040402,4342,3760,185,165,12,43,0,18,582
21211040403,4394,3528,402,191,10,24,6,11,866
21211040404,3718,2641,441,345,4,46,0,17,1077
21211040501,2496,2219,111,36,1,10,0,17,277
21211040503,3696,2950,318,192,4,47,0,26,746
21211040504,3405,3013,83,130,8,45,0,21,392
21213970100,2344,2144,44,75,11,2,1,6,200
21213970200,5094,4257,174,386,12,20,1,16,837
21213970300,5042,3982,184,582,13,24,3,26,1060
21213970401,4493,3671,137,376,8,41,0,9,822
21213970402,2621,2147,109,203,14,7,0,15,474
21215080101,4830,4388,107,81,11,29,6,3,442
21215080102,6237,5654,179,104,7,36,3,12,583
21215080103,2129,1971,33,16,1,10,0,2,158
21215080200,6294,5751,131,96,13,15,3,13,543
21217920100,2697,2535,67,15,1,3,1,8,162
21217920200,3096,2923,55,33,0,14,1,4,173
21217920300,4752,4050,165,256,2,78,3,12,702
21217920401,4468,3524,157,438,12,119,5,48,944
21217920402,3900,3418,112,165,0,20,0,13,482
21217920501,2911,2675,57,64,5,8,0,8,236
21217920502,4199,3599,107,281,6,2,0,17,600
21219950100,2899,2728,73,5,4,4,3,2,171
21219950200,5437,4593,265,361,4,3,1,24,844
21219950300,2457,1654,167,458,6,13,2,15,803
21219950400,1450,1259,93,56,0,2,0,0,191
21221970100,2674,2403,50,136,5,2,0,1,271
21221970201,2914,2173,63,528,10,8,0,5,741
21221970202,3798,3340,73,205,8,12,4,17,458
21221970301,2647,2448,71,51,6,1,1,5,199
21221970302,2023,1838,58,30,5,4,0,6,185
21221980100,1,0,1,0,0,0,0,0,1
21221980200,4,0,1,0,0,0,1,0,4
21223100100,3190,2998,65,2,13,13,3,1,192
21223100200,5284,4916,127,26,16,14,1,7,368
21225950100,1670,1535,23,56,6,0,0,6,135
21225950201,4806,3924,76,531,8,28,0,14,882
21225950202,2720,2288,46,288,4,1,0,10,432
21225950300,4472,4055,43,154,9,3,1,9,417
21227010100,2755,1993,157,366,9,92,1,12,762
21227010200,3524,1486,417,1258,6,143,6,18,2038
21227010300,4503,2171,1070,937,8,112,0,15,2332
21227010400,4168,3157,157,553,4,112,3,23,1011
21227010500,2271,1926,95,128,3,27,6,4,345
21227010600,4302,3160,292,396,7,124,94,12,1142
21227010701,5422,3551,384,370,12,840,57,19,1871
21227010702,6647,3903,355,545,18,1448,74,39,2744
21227010801,3984,3113,268,265,10,134,24,23,871
21227010802,8708,7100,307,329,7,634,0,33,1608
21227010804,2882,1945,86,435,2,190,11,31,937
21227010805,3998,2887,239,383,0,221,71,47,1111
21227010900,4703,3546,246,379,9,197,35,30,1157
21227011001,4305,1607,914,834,9,685,42,15,2698
21227011002,7852,3944,1063,1281,12,983,94,52,3908
21227011100,7759,6037,418,502,14,361,40,32,1722
21227011200,5369,2536,911,1369,7,211,21,33,2833
21227011300,4733,3492,359,509,19,61,18,12,1241
21227011401,7233,6270,245,263,6,192,8,41,963
21227011402,3501,2847,150,159,3,177,23,12,654
21227011500,7550,6869,192,104,14,70,12,30,681
21227011600,5964,5259,150,310,3,30,0,19,705
21227011701,5749,4005,513,775,8,53,11,42,1744
21227011702,3705,3299,98,88,11,18,2,9,406
21227011801,3187,2947,99,29,9,15,0,0,240
21227011802,2721,2514,67,22,9,11,3,6,207
21227011900,7059,6180,189,215,16,154,5,21,879
21229930100,2833,2664,53,21,8,2,0,10,169
21229930201,3442,2413,279,503,8,17,5,22,1029
21229930202,3552,3263,94,102,4,15,0,4,289
21229930300,2200,2057,44,26,5,4,0,16,143
21231920101,1626,1525,35,4,4,9,0,0,101
21231920102,2787,2590,50,58,7,11,0,2,197
21231920201,1880,1684,120,19,0,5,0,6,196
21231920202,3851,3230,399,85,2,15,0,1,621
21231920300,3815,3470,212,42,5,12,0,2,345
21231920401,1578,1487,45,16,0,6,3,3,91
21231920402,1572,1522,21,3,6,0,0,0,50
21231920701,1031,992,10,0,4,1,0,2,39
21231920702,1415,1372,10,1,0,1,2,1,43
21233960100,4431,3555,706,22,10,10,0,18,876
21233960200,2756,2540,42,72,5,0,0,4,216
21233960300,2102,1972,37,8,2,6,1,4,130
21233960400,3728,3078,60,374,6,8,0,17,650
21235920100,3058,2795,74,15,13,26,0,6,263
21235920200,2896,2660,89,16,8,29,0,1,236
21235920301,1866,1772,17,3,1,2,0,2,94
21235920302,4888,4640,63,14,13,25,0,5,248
21235920401,1975,1888,22,9,12,6,0,1,87
21235920402,4149,3938,58,9,7,8,0,5,211
21235920501,1735,1657,22,3,0,6,0,0,78
21235920502,4401,4150,47,36,2,5,0,1,251
21235920601,1103,1015,24,7,3,10,0,9,88
21235920602,4371,3596,187,401,6,80,10,18,775
21235920700,4498,4274,68,12,12,2,0,0,224
21235920800,1772,1691,16,6,12,5,0,2,81
21237930100,2964,2871,20,13,5,2,0,12,93
21237930200,3598,3485,41,14,4,3,0,3,113
21239050103,3635,2392,602,421,5,19,0,12,1243
21239050104,3937,3200,314,195,1,21,1,18,737
21239050105,3384,2804,231,153,5,37,2,2,580
21239050106,3921,3493,197,94,0,15,0,14,428
21239050107,4167,3508,300,174,2,39,0,9,659
21239050200,3759,3434,119,22,4,13,3,7,325
21239050300,1773,1551,121,32,5,6,3,8,222
21239050400,2295,1979,129,120,6,7,1,6,316
22001960101,3405,2442,150,719,0,1,0,3,963
22001960102,2431,1224,85,993,4,8,0,4,1207
22001960201,3331,2878,123,227,10,10,0,17,453
22001960202,2502,2343,40,49,11,10,0,6,159
22001960300,3521,3229,114,82,16,8,0,7,292
22001960401,2246,2017,86,77,5,10,0,4,229
22001960402,2133,1902,83,91,2,0,0,0,231
22001960403,2274,2175,44,11,9,4,0,5,99
22001960501,2866,2542,112,121,2,4,0,5,324
22001960502,2025,1726,62,175,6,5,0,2,299
22001960503,1271,1092,25,127,5,2,0,0,179
22001960601,1660,1201,44,341,8,7,0,5,459
22001960602,3993,3006,62,815,3,6,2,3,987
22001960700,3728,1872,52,1643,19,18,0,14,1856
22001960801,3593,2779,97,582,12,14,0,8,814
22001960802,1344,1166,33,93,2,17,0,2,178
22001960901,3189,1334,72,1674,3,25,0,2,1855
22001960902,1183,338,36,767,3,0,0,0,845
22001961000,4607,3103,214,1112,10,8,0,8,1504
22001961100,3125,2861,49,122,14,2,0,2,264
22001961200,3149,2885,58,125,1,4,0,2,264
22003950100,4684,4264,96,40,77,15,0,10,420
22003950201,2574,1896,48,458,43,21,0,6,678
22003950202,1951,571,856,482,11,23,0,0,1380
22003950300,2817,1332,50,1196,22,22,2,23,1485
22003950400,3860,2730,126,794,45,16,3,14,1130
22003950501,3380,2640,82,449,78,32,0,2,740
22003950502,3484,1713,635,597,249,54,2,6,1771
22005030102,5218,4312,479,214,13,9,1,17,906
22005030104,3680,2619,247,613,4,65,0,22,1061
22005030105,6741,5025,494,875,12,57,2,16,1716
22005030106,2353,2123,116,25,7,5,1,3,230
22005030107,3167,2895,125,29,13,3,0,8,272
22005030207,6372,4352,426,1037,15,324,5,21,2020
22005030208,4410,3385,369,409,6,82,2,15,1025
22005030209,2641,2085,186,234,2,39,1,9,556
22005030210,5952,4188,412,1000,7,128,0,9,1764
22005030211,6881,4962,519,979,14,110,1,16,1919
22005030212,7182,4626,692,1451,16,136,3,37,2556
22005030213,4918,3281,338,966,12,119,0,19,1637
22005030214,5946,3455,880,1309,18,87,5,17,2491
22005030215,5411,3857,552,774,14,37,3,6,1554
22005030301,5172,3785,288,713,20,161,0,15,1387
22005030302,5614,2869,230,2332,9,48,0,8,2745
22005030303,3938,2074,338,1272,12,56,0,16,1864
22005030304,2153,1211,204,637,5,37,0,1,942
22005030403,2634,1521,260,736,8,13,0,15,1113
22005030404,2955,1394,401,1043,9,13,0,14,1561
22005030405,4911,1450,929,2362,9,45,0,7,3461
22005030406,4245,1224,415,2470,3,27,4,13,3021
22005030501,3137,2374,213,422,5,22,1,0,763
22005030502,2468,2259,100,45,8,0,1,2,209
22005030503,3040,2709,173,49,4,4,0,7,331
22005030600,5624,3233,625,1525,20,38,2,21,2391
22005030900,3906,879,234,2696,0,6,0,10,3027
22005031001,2304,868,69,1315,0,7,0,4,1436
22005031002,3527,630,69,2764,1,3,0,7,2897
22007050100,3245,1475,119,1604,0,4,0,0,1770
22007050201,2822,2704,75,4,3,3,0,0,118
22007050202,2159,2030,65,3,6,7,0,0,129
22007050300,3419,1575,74,1680,12,7,0,7,1844
22007050400,2895,1750,139,952,7,4,0,0,1145
22007050500,2523,1026,107,1312,9,8,0,0,1497
22007050600,3976,3020,335,418,46,23,0,10,956
22009030100,2290,2095,37,74,10,7,0,6,195
22009030200,2807,2696,23,13,3,4,0,1,111
22009030300,3855,3103,61,471,41,15,0,11,752
22009030401,3881,2343,58,1138,56,19,0,15,1538
22009030402,2863,1064,47,1491,85,4,1,10,1799
22009030501,3650,2985,84,417,27,13,0,4,665
22009030502,3395,1803,38,1325,25,12,0,5,1592
22009030600,4509,1940,143,2196,16,12,0,9,2569
22009030701,4152,1534,829,1426,22,234,1,30,2618
22009030702,3078,1867,62,1004,25,9,1,10,1211
22009030800,2842,2579,73,87,20,2,0,2,263
22009030900,2371,1227,30,1007,19,14,0,3,1144
22011960101,4027,3666,73,52,27,16,2,9,361
22011960102,2229,2058,33,45,10,4,0,12,171
22011960200,5084,4449,163,146,46,25,2,10,635
22011960300,3963,2082,259,1270,32,53,1,23,1881
22011960400,3066,1847,114,908,30,26,3,10,1219
22011960500,5099,3503,300,917,33,79,17,1,1596
22011960600,3119,2684,66,175,28,5,0,7,435
22011960701,4253,3916,114,72,24,5,0,8,337
22011960702,5709,4834,149,497,43,9,2,11,875
22013970100,3330,950,69,2203,13,6,2,4,2380
22013970200,1519,511,36,915,4,1,0,0,1008
22013970300,2994,1647,46,1144,16,2,0,0,1347
22013970400,2424,2020,35,236,22,7,3,2,404
22013970500,2714,1773,25,775,6,5,0,4,941
22015010400,1680,299,228,1042,3,25,1,4,1381
22015010500,4605,2069,454,1623,15,198,1,16,2536
22015010601,6718,1725,1133,3456,20,105,5,29,4993
22015010602,2952,1021,276,1402,5,126,0,7,1931
22015010701,4151,1533,528,1829,15,59,0,26,2618
22015010702,4059,1283,680,1732,16,100,14,33,2776
22015010801,3509,1210,699,1327,22,63,3,32,2299
22015010805,3032,1356,214,1216,14,96,4,7,1676
22015010806,4014,2649,282,697,19,65,6,15,1365
22015010807,3732,2359,234,741,15,142,9,9,1373
22015010808,4532,2930,383,813,19,78,1,16,1602
22015010900,1951,1113,304,253,9,53,16,14,838
22015011002,4959,3603,283,646,24,111,8,15,1356
22015011003,4729,3408,390,589,18,75,5,12,1321
22015011004,3195,2239,115,630,28,24,0,23,956
22015011107,1991,1024,90,731,11,21,0,8,967
22015011111,5141,3528,432,807,37,22,1,17,1613
22015011112,4296,2943,195,832,25,15,1,23,1353
22015011113,4300,3149,423,399,31,53,0,9,1151
22015011114,2750,1917,289,374,12,16,5,9,833
22015011115,1770,1394,62,194,23,3,2,6,376
22015011116,6725,5611,280,374,27,103,5,19,1114
22015011117,7126,5083,370,1064,33,225,0,19,2043
22015011118,1740,925,312,389,7,16,0,4,815
22015011119,4205,2860,227,772,4,133,6,22,1345
22015011120,3611,2922,136,360,10,75,7,7,689
22015011121,2066,1731,84,126,16,11,1,2,335
22015011122,10313,7567,527,1401,44,241,5,40,2746
22015011123,4385,3409,203,496,18,52,2,18,976
22015011124,2029,1716,122,57,23,7,1,5,313
22015011201,4655,2507,102,1890,6,4,0,5,2148
22015011202,2035,1613,45,288,0,1,4,4,422
22015011300,1790,286,135,1318,4,23,0,5,1504
22017020500,2611,138,53,2368,8,2,1,1,2473
22017020600,861,23,11,783,3,0,0,4,838
22017020700,761,12,7,723,0,3,1,0,749
22017021000,1328,728,88,401,9,18,0,4,600
22017021100,2403,788,150,1329,11,17,0,24,1615
22017021200,3535,1811,277,1205,28,19,2,13,1724
22017021300,2646,328,220,1904,5,100,1,17,2318
22017021400,2049,913,171,776,3,46,4,16,1136
22017021500,2154,1415,121,448,5,27,11,23,739
22017021600,3748,2657,165,647,7,102,3,17,1091
22017021700,1662,217,50,1340,5,3,0,4,1445
22017021800,1353,129,25,1160,1,3,1,3,1224
22017021900,1082,57,12,987,0,1,0,2,1025
22017022000,1478,27,23,1400,0,0,0,2,1451
22017022101,4824,355,62,4219,14,24,0,6,4469
22017022102,1486,39,11,1369,10,0,1,9,1447
22017022200,3781,339,72,3235,26,9,0,21,3442
22017022300,2214,115,75,1949,0,5,0,1,2099
22017022400,3203,196,73,2808,3,6,3,19,3007
22017022500,4010,273,129,3426,8,17,0,11,3737
22017022600,3000,2599,119,159,7,19,1,14,401
22017022700,2192,1892,103,51,21,19,4,4,300
22017022800,3851,3221,205,162,22,51,1,18,630
22017022900,4502,2980,231,937,20,123,4,9,1522
22017023000,4346,3297,170,568,8,128,5,13,1049
22017023100,1484,1101,55,276,0,7,2,1,383
22017023200,1351,148,51,1048,10,9,0,15,1203
22017023300,1918,37,30,1788,9,0,1,2,1881
22017023401,3712,268,54,3297,3,4,0,6,3444
22017023402,2479,198,20,2185,10,14,0,5,2281
22017023500,2762,32,22,2646,3,2,0,0,2730
22017023600,2775,27,25,2646,0,14,0,8,2748
22017023701,3649,174,92,3293,11,16,0,5,3475
22017023702,2097,162,54,1845,1,1,1,1,1935
22017023801,3640,1743,112,1565,6,87,1,9,1897
22017023802,1838,153,26,1610,0,3,0,2,1685
22017023903,3963,2538,210,946,19,103,10,8,1425
22017023904,3439,1958,166,987,7,180,1,18,1481
22017023905,4710,2732,192,1293,17,290,9,26,1978
22017023906,3234,2213,99,685,4,92,9,5,1021
22017023907,3654,2156,177,818,21,325,2,17,1498
22017024001,7312,5896,308,540,18,261,1,23,1416
22017024002,6423,5292,202,382,28,328,0,9,1131
22017024102,3835,2316,125,1165,39,31,0,4,1519
22017024104,6860,1526,204,4794,28,102,2,36,5334
22017024107,4843,1512,161,2918,20,43,3,42,3331
22017024108,6572,2944,213,3124,24,55,2,23,3628
22017024109,3724,1825,200,1510,12,34,0,11,1899
22017024110,2671,412,38,2122,12,19,4,0,2259
22017024111,4534,1620,160,2539,10,30,0,16,2914
22017024201,3926,678,76,3037,9,20,0,14,3248
22017024204,4947,3151,173,1302,40,24,5,22,1796
22017024205,2160,1543,69,413,20,10,0,3,617
22017024206,2592,1967,81,421,17,5,0,11,625
22017024207,1987,1547,48,300,16,2,0,1,440
22017024303,5802,1518,437,3570,16,31,0,31,4284
22017024304,4841,2884,219,1399,33,35,0,61,1957
22017024305,2582,1001,229,1245,9,18,0,8,1581
22017024306,3910,512,58,3232,6,18,0,18,3398
22017024400,4451,1550,115,2572,9,56,2,25,2901
22017024503,4914,2322,348,1970,19,12,10,31,2592
22017024504,5884,4778,212,449,44,13,9,13,1106
22017024601,4369,346,69,3836,5,4,0,14,4023
22017024602,5309,395,63,4729,14,4,0,4,4914
22017024700,1924,976,63,756,7,34,0,9,948
22017024800,876,584,37,234,1,0,0,3,292
22017024900,2953,2323,39,438,17,6,1,7,630
22017025000,3119,1587,61,1285,14,28,0,4,1532
22017025100,1687,1238,43,335,8,5,1,3,449
22017025200,985,63,9,871,4,0,0,1,922
22017025300,1137,373,42,677,5,5,0,0,764
22017025405,4696,3623,107,708,17,39,1,19,1073
22017025406,4238,3236,164,614,29,18,0,7,1002
22017980000,0,0,0,0,0,0,0,0,0
22019000100,2341,1253,117,847,12,25,1,7,1088
22019000200,1535,168,17,1277,12,4,0,5,1367
22019000300,1733,81,42,1545,1,2,0,5,1652
22019000400,1639,33,34,1511,0,0,2,11,1606
22019000500,3394,2617,203,410,17,18,3,15,777
22019000601,3322,229,180,2798,4,2,1,18,3093
22019000602,3610,420,105,2934,4,7,0,19,3190
22019000700,5575,2301,399,2523,24,89,0,31,3274
22019000800,3746,1490,211,1806,31,28,2,11,2256
22019000900,4220,798,176,3046,10,87,0,19,3422
22019001000,3859,3045,179,468,10,62,4,13,814
22019001100,4565,2160,410,1433,27,257,8,19,2405
22019001201,5218,1169,344,3309,13,102,0,26,4049
22019001202,3489,373,180,2758,15,9,9,16,3116
22019001301,3795,2560,281,553,10,227,3,25,1235
22019001302,3604,2651,201,451,10,107,3,12,953
22019001401,3010,774,84,2034,4,9,2,17,2236
22019001402,3238,109,33,2965,17,0,8,26,3129
22019001500,1887,121,52,1612,0,3,1,26,1766
22019001600,4736,1034,215,3291,4,42,1,19,3702
22019001700,13008,6944,881,4261,69,265,9,90,6064
22019001802,6972,4986,496,886,35,251,18,53,1986
22019001803,5259,4475,176,157,18,206,3,21,784
22019001901,3673,3011,166,169,7,185,1,23,662
22019001905,3872,2509,223,654,33,295,20,20,1363
22019001906,3817,2661,280,449,12,259,1,8,1156
22019001907,3764,2327,488,555,16,214,4,15,1437
22019001908,3170,2536,176,190,7,151,2,21,634
22019002001,5368,4419,163,548,35,28,0,23,949
22019002002,6166,4386,299,1212,19,17,2,39,1780
22019002100,3501,2134,88,1067,11,19,5,7,1367
22019002204,5680,4618,253,472,27,74,0,13,1062
22019002205,5098,4414,172,256,20,32,0,6,684
22019002206,4839,4043,221,307,20,34,2,19,796
22019002207,3750,3033,199,289,22,43,1,8,717
22019002208,3242,2608,133,281,21,43,0,18,634
22019002300,3399,3036,89,127,13,11,0,4,363
22019002401,3266,2890,70,157,23,5,2,2,376
22019002402,2625,1770,50,684,30,8,0,0,855
22019002500,4430,3730,188,332,13,27,0,16,700
22019002600,4743,3384,298,839,9,40,1,3,1359
22019002701,4809,4343,182,112,26,12,0,8,466
22019002702,3240,2583,180,344,3,31,3,0,657
22019002800,4530,3438,381,436,33,15,1,2,1092
22019002900,2179,1794,123,138,10,6,0,10,385
22019003000,4793,3573,347,562,8,34,4,11,1220
22019003101,5332,4440,339,246,23,58,1,9,892
22019003102,2450,1974,181,144,0,57,0,6,476
22019003200,2076,1722,139,73,10,42,3,8,354
22019003300,6185,4957,355,409,30,220,6,7,1228
22019003400,5399,4929,200,106,19,5,0,26,470
22019003500,3449,2273,291,664,28,26,0,11,1176
22019003601,3066,2732,89,101,20,4,0,6,334
22019003602,1119,1052,5,27,7,0,0,0,67
22019980000,0,0,0,0,0,0,0,0,0
22019980100,0,0,0,0,0,0,0,0,0
22021000100,2199,1961,59,102,2,20,2,3,238
22021000200,2790,2001,65,628,6,11,0,1,789
22021000300,4656,3589,97,798,11,11,1,2,1067
22023970101,3132,2856,133,29,14,11,0,7,276
22023970102,935,866,28,28,3,0,0,0,69
22023970202,624,573,14,14,6,1,1,1,51
22023970203,926,879,22,0,5,1,0,0,47
22023990000,0,0,0,0,0,0,0,0,0
22025000100,4026,2632,553,718,11,15,3,4,1394
22025000200,2106,604,28,1415,6,3,1,6,1502
22025000300,2774,2502,33,142,17,8,2,0,272
22027950100,3035,1917,32,989,10,4,0,4,1118
22027950201,2431,1333,295,765,4,13,0,0,1098
22027950202,1039,739,15,241,1,0,0,6,300
22027950300,2147,776,40,1239,12,2,0,1,1371
22027950400,3035,817,41,2054,15,14,0,2,2218
22027950500,2483,1482,56,850,1,9,0,8,1001
22029000100,2234,1361,30,794,7,6,0,3,873
22029000201,2360,554,45,1700,11,7,0,1,1806
22029000202,2755,537,31,2130,1,0,0,0,2218
22029000300,3766,2246,101,1257,7,3,0,0,1520
22029000400,4277,2895,146,1088,8,51,0,12,1382
22029000500,3295,2564,106,508,5,48,0,0,731
22031950101,2608,1598,76,779,33,7,0,2,1010
22031950102,3459,2506,123,586,65,12,0,6,953
22031950103,4396,3632,137,360,47,30,0,18,764
22031950200,3755,2560,114,881,26,2,0,24,1195
22031950300,2484,1348,70,956,11,7,0,8,1136
22031950400,2785,805,106,1759,8,27,0,4,1980
22031950500,1901,396,42,1395,16,0,0,3,1505
22031950600,2854,316,33,2421,13,11,0,4,2538
22031950700,2570,1961,61,449,23,3,0,3,609
22033000100,1541,66,9,1425,4,0,1,3,1475
22033000200,6535,262,110,5976,17,1,0,10,6273
22033000300,1424,36,14,1348,1,0,0,0,1388
22033000400,2606,105,37,2375,1,11,0,17,2501
22033000500,3439,127,24,3237,5,0,0,5,3312
22033000601,2993,60,38,2868,0,0,0,0,2933
22033000602,3893,48,40,3731,3,1,2,8,3845
22033000701,2103,71,133,1808,12,14,0,12,2032
22033000702,3122,87,49,2892,2,15,0,7,3035
22033000900,3656,47,49,3477,6,3,1,8,3609
22033001000,2754,39,39,2608,0,6,1,3,2715
22033001102,3647,463,98,2987,3,29,0,8,3184
22033001103,3005,264,90,2553,6,16,0,13,2741
22033001104,4005,92,517,3308,5,4,3,12,3913
22033001600,3178,1500,99,1406,4,25,0,12,1678
22033001700,5035,3219,220,1384,9,38,2,17,1816
22033001800,2271,1285,239,633,4,42,1,14,986
22033001900,2751,2298,129,207,5,33,0,0,453
22033002000,3562,2881,182,279,14,99,0,7,681
22033002200,1169,213,30,890,2,2,0,7,956
22033002300,2727,2394,127,69,10,23,0,18,333
22033002400,2576,495,265,1700,4,55,0,9,2081
22033002500,2762,874,106,1581,2,63,2,7,1888
22033002601,4288,3702,200,146,5,83,1,21,586
22033002602,4763,3287,294,940,2,96,1,7,1476
22033002700,1598,504,68,984,0,11,1,5,1094
22033002801,5647,3141,420,1566,15,315,5,16,2506
22033002802,4934,3690,282,500,15,330,3,8,1244
22033003000,4798,42,49,4628,5,1,0,23,4756
22033003104,5465,254,113,5021,4,2,0,4,5211
22033003201,3661,547,54,2949,5,14,0,2,3114
22033003202,3702,878,78,2620,3,8,2,19,2824
22033003300,4962,52,43,4747,2,5,0,7,4910
22033003400,6567,150,110,6188,3,3,0,18,6417
22033003501,2383,179,425,1699,0,24,0,0,2204
22033003504,5954,78,67,5731,7,1,4,5,5876
22033003505,4076,270,372,3329,7,4,1,7,3806
22033003506,6774,526,266,5736,9,123,0,21,6248
22033003507,5570,411,146,4858,10,41,0,9,5159
22033003601,3784,659,301,2506,10,224,0,22,3125
22033003603,2337,484,439,1316,2,30,0,14,1853
22033003604,5638,290,1213,3723,11,274,5,19,5348
22033003701,5841,3392,294,1636,2,310,0,34,2449
22033003702,3552,1529,197,1461,10,256,1,13,2023
22033003703,6576,2247,387,2764,17,979,3,22,4329
22033003804,4745,3203,241,869,5,230,0,18,1542
22033003806,3497,1320,292,1684,3,73,0,18,2177
22033003807,4064,2802,230,642,5,244,0,11,1262
22033003808,2786,1698,146,766,6,77,2,7,1088
22033003809,2934,2155,154,447,3,55,0,13,779
22033003810,2863,2137,151,382,1,83,2,11,726
22033003811,4136,2452,252,1037,2,267,0,13,1684
22033003907,6098,2814,486,2293,7,281,7,23,3284
22033003908,4485,2555,291,1202,3,213,4,29,1930
22033003909,4935,1640,346,2502,16,218,1,33,3295
22033003910,3226,585,1227,1231,5,92,0,14,2641
22033003911,2895,1280,189,1032,7,262,0,15,1615
22033003912,3963,293,872,2652,8,40,0,23,3670
22033003913,5684,3508,317,1257,3,381,3,29,2176
22033003914,3390,1843,241,857,4,289,1,16,1547
22033004010,4672,3183,431,679,3,177,0,26,1489
22033004013,3472,1033,228,1781,5,260,3,30,2439
22033004017,3704,1345,173,1887,13,160,0,15,2359
22033004018,2181,755,151,1126,7,63,0,11,1426
22033004019,4205,2804,239,798,7,220,0,22,1401
22033004020,5034,3852,233,524,5,260,0,17,1182
22033004021,4433,1867,405,1803,6,222,1,14,2566
22033004022,4978,2983,651,798,18,354,0,28,1995
22033004023,3229,1902,236,655,15,268,2,18,1327
22033004024,4382,2462,332,905,9,468,4,17,1920
22033004025,2473,1954,137,158,1,138,1,7,519
22033004026,7558,5529,376,645,11,790,0,11,2029
22033004027,2434,2043,115,72,6,142,0,5,391
22033004028,4071,903,1247,1603,9,156,0,28,3168
22033004029,4780,727,622,3235,9,69,1,9,4053
22033004030,3893,888,1119,1594,8,173,0,26,3005
22033004031,6719,3764,863,1393,14,396,0,18,2955
22033004201,5515,470,60,4882,8,3,0,15,5045
22033004203,3302,697,208,2289,8,8,1,15,2605
22033004204,3720,590,222,2810,3,16,0,5,3130
22033004205,5424,644,53,4636,4,8,1,13,4780
22033004301,6764,5168,214,1095,19,31,1,19,1596
22033004302,5733,5045,184,234,20,22,0,10,688
22033004401,5279,3727,328,975,10,54,3,13,1552
22033004402,6614,4878,415,958,19,81,0,29,1736
22033004403,6361,4548,333,1156,6,53,0,20,1813
22033004503,6582,1379,1315,3258,18,431,0,39,5203
22033004504,6618,2142,1362,2409,9,435,1,30,4476
22033004507,5665,3516,365,1264,7,277,0,28,2149
22033004509,7321,4049,513,2261,17,172,0,36,3272
22033004511,5188,1806,638,2381,10,199,0,35,3382
22033004512,2885,1425,142,939,2,290,0,8,1460
22033004513,4879,3559,282,585,8,233,3,13,1320
22033004514,3064,2578,140,186,5,66,0,1,486
22033004515,4698,3712,256,469,14,113,1,14,986
22033004516,4070,2764,298,674,8,158,2,26,1306
22033004602,6500,2596,150,3482,16,54,5,10,3904
22033004603,6383,2371,195,3564,6,80,1,19,4012
22033004605,7286,4073,201,2639,7,89,1,18,3213
22033004606,5898,3099,176,2295,11,95,0,19,2799
22033004700,5448,3612,137,1487,19,6,0,8,1836
22033004800,4048,2941,231,507,3,220,0,6,1107
22033004900,4550,3611,239,313,9,239,0,15,939
22033005000,3112,2555,140,159,5,86,2,5,557
22033005100,3228,1153,154,1743,0,74,0,12,2075
22033005200,1882,509,73,1215,7,29,1,7,1373
22033005300,3221,621,72,2388,8,31,11,8,2600
22033980000,0,0,0,0,0,0,0,0,0
22035000100,2532,835,47,1580,0,15,0,0,1697
22035000200,2752,1164,53,1500,2,2,0,5,1588
22035000300,2175,35,15,2084,0,0,0,0,2140
22037951300,2670,1272,24,1301,1,6,0,9,1398
22037951400,3462,1651,42,1633,10,10,6,14,1811
22037951501,1220,908,35,219,0,3,2,1,312
22037951502,7109,4488,204,2222,33,5,1,9,2621
22037951600,5078,3092,86,1733,16,22,0,9,1986
22039950101,2791,2530,39,133,5,6,0,15,261
22039950102,3869,3132,421,177,5,19,1,9,737
22039950200,1828,1657,32,77,4,6,0,8,171
22039950301,1089,790,55,189,3,0,0,9,299
22039950302,3453,2469,400,412,8,51,0,10,984
22039950401,3038,1452,59,1362,0,14,0,14,1586
22039950402,2986,2478,57,347,8,4,0,0,508
22039950500,2757,692,32,1941,3,6,0,10,2065
22039950600,3169,926,27,2036,3,41,0,2,2243
22039950700,3486,2694,98,595,3,28,0,0,792
22039950800,3884,2342,116,1340,3,8,1,14,1542
22041950100,3818,3244,48,437,9,5,0,1,574
22041950200,4353,2893,57,1314,4,1,0,5,1460
22041950300,5286,1399,82,3607,9,26,0,6,3887
22041950400,2650,2237,36,273,0,2,0,2,413
22041950500,1642,1480,19,106,4,0,0,0,162
22041950600,2025,1177,34,771,0,4,0,3,848
22043020100,2345,2181,39,11,28,2,1,0,164
22043020200,2930,2322,52,369,20,2,2,3,608
22043020300,2510,1136,24,1274,4,4,0,3,1374
22043020403,3824,3497,82,35,27,7,2,19,327
22043020404,2296,2151,28,4,15,4,0,7,145
22043020405,2994,2660,87,58,37,7,0,3,334
22043020406,5270,2731,1021,1309,62,41,1,7,2539
22045030101,4286,1466,101,2574,4,18,0,2,2820
22045030102,2066,1193,88,691,5,16,0,2,873
22045030201,2722,2245,74,322,10,6,0,2,477
22045030202,3671,2898,136,518,8,12,0,16,773
22045030301,3735,2386,209,741,14,262,0,11,1349
22045030303,3754,2441,235,511,17,403,0,23,1313
22045030304,2224,1777,261,123,13,8,0,1,447
22045030401,4068,2780,514,570,18,29,0,23,1288
22045030402,3305,1406,183,1348,6,255,2,17,1899
22045030500,4138,2414,261,1213,11,103,0,20,1724
22045030601,1650,1201,87,251,11,41,0,6,449
22045030602,5154,3706,251,902,23,126,0,13,1448
22045030700,3799,2887,293,440,17,24,0,0,912
22045030800,1819,72,29,1650,5,21,0,5,1747
22045030900,3278,830,136,2081,4,127,0,13,2448
22045031000,3009,410,62,2394,9,25,0,6,2599
22045031101,3307,1060,183,1871,4,80,0,5,2247
22045031102,1803,1111,126,466,9,8,0,15,692
22045031200,3150,1655,189,1114,8,64,0,16,1495
22045031301,3743,2621,218,618,23,160,0,5,1122
22045031302,2202,1132,117,730,12,116,0,5,1070
22045031600,3046,881,144,1856,16,29,1,21,2165
22045990000,0,0,0,0,0,0,0,0,0
22047952600,2368,864,17,1441,7,5,0,1,1504
22047952701,2797,2245,101,346,7,3,0,11,552
22047952702,3091,1311,121,1572,4,26,3,2,1780
22047952901,2759,2284,100,313,11,0,1,2,475
22047952902,2223,591,38,1561,0,0,3,0,1632
22047953000,2006,1090,86,780,8,0,0,10,916
22047953101,5408,2155,158,2918,14,19,4,3,3253
22047953102,2098,715,83,1236,1,8,1,10,1383
22047953200,7491,3377,714,3146,6,62,1,36,4114
22049970100,2673,1836,57,630,8,14,0,1,837
22049970200,3396,2584,69,578,9,18,0,7,812
22049970300,4336,3262,263,602,12,98,4,6,1074
22049970400,3001,1075,37,1784,4,9,1,4,1926
22049970500,1625,1139,42,351,1,7,0,5,486
22051020204,2782,2210,218,25,6,240,0,17,572
22051020205,3652,710,1385,1246,10,149,0,27,2942
22051020206,4415,2655,748,426,11,414,0,17,1760
22051020304,4379,3278,540,138,1,262,0,20,1101
22051020305,4589,2951,908,194,2,355,0,24,1638
22051020400,3068,2440,369,55,1,127,0,9,628
22051020502,6429,2116,2783,1003,12,231,0,63,4313
22051020505,1729,72,372,1239,0,6,0,7,1657
22051020506,4204,1926,1457,420,11,275,0,30,2278
22051020507,4276,2101,1242,556,4,189,2,23,2175
22051020511,4289,1875,1140,646,1,416,0,31,2414
22051020512,2731,1407,546,365,10,324,5,23,1324
22051020513,4690,2032,1172,952,0,335,2,29,2658
22051020514,3555,2727,403,75,0,232,0,14,828
22051020515,2923,1336,960,408,5,104,0,32,1587
22051020516,4723,1122,2418,1011,8,54,2,21,3601
22051020517,4336,2509,729,584,4,342,3,32,1827
22051020518,3421,1448,1137,578,8,110,0,20,1973
22051020519,4354,1807,1358,717,5,286,0,34,2547
22051020600,4804,349,1867,2433,7,18,3,48,4455
22051021000,2280,1045,521,588,6,55,0,9,1235
22051021100,2183,1119,673,205,19,89,0,6,1064
22051021200,2464,1091,805,409,6,74,6,7,1373
22051021300,2797,1898,513,101,7,132,0,12,899
22051021400,2133,1419,411,76,6,108,0,9,714
22051021500,2918,894,713,1072,8,132,0,25,2024
22051021601,3137,1061,1506,358,8,99,0,24,2076
22051021602,1566,1099,313,37,0,41,0,7,467
22051022601,2961,2637,169,22,0,47,1,24,324
22051023003,2745,2107,399,59,4,44,3,6,638
22051023004,4836,3607,714,225,2,126,2,19,1229
22051023300,1724,1207,297,65,9,53,0,14,517
22051023400,3201,2280,599,80,3,87,1,17,921
22051023500,4391,3165,764,142,14,124,0,30,1226
22051023600,4966,2814,1068,755,9,114,0,28,2152
22051023700,1986,53,135,1737,1,2,1,19,1933
22051023800,3765,1871,412,1300,7,40,0,13,1894
22051023901,2396,2039,243,39,6,21,0,0,357
22051023902,2305,1965,206,7,5,29,0,13,340
22051023903,2378,1995,214,43,4,26,1,11,383
22051023904,2752,2098,298,215,0,45,1,12,654
22051024001,2669,2301,195,58,1,13,0,0,368
22051024002,3051,2666,237,13,9,28,0,11,385
22051024100,3394,2452,384,311,7,69,1,5,942
22051024202,4756,2080,437,1541,16,488,0,31,2676
22051024300,2870,2079,349,299,1,29,0,16,791
22051024400,2784,1795,267,558,12,35,2,3,989
22051024500,1576,1126,204,158,5,17,0,10,450
22051024601,1125,232,115,728,0,16,2,2,893
22051024700,1493,909,183,331,6,34,0,6,584
22051024801,3055,2692,218,36,1,34,1,0,363
22051024900,1675,840,433,284,2,25,1,7,835
22051025002,3312,1075,1089,893,3,151,3,24,2237
22051025003,4286,1660,1337,927,4,175,0,22,2626
22051025004,3886,659,1011,1943,9,146,7,11,3227
22051025005,3959,730,540,2056,8,505,1,22,3229
22051025102,4500,2273,534,1094,4,392,0,18,2227
22051025103,3655,1291,575,1296,8,320,0,30,2364
22051025104,3670,1290,519,1435,5,168,0,60,2380
22051025201,2950,592,910,1291,7,48,0,18,2358
22051025202,6702,1751,2057,2493,13,157,10,33,4951
22051025300,2216,1167,563,349,12,46,0,13,1049
22051025400,4807,1429,1248,1731,32,188,3,29,3378
22051025500,2743,508,874,1168,4,74,2,32,2235
22051025600,1421,819,155,323,13,49,0,6,602
22051025700,1411,170,121,1055,6,5,0,9,1241
22051025800,1687,758,93,718,16,17,0,15,929
22051025900,3412,1732,338,1187,8,32,1,17,1680
22051026000,1918,1037,340,387,5,64,1,3,881
22051026100,5140,822,1257,2686,15,230,1,28,4318
22051026200,1317,37,77,1154,1,5,0,3,1280
22051026300,2407,1611,276,344,12,53,2,15,796
22051026400,1761,1152,217,176,17,102,0,8,609
22051026500,1817,1263,213,216,20,41,1,10,554
22051026600,1992,1313,305,236,23,19,3,10,679
22051026700,1666,910,135,447,17,61,0,5,756
22051026800,2620,315,194,1938,1,99,0,7,2305
22051026900,3181,100,59,2933,1,5,0,8,3081
22051027000,6096,2009,549,2412,25,919,0,23,4087
22051027100,3221,1751,292,949,33,41,1,22,1470
22051027200,4864,2889,424,1277,38,42,2,29,1975
22051027501,6664,2381,583,3309,34,125,0,46,4283
22051027502,3298,26,144,3051,13,3,0,2,3272
22051027601,4815,1901,564,1630,20,521,0,16,2914
22051027602,3555,397,775,2098,13,168,2,13,3158
22051027701,5950,156,137,5434,5,73,0,23,5794
22051027703,4212,946,630,2224,24,238,0,19,3266
22051027803,4018,572,946,2187,6,182,1,20,3446
22051027806,6453,3510,914,1331,46,383,0,8,2943
22051027810,3915,290,354,2928,7,223,0,21,3625
22051027811,3285,232,229,2621,3,98,0,24,3053
22051027812,3982,152,279,3343,8,78,2,9,3830
22051027813,4531,1604,408,1863,12,484,1,34,2927
22051027814,3782,1288,356,1471,11,510,0,22,2494
22051027815,2379,227,150,1873,0,89,1,17,2152
22051027816,6636,1993,754,2635,16,988,1,40,4643
22051027817,5985,2995,769,1444,26,482,3,36,2990
22051027818,3296,1470,249,830,13,621,1,28,1826
22051027819,2303,1107,205,754,31,70,0,15,1196
22051027820,5433,2562,886,1472,46,210,0,22,2871
22051027903,1010,933,30,2,16,6,0,4,77
22051027904,3881,3202,192,71,68,39,0,10,679
22051028000,5613,3317,691,1042,72,227,0,16,2296
22051028200,4224,1907,948,1186,24,18,0,6,2317
22051028300,3057,504,358,2086,9,9,0,12,2553
22051028400,5442,4377,663,128,14,94,0,24,1065
22051028500,3934,3072,426,154,0,149,0,12,862
22051028600,2766,2150,377,54,7,76,1,18,616
22051028700,4517,1976,1633,511,0,180,1,34,2541
22051028800,3963,1524,589,1261,5,379,0,42,2439
22051028900,3939,2820,567,368,9,38,0,11,1119
22051029000,3115,2126,576,220,10,53,1,21,989
22051029100,3580,2439,669,223,18,55,0,27,1141
22051029200,3804,3265,326,51,3,54,1,9,539
22051029300,4306,3623,421,78,5,62,0,21,683
22051029400,3519,2987,300,17,4,118,0,13,532
22051029500,3801,3166,346,34,2,143,3,13,635
22051029600,6275,1337,2316,2146,5,228,3,55,4938
22051029700,2826,972,1035,552,4,131,0,36,1854
22051029800,3496,1302,1349,560,2,155,1,24,2194
22051029900,3942,1496,819,1321,19,101,0,19,2446
22051030000,2248,1711,340,68,10,28,0,12,537
22051030100,4986,3080,1110,277,11,355,0,27,1906
22051030200,4618,2677,1073,431,10,221,2,35,1941
22051030300,3129,1793,522,524,6,164,2,16,1336
22051980000,0,0,0,0,0,0,0,0,0
22051990000,0,0,0,0,0,0,0,0,0
22051990100,0,0,0,0,0,0,0,0,0
22053000100,5319,4157,174,650,77,21,0,23,1162
22053000200,5641,4856,135,390,27,7,0,24,785
22053000300,5116,3969,89,828,5,8,0,18,1147
22053000401,2692,2264,35,274,2,2,1,6,428
22053000402,3826,3252,65,373,7,32,0,22,574
22053000500,4523,3596,98,630,13,22,0,9,927
22053000600,2948,1512,104,1184,11,6,0,5,1436
22053000700,2185,1249,34,801,5,2,3,11,936
22055000100,3185,1589,122,1398,6,15,0,4,1596
22055000200,2123,208,72,1748,8,9,0,17,1915
22055000500,2443,2116,117,89,3,13,3,9,327
22055000602,4167,2799,307,835,12,34,3,26,1368
22055000603,2553,1467,266,633,10,72,0,22,1086
22055000605,2724,1508,181,654,4,245,0,17,1216
22055000606,3948,2301,422,900,11,132,0,17,1647
22055000700,2942,397,260,2178,9,15,1,8,2545
22055000800,2691,176,111,2301,11,14,2,8,2515
22055000900,1569,39,27,1444,3,2,0,3,1530
22055001001,5821,2815,711,2080,18,66,0,17,3006
22055001002,3474,1159,143,1977,5,34,2,20,2315
22055001003,3889,1856,184,1665,12,26,0,13,2033
22055001100,5812,723,149,4748,14,4,2,20,5089
22055001201,3372,759,123,2394,6,10,0,7,2613
22055001202,3948,646,127,3078,7,13,0,14,3302
22055001301,1686,859,52,701,3,18,1,4,827
22055001302,2956,284,65,2494,6,16,0,6,2672
22055001403,6596,4787,540,830,24,172,0,26,1809
22055001408,2169,1579,180,270,6,31,0,23,590
22055001412,6341,4567,394,686,34,459,0,31,1774
22055001413,4069,3043,188,376,8,295,2,10,1026
22055001414,6091,4921,273,442,12,180,0,22,1170
22055001415,3751,3220,158,226,4,30,0,11,531
22055001416,3733,3007,173,261,15,146,0,6,726
22055001417,6084,4903,288,428,26,153,0,33,1181
22055001418,3619,2255,296,837,12,66,3,11,1364
22055001419,4802,3450,335,705,8,134,3,25,1352
22055001420,2983,1767,202,776,10,101,0,4,1216
22055001421,2775,1884,205,410,10,139,0,21,891
22055001422,2243,1867,122,109,6,87,0,11,376
22055001423,3688,3148,232,138,1,55,0,4,540
22055001424,6275,4797,295,848,19,84,0,23,1478
22055001425,4898,3097,280,1224,23,85,4,18,1801
22055001426,8422,6533,573,814,22,178,6,11,1889
22055001427,8034,5852,470,1049,31,294,6,40,2182
22055001428,5737,4742,274,424,30,77,0,6,995
22055001500,5211,4293,294,390,10,76,0,14,918
22055001600,3028,2733,131,43,10,22,6,11,295
22055001700,6064,4906,369,414,29,108,4,27,1158
22055001801,2884,1595,394,661,10,78,0,6,1289
22055001802,3821,2434,353,748,6,117,1,21,1387
22055001903,5901,3095,942,1487,19,155,2,21,2806
22055001904,4010,2713,431,570,19,129,0,14,1297
22055001905,6446,4160,603,987,9,458,0,26,2286
22055001906,4721,3605,280,642,11,27,0,9,1116
22055001907,3068,2310,217,385,9,17,2,16,758
22055001908,4091,2943,336,619,9,61,0,0,1148
22055001909,2537,1865,186,321,14,25,0,11,672
22055002001,5034,3084,264,1465,12,10,0,22,1950
22055002003,3223,1649,643,779,8,27,0,17,1574
22055002004,3159,1762,316,933,11,16,0,11,1397
22055002101,6116,3381,253,2247,17,29,2,21,2735
22055002102,5132,3098,183,1603,17,57,0,26,2034
22055002103,5382,2472,298,2380,18,39,3,34,2910
22055002105,3215,2189,234,658,11,21,6,10,1026
22055002106,3077,2348,114,501,3,8,0,9,729
22055002200,4020,2720,225,674,15,228,4,10,1300
22057020100,2921,2018,109,681,24,8,0,2,903
22057020202,4432,3394,195,638,47,34,4,6,1038
22057020400,2165,531,73,1487,8,0,0,9,1634
22057020500,6962,3546,325,2827,48,37,1,10,3416
22057020600,2187,1507,81,475,21,35,1,4,680
22057020702,4276,2706,196,1123,60,32,7,20,1570
22057020703,5739,4239,244,1022,21,86,4,9,1500
22057020704,5628,4868,201,342,28,25,0,5,760
22057020800,3569,3259,114,57,16,9,0,10,310
22057020900,2034,998,85,891,2,3,0,2,1036
22057021000,3118,2514,207,237,50,5,0,3,604
22057021101,1966,1551,220,21,93,9,0,0,415
22057021102,4592,3509,505,110,204,75,0,9,1083
22057021200,4362,3303,479,119,249,44,0,2,1059
22057021300,2187,1719,121,26,201,11,0,1,468
22057021400,4452,3570,357,56,158,135,3,8,882
22057021500,4167,3149,399,190,179,68,0,11,1018
22057021602,3451,2830,142,19,320,12,0,0,621
22057021603,3023,2396,269,100,132,9,3,4,627
22057021604,3816,3347,135,158,62,27,0,1,469
22057021700,3662,3021,191,213,53,8,1,1,641
22057021800,4754,2687,243,1565,65,18,2,11,2067
22057021902,4186,3516,127,289,58,7,0,7,670
22057021903,4918,3730,321,356,223,22,0,15,1188
22057021904,2173,1597,189,149,98,14,5,8,576
22057022000,2817,1217,144,1381,7,26,0,2,1600
22057990000,0,0,0,0,0,0,0,0,0
22059970100,4151,3394,319,135,28,143,2,9,757
22059970200,6388,3845,1052,1095,58,109,8,13,2543
22059970300,4252,4024,31,53,47,0,0,4,228
22061960100,3690,2961,104,479,6,11,0,3,729
22061960200,3883,2053,184,1454,26,9,0,11,1830
22061960300,5574,309,86,5045,8,11,0,7,5265
22061960401,2568,1478,111,761,6,113,4,3,1090
22061960402,2467,1800,99,420,5,89,0,5,667
22061960500,4815,3338,279,880,8,123,0,3,1477
22061960600,5044,2946,241,1611,11,81,0,28,2098
22061960701,3677,3152,122,245,6,15,0,2,525
22061960702,2917,2531,167,112,5,22,0,0,386
22061960800,3902,878,86,2742,7,36,0,14,3024
22061960900,2369,343,28,1887,10,37,0,15,2026
22061961000,7490,3883,247,2990,47,135,1,15,3607
22063040101,3189,2674,149,211,3,4,1,1,515
22063040102,3421,2630,134,513,1,4,0,8,791
22063040103,4201,3368,339,318,7,5,0,4,833
22063040202,4976,4608,129,38,18,5,0,21,368
22063040203,2312,2133,77,21,4,0,0,2,179
22063040204,4673,4201,141,150,11,23,0,2,472
22063040304,5754,5105,223,145,17,12,0,11,649
22063040305,5667,4872,237,295,20,21,8,8,795
22063040306,4735,4157,178,174,5,44,0,4,578
22063040307,4296,3667,207,196,21,47,0,10,629
22063040308,5883,5068,289,192,23,13,1,12,815
22063040403,3329,2697,343,112,7,12,0,18,632
22063040404,3401,2899,175,144,3,60,3,7,502
22063040405,3670,2771,135,500,3,45,0,10,899
22063040406,5244,4505,249,272,8,41,2,12,739
22063040501,3411,2333,513,404,17,22,0,15,1078
22063040502,5971,5010,351,303,13,33,4,10,961
22063040503,3990,2725,364,562,9,90,0,5,1265
22063040601,4559,3010,217,1099,9,53,0,12,1549
22063040602,4241,3300,355,371,14,42,2,15,941
22063040700,3528,2700,389,231,11,55,0,20,828
22063040805,5143,3665,780,403,18,52,6,8,1478
22063040807,2890,2417,207,103,9,17,0,10,473
22063040808,5098,4208,442,179,11,75,2,12,890
22063040809,3149,2888,93,24,12,1,2,4,261
22063040810,3245,2951,73,43,7,31,0,9,294
22063040811,2341,2002,169,54,5,21,1,1,339
22063040812,8021,5199,708,1527,24,127,2,39,2822
22063040813,4159,2908,278,720,15,58,1,7,1251
22063040814,5258,3754,314,865,12,65,0,25,1504
22063040903,3207,2280,211,580,13,2,0,8,927
22063040904,4025,3465,155,185,5,24,1,17,560
22063040905,3233,2951,80,91,10,8,0,13,282
22063040906,2062,1755,87,153,0,4,0,1,307
22065960100,1739,1248,66,365,4,1,3,0,491
22065960200,2441,1326,42,1016,13,0,0,1,1115
22065960300,2335,232,21,2061,2,0,1,0,2103
22065960400,1437,39,17,1356,2,0,1,2,1398
22065960500,2065,569,58,1375,6,5,0,1,1496
22067950100,1437,1003,42,314,2,5,0,2,434
22067950200,5401,3879,57,1159,20,30,1,4,1522
22067950300,2478,1742,30,627,15,8,0,2,736
22067950400,2895,276,89,2455,4,16,0,7,2619
22067950500,4243,1398,58,2572,6,24,0,5,2845
22067950600,2695,1646,37,909,6,0,2,4,1049
22067950700,3360,2016,44,1203,18,6,0,0,1344
22067950800,3120,260,24,2737,9,0,0,5,2860
22069000100,1915,1427,27,385,12,0,3,2,488
22069000200,2964,1796,76,888,43,0,1,11,1168
22069000300,4347,3205,162,708,56,11,2,13,1142
22069000400,3529,482,69,2843,8,0,1,24,3047
22069000500,4219,2673,151,1147,33,51,3,27,1546
22069000601,4653,1409,473,2524,8,46,4,19,3244
22069000602,4341,1590,143,2355,24,29,0,34,2751
22069000700,2785,582,128,1966,8,7,0,10,2203
22069000800,4176,3391,133,423,42,7,2,0,785
22069000901,2635,1066,65,1255,20,12,0,68,1569
22069000902,1951,1277,63,363,30,3,3,93,674
22071000100,2289,1622,165,341,12,18,4,14,667
22071000200,1136,317,50,699,0,11,0,9,819
22071000300,1176,129,46,971,0,1,0,2,1047
22071000400,2060,367,69,1527,0,19,4,2,1693
22071000601,1045,4,21,993,3,0,0,0,1041
22071000602,2477,151,188,2066,5,9,0,6,2326
22071000603,1491,38,497,876,1,29,0,9,1453
22071000604,3960,276,311,3180,1,28,2,34,3684
22071000605,2070,414,194,1354,2,11,0,7,1656
22071000606,4112,1033,427,2396,1,103,0,30,3079
22071000607,3702,1508,283,1683,4,64,1,20,2194
22071000611,3548,72,237,2911,4,258,2,19,3476
22071000612,1747,834,121,523,0,191,3,10,913
22071000615,3278,452,224,2427,9,79,0,5,2826
22071000616,4388,1145,357,2588,18,125,2,18,3243
22071000617,3854,391,199,3086,6,61,0,10,3463
22071000618,3611,993,233,2036,7,201,0,39,2618
22071000619,2123,164,182,1674,3,30,0,8,1959
22071000620,2533,334,207,1903,8,11,6,7,2199
22071000701,1074,67,36,933,0,0,0,15,1007
22071000702,1755,426,104,1127,6,0,0,12,1329
22071000800,1738,267,58,1342,0,7,2,5,1471
22071000901,1138,84,49,958,0,8,0,8,1054
22071000902,708,8,28,649,0,0,0,4,700
22071000903,915,10,36,847,0,0,0,10,905
22071000904,1147,36,29,1034,5,1,0,10,1111
22071001100,1865,951,97,671,3,23,0,9,914
22071001200,1698,1244,145,158,3,38,2,14,454
22071001301,1942,735,92,1027,7,11,0,5,1207
22071001302,1380,265,57,1020,0,0,0,6,1115
22071001401,1689,99,67,1477,0,0,3,0,1590
22071001402,2061,249,86,1634,10,3,1,12,1812
22071001500,1140,285,91,709,0,2,0,6,855
22071001600,160,2,2,154,0,0,1,0,158
22071001701,2103,64,46,1925,7,3,2,7,2039
22071001702,3206,541,124,2365,3,52,3,16,2665
22071001720,4258,48,156,3980,2,5,0,10,4210
22071001723,4694,81,138,4277,2,96,0,22,4613
22071001724,4984,152,168,4536,5,16,0,7,4832
22071001736,2235,42,54,2072,7,4,0,10,2193
22071001737,3647,143,90,3310,9,15,0,11,3504
22071001739,1716,14,29,1610,2,17,0,1,1702
22071001740,4390,34,115,4067,4,74,0,18,4356
22071001741,1472,21,68,884,0,473,0,7,1451
22071001743,2314,59,91,2088,2,7,1,11,2255
22071001744,4668,40,112,4365,11,39,2,23,4628
22071001745,3416,60,74,3164,3,36,0,13,3356
22071001746,4744,86,139,4391,8,0,0,21,4658
22071001747,3599,55,77,2586,0,774,0,14,3544
22071001748,4084,80,112,3465,3,337,5,24,4004
22071001749,2562,44,572,792,7,1092,0,10,2518
22071001750,4867,51,1020,2392,7,1326,1,8,4816
22071001751,1044,91,246,640,3,29,0,10,953
22071001752,3133,53,459,2525,8,28,0,13,3080
22071001753,2257,12,95,2062,4,6,0,17,2245
22071001754,3265,105,110,2965,6,7,0,11,3160
22071001755,3305,71,80,3087,7,10,0,9,3234
22071001756,1495,9,66,1375,2,0,0,12,1486
22071001757,1280,18,36,1199,1,4,0,2,1262
22071001758,1794,692,93,830,2,121,0,14,1102
22071001800,1335,1079,90,70,5,24,0,8,256
22071001900,1492,562,155,688,0,13,0,4,930
22071002000,1413,352,119,847,4,6,0,19,1061
22071002100,1110,85,110,867,8,5,0,3,1025
22071002200,1351,135,71,1081,7,1,0,13,1216
22071002300,2119,134,123,1802,5,2,0,8,1985
22071002401,1639,251,119,1197,1,10,0,14,1388
22071002402,2949,377,167,2265,8,8,0,20,2572
22071002501,2034,328,160,1398,3,36,0,22,1706
22071002502,2199,155,56,1884,1,13,0,29,2044
22071002503,1836,534,141,1031,0,12,0,36,1302
22071002504,2303,660,173,1282,3,31,0,27,1643
22071002600,1134,858,81,104,7,11,0,10,276
22071002700,1324,440,137,679,2,20,0,5,884
22071002800,1540,105,64,1294,2,2,0,9,1435
22071002900,1238,147,55,989,5,5,0,4,1091
22071003000,1215,93,32,1058,0,3,0,6,1122
22071003100,1335,108,68,1089,2,4,2,16,1227
22071003301,2622,1239,244,852,1,112,2,25,1383
22071003302,3339,659,225,2246,7,56,1,32,2680
22071003303,2295,522,204,1395,5,66,1,17,1773
22071003304,2347,304,158,1783,9,16,0,12,2043
22071003307,1350,111,67,1104,6,2,0,10,1239
22071003308,4063,317,107,3443,9,26,2,28,3746
22071003400,1343,454,67,735,3,11,0,9,889
22071003500,1452,286,56,1017,1,11,0,12,1166
22071003600,1462,433,103,834,3,13,1,9,1029
22071003701,1883,742,119,897,8,32,0,9,1141
22071003702,3460,1381,244,1593,17,35,3,29,2079
22071003800,1277,1092,80,43,0,11,1,12,185
22071003900,1228,479,82,572,8,10,1,13,749
22071004000,1939,592,151,1062,6,13,1,26,1347
22071004100,1429,1114,110,127,1,31,0,4,315
22071004401,1543,299,190,960,8,11,1,24,1244
22071004402,1038,16,28,967,5,7,0,0,1022
22071004500,2154,1131,208,662,1,27,0,15,1023
22071004600,2711,2154,238,135,4,45,3,11,557
22071004800,1122,85,34,959,7,8,0,1,1037
22071004900,1794,376,449,876,5,15,0,14,1418
22071005000,1697,619,408,542,0,35,2,17,1078
22071005400,1816,1299,153,213,13,39,0,11,517
22071005500,2846,2294,242,129,5,45,2,30,552
22071005601,2872,2333,253,100,6,45,1,6,539
22071005602,3186,2626,252,57,2,94,1,13,560
22071005603,1778,1416,167,76,0,44,0,2,362
22071005604,1915,1619,149,34,3,41,2,5,296
22071006000,1812,301,247,1124,0,85,0,6,1511
22071006300,2077,703,716,530,6,23,1,14,1374
22071006400,2591,1305,533,543,7,52,1,15,1286
22071006500,2651,1459,443,594,4,41,0,8,1192
22071006900,1399,54,59,1238,2,8,0,1,1345
22071007000,1926,93,66,1685,2,12,0,7,1833
22071007101,1898,325,230,1239,0,48,1,11,1573
22071007200,2321,222,274,1685,10,55,1,18,2099
22071007501,2271,146,157,1891,3,4,0,4,2125
22071007502,2917,148,373,2285,5,6,0,14,2769
22071007604,1894,1533,156,89,2,40,0,8,361
22071007605,1397,92,117,1143,3,6,0,4,1305
22071007607,2912,2043,353,197,4,202,0,9,869
22071007608,1723,1314,184,86,1,76,1,3,409
22071007700,2481,1581,230,359,8,155,0,14,900
22071007800,1113,814,114,104,5,21,0,5,299
22071008200,1546,1031,155,235,0,50,0,8,515
22071008300,1062,779,79,129,2,24,0,5,283
22071008400,1145,419,110,526,7,31,1,13,726
22071008500,1198,171,200,770,1,15,0,0,1027
22071008600,1137,75,226,801,3,2,0,8,1062
22071008800,1534,986,155,278,4,24,0,8,548
22071009000,1877,1574,127,75,3,32,0,3,303
22071009100,1933,866,214,706,8,30,1,14,1067
22071009200,1267,162,153,873,5,8,0,1,1105
22071009400,1481,57,97,1272,0,1,2,7,1424
22071009600,1321,818,107,313,0,22,1,6,503
22071009700,1280,788,102,301,4,23,1,3,492
22071009900,2859,2075,262,337,6,62,0,11,784
22071010000,1625,510,155,867,5,26,0,6,1115
22071010100,2021,1286,144,435,3,42,0,12,735
22071010200,1905,549,183,1071,0,34,0,12,1356
22071010300,2784,612,307,1763,5,28,0,3,2172
22071010600,1419,915,126,291,0,17,0,12,504
22071010700,1753,1280,129,219,5,44,0,8,473
22071010800,1358,1146,87,56,3,18,0,11,212
22071010900,2750,1808,225,539,4,71,0,16,942
22071011100,1643,755,162,621,5,34,0,3,888
22071011200,1331,839,105,283,0,27,0,9,492
22071011400,1901,1560,132,71,4,58,4,0,341
22071011500,1450,1204,83,74,0,37,0,1,246
22071011600,1325,1149,66,46,2,23,1,2,176
22071011700,3202,2659,351,34,13,71,0,5,543
22071011900,1704,1362,126,47,4,86,0,19,342
22071012000,1443,1132,184,34,1,35,2,5,311
22071012101,2658,1787,596,54,10,111,0,13,871
22071012102,5272,3241,1651,72,32,122,25,35,2031
22071012200,2078,1581,182,145,2,63,0,20,497
22071012300,1924,907,219,659,4,39,0,23,1017
22071012400,1719,848,116,650,6,21,0,7,871
22071012500,1866,1336,146,250,0,59,0,8,530
22071012600,1820,1355,171,142,5,69,0,9,465
22071012700,2221,1417,203,372,1,84,2,17,804
22071012800,2336,1592,190,357,9,62,0,18,744
22071012900,1347,855,101,294,2,35,0,4,492
22071013000,1569,818,120,493,1,51,0,4,751
22071013100,1533,387,107,973,4,21,2,5,1146
22071013200,2476,894,213,1192,3,29,0,24,1582
22071013301,3730,3119,319,70,2,117,0,12,611
22071013302,3609,1725,257,1241,25,234,0,40,1884
22071013400,4351,2471,334,940,7,377,3,42,1880
22071013501,1194,932,84,108,8,12,1,14,262
22071013502,1052,796,70,111,5,18,0,0,256
22071013600,968,551,56,293,0,21,0,16,417
22071013701,1351,114,44,1139,0,1,0,1,1237
22071013702,1638,1,26,1577,1,3,0,9,1637
22071013800,2732,149,127,2362,1,5,0,17,2583
22071013900,1647,731,132,610,8,81,0,12,916
22071014000,2122,104,92,1855,2,0,0,1,2018
22071014101,1487,398,72,909,2,30,0,5,1089
22071014102,808,205,38,536,2,8,0,1,603
22071014200,1570,1014,119,337,2,26,0,13,556
22071014300,2147,101,124,1837,10,3,0,6,2046
22071014400,1422,887,109,318,3,34,0,12,535
22071014500,1628,332,125,1154,6,7,0,0,1296
22071980000,8,3,1,1,0,0,0,0,5
22071980100,8,1,2,2,0,1,0,0,7
22071990000,0,0,0,0,0,0,0,0,0
22073000100,5242,2891,155,1865,16,109,0,28,2351
22073000200,5578,4430,149,779,4,80,0,19,1148
22073000401,2596,903,52,1463,11,97,2,4,1693
22073000402,3058,833,87,1915,11,141,2,0,2225
22073000500,3216,1110,136,1827,1,35,3,9,2106
22073000600,3420,21,19,3306,6,0,0,5,3399
22073000700,1863,16,17,1793,6,0,0,1,1847
22073000900,1323,14,12,1267,0,3,0,0,1309
22073001100,3048,9,17,2931,3,1,0,5,3039
22073001400,1875,162,27,1634,6,7,0,0,1713
22073001500,1590,76,18,1434,3,0,1,5,1514
22073001700,3517,1575,97,1516,1,244,3,0,1942
22073005100,2401,1896,83,310,5,12,7,2,505
22073005201,3666,3342,89,64,14,31,0,6,324
22073005203,3248,2671,95,313,8,24,0,10,577
22073005204,5754,5120,154,198,23,29,0,11,634
22073005303,2758,2370,81,133,10,31,0,3,388
22073005304,4248,3562,197,211,13,91,1,8,686
22073005305,3451,2394,122,556,11,226,0,9,1057
22073005306,2588,2167,68,204,4,31,0,14,421
22073005400,1999,1251,195,471,2,6,0,6,748
22073005500,3196,1281,173,1574,7,36,0,14,1915
22073005800,2810,1408,380,875,13,19,0,10,1402
22073005900,2819,2005,334,285,24,5,2,6,814
22073010101,4657,3308,87,1021,15,40,3,14,1349
22073010103,3228,1111,83,1919,3,14,0,5,2117
22073010104,2856,1402,105,1214,7,6,0,2,1454
22073010202,8215,6206,167,1349,13,159,0,29,2009
22073010203,2355,780,41,1406,6,61,0,2,1575
22073010204,3690,1076,73,2266,5,126,0,26,2614
22073010301,3500,2485,109,666,7,139,0,12,1015
22073010302,4261,2523,116,1390,2,68,0,15,1738
22073010401,5039,4569,108,98,12,22,0,11,470
22073010402,5852,5006,120,438,28,9,0,14,846
22073010502,4568,4155,98,39,26,10,1,17,413
22073010503,1936,1755,27,64,3,9,0,0,181
22073010505,6064,4775,323,547,22,77,2,16,1289
22073010506,3545,3196,112,57,22,8,0,3,349
22073010604,1933,1046,93,650,5,1,0,8,887
22073010605,5236,649,813,3449,6,230,2,35,4587
22073010606,1431,408,39,906,5,11,0,4,1023
22073010700,2460,58,23,2310,2,1,1,1,2402
22073010800,1918,389,59,1384,1,14,0,9,1529
22073010900,4204,76,30,4018,7,6,0,3,4128
22073011000,5115,154,67,4791,5,0,0,3,4961
22073011100,3041,792,208,1898,9,7,0,4,2249
22073980000,0,0,0,0,0,0,0,0,0
22075050100,1890,444,100,1293,0,7,0,9,1446
22075050201,4285,3206,386,271,36,197,2,25,1079
22075050202,4616,3594,441,190,23,138,13,28,1022
22075050300,4736,2801,679,790,31,125,18,34,1935
22075050400,3422,1797,356,979,63,24,4,33,1625
22075050500,1379,331,50,797,54,55,0,27,1048
22075050600,916,472,91,219,7,67,3,11,444
22075050700,1377,623,70,165,19,384,0,21,754
22075050800,894,496,63,159,22,45,0,3,398
22075990000,0,0,0,0,0,0,0,0,0
22077951900,4984,1169,46,3631,2,4,0,19,3815
22077952000,1823,849,100,835,9,4,0,9,974
22077952100,4398,3163,205,880,7,6,2,18,1235
22077952201,1321,1112,53,98,1,0,0,0,209
22077952202,2031,1625,68,269,11,9,0,2,406
22077952300,1869,1069,42,683,1,31,0,5,800
22077952400,4332,3258,111,825,6,6,0,4,1074
22079010101,4399,3646,135,291,39,70,0,9,753
22079010102,5685,5168,138,30,29,22,0,8,517
22079010300,4952,3802,230,546,50,18,1,26,1150
22079010400,2827,2383,105,163,19,29,0,0,444
22079010501,2118,1077,59,899,14,9,0,0,1041
22079010502,4317,844,101,3129,19,16,0,20,3473
22079010600,4675,3983,124,206,151,17,0,19,692
22079010701,3453,2611,158,412,11,159,0,13,842
22079010702,2009,1538,60,260,20,56,0,4,471
22079011000,2451,347,112,1881,8,16,0,12,2104
22079011300,2461,1793,88,415,13,25,0,2,668
22079011501,3432,2644,144,383,15,51,6,14,788
22079011502,4331,2344,150,1476,28,48,2,35,1987
22079011600,2159,1360,56,564,10,23,2,4,799
22079011700,2124,858,59,1064,12,56,0,8,1266
22079012000,1329,64,12,1193,1,0,1,5,1265
22079012100,2871,924,71,1740,20,11,0,13,1947
22079012200,3593,1336,151,1946,12,41,0,18,2257
22079012301,6087,4101,212,1214,19,313,0,13,1986
22079012302,3979,2890,136,698,11,74,4,26,1089
22079012400,4120,2610,173,929,19,193,0,14,1510
22079012500,5926,1379,175,4143,12,58,0,19,4547
22079012600,2196,968,82,981,12,88,1,5,1228
22079012700,2810,196,18,2489,8,5,6,4,2614
22079012800,884,21,12,829,6,2,0,4,863
22079012900,2178,22,25,2054,1,0,0,8,2156
22079013000,2166,168,14,1910,5,1,0,8,1998
22079013100,2711,1133,65,1367,10,12,2,10,1578
22079013201,6682,5266,172,753,62,81,0,32,1416
22079013202,2378,2051,51,124,13,7,0,11,327
22079013300,4762,2969,120,1412,31,12,0,24,1793
22079013400,3652,3089,107,247,31,32,1,6,563
22079013501,3609,2603,668,95,40,67,2,19,1006
22079013502,2246,1400,418,327,26,31,0,5,846
22079013600,2987,2633,115,17,86,13,0,14,354
22079013700,4807,3778,190,501,17,38,0,16,1029
22079013800,4043,1923,96,1764,17,88,2,8,2120
22079013900,2289,395,20,1785,4,2,0,1,1894
22079980000,325,6,268,24,0,21,3,2,319
22081960100,4073,3086,105,681,26,0,0,13,987
22081960300,3547,1064,83,2271,15,0,0,7,2483
22083970100,2813,868,54,1825,10,8,0,3,1945
22083970200,2112,1281,74,693,5,3,0,7,831
22083970300,2892,2380,78,345,9,8,0,0,512
22083970400,3550,2670,64,688,9,3,0,13,880
22083970500,4628,1258,83,3112,8,22,0,30,3370
22083970600,4048,3210,47,640,12,6,0,13,838
22085000100,2754,1889,98,384,230,0,0,9,865
22085000201,1391,908,66,22,273,6,3,3,483
22085000202,2022,1280,79,16,489,9,3,2,742
22085000300,1868,590,100,675,360,7,1,2,1278
22085000400,4296,3091,169,454,297,7,0,18,1205
22085000500,3174,1442,73,1481,29,17,2,15,1732
22085000600,3580,2834,75,470,66,5,1,3,746
22085000701,1485,1400,22,1,4,3,0,8,85
22085000702,1585,1416,28,17,42,9,2,9,169
22087030103,4440,2604,636,983,31,21,0,26,1836
22087030104,1941,1484,347,40,15,5,0,1,457
22087030105,335,211,62,52,0,1,0,2,124
22087030203,2962,1915,518,332,9,57,0,15,1047
22087030204,4499,902,267,3124,26,28,0,14,3597
22087030206,2143,1316,253,321,0,110,5,15,827
22087030207,3843,2277,449,779,13,152,0,24,1566
22087030208,3237,2108,419,394,19,116,0,7,1129
22087030209,3219,2164,395,490,19,35,0,13,1055
22087030300,1508,864,239,295,2,32,0,10,644
22087030400,1384,899,167,213,6,18,0,2,485
22087030500,1807,1032,247,314,7,84,0,28,775
22087030601,1552,498,189,620,18,168,1,25,1054
22087030602,3124,1670,454,801,14,43,0,26,1454
22087030603,1700,126,396,1072,1,11,0,14,1574
22087030700,1664,1093,252,186,8,26,0,18,571
22087030800,4406,2002,720,1354,27,65,0,45,2404
22087990000,0,0,0,0,0,0,0,0,0
22089060100,2154,1594,125,311,18,12,0,17,560
22089062100,5416,2474,877,1714,8,138,2,20,2942
22089062200,2359,805,132,1323,6,22,1,3,1554
22089062301,6345,4300,666,963,19,131,7,21,2045
22089062302,4650,3271,354,832,12,28,3,19,1379
22089062400,1262,499,58,650,4,0,0,9,763
22089062500,2970,2431,177,208,4,15,0,7,539
22089062700,4231,1630,188,2298,15,19,0,7,2601
22089062800,5806,2338,489,2715,17,49,2,28,3468
22089062900,2561,1908,248,276,20,11,0,9,653
22089063000,1290,654,61,532,7,0,1,2,636
22089063100,8095,6357,520,732,27,112,3,21,1738
22089063200,5410,4447,246,470,58,18,1,9,963
22091951100,3816,1792,76,1806,10,8,2,16,2024
22091951201,4279,1700,67,2378,17,4,2,3,2579
22091951202,2825,1002,73,1662,11,7,0,4,1823
22093040100,3164,1611,50,1400,7,12,0,7,1553
22093040200,3190,1437,43,1645,4,8,0,9,1753
22093040300,3801,3166,67,502,0,2,0,1,635
22093040400,2075,922,31,1078,7,2,0,1,1153
22093040500,1933,139,37,1713,4,3,0,2,1794
22093040600,2626,491,45,2053,0,0,0,1,2135
22093040700,3403,2151,70,1095,6,1,0,7,1252
22095070100,2573,1298,325,847,11,14,0,10,1275
22095070200,7255,690,666,5629,18,71,0,27,6565
22095070300,6123,2497,691,2655,9,51,4,53,3626
22095070400,4305,1963,374,1687,11,113,0,9,2342
22095070500,6414,1266,470,4435,7,24,0,20,5148
22095070600,2123,1014,47,989,3,0,0,1,1109
22095070700,3424,2116,239,963,21,10,2,2,1308
22095070800,1930,147,32,1727,2,0,0,2,1783
22095070900,2785,718,161,1799,11,25,0,9,2067
22095071000,2594,1301,255,906,9,5,0,0,1293
22095071100,2951,338,31,2439,3,1,1,7,2613
22097960100,1852,1171,18,608,0,5,3,6,681
22097960200,4232,2715,88,1297,9,6,1,17,1517
22097960300,3736,2302,62,1237,4,6,0,14,1434
22097960400,2086,1943,50,10,7,2,0,2,143
22097960500,5054,4437,75,445,2,11,2,5,617
22097960601,4653,1226,66,3221,6,7,0,31,3427
22097960602,1875,970,17,836,2,10,0,2,905
22097960701,2303,1158,61,1006,2,4,0,16,1145
22097960702,3437,1938,171,1162,4,6,0,17,1499
22097960800,3868,2853,75,765,8,17,0,13,1015
22097960901,1578,860,42,583,4,10,0,9,718
22097960902,1991,484,16,1402,6,29,0,5,1507
22097961000,2042,1472,89,418,0,8,0,10,570
22097961100,3160,2065,122,830,2,33,0,6,1095
22097961200,6072,2898,377,2597,8,38,0,22,3174
22097961301,2158,230,17,1859,7,0,0,10,1928
22097961302,2810,312,37,2378,0,10,0,5,2498
22097961401,1905,459,21,1362,7,9,0,6,1446
22097961402,1299,76,10,1165,4,0,0,10,1223
22097961501,1785,87,49,1617,1,2,0,1,1698
22097961502,2633,1346,90,1039,9,74,0,15,1287
22097961601,2009,305,27,1608,2,5,0,4,1704
22097961602,1640,82,16,1499,6,2,0,0,1558
22097961701,4643,2786,88,1557,8,41,2,24,1857
22097961702,2691,1768,78,746,8,19,3,10,923
22097961801,5658,4131,237,1095,28,14,1,9,1527
22097961802,2164,1733,114,252,5,5,0,4,431
22097961900,3206,1418,65,1624,4,1,0,9,1788
22099020101,2922,2525,85,215,2,10,1,11,397
22099020102,1926,1831,30,20,4,3,0,0,95
22099020201,5816,3723,98,1782,31,13,0,17,2093
22099020202,1424,952,37,392,9,2,0,2,472
22099020301,4657,3139,147,1142,8,40,1,26,1518
22099020303,5271,3822,162,1121,16,14,0,20,1449
22099020304,2743,1935,347,241,24,115,0,10,808
22099020401,5016,3240,122,1436,7,58,1,21,1776
22099020402,1529,991,46,454,0,0,0,2,538
22099020502,3684,2145,101,1278,17,40,0,9,1539
22099020503,2407,1442,116,735,11,13,0,12,965
22099020504,2855,841,70,1822,6,3,0,9,2014
22099020601,2854,1862,129,692,7,78,0,11,992
22099020602,2917,741,51,2041,12,4,0,6,2176
22099020800,2711,1608,57,962,5,30,0,9,1103
22099020900,1667,852,37,712,0,15,0,4,815
22099021000,1368,1270,44,5,18,2,0,1,98
22101040100,2565,708,1070,443,17,256,0,1,1857
22101040200,4738,3215,565,574,44,147,0,12,1523
22101040300,2912,1170,537,1015,32,25,1,5,1742
22101040400,3690,2147,436,914,27,12,0,11,1543
22101040500,4806,3623,396,516,45,26,3,7,1183
22101040600,4218,3173,431,333,58,20,6,11,1045
22101040700,3633,1427,139,1871,28,13,1,15,2206
22101040800,4773,3091,301,1034,62,48,0,36,1682
22101040900,2912,1674,108,954,56,1,1,19,1238
22101041000,3678,1955,109,991,450,16,0,15,1723
22101041100,1478,421,42,952,4,30,0,0,1057
22101041200,1546,439,29,987,13,9,1,4,1107
22101041300,1922,967,70,787,20,7,0,3,955
22101041400,3142,1136,189,1655,23,18,0,14,2006
22101041500,1710,938,62,596,23,13,0,19,772
22101041600,1683,250,40,1328,9,6,0,7,1433
22101990000,0,0,0,0,0,0,0,0,0
22103040103,4848,4298,294,37,19,14,0,8,550
22103040105,5656,4560,481,294,20,14,1,37,1096
22103040106,4190,3732,178,32,19,9,2,11,458
22103040107,3555,3159,201,31,6,15,6,20,396
22103040108,2912,2596,122,58,17,10,0,8,316
22103040203,3919,2949,287,512,5,10,0,30,970
22103040204,6372,4697,660,611,19,55,6,26,1675
22103040205,4460,3771,370,88,7,37,4,12,689
22103040206,2557,2198,149,142,0,2,0,1,359
22103040304,6732,5969,415,73,19,62,0,16,763
22103040306,5992,4803,497,229,21,184,5,21,1189
22103040307,4175,3365,356,138,9,130,0,20,810
22103040308,6900,5709,520,308,14,68,0,17,1191
22103040309,11328,9542,811,344,31,125,0,52,1786
22103040401,8037,6674,592,367,11,96,5,42,1363
22103040402,2753,2342,180,43,15,26,2,22,411
22103040501,4035,1956,238,1646,7,40,0,23,2079
22103040502,4333,2790,298,1027,13,28,0,14,1543
22103040601,4263,3642,237,152,6,83,0,10,621
22103040602,2618,2253,178,38,7,8,0,12,365
22103040606,4408,3270,504,315,14,43,1,13,1138
22103040607,3968,3233,317,117,6,125,0,23,735
22103040608,3248,2202,444,410,0,42,1,21,1046
22103040609,5348,3801,652,500,9,139,2,30,1547
22103040705,7133,4692,587,1209,32,120,4,55,2441
22103040706,6079,4683,598,392,26,52,1,22,1396
22103040708,6171,4714,361,612,25,193,0,26,1457
22103040709,4195,3185,303,437,9,68,3,25,1010
22103040710,5733,3821,450,927,17,213,0,39,1912
22103040711,3960,1968,255,1462,15,59,0,18,1992
22103040712,4791,3669,416,346,21,53,3,24,1122
22103040713,4237,2370,306,1276,19,16,2,21,1867
22103040714,1928,1679,116,25,15,6,2,4,249
22103040801,4915,2704,362,1442,22,96,6,14,2211
22103040804,2691,1701,161,537,6,165,0,12,990
22103040805,4671,3701,288,320,20,154,3,23,970
22103040806,6945,2039,444,3900,32,180,2,46,4906
22103040807,5249,2085,433,2255,16,218,2,33,3164
22103040900,3535,1415,270,1633,12,40,0,12,2120
22103041002,2711,2087,187,267,12,29,1,13,624
22103041003,5738,3977,447,863,26,114,1,32,1761
22103041004,4517,3442,308,464,24,40,5,31,1075
22103041101,3886,2647,294,564,25,17,5,29,1239
22103041103,3457,1593,560,1110,18,22,2,7,1864
22103041104,3188,2043,320,633,17,21,1,5,1145
22103041105,5659,2749,465,2042,23,44,7,47,2910
22103041106,1278,804,102,237,7,3,0,21,474
22103041202,2338,1569,154,457,21,12,0,11,769
22103041207,4472,3625,394,187,11,87,3,17,847
22103041208,4294,3627,321,87,8,87,2,12,667
22103041209,5124,4135,412,270,18,47,4,30,989
22103041210,2991,2401,254,145,11,24,4,9,590
22103041211,6567,5327,668,133,15,88,1,36,1240
22103041212,3738,3082,341,106,4,41,0,9,656
22103041213,5582,3403,499,1183,25,35,0,60,2179
22103041214,3451,2282,238,601,17,26,2,83,1169
22103041301,3934,3106,298,246,6,46,0,23,828
22103041302,2805,2308,251,89,7,33,4,14,497
22103990000,0,0,0,0,0,0,0,0,0
22105953200,2675,1893,65,642,9,3,0,5,782
22105953300,3786,1122,56,2479,4,10,0,7,2664
22105953401,2974,968,51,1891,5,7,0,1,2006
22105953402,3044,1574,65,1328,1,19,0,2,1470
22105953501,4055,2782,103,970,19,15,0,14,1273
22105953502,3458,2582,188,521,22,7,3,13,876
22105953601,2044,316,48,1613,2,19,0,3,1728
22105953602,3485,990,313,2058,1,10,0,15,2495
22105953701,5775,4556,175,799,8,14,0,6,1219
22105953702,6441,5351,349,424,19,16,0,18,1090
22105953800,4820,3063,522,1023,20,21,3,16,1757
22105953901,4703,2241,355,1903,22,38,0,8,2462
22105953902,5135,2657,419,1854,14,27,0,16,2478
22105954001,4214,2233,216,1514,20,75,0,4,1981
22105954003,3055,2147,156,573,11,36,0,0,908
22105954004,3276,1509,191,1459,8,5,0,2,1767
22105954103,4243,2304,269,1463,10,41,2,20,1939
22105954104,1719,704,85,859,8,14,0,8,1015
22105954105,4987,3506,246,1055,16,16,0,16,1481
22105954106,5811,4157,326,1051,15,35,2,15,1654
22105954200,4683,2517,406,1501,14,98,3,11,2166
22105954300,3782,831,99,2625,16,75,1,22,2951
22105954400,3696,1582,203,1742,14,21,2,13,2114
22105954503,3850,2053,379,1213,5,41,0,4,1797
22105954504,2892,1830,121,795,17,13,1,19,1062
22105954505,5699,3389,291,1744,8,31,0,8,2310
22105954506,2059,985,110,883,3,20,0,4,1074
22105954601,8678,6094,430,1545,39,98,3,39,2584
22105954602,7661,6064,547,573,24,52,1,37,1597
22105954700,4703,3470,261,743,19,34,0,5,1233
22105954800,5754,4355,197,927,16,31,2,25,1399
22107000100,1536,810,18,664,0,0,1,3,726
22107000200,941,597,19,290,0,2,0,4,344
22107000300,1670,321,30,1278,0,4,0,4,1349
22109000103,3947,2550,199,913,90,30,0,6,1397
22109000104,2354,1241,179,798,27,8,0,7,1113
22109000105,1131,566,38,435,26,2,1,10,565
22109000106,3545,1781,207,1280,106,21,0,18,1764
22109000201,3216,2094,225,626,107,34,0,9,1122
22109000203,4891,3360,254,746,195,94,3,7,1531
22109000204,2674,1652,468,237,134,14,0,19,1022
22109000300,3882,2094,284,1192,105,25,0,15,1788
22109000401,4768,3045,278,947,176,78,8,7,1723
22109000402,3726,2784,202,435,113,23,2,18,942
22109000501,2610,1154,194,1058,88,9,2,6,1456
22109000502,2912,2153,198,285,114,11,0,20,759
22109000601,2797,1794,295,367,145,24,1,4,1003
22109000602,3092,1195,447,1049,114,168,3,7,1897
22109000701,2719,1355,472,594,165,23,1,7,1364
22109000702,2767,480,158,1925,75,27,2,0,2287
22109000800,6229,3321,683,1288,495,62,1,22,2908
22109000901,2836,1516,178,878,99,21,0,10,1320
22109000902,1980,995,89,749,57,15,0,7,985
22109001001,2055,1753,68,48,103,2,0,2,302
22109001002,4463,3663,225,109,232,24,1,1,800
22109001100,3000,2088,47,45,575,9,2,2,912
22109001201,2136,1533,60,346,111,5,0,4,603
22109001202,3515,3073,104,19,144,26,0,5,442
22109001301,3017,1000,450,835,494,34,0,5,2017
22109001302,1325,627,98,129,351,26,0,0,698
22109001303,2722,1266,162,359,678,68,0,7,1456
22109001400,3147,2090,87,573,235,9,0,7,1057
22109001501,2198,1750,117,167,31,43,5,3,448
22109001502,4751,3919,209,245,130,40,2,14,832
22109001600,2916,1599,89,1057,65,6,0,10,1317
22109001701,1749,1348,98,247,24,1,1,0,401
22109001702,5347,3845,264,714,123,149,4,33,1502
22109001703,5163,4118,232,364,81,163,0,7,1045
22109990000,0,0,0,0,0,0,0,0,0
22111960100,3728,2378,263,979,17,9,0,5,1350
22111960200,3120,1780,138,1102,7,5,2,1,1340
22111960300,2790,1860,295,541,6,5,0,7,930
22111960400,3327,1009,146,2061,11,9,0,7,2318
22111960500,4631,4096,194,163,9,6,3,6,535
22111960600,3511,3166,99,134,9,4,1,4,345
22113950101,4233,3469,218,288,5,124,0,5,764
22113950102,3030,2552,88,251,7,23,1,10,478
22113950103,3695,3406,113,78,0,12,1,8,289
22113950201,2069,1977,24,33,2,0,1,11,92
22113950202,2345,2102,40,167,0,1,2,7,243
22113950400,5012,3995,133,632,14,44,0,10,1017
22113950500,5758,5069,238,230,16,47,2,10,689
22113950600,3337,2632,171,281,10,144,0,18,705
22113950700,3300,1751,129,1035,15,282,0,10,1549
22113950800,4570,1333,178,2734,16,137,0,20,3237
22113950901,2811,2110,244,255,6,108,0,2,701
22113950903,3338,1800,159,1059,14,171,0,24,1538
22113950904,4853,4133,206,294,18,50,1,18,720
22113951001,4159,3563,164,187,23,107,0,0,596
22113951002,3463,2863,125,322,18,0,1,12,600
22113951100,1386,1265,66,13,7,3,0,5,121
22113990000,0,0,0,0,0,0,0,0,0
22115950100,5661,4842,200,282,53,33,12,25,819
22115950200,4842,4294,114,103,67,25,10,2,548
22115950301,3344,2849,168,55,34,45,7,18,495
22115950302,1247,1110,42,6,17,4,1,8,137
22115950400,3213,1407,258,1238,22,45,20,26,1806
22115950501,2999,1584,238,793,33,80,7,38,1415
22115950502,2429,971,237,871,29,122,9,23,1458
22115950600,3380,2032,376,527,34,128,32,12,1348
22115950701,1655,1053,191,223,2,68,9,14,602
22115950702,3033,1457,618,557,15,75,73,20,1576
22115950703,2179,1219,486,270,14,37,13,2,960
22115950704,3502,1889,606,565,20,84,82,33,1613
22115950801,2609,2111,123,150,37,21,6,15,498
22115950802,1609,1437,42,18,33,3,0,6,172
22115950901,2546,1911,164,215,39,49,1,15,635
22115950902,4502,3433,312,452,35,43,7,17,1069
22117950101,3947,2414,136,1302,19,1,0,1,1533
22117950102,3997,2991,48,824,8,10,0,4,1006
22117950201,3862,2533,94,1120,10,14,0,4,1329
22117950202,2486,2305,75,36,11,4,0,7,181
22117950300,4321,1504,152,2532,5,4,0,12,2817
22117950400,3959,2946,101,761,21,6,0,2,1013
22117950501,3182,2698,179,135,12,6,0,8,484
22117950502,2898,2472,95,229,5,11,0,5,426
22117950600,4502,3847,102,362,19,8,0,11,655
22117950700,4882,2802,239,1611,11,44,0,13,2080
22117950800,3291,1073,55,2045,5,19,0,4,2218
22117950900,989,389,17,525,6,10,0,3,600
22117951000,3147,1614,117,1276,2,24,0,6,1533
22119031100,1750,1504,29,132,2,3,0,6,246
22119031200,2387,1404,31,883,6,5,0,3,983
22119031300,4548,2774,78,1482,8,32,0,23,1774
22119031400,2694,2111,41,417,24,1,0,0,583
22119031501,3034,2464,91,331,19,18,0,2,570
22119031502,2102,1392,31,571,3,6,0,17,710
22119031600,2909,2420,53,288,11,25,6,2,489
22119031700,2705,387,19,2241,4,2,0,11,2318
22119031800,2668,1324,52,1142,9,17,0,5,1344
22119031900,2258,282,32,1873,5,7,1,2,1976
22119032000,3346,2104,62,1084,5,14,4,4,1242
22119032101,2732,1701,72,824,21,6,1,0,1031
22119032102,3834,2687,97,874,19,2,0,1,1147
22121020100,3979,1463,104,2272,12,9,0,8,2516
22121020200,3337,1116,224,1859,7,36,6,8,2221
22121020301,3331,1973,149,1055,11,2,0,17,1358
22121020302,3169,1915,151,977,17,17,0,9,1254
22121020401,5195,2561,254,2193,1,40,1,11,2634
22121020402,8188,5086,362,2358,11,115,1,17,3102
22123000100,4089,3314,129,515,9,2,0,0,775
22123000200,3580,3058,133,307,11,7,0,0,522
22123000300,2082,1427,63,516,17,4,0,0,655
22125951703,1,1,0,0,0,0,0,0,0
22125951704,1332,899,26,356,8,0,0,0,433
22125951705,1560,644,24,853,1,0,0,0,916
22125951801,2023,1220,42,671,1,17,1,3,803
22125951802,1364,960,42,310,2,1,1,2,404
22125951803,3403,2609,93,535,9,12,3,27,794
22125980000,5627,4252,424,864,74,0,0,0,1375
22127960100,3521,3147,42,195,18,21,0,1,374
22127960201,3530,1939,805,523,19,135,16,9,1591
22127960202,2217,1639,38,424,21,12,0,1,578
22127960300,2377,1013,53,1217,7,3,0,6,1364
22127960400,2110,760,85,1159,12,1,0,8,1350
23001010100,1791,1414,48,195,10,28,0,3,377
23001010200,4924,4132,122,359,9,57,3,32,792
23001010300,2751,2234,110,176,18,32,0,13,517
23001010400,2142,1949,45,36,5,34,1,0,193
23001010500,2066,1754,82,95,7,17,1,4,312
23001010600,3206,2892,60,45,11,23,3,9,314
23001010700,3102,2842,44,60,4,16,0,6,260
23001010800,4079,3686,71,87,14,30,1,9,393
23001020100,1835,1018,58,621,16,12,0,18,817
23001020200,1324,1063,50,96,7,7,0,0,261
23001020301,2278,1840,64,208,8,23,16,42,438
23001020302,2383,1745,85,357,9,58,2,5,638
23001020303,2358,1382,73,670,10,9,4,11,976
23001020401,2337,813,73,1369,5,8,1,2,1524
23001020402,1501,985,71,346,17,7,0,8,516
23001020500,3468,2891,82,187,15,52,0,17,577
23001020600,2818,2602,57,27,5,20,2,4,216
23001020700,5055,4540,82,132,13,80,0,20,515
23001020801,2830,2599,40,49,11,34,0,7,231
23001020802,4431,3687,86,401,8,52,0,10,744
23001020900,4503,3456,97,645,19,69,2,29,1047
23001030100,5274,4826,94,58,23,28,5,18,448
23001030200,4437,4039,76,34,15,31,2,19,398
23001040000,4173,3931,44,8,3,22,4,16,242
23001041000,5906,5515,77,18,29,22,0,16,391
23001041500,5873,5456,63,27,11,25,0,14,417
23001042000,5817,5373,137,32,30,26,0,19,444
23001043000,2127,2003,21,15,3,8,2,1,124
23001044000,3060,2801,50,8,9,13,0,7,259
23001045000,2262,2081,41,15,10,3,0,4,181
23001046000,4376,4134,41,18,11,12,1,5,242
23001046500,6652,6192,78,42,17,37,0,8,460
23003950100,2567,2358,38,13,73,9,0,4,209
23003950200,2404,2277,35,14,18,4,1,2,127
23003950300,3867,3671,49,7,14,19,0,13,196
23003950400,1782,1728,10,9,2,0,0,1,54
23003950600,4067,3682,59,98,22,89,0,5,385
23003950700,2745,2636,30,9,21,2,0,1,109
23003950900,1871,1788,10,1,10,0,1,0,83
23003951000,3344,3136,46,11,30,9,1,3,208
23003951100,2750,2604,21,9,31,8,0,5,146
23003951200,2229,2068,29,20,23,15,2,1,161
23003951300,3057,2861,32,18,32,22,1,10,196
23003951400,2110,1927,29,6,38,13,0,13,183
23003951600,1526,1406,27,16,10,3,2,10,120
23003951700,4642,4348,70,18,44,15,1,8,294
23003951800,3472,3165,76,34,43,54,0,2,307
23003951900,2766,2571,34,17,24,43,1,7,195
23003952000,2559,2184,53,31,143,30,0,19,375
23003952100,2482,2362,24,10,39,2,1,4,120
23003952300,2430,2193,39,12,102,2,4,2,237
23003952400,3857,3327,58,33,298,23,3,4,530
23003952500,2198,2030,38,16,64,14,0,4,168
23003952600,3146,2958,41,5,62,5,0,1,188
23003952700,2361,2206,28,8,23,8,0,1,155
23003952900,2873,2677,36,8,40,3,0,11,196
23005000100,2402,2005,59,196,3,29,0,16,397
23005000200,2416,1877,78,305,4,33,0,11,539
23005000300,3192,2480,133,343,8,66,3,20,712
23005000500,2469,1547,168,524,12,128,3,4,922
23005000600,3410,2069,188,868,11,79,0,34,1341
23005001000,2825,2146,132,369,13,40,0,18,679
23005001100,2577,2130,60,213,6,46,3,13,447
23005001200,1397,1051,50,211,2,32,0,2,346
23005001300,3800,2820,365,317,14,94,2,21,980
23005001500,3518,2893,170,209,4,99,1,15,625
23005001700,4370,3780,120,118,8,142,0,22,590
23005001800,3746,3256,115,150,9,65,0,14,490
23005001900,4209,3697,96,91,11,93,1,17,512
23005002001,3568,2853,101,178,6,243,0,5,715
23005002002,2803,2132,177,273,2,94,0,12,671
23005002101,6237,4975,126,659,7,159,3,34,1262
23005002102,5481,3676,182,979,12,371,8,37,1805
23005002200,5267,4401,145,345,7,179,1,18,866
23005002300,3609,2552,134,567,5,189,2,13,1057
23005002400,1346,1253,41,6,7,5,0,4,93
23005002501,3543,3247,68,25,4,67,2,25,296
23005002503,3936,3476,109,44,9,123,0,16,460
23005002504,4965,4476,100,23,11,185,0,6,489
23005002600,4231,3629,82,152,9,180,0,22,602
23005002700,5175,3936,164,688,13,118,2,14,1239
23005002800,3202,2634,77,232,11,128,2,6,568
23005002901,4537,3781,107,179,13,239,0,22,756
23005002902,3255,2614,119,282,15,70,0,14,641
23005003001,3651,3092,121,121,11,141,3,8,559
23005003002,3410,1811,241,981,14,243,1,11,1599
23005003100,3895,3302,147,120,10,129,3,21,593
23005003200,3418,3083,77,67,5,58,3,11,335
23005003300,3270,2690,122,109,13,187,2,14,580
23005003400,4804,4369,105,45,4,105,0,21,435
23005003500,4050,3632,95,85,7,40,2,44,418
23005003701,4251,3872,84,13,0,112,2,5,379
23005003702,5284,4829,163,42,0,79,1,23,455
23005004001,3219,2890,59,30,2,94,0,2,329
23005004002,8171,7351,169,159,35,112,3,31,820
23005004100,6946,6348,111,104,15,92,5,25,598
23005004201,4353,4062,81,25,0,50,2,2,291
23005004202,4516,4223,73,25,5,47,1,13,293
23005004401,5447,4902,132,63,13,109,3,25,545
23005004402,3543,3245,58,32,4,58,0,15,298
23005004501,3443,3162,62,25,7,36,0,17,281
23005004502,5294,4729,105,31,17,160,2,22,565
23005004600,4072,3782,81,22,7,25,2,9,290
23005004701,2154,2037,25,6,1,14,1,4,117
23005004702,6115,5610,103,27,2,61,0,30,505
23005004802,4913,4514,69,56,16,57,1,16,399
23005004803,6124,5453,175,169,21,81,5,16,671
23005004804,4179,3795,57,70,19,63,0,1,384
23005004805,3218,2941,61,32,11,18,0,14,277
23005011100,4753,4125,141,101,26,84,2,26,628
23005011203,3608,3283,89,35,6,43,0,9,325
23005011204,3587,3207,127,18,6,76,1,10,380
23005011205,3091,2665,92,57,7,100,0,18,426
23005011206,4044,3176,245,142,6,171,3,18,868
23005011300,2673,2410,89,13,8,21,1,24,263
23005011500,7242,6753,115,34,20,30,0,25,489
23005012001,1673,1550,28,11,2,13,0,1,123
23005012002,2863,2649,51,6,3,13,0,12,214
23005013001,1508,1394,27,5,4,4,1,16,114
23005013002,2138,1939,34,20,3,10,0,4,199
23005014001,2542,2357,30,12,3,13,0,8,185
23005014002,1383,1270,31,1,1,7,0,2,113
23005015000,2447,2256,27,14,10,12,1,8,191
23005016001,3243,2999,61,18,5,20,0,7,244
23005016002,2175,1972,55,16,5,11,1,18,203
23005016500,3431,3185,44,9,4,15,1,11,246
23005017002,3726,3492,59,18,5,25,3,12,234
23005017003,3470,3222,63,16,3,13,2,7,248
23005017004,3080,2851,44,14,7,26,0,1,229
23005017101,2118,1984,37,3,10,12,0,9,134
23005017102,2913,2740,49,9,1,25,0,6,173
23005017303,4889,4442,100,17,10,148,1,9,447
23005017305,5620,4513,113,246,16,529,1,16,1107
23005017306,5053,4527,93,29,4,168,1,20,526
23005017307,2595,2410,69,16,3,29,2,8,185
23005017308,3978,3656,56,40,14,82,0,9,322
23005990000,0,0,0,0,0,0,0,0,0
23007970101,2260,2108,25,1,6,11,6,10,152
23007970102,895,840,14,0,2,0,1,2,55
23007970601,1838,1749,39,3,3,5,3,2,89
23007970602,2022,1911,26,3,2,6,0,9,111
23007971000,3608,3413,41,10,11,1,0,7,195
23007971100,2786,2586,34,9,6,4,1,26,200
23007971201,3410,2987,66,61,4,154,2,12,423
23007971202,4182,3684,76,50,10,167,9,18,498
23007971300,3835,3579,43,11,19,16,1,9,256
23007971400,4620,4354,43,18,10,19,0,14,266
23009965100,1885,1739,27,8,19,4,0,4,146
23009965200,2321,2182,17,2,13,15,1,9,139
23009965300,4944,4609,83,15,19,19,1,15,335
23009965400,2728,2537,52,1,2,8,0,12,191
23009965503,3768,3284,111,60,32,78,1,6,484
23009965504,4660,4324,74,29,12,37,0,15,336
23009965700,3065,2753,62,4,28,27,0,19,312
23009965800,2164,2017,60,7,1,8,0,2,147
23009965900,5089,4471,102,100,32,173,0,33,618
23009966000,2146,2020,32,16,5,20,0,7,126
23009966100,1916,1761,47,10,9,12,1,5,155
23009966200,1928,1775,35,3,5,15,0,6,153
23009966300,4424,4122,62,21,6,26,1,22,302
23009966400,2456,2284,52,20,6,22,2,17,172
23009966500,2964,2809,27,12,10,21,0,12,155
23009966600,3250,3097,37,9,7,14,2,0,153
23009966700,5770,5314,89,34,25,61,1,35,456
23009990000,0,0,0,0,0,0,0,0,0
23011010100,4963,4484,98,27,36,77,8,10,479
23011010200,4108,3614,123,41,20,76,0,7,494
23011010300,3359,2887,122,70,16,56,0,20,472
23011010400,2216,1928,49,29,12,99,3,14,288
23011010500,4253,3795,118,45,11,108,1,10,458
23011010601,4618,4268,80,20,18,14,0,10,350
23011010602,2778,2551,30,12,25,17,0,4,227
23011010700,2570,2363,45,7,8,33,0,16,207
23011010801,2456,2286,28,7,9,27,0,9,170
23011010803,2995,2762,55,25,9,29,1,3,233
23011010804,3671,3419,42,12,18,10,0,21,252
23011010900,1694,1498,65,10,7,8,0,14,196
23011011000,4267,3875,53,34,7,21,1,16,392
23011012000,3586,3332,52,9,7,10,0,9,254
23011013000,4066,3779,82,12,8,12,1,12,287
23011014001,3734,3419,73,37,7,30,0,9,315
23011014002,2387,2225,29,14,11,17,0,1,162
23011014500,2289,2159,20,10,7,6,1,7,130
23011015000,2597,2416,58,13,4,10,0,3,181
23011015500,3447,3237,54,3,4,11,1,25,210
23011016000,3250,3061,38,5,11,17,0,6,189
23011017000,4645,4334,80,10,9,34,0,18,311
23011018000,4520,4195,44,18,13,14,2,27,325
23011019000,2632,2454,47,10,7,6,1,4,178
23011020000,4408,4084,80,19,21,25,2,2,324
23011020500,2042,1898,27,9,7,13,0,0,144
23011021000,3370,3148,57,6,7,9,1,13,222
23011022000,2715,2558,34,7,6,4,0,5,157
23011023001,3876,3567,107,28,20,21,0,8,309
23011023002,4072,3739,60,14,9,44,0,8,333
23011024101,4106,3577,159,44,27,44,1,16,529
23011024102,5092,4371,188,103,42,62,4,18,721
23011024201,3076,2760,72,32,8,44,1,7,316
23011024202,3554,2896,184,78,8,175,0,19,658
23011025001,4425,4048,78,23,13,19,0,13,377
23011025002,1805,1695,21,7,8,13,0,1,110
23013970200,5232,4882,72,17,3,34,2,19,350
23013970301,3109,2903,30,8,6,10,0,12,206
23013970302,3975,3741,54,10,6,7,4,18,234
23013970401,4865,4375,98,131,57,22,4,15,490
23013970402,2739,2491,70,14,8,33,4,5,248
23013970500,3644,3300,100,9,7,44,0,6,344
23013970600,2526,2326,47,23,13,21,0,10,200
23013970700,4410,4016,95,20,12,49,2,24,394
23013970800,3015,2840,24,10,7,11,0,3,175
23013970900,2594,2428,27,6,9,7,0,11,166
23013971000,2644,2486,29,0,8,3,1,7,158
23013971100,1854,1745,26,8,3,9,1,14,109
23013990000,0,0,0,0,0,0,0,0,0
23015975100,5560,5180,81,23,28,24,2,19,380
23015975200,5154,4856,46,19,20,33,0,9,298
23015975300,4088,3870,36,11,8,39,0,14,218
23015975400,3746,3515,58,10,4,22,3,12,231
23015975500,6186,5799,44,36,16,52,1,18,387
23015975600,3724,3531,45,14,5,15,2,14,193
23015975700,1127,1026,33,14,3,7,0,3,101
23015975800,3003,2835,24,9,11,10,0,3,168
23015976200,2649,2459,28,20,10,25,1,5,190
23015990000,0,0,0,0,0,0,0,0,0
23017965100,1529,1433,21,0,4,6,0,2,96
23017965400,3220,2987,52,20,5,21,0,8,233
23017965500,2153,1920,72,19,11,7,2,7,233
23017965600,3705,3427,53,17,11,5,0,6,278
23017965700,3378,3139,41,16,15,27,0,6,239
23017965800,3685,3434,35,8,13,6,0,17,251
23017965900,2940,2758,30,3,9,15,1,6,182
23017966001,2126,1977,36,5,0,9,1,6,149
23017966002,1245,1170,6,6,2,9,0,6,75
23017966100,1766,1593,37,2,13,7,0,8,173
23017966200,5179,4781,99,21,14,37,3,12,398
23017966300,3206,2983,27,27,11,9,0,5,223
23017966401,3999,3676,51,16,28,8,0,2,323
23017966402,2083,1959,25,1,10,11,3,0,124
23017966500,5077,4632,76,15,11,42,0,8,445
23017966600,3080,2883,38,9,3,9,2,20,197
23017966700,3369,3075,78,14,9,25,4,10,294
23017966800,2828,2643,47,2,7,13,0,14,185
23017966900,3209,2986,41,8,11,9,0,14,223
23019000200,3674,3145,116,89,42,79,0,13,529
23019000300,4428,3758,103,81,30,198,1,24,670
23019000400,2256,1984,73,19,14,44,0,6,272
23019000500,3646,3212,89,76,40,34,2,17,434
23019000600,2110,1797,80,56,44,30,0,5,313
23019000700,2631,2416,52,20,15,29,2,5,215
23019000900,6430,5529,163,166,77,97,4,19,901
23019002000,7709,7108,126,54,28,89,0,32,601
23019003000,3812,3596,30,4,12,25,1,13,216
23019004100,1762,1528,46,26,18,18,0,0,234
23019004200,2704,2478,62,27,5,34,3,5,226
23019004300,5206,4687,124,46,36,86,0,11,519
23019005000,1814,1649,29,14,15,37,0,8,165
23019006100,4049,3544,107,51,23,143,0,10,505
23019006200,2879,2594,71,16,26,41,0,27,285
23019006300,4255,3629,126,78,31,215,5,17,626
23019007100,4801,4268,113,56,85,64,0,11,533
23019007200,2630,2349,36,43,30,55,0,4,281
23019008001,4601,4214,44,28,70,34,2,9,387
23019009000,6311,5911,100,25,42,16,3,14,400
23019010000,6461,6019,80,43,31,39,0,21,442
23019011000,2867,2693,36,8,12,10,0,0,174
23019012000,1595,1511,18,1,12,6,1,2,84
23019012500,2536,2344,30,20,17,5,1,14,192
23019013000,3133,2938,61,16,10,18,0,6,195
23019013500,2412,2290,23,4,6,7,1,5,122
23019014000,2221,2096,39,3,7,2,0,9,125
23019015000,3803,3475,67,10,24,25,2,8,328
23019015500,1989,1858,40,7,12,9,0,5,131
23019018000,2940,2742,49,15,19,8,4,0,198
23019020500,2600,2362,49,10,13,0,0,5,238
23019021500,1853,1704,20,12,20,2,0,7,149
23019022500,1800,1661,11,14,32,4,0,2,139
23019024500,2364,2193,28,7,14,39,0,7,171
23019025500,1537,1425,16,3,9,1,3,4,112
23019026500,1937,1834,9,7,3,5,0,0,103
23019027000,4853,4551,80,8,33,24,0,7,302
23019028000,1435,1354,14,1,9,6,0,5,81
23019028500,1223,1165,7,0,15,0,1,2,58
23019029000,1853,1771,20,0,5,6,0,6,82
23019030000,4114,3861,44,10,28,17,0,4,253
23019031000,1572,1484,20,5,4,8,0,2,88
23019031100,6578,5855,98,200,29,185,0,22,723
23019031200,4451,4074,72,32,30,14,1,19,377
23019031300,5994,5610,76,32,21,45,0,8,384
23019940000,370,40,18,0,251,0,0,0,330
23021960301,1538,1473,12,3,7,1,0,3,65
23021960302,445,428,8,0,0,0,1,0,17
23021960400,1246,1159,13,2,12,0,0,15,87
23021960500,1654,1524,35,0,12,1,0,10,130
23021960600,2573,2391,24,11,7,21,1,8,182
23021960700,4422,3971,91,22,20,76,1,23,451
23021960800,3633,3329,55,17,36,16,0,5,304
23021960900,1289,1199,23,2,8,5,4,2,90
23023970100,3522,3276,50,9,16,12,0,7,246
23023970200,6183,5736,116,16,20,24,2,18,447
23023970301,5192,4804,100,48,3,71,0,12,388
23023970302,4368,4048,69,28,12,48,0,9,320
23023970400,4603,4287,77,17,10,23,0,19,316
23023970500,5434,4888,126,68,12,39,0,16,546
23023970600,3332,2968,69,84,14,21,0,13,364
23023970700,4065,3823,42,25,5,9,1,22,242
23023990000,0,0,0,0,0,0,0,0,0
23025965301,970,889,16,7,8,5,0,11,81
23025965302,1291,1226,12,1,0,5,0,2,65
23025965600,1839,1745,18,4,4,8,0,5,94
23025965700,2972,2783,21,6,15,9,0,6,189
23025965800,2809,2653,34,12,13,6,0,1,156
23025965900,1705,1580,23,5,5,1,0,21,125
23025966000,3908,3594,77,19,23,18,6,4,314
23025966100,3510,3296,54,18,13,3,0,4,214
23025966200,1844,1718,26,14,7,7,0,3,126
23025966300,2003,1854,29,2,5,16,1,8,149
23025966400,2291,2105,27,5,25,9,0,4,186
23025966500,4726,4386,72,41,28,28,0,16,340
23025966601,2036,1829,25,14,7,30,2,7,207
23025966602,2293,2149,14,17,2,22,1,6,144
23025966701,2444,2225,33,19,14,25,0,5,219
23025966702,1847,1699,24,4,6,14,0,5,148
23025966801,3381,3069,47,37,9,26,0,12,312
23025966802,3103,2934,32,6,10,8,3,6,169
23025966900,3278,3069,45,15,12,15,1,10,209
23025967000,2227,2111,27,2,7,6,0,4,116
23027041000,3817,3544,54,17,11,17,5,11,273
23027042000,6111,5705,78,13,39,24,2,16,406
23027043000,6938,6444,91,31,18,56,0,26,494
23027044000,4445,4171,66,13,10,28,2,22,274
23027045000,6112,5679,107,13,10,33,0,23,433
23027046001,2281,2133,34,4,12,4,2,9,148
23027046002,5180,4809,78,34,22,19,1,15,371
23027047000,4723,4398,51,10,18,19,0,12,325
23029955100,2711,1880,39,1,643,14,1,5,831
23029955300,1464,1353,14,0,49,3,0,0,111
23029955400,1318,1214,21,10,11,0,0,0,104
23029955500,3079,2828,55,11,53,20,0,2,251
23029955600,2033,1434,42,5,409,3,0,7,599
23029955700,1288,1135,22,5,55,4,0,11,153
23029955800,2210,2077,37,6,9,6,0,4,133
23029955900,2690,2499,27,7,46,11,1,18,191
23029956100,2288,2124,50,13,19,11,2,11,164
23029956200,2790,2540,64,56,23,20,0,5,250
23029956300,2592,2464,41,19,13,8,1,1,128
23029956400,3021,2786,80,9,17,6,2,9,235
23029956500,3611,3253,175,14,34,15,0,13,358
23029990000,0,0,0,0,0,0,0,0,0
23031005100,5524,5116,70,42,7,62,2,18,408
23031005200,5418,4837,117,71,16,142,0,16,581
23031005301,3690,3099,147,160,14,74,0,6,591
23031005302,2935,2634,62,41,6,76,0,6,301
23031005400,2814,2660,49,12,0,14,0,7,154
23031006103,3017,2715,64,29,7,69,2,12,302
23031006104,2769,2596,61,9,8,20,3,5,173
23031006105,912,854,14,8,4,4,0,5,58
23031006106,2262,2053,61,20,8,35,0,12,209
23031020001,3473,3252,36,23,13,37,0,5,221
23031020002,4903,4498,76,35,12,54,0,13,405
23031021000,4745,4416,59,17,17,11,1,25,329
23031022000,3892,3593,52,9,14,8,4,14,299
23031022500,3299,3105,40,9,13,14,1,8,194
23031023000,3188,2911,68,16,17,6,0,5,277
23031023501,3717,3488,55,14,3,25,5,5,229
23031023502,3523,3308,39,14,6,7,0,12,215
23031024001,3860,3572,75,14,12,16,0,9,288
23031024002,4076,3828,44,12,11,24,1,20,248
23031024501,4525,4206,59,21,15,36,0,10,319
23031024502,2129,1988,20,6,10,10,0,2,141
23031025100,3933,3573,100,58,19,70,0,10,360
23031025203,2874,2477,86,77,14,87,2,6,397
23031025204,2253,1862,92,124,8,59,0,0,391
23031025205,3272,2813,98,89,14,85,0,12,459
23031025206,4498,3832,151,191,40,50,2,19,666
23031025300,3043,2842,33,14,6,46,0,6,201
23031025400,2679,2487,28,28,4,54,3,33,192
23031026000,4264,3981,58,10,20,28,0,14,283
23031027000,3629,3444,48,7,4,15,1,16,185
23031028001,3585,3344,38,11,5,54,1,7,241
23031028003,4486,4138,99,22,9,77,0,16,348
23031028004,3465,3267,48,20,3,36,0,17,198
23031029000,3073,2838,39,42,11,18,1,9,235
23031030101,2266,2073,51,10,9,32,0,0,193
23031030102,2240,2027,36,32,10,36,0,2,213
23031030201,4230,3809,95,54,15,54,0,14,421
23031030203,3508,3120,69,34,19,103,0,14,388
23031030204,2909,2590,85,38,11,27,0,10,319
23031030205,3104,2718,52,58,13,85,2,9,386
23031030300,3725,3360,71,52,7,54,0,2,365
23031031000,6469,6024,85,21,24,37,0,29,445
23031032001,4840,4413,102,21,12,89,0,14,427
23031032002,3110,2863,45,26,1,32,2,11,247
23031033000,4978,4601,68,23,9,49,1,25,377
23031034002,6425,6015,91,44,9,50,1,14,410
23031034003,1776,1687,34,13,1,11,0,3,89
23031034004,1752,1620,27,14,3,42,0,2,132
23031034005,1361,1279,20,6,5,6,0,5,82
23031034006,1577,1484,27,14,2,8,0,10,93
23031035001,3576,3286,43,15,7,35,1,17,290
23031035002,3891,3585,90,17,7,23,0,7,306
23031036002,6260,5781,162,36,7,70,0,12,479
23031036003,3374,3199,32,11,0,26,0,9,175
23031036004,4089,3833,77,13,3,37,0,13,256
23031037000,6717,6159,140,43,9,52,0,33,558
23031038001,6674,5819,326,94,10,74,21,38,855
23031038002,3396,3072,83,45,3,47,1,8,324
23031990100,0,0,0,0,0,0,0,0,0
24001000100,3370,3221,15,20,1,5,5,7,149
24001000200,4097,2942,143,869,11,30,1,4,1155
24001000500,2055,1700,58,172,1,28,0,7,355
24001000600,3081,2676,42,160,5,15,0,16,405
24001000700,3330,2807,57,184,13,15,0,3,523
24001000800,1902,1601,30,99,6,7,0,14,301
24001001000,2126,1705,77,160,4,16,0,22,421
24001001100,1431,1191,31,103,3,18,0,8,240
24001001200,2899,2521,41,101,3,93,3,6,378
24001001300,4990,2381,141,2319,18,22,1,8,2609
24001001401,3890,3578,57,36,0,85,5,3,312
24001001402,1439,1296,14,44,1,21,1,0,143
24001001502,1845,1737,26,11,1,4,0,4,108
24001001503,1716,1656,3,14,0,0,0,0,60
24001001600,1618,1500,16,19,2,34,4,0,118
24001001700,4300,3876,54,103,7,74,0,13,424
24001001800,3891,2897,94,589,15,127,0,37,994
24001001900,2514,2388,21,0,7,13,1,1,126
24001002000,5370,4960,55,42,2,73,0,16,410
24001002100,3055,2959,20,8,4,0,0,2,96
24001002200,3684,3513,50,20,3,8,0,4,171
24001002300,5503,4848,104,213,8,45,1,10,655
24003701101,4369,3728,229,99,2,82,0,21,641
24003701103,3690,2766,587,55,7,75,2,23,924
24003701104,4083,3187,359,175,6,139,0,29,896
24003701201,3864,3405,170,48,2,41,1,20,459
24003701202,4968,4235,302,75,9,81,0,27,733
24003701301,4003,3401,175,169,0,77,1,25,602
24003701302,4035,3039,282,416,26,47,4,17,996
24003701400,3503,2741,174,376,0,50,2,12,762
24003702100,6854,5797,280,225,8,115,2,44,1057
24003702204,4465,3402,272,259,0,244,1,31,1063
24003702205,5881,4018,347,869,5,292,0,32,1863
24003702206,6651,4358,518,976,11,317,0,33,2293
24003702208,8244,4277,750,1780,9,864,10,38,3967
24003702209,4400,3008,289,498,4,275,3,20,1392
24003702300,5799,4743,321,163,10,170,2,31,1056
24003702402,7373,5888,446,453,17,230,0,32,1485
24003702500,6850,2052,1929,2434,10,176,4,29,4798
24003702601,5689,4208,405,685,4,110,0,29,1481
24003702602,5952,4798,238,556,3,102,2,29,1154
24003702702,4108,3593,145,96,3,98,1,14,515
24003702703,2503,2034,138,158,6,75,1,1,469
24003702704,2618,1609,238,488,9,120,4,14,1009
24003706102,2337,1284,164,791,1,29,1,7,1053
24003706103,1463,1114,72,118,0,81,5,4,349
24003706302,3354,2645,348,141,4,84,0,12,709
24003706303,2474,1069,417,820,3,49,2,13,1405
24003706304,2249,1611,317,186,0,59,0,9,638
24003706402,3520,1739,704,907,7,46,3,8,1781
24003706403,4104,1441,1788,577,2,155,0,15,2663
24003706404,2872,800,1568,368,3,40,4,6,2072
24003706500,5511,3093,1027,1015,4,159,0,24,2418
24003706600,5413,3337,921,856,8,91,1,21,2076
24003706700,621,418,90,47,2,39,0,4,203
24003707001,6060,4872,222,540,15,43,3,19,1188
24003707002,4660,3911,191,279,8,32,0,18,749
24003708001,3792,3284,120,160,10,44,0,10,508
24003708004,6203,3635,1310,835,23,59,2,29,2568
24003730101,2311,1862,87,170,7,68,4,5,449
24003730102,12283,6816,946,2973,22,714,16,81,5467
24003730204,7019,3029,839,2342,12,353,7,50,3990
24003730205,2345,849,456,674,17,201,0,11,1496
24003730206,3398,1678,511,863,17,132,2,21,1720
24003730300,3309,2123,507,366,21,102,0,8,1186
24003730401,5469,2869,744,1138,15,343,7,26,2600
24003730403,4085,1848,675,1164,10,144,2,32,2237
24003730404,2421,1334,520,312,5,78,0,11,1087
24003730507,4274,2485,345,828,17,340,6,14,1789
24003730508,2549,792,247,1308,8,53,3,23,1757
24003730509,5076,2948,440,1136,5,212,7,35,2128
24003730510,3554,1590,317,1225,5,182,1,15,1964
24003730511,1552,294,162,953,2,36,1,22,1258
24003730512,2245,735,272,1022,8,89,0,10,1510
24003730513,1604,543,158,709,3,100,0,7,1061
24003730514,3091,752,481,1493,4,161,6,25,2339
24003730601,7052,6006,193,166,5,321,4,20,1046
24003730603,3292,2611,136,155,0,192,0,27,681
24003730605,2877,2059,128,268,0,237,1,19,818
24003730606,5066,4315,214,147,2,141,0,23,751
24003730701,2784,2275,143,150,0,77,0,8,509
24003730702,4662,4138,170,29,3,97,0,13,524
24003730800,2435,2103,91,30,2,76,3,13,332
24003730901,2732,2061,154,313,1,65,1,4,671
24003730902,4022,3264,244,206,0,81,0,16,758
24003731002,3162,2372,323,252,0,54,2,18,790
24003731003,4444,3648,274,123,9,111,4,22,796
24003731004,4524,3570,287,231,7,119,7,15,954
24003731103,5974,4627,357,402,10,239,2,22,1347
24003731104,4557,3421,373,275,4,185,7,18,1136
24003731105,3504,2888,165,146,4,85,2,17,616
24003731106,4297,3516,226,189,6,122,3,21,781
24003731107,3625,3063,188,89,3,71,1,16,562
24003731201,6619,5633,281,146,4,203,0,20,986
24003731205,4283,3749,172,113,8,39,1,13,534
24003731206,3360,2995,129,52,6,26,0,17,365
24003731207,3323,2713,149,208,2,97,0,7,610
24003731208,3927,3202,151,266,15,56,5,22,725
24003731209,5587,3956,358,741,7,181,3,25,1631
24003731210,2130,1782,93,101,1,55,2,3,348
24003731303,6734,6044,180,77,8,76,6,26,690
24003731306,6474,5714,179,130,16,107,2,20,760
24003731307,6687,5231,332,493,5,189,1,43,1456
24003731308,3567,3117,143,84,4,46,0,31,450
24003731309,5345,4325,205,287,20,116,5,24,1020
24003731310,5272,4211,343,309,16,77,1,22,1061
24003731312,4837,3661,386,289,32,144,0,41,1176
24003731313,3255,2229,237,428,11,123,0,10,1026
24003740103,9197,3529,1264,2718,29,998,6,49,5668
24003740104,9010,2390,789,4383,15,775,9,49,6620
24003740105,4324,710,761,2440,10,155,4,27,3614
24003740106,3723,1673,387,1201,7,245,0,17,2050
24003740107,3732,1112,306,1245,0,846,5,20,2620
24003740108,5992,2173,758,1668,10,979,6,40,3819
24003740203,6655,4084,579,1012,33,417,3,42,2571
24003740204,4046,1490,482,1379,15,421,0,44,2556
24003740205,3557,1802,688,634,13,172,12,23,1755
24003740303,4727,2820,464,829,9,288,0,22,1907
24003740304,6628,3380,550,1765,20,398,13,52,3248
24003740305,10915,2462,920,6298,18,497,13,62,8453
24003740400,3937,785,120,3011,10,8,0,1,3152
24003740501,5764,960,564,3540,6,376,1,34,4804
24003740502,5331,968,415,3126,5,542,3,38,4363
24003740601,5432,2177,771,1467,11,477,23,35,3255
24003740602,2975,1410,511,617,9,92,9,34,1565
24003740603,2785,1462,467,508,14,127,15,10,1323
24003740701,6270,3833,470,1110,9,381,5,42,2437
24003740703,5771,3617,382,916,21,381,2,30,2154
24003740704,6959,3786,470,1711,18,484,11,50,3173
24003740800,4709,3626,265,342,13,153,1,31,1083
24003740900,7748,4458,785,1447,12,436,8,57,3290
24003741000,2686,1824,191,298,1,185,0,23,862
24003750101,4780,2407,806,974,20,205,6,32,2373
24003750102,2753,1503,446,524,11,79,0,5,1250
24003750201,3327,1597,431,983,10,139,0,8,1730
24003750204,5338,3337,620,876,21,170,4,27,2001
24003750300,2761,1908,222,251,11,198,8,23,853
24003750400,4255,3513,170,166,12,201,10,14,742
24003750801,5827,4188,456,585,10,244,8,30,1639
24003750803,7293,2769,1028,2552,34,457,11,31,4524
24003750804,3971,2476,581,529,15,143,1,30,1495
24003750900,3353,2331,417,260,5,108,5,28,1022
24003751000,3997,2579,566,458,19,108,4,20,1418
24003751102,4227,2060,388,1357,2,163,3,19,2167
24003751103,5766,4337,435,532,27,92,1,24,1429
24003751200,5321,3754,330,631,4,301,3,38,1567
24003751400,4414,2538,311,988,4,291,11,33,1876
24003751500,8062,1831,3040,2419,20,319,1,132,6231
24003751600,5392,4324,465,307,11,99,0,20,1068
24003751700,3022,2324,161,234,4,131,0,10,698
24003980000,0,0,0,0,0,0,0,0,0
24003990000,0,0,0,0,0,0,0,0,0
24005400100,4638,3336,140,492,7,561,0,4,1302
24005400200,2785,1718,132,449,4,293,3,10,1067
24005400400,5987,4818,205,256,6,430,2,32,1169
24005400500,2863,2500,76,59,0,86,0,14,363
24005400600,3058,1933,135,647,7,115,0,30,1125
24005400701,3037,1456,195,856,6,345,0,28,1581
24005400702,2033,927,110,716,2,148,0,5,1106
24005400800,3098,1282,317,775,5,545,4,16,1816
24005400900,2132,1023,296,450,10,258,2,13,1109
24005401000,2325,1647,103,365,3,104,0,7,678
24005401101,6773,1001,885,3897,7,722,3,50,5772
24005401102,955,135,102,547,5,114,0,22,820
24005401200,3138,497,283,2151,11,33,1,15,2641
24005401301,3872,490,297,2803,15,133,0,6,3382
24005401302,2565,264,117,2021,7,40,0,41,2301
24005401400,1630,1404,65,34,0,59,0,12,226
24005401503,6732,5273,288,342,15,414,0,49,1459
24005401504,6272,1713,307,2191,8,1755,2,33,4559
24005401505,4111,980,397,1499,4,1040,1,28,3131
24005401506,5230,523,263,3404,9,824,0,43,4707
24005401507,6058,520,697,3102,12,1500,1,48,5538
24005402201,3193,1576,117,1272,13,63,0,19,1617
24005402202,1593,955,78,413,4,57,1,14,638
24005402302,5305,259,255,4441,7,167,1,33,5046
24005402303,6849,369,493,5575,21,159,1,35,6480
24005402304,3609,91,172,3214,8,40,0,15,3518
24005402305,2055,318,55,1594,4,22,0,14,1737
24005402306,4025,187,151,3518,0,47,0,25,3838
24005402307,6364,301,380,5390,15,87,1,22,6063
24005402403,2028,74,53,1828,4,7,0,3,1954
24005402404,5239,131,305,4576,9,43,0,39,5108
24005402405,3407,254,286,2700,7,74,0,13,3153
24005402407,1433,267,86,952,1,52,0,11,1166
24005402408,2815,168,100,2307,6,81,4,33,2647
24005402409,3831,145,282,3177,7,105,0,13,3686
24005402503,5104,527,169,4094,12,77,0,29,4577
24005402504,4458,425,91,3670,2,77,3,39,4033
24005402505,3485,115,87,3101,1,38,2,21,3370
24005402506,4276,358,200,3464,7,96,2,24,3918
24005402510,5586,881,212,3829,8,395,5,40,4705
24005402511,4851,654,96,3285,7,655,0,23,4197
24005402602,2014,214,166,1507,0,40,1,12,1800
24005402603,6049,931,155,4602,5,142,0,42,5118
24005402604,5988,507,258,4831,9,144,0,27,5481
24005403100,2413,432,153,1688,1,34,0,8,1981
24005403201,3070,175,176,2528,14,49,0,21,2895
24005403202,2278,122,78,1932,7,20,2,12,2156
24005403300,2424,787,221,1166,6,100,1,20,1637
24005403401,3356,1614,141,1330,3,146,0,14,1742
24005403402,5250,1512,656,2696,9,164,5,21,3738
24005403500,5949,4821,246,341,2,287,1,83,1128
24005403601,4951,3880,120,425,3,301,2,54,1071
24005403602,5969,3756,191,1159,10,544,0,58,2213
24005403702,5476,2696,232,2220,3,169,2,15,2780
24005403703,2508,2029,49,302,2,68,0,10,479
24005403704,4578,1974,240,1868,8,266,0,27,2604
24005403801,1678,1402,45,77,1,91,3,7,276
24005403802,2971,2596,61,94,1,103,1,24,375
24005403803,3652,3145,72,202,4,127,2,15,507
24005404101,7434,2246,318,3944,5,553,4,67,5188
24005404102,5579,1717,639,2553,4,391,0,42,3862
24005404201,5887,1493,890,2623,6,566,0,51,4394
24005404202,8641,1694,2112,4112,22,380,2,56,6947
24005404402,6333,3769,343,1511,9,393,0,51,2564
24005404403,5202,1441,927,2126,8,397,0,36,3761
24005404404,4854,2672,361,1167,0,407,0,23,2182
24005404501,6815,3109,956,1950,25,468,5,33,3706
24005404502,4064,1361,760,1429,5,274,1,25,2703
24005404600,2620,2137,146,184,0,42,0,14,483
24005404800,2057,1466,81,310,0,105,0,11,591
24005404900,4681,3670,177,519,3,180,0,18,1011
24005405000,4587,4145,159,69,4,40,0,35,442
24005406000,5762,5202,144,93,13,75,0,20,560
24005407001,3327,2947,80,84,3,47,0,13,380
24005407002,5532,4876,169,85,17,123,4,27,656
24005408100,6314,5074,183,206,8,590,7,21,1240
24005408200,1955,1659,70,61,1,116,0,10,296
24005408302,2873,2339,65,42,2,324,0,10,534
24005408303,3496,2887,106,145,1,220,0,17,609
24005408304,4732,3992,119,111,3,378,0,12,740
24005408400,1309,972,58,114,4,122,0,6,337
24005408502,5765,4743,193,246,4,399,1,9,1022
24005408503,3812,1470,862,621,5,713,0,24,2342
24005408505,3973,2814,235,294,3,474,0,13,1159
24005408506,4981,1642,760,1942,18,396,7,37,3339
24005408507,6416,1989,1316,1830,15,923,7,52,4427
24005408601,4035,3041,226,142,4,458,0,10,994
24005408602,2162,1647,116,53,4,240,6,15,515
24005408702,2477,2117,60,97,5,108,0,6,360
24005408703,6350,4880,241,228,4,732,3,12,1470
24005408704,5851,4365,213,111,0,961,0,14,1486
24005408800,2452,1866,126,141,4,163,0,20,586
24005408900,2878,2294,127,120,2,221,0,0,584
24005410100,6095,5426,214,59,8,120,0,23,669
24005410200,5175,4556,165,73,4,170,0,24,619
24005411101,2206,1996,85,22,1,30,11,5,210
24005411102,3059,2793,87,34,4,33,0,7,266
24005411201,3262,2959,106,29,0,29,0,10,303
24005411202,3853,3443,101,48,1,104,3,11,410
24005411302,4675,2869,193,638,4,744,0,11,1806
24005411303,6415,4247,255,1010,13,624,2,43,2168
24005411306,5906,3411,196,1003,7,1007,4,24,2495
24005411307,3730,2073,205,798,5,488,0,21,1657
24005411308,4021,2742,146,311,4,657,0,9,1279
24005411309,9486,6385,310,899,13,1416,0,38,3101
24005411404,3738,2702,158,432,2,296,3,10,1036
24005411406,4340,3388,117,265,8,363,0,12,952
24005411408,4041,2083,248,924,7,623,0,12,1958
24005411409,5343,3363,156,800,0,763,1,23,1980
24005411410,4548,2732,200,808,12,562,2,11,1816
24005411411,3655,1976,163,1005,7,328,0,15,1679
24005411412,3702,1270,237,1613,3,362,4,22,2432
24005411413,2473,2260,81,44,0,54,0,3,213
24005420100,3468,2794,288,116,25,76,0,18,674
24005420200,3217,2643,145,197,4,49,1,14,574
24005420301,2251,1415,274,347,11,52,1,7,836
24005420302,2828,1919,255,364,32,55,0,17,909
24005420303,1319,1040,70,77,11,26,0,4,279
24005420401,6679,3778,801,1391,59,141,0,44,2901
24005420402,2190,1590,202,170,18,28,0,3,600
24005420500,4054,2187,1248,308,31,82,0,31,1867
24005420600,4835,2890,835,645,47,88,1,35,1945
24005420701,3313,1922,626,434,28,129,0,18,1391
24005420702,2285,1497,496,94,17,93,0,8,788
24005420800,3633,2610,413,239,15,115,4,22,1023
24005420900,3973,2291,523,797,16,75,0,8,1682
24005421000,2138,1140,427,403,14,24,2,16,998
24005421101,3276,1924,445,644,38,41,2,5,1352
24005421102,2646,1884,286,296,15,18,2,14,762
24005421200,1861,1430,179,98,9,30,1,1,431
24005430101,4898,1470,1586,1402,13,122,1,53,3428
24005430104,2842,1938,413,148,5,178,2,6,904
24005430200,3000,1712,358,513,4,186,4,46,1288
24005430300,5998,2380,1512,1585,16,187,0,23,3618
24005430400,4398,3103,313,436,11,254,0,15,1295
24005430600,2690,2076,109,213,2,153,0,7,614
24005430700,5116,3813,188,486,5,322,0,20,1303
24005430800,3749,2618,134,337,6,460,0,22,1131
24005430900,5702,2047,313,1097,16,1904,1,21,3655
24005440100,4458,3415,215,376,13,140,0,44,1043
24005440200,2689,1629,119,698,19,100,0,16,1060
24005440300,2258,878,144,800,2,324,0,11,1380
24005440400,5440,2941,342,1768,17,91,3,30,2499
24005440500,3382,2339,148,628,8,96,0,20,1043
24005440600,2396,1365,97,430,5,386,1,3,1031
24005440701,7268,1903,833,3636,12,602,0,50,5365
24005440702,5178,2318,290,1775,17,491,2,47,2860
24005440800,3348,1098,170,1331,6,594,2,14,2250
24005440900,3754,1015,340,1841,15,390,0,23,2739
24005441000,3794,504,150,2960,7,57,9,13,3290
24005441101,2462,1217,223,644,12,261,1,17,1245
24005441102,4860,2208,495,1506,6,415,1,26,2652
24005450100,3988,2696,471,450,15,163,0,12,1292
24005450200,3415,2617,275,255,11,71,1,18,798
24005450300,3659,2628,300,299,17,176,0,32,1031
24005450400,2490,1737,240,236,18,66,0,14,753
24005450501,4107,2755,420,546,30,94,4,30,1352
24005450503,5949,1229,602,3621,19,80,1,65,4720
24005450504,5452,1131,327,3613,22,61,3,22,4321
24005450800,4203,1912,399,1518,34,102,3,35,2291
24005450900,4335,3412,150,509,12,41,1,13,923
24005451000,1702,1576,37,15,6,15,0,8,126
24005451100,2386,949,96,1102,6,57,0,14,1437
24005451200,3941,2994,269,315,34,118,0,19,947
24005451300,3637,1883,339,1088,7,89,1,15,1754
24005451401,4357,693,397,2492,3,563,0,19,3664
24005451402,5686,1687,852,2659,24,109,0,18,3999
24005451500,4137,1915,277,1625,20,26,2,32,2222
24005451600,1896,1607,87,75,2,30,1,0,289
24005451701,7200,3752,403,2177,17,498,2,27,3448
24005451702,1870,1692,33,23,12,15,0,7,178
24005451801,5394,3820,186,1048,6,53,2,15,1574
24005451802,4015,3310,250,244,6,31,0,9,705
24005451803,4653,2919,165,1211,12,83,3,24,1734
24005451900,2764,2432,87,84,7,23,2,8,332
24005452000,2522,2173,40,202,7,10,0,1,349
24005452100,3651,3219,107,77,7,22,0,18,432
24005452300,3334,1484,1309,298,14,78,4,12,1850
24005452400,3315,2619,165,225,11,90,0,3,696
24005452500,4157,2895,388,501,45,41,0,15,1262
24005490100,4221,3604,98,99,5,232,3,14,617
24005490200,2984,2281,123,85,4,350,3,15,703
24005490302,3634,2306,193,678,6,301,4,13,1328
24005490303,3675,1724,225,1363,5,219,1,6,1951
24005490304,4177,2166,251,1141,5,410,0,24,2011
24005490400,1878,1647,63,40,0,57,0,5,231
24005490500,3655,3177,136,91,0,110,1,2,478
24005490601,2248,1882,120,57,2,77,0,8,366
24005490602,3195,2453,191,158,0,216,0,6,742
24005490603,2399,1932,114,74,0,190,0,6,467
24005490605,6524,3066,479,2346,5,274,2,25,3458
24005490701,1512,1364,31,54,3,19,2,5,148
24005490703,3069,2318,148,239,1,224,0,14,751
24005490800,3249,2728,132,132,4,140,0,7,521
24005490900,4695,2676,313,1065,8,426,1,22,2019
24005491000,2441,2063,100,66,0,63,0,18,378
24005491100,3650,2360,296,528,4,292,0,16,1290
24005491201,1888,1172,117,391,1,126,1,2,716
24005491202,1850,1129,100,429,5,84,0,20,721
24005491300,3234,1191,183,1253,13,400,0,14,2043
24005491401,5135,429,309,4143,11,99,0,18,4706
24005491402,3125,754,212,1926,7,74,5,20,2371
24005491500,4293,1956,511,1368,10,229,4,32,2337
24005491600,3345,1306,368,1354,13,135,0,27,2039
24005491701,4281,2489,219,1059,7,302,1,19,1792
24005491900,1983,1436,135,197,2,122,1,4,547
24005492001,1463,749,139,371,4,111,1,10,714
24005492002,4012,2489,259,937,8,131,1,28,1523
24005492101,3890,2290,215,1022,10,164,0,14,1600
24005492102,2091,1334,124,440,4,84,0,10,757
24005492200,4872,3099,223,985,6,325,0,25,1773
24005492300,4143,2337,466,920,27,101,1,28,1806
24005492401,3857,282,122,3179,7,124,3,19,3575
24005492402,6685,1348,290,4366,4,412,1,32,5337
24005492500,4383,1833,272,1175,4,764,4,30,2550
24005492600,3475,2004,159,869,12,226,5,20,1471
24005492700,3156,712,281,1884,16,40,0,1,2444
24005980100,0,0,0,0,0,0,0,0,0
24005980200,6,2,0,0,0,0,0,0,4
24009860103,6290,4929,321,487,10,178,2,30,1361
24009860200,6280,4810,227,702,14,142,9,28,1470
24009860300,4291,3241,152,593,15,32,2,19,1050
24009860402,3958,2851,195,580,3,37,6,22,1107
24009860403,3456,2471,172,476,2,60,8,18,985
24009860404,6567,5001,380,586,6,90,9,30,1566
24009860501,7145,5331,342,769,17,171,5,45,1814
24009860502,2843,2340,90,200,3,20,3,10,503
24009860600,7126,5638,281,615,12,148,6,27,1488
24009860701,2877,2159,125,349,14,72,3,9,718
24009860702,3453,2071,151,885,17,86,1,22,1382
24009860703,4042,2548,238,923,15,64,4,17,1494
24009860801,7092,5371,268,909,15,84,5,25,1721
24009860901,4739,3669,151,607,8,94,2,6,1070
24009860902,2992,1820,159,759,7,19,3,21,1172
24009861003,6517,4744,325,861,10,72,1,25,1773
24009861004,7201,5036,399,1110,27,109,0,31,2165
24009861100,5914,4730,226,511,12,71,5,21,1184
24009990100,0,0,0,0,0,0,0,0,0
24011955000,3368,1757,1368,99,1,11,2,14,1611
24011955100,5484,4376,405,330,13,33,0,29,1108
24011955201,3793,2842,229,499,5,37,1,16,951
24011955202,2124,1802,78,151,0,10,2,2,322
24011955301,4267,3421,152,394,12,82,1,9,846
24011955302,3393,2170,205,762,19,54,1,9,1223
24011955400,2039,1743,27,190,7,11,4,0,296
24011955500,3831,3043,161,443,5,24,0,10,788
24011955600,4994,2960,195,1500,5,83,2,13,2034
24013501001,4579,3690,212,349,11,50,0,11,889
24013501002,5279,4734,147,143,12,28,0,25,545
24013502000,4137,3797,102,37,0,47,0,17,340
24013503000,5460,5021,107,80,7,41,0,12,439
24013504100,5112,4398,193,173,7,76,0,18,714
24013504201,6504,5687,185,188,10,148,5,19,817
24013504202,6180,5486,142,159,11,91,3,29,694
24013505101,4255,3609,138,186,7,114,0,12,646
24013505102,5840,4927,189,154,19,243,1,23,913
24013505203,3983,2784,191,616,4,232,0,19,1199
24013505205,3649,2942,142,130,9,233,2,18,707
24013505206,3488,3040,120,79,2,90,0,6,448
24013505207,3927,3148,170,159,1,256,0,17,779
24013505208,5138,4333,202,252,6,134,0,5,805
24013506101,4732,4180,180,113,2,80,0,18,552
24013506102,4445,3928,163,72,9,79,0,3,517
24013506200,5454,4938,142,134,6,32,3,33,516
24013507500,5379,3787,330,723,16,200,5,29,1592
24013507601,5148,3883,637,230,19,109,0,27,1265
24013507602,4286,3612,270,133,9,67,1,15,674
24013507702,3944,3287,255,170,1,70,4,6,657
24013507703,2838,2535,77,83,5,52,0,5,303
24013507704,6176,4847,421,285,7,234,0,27,1329
24013507801,5929,4444,534,500,13,153,4,9,1485
24013507802,4754,4059,189,128,6,134,0,23,695
24013508103,7778,6844,271,162,15,103,4,37,934
24013508200,6928,6137,283,124,1,100,0,22,791
24013509001,4710,4239,107,71,6,42,0,15,471
24013509002,2798,2493,109,38,5,30,1,10,305
24013510000,1326,1213,34,45,2,2,0,0,113
24013511000,3693,3329,86,64,6,34,0,4,364
24013512000,1526,1330,35,76,0,5,0,7,196
24013513001,5051,4238,324,126,11,105,0,14,813
24013513002,5731,4658,518,106,6,131,1,29,1073
24013514100,3849,3390,135,83,4,55,2,12,459
24013514201,5371,4728,224,92,6,80,0,20,643
24013514202,3514,3006,181,98,7,86,0,5,508
24015030100,4787,4112,313,156,1,21,0,18,675
24015030200,5289,4695,253,73,12,11,0,17,594
24015030400,4956,3154,541,881,16,24,1,22,1802
24015030501,4282,3748,181,112,7,15,0,10,534
24015030503,5866,4099,406,822,13,131,1,24,1767
24015030505,3936,2898,256,470,14,41,0,12,1038
24015030507,3702,2077,305,839,5,228,0,38,1625
24015030508,4399,3063,333,628,5,52,4,15,1336
24015030601,3703,3285,187,51,2,28,0,6,418
24015030602,5168,3419,386,887,9,126,1,32,1749
24015030700,5345,4903,138,63,20,40,2,20,442
24015030903,5607,4268,372,468,12,51,3,34,1339
24015030904,7103,6195,230,204,10,92,1,45,908
24015030905,2703,2420,118,51,5,11,2,10,283
24015030907,4376,3483,190,359,3,76,0,19,893
24015030908,6239,4943,338,415,14,86,3,19,1296
24015031201,6125,5277,196,239,27,50,0,14,848
24015031202,5610,4295,213,670,24,58,2,23,1315
24015031301,3378,3115,76,32,8,13,2,9,263
24015031302,7178,6438,307,45,13,58,1,10,740
24015031400,3973,3598,111,35,11,20,0,11,375
24017850101,7030,1252,509,4554,42,236,19,33,5778
24017850102,2374,891,299,943,34,81,1,17,1483
24017850201,972,333,147,395,11,18,0,4,639
24017850202,4647,1778,249,2171,38,114,0,12,2869
24017850300,1956,1028,95,639,24,24,1,7,928
24017850400,3559,2158,114,1006,37,26,0,18,1401
24017850500,2775,2016,106,432,22,19,3,16,759
24017850600,4546,2250,254,1605,45,137,3,8,2296
24017850706,5638,984,418,3388,33,477,5,43,4654
24017850708,5281,1033,384,3139,19,374,4,28,4248
24017850709,7566,847,792,5147,23,302,4,65,6719
24017850710,5578,1015,406,3429,25,310,7,38,4563
24017850711,5739,726,536,3837,30,287,6,39,5013
24017850712,6117,1814,352,3254,50,202,0,32,4303
24017850713,9599,2332,614,5416,22,535,7,59,7267
24017850801,4548,1780,374,1938,20,112,10,36,2768
24017850802,5937,1355,728,3356,32,136,1,23,4582
24017850901,5761,1102,540,3566,38,140,5,43,4659
24017850902,5433,1678,699,2482,22,154,14,32,3755
24017850904,13090,1923,697,9115,55,518,8,73,11167
24017850905,4312,953,382,2607,22,101,7,33,3359
24017850906,4750,784,421,3123,49,92,2,25,3966
24017851001,3507,2148,199,892,7,90,0,5,1359
24017851003,4438,3025,232,689,21,141,6,18,1413
24017851004,5953,2641,424,2172,24,255,12,16,3312
24017851100,2849,2115,153,379,35,35,0,12,734
24017851200,4675,3496,175,628,32,66,8,25,1179
24017851301,4900,3989,158,391,33,42,2,18,911
24017851302,4407,2875,187,936,17,87,5,18,1532
24017851401,3218,1550,145,1233,42,38,6,17,1668
24017851402,3445,2258,137,723,18,59,0,26,1187
24017851403,1847,958,103,619,18,24,0,21,889
24017851501,4630,877,313,2882,30,214,0,47,3753
24017851502,5540,868,335,3764,25,178,1,50,4672
24017990000,0,0,0,0,0,0,0,0,0
24019970100,2653,2047,83,387,3,25,3,5,606
24019970200,5666,3394,220,1672,18,53,0,34,2272
24019970300,4577,3789,158,403,10,31,0,16,788
24019970400,3337,2165,256,726,7,34,0,16,1172
24019970500,4106,873,360,2629,8,14,0,24,3233
24019970600,5232,1795,406,2672,10,124,2,23,3437
24019970702,3862,3174,191,325,12,37,0,8,688
24019970804,1788,1594,67,58,13,22,0,2,194
24019970900,1310,1060,36,145,10,15,1,2,250
24019990000,0,0,0,0,0,0,0,0,0
24021740200,5027,3912,398,305,8,128,1,36,1115
24021750100,1651,1179,129,214,3,18,1,9,472
24021750200,1686,1450,80,57,0,26,0,0,236
24021750300,1728,966,120,490,7,20,0,14,762
24021750504,6012,2357,1353,1555,11,407,5,42,3655
24021750505,7660,1970,3225,1466,11,558,0,57,5690
24021750506,4321,1718,1283,678,2,425,5,22,2603
24021750507,4271,913,2248,702,2,238,0,21,3358
24021750508,5056,1179,1849,1476,14,242,3,52,3877
24021750600,2756,2231,178,188,1,41,0,35,525
24021750701,5623,2694,1109,1140,10,282,11,37,2929
24021750702,3822,1910,656,822,10,180,8,17,1912
24021750801,2883,2058,272,327,10,57,0,18,825
24021750802,6055,4093,517,863,2,267,0,14,1962
24021750804,2441,1594,301,314,0,112,2,9,847
24021750805,4914,2935,612,816,4,220,2,28,1979
24021751001,2076,922,300,452,4,253,0,22,1154
24021751002,5297,3067,806,702,13,361,5,40,2230
24021751003,5920,2687,1062,1298,22,480,6,39,3233
24021751004,5749,3137,848,1000,4,368,6,42,2612
24021751201,5702,3442,637,910,2,400,21,41,2260
24021751202,6654,3784,631,1201,26,561,1,41,2870
24021751203,2424,1931,176,124,1,70,0,10,493
24021751301,4752,3498,427,395,3,193,7,23,1254
24021751302,3166,2765,187,34,6,27,5,6,401
24021751600,3023,2764,80,34,3,30,0,6,259
24021751701,2463,2156,106,52,2,17,0,6,307
24021751702,3782,3308,150,66,3,40,1,8,474
24021751801,5417,4475,297,158,9,161,3,30,942
24021751802,3823,3428,156,37,5,19,0,9,395
24021751902,6005,4555,474,382,3,254,1,23,1450
24021751903,6485,5468,392,149,7,153,0,15,1017
24021751904,4606,3173,382,434,6,357,0,26,1433
24021751905,3755,2614,298,200,5,381,0,21,1141
24021751906,2521,1992,187,99,0,100,2,11,529
24021752001,4815,4002,327,162,5,69,5,7,813
24021752101,3661,2939,253,99,8,155,1,27,722
24021752102,6881,4863,644,443,8,546,0,45,2018
24021752201,2399,1882,153,112,5,122,1,8,517
24021752202,4481,2115,597,561,2,868,2,34,2366
24021752205,3571,1633,424,342,3,967,3,25,1938
24021752206,5889,3425,597,486,8,1027,0,40,2464
24021752301,7217,3454,1235,1475,7,557,5,57,3763
24021752302,4274,3333,332,230,8,120,0,29,941
24021752303,3606,2626,289,289,12,162,0,16,980
24021752501,5170,4314,411,112,3,80,1,13,856
24021752502,2362,2047,102,52,8,30,1,14,315
24021752601,4481,3863,203,85,4,121,0,20,618
24021752602,2729,2335,196,58,0,49,0,8,394
24021752603,4057,3327,259,149,5,128,0,24,730
24021752801,2192,2001,54,26,2,15,0,1,191
24021752802,3654,3202,168,81,6,53,0,6,452
24021752900,3094,2824,76,56,1,15,3,12,270
24021753001,4527,4093,167,36,11,51,0,8,434
24021753002,2746,2441,130,28,4,23,0,9,305
24021765100,4288,2282,961,684,6,157,0,31,2006
24021766800,5872,4611,331,528,13,114,23,9,1261
24021767500,2792,2588,75,17,2,24,0,15,204
24021767600,3170,2755,151,62,9,22,2,17,415
24021770700,3638,3183,149,45,4,34,7,17,455
24021772200,1566,942,185,277,11,23,0,16,624
24021773500,4236,2780,613,434,8,109,4,31,1456
24021775302,5722,4236,487,524,6,142,0,24,1486
24021775400,3929,3114,261,254,3,45,0,28,815
24021775600,5172,4101,363,160,10,153,0,24,1071
24023000100,3980,3746,67,24,3,9,0,11,234
24023000200,3800,3664,32,15,0,3,0,21,136
24023000300,2486,2397,6,22,0,9,0,1,89
24023000400,2951,2825,20,24,7,1,1,1,126
24023000501,1426,1386,11,2,4,9,0,3,40
24023000502,2638,2360,67,98,7,23,0,6,278
24023000601,4165,4008,40,18,0,12,0,4,157
24023000602,1782,1692,13,9,2,3,0,0,90
24023000700,5578,5324,65,27,10,13,1,7,254
24025301102,4169,3123,172,315,12,354,2,19,1046
24025301105,3980,3177,175,266,2,150,0,20,803
24025301106,4125,3358,202,202,3,163,6,23,767
24025301107,3961,2549,305,688,7,198,4,23,1412
24025301108,3737,2761,178,373,7,213,0,24,976
24025301201,2033,1820,53,38,3,9,0,3,213
24025301202,7954,5565,499,723,7,734,0,12,2389
24025301204,4476,2938,278,774,5,172,0,29,1538
24025301205,4186,2995,229,611,2,120,4,23,1191
24025301301,5009,3081,451,1002,14,186,2,15,1928
24025301302,7700,2032,766,4188,19,132,3,72,5668
24025301401,7709,5094,402,1570,11,163,6,45,2615
24025301402,2823,1780,158,617,4,64,3,13,1043
24025301601,6721,2199,769,3165,11,64,13,47,4522
24025301602,7749,3252,603,3114,15,177,4,46,4497
24025301703,5049,2748,285,1550,10,187,4,42,2301
24025301704,3492,2046,209,840,3,109,0,32,1446
24025301705,2755,1432,163,821,9,124,7,28,1323
24025301706,3078,1220,238,1273,7,124,3,21,1858
24025301707,3644,1949,277,1116,19,74,6,28,1695
24025302100,2141,1936,44,40,4,24,0,1,205
24025302200,2972,2235,128,368,5,65,2,4,737
24025302400,4099,2168,280,1243,13,133,10,3,1931
24025302801,4436,2936,263,801,9,122,11,24,1500
24025302802,4520,2133,509,1372,7,164,0,28,2387
24025302901,2887,1165,391,1001,3,53,10,18,1722
24025302902,4491,2353,327,1348,24,92,11,16,2138
24025303101,6361,5289,278,271,4,179,1,18,1072
24025303102,2864,2523,89,58,4,69,0,0,341
24025303201,5937,5219,212,109,7,104,0,27,718
24025303203,3393,2899,128,87,3,95,0,28,494
24025303204,4552,3985,149,122,9,104,3,11,567
24025303205,1674,1495,53,26,1,19,0,11,179
24025303206,3975,3438,124,106,2,100,5,21,537
24025303300,6834,6161,177,95,15,113,1,21,673
24025303400,4910,4231,158,145,6,175,0,26,679
24025303501,7526,5926,315,374,7,532,3,18,1600
24025303502,3539,3135,101,128,1,34,1,1,404
24025303602,3963,3372,130,108,3,139,0,13,591
24025303603,7131,5874,255,292,11,347,0,17,1257
24025303605,6338,4711,352,528,7,389,3,54,1627
24025303606,3269,2499,149,194,2,295,4,9,770
24025303700,3867,3363,127,115,9,71,1,3,504
24025303801,2737,2267,169,129,3,56,1,7,470
24025303802,2013,1554,74,240,4,71,4,5,459
24025303803,5292,4240,444,240,2,137,0,20,1052
24025303900,2383,1982,99,146,1,54,0,7,401
24025304101,4564,4210,93,31,5,28,0,14,354
24025304102,3875,3584,77,11,10,16,4,17,291
24025304201,6364,5732,163,69,4,112,1,20,632
24025304202,6821,6064,156,191,6,73,2,35,757
24025305100,7557,6885,153,101,12,45,4,12,672
24025305200,2610,2378,58,55,9,12,0,5,232
24025305300,2069,1798,76,76,6,6,2,6,271
24025306100,3898,2549,302,732,10,54,0,16,1349
24025306200,2174,1655,125,201,11,20,4,15,519
24025306300,3124,2009,177,663,15,84,12,29,1115
24025306400,7563,5122,407,1275,12,304,7,44,2441
24025306500,1851,790,283,500,6,87,4,22,1061
24027601103,6036,3403,344,686,9,1271,0,18,2633
24027601104,6605,3991,230,658,8,1376,0,37,2614
24027601105,5187,2795,318,744,7,1045,0,22,2392
24027601107,5076,1785,1662,579,12,796,0,42,3291
24027601108,3920,1971,269,689,4,789,2,15,1949
24027601203,9282,2044,734,3701,22,2251,15,75,7238
24027601204,7744,2821,1225,1876,13,1330,6,47,4923
24027601205,4932,1973,325,1269,16,1012,7,29,2959
24027601206,4353,2505,230,717,2,632,0,27,1848
24027602100,9126,5130,346,594,6,2645,0,36,3996
24027602201,4114,1945,149,399,3,1433,1,22,2169
24027602202,5730,3283,237,462,0,1447,1,34,2447
24027602302,6876,3340,360,1216,2,1539,6,29,3536
24027602303,4287,1924,143,183,5,1794,0,34,2363
24027602304,5126,2663,161,187,2,1829,0,14,2463
24027602305,3998,2775,125,189,4,708,0,7,1223
24027602306,5509,3148,306,503,12,1224,0,25,2361
24027602600,8281,2619,629,1290,13,3425,0,53,5662
24027602700,5929,3309,235,446,0,1678,0,11,2620
24027602800,6657,2951,271,730,6,2348,1,29,3706
24027602900,4944,1426,368,845,19,2067,1,31,3518
24027603001,6883,3500,156,449,10,2534,0,28,3383
24027603003,4606,3403,198,186,0,554,0,28,1203
24027603004,7658,4637,242,559,7,1865,0,40,3021
24027604001,6457,5168,343,208,7,351,0,47,1289
24027604003,4111,3290,153,210,3,269,2,18,821
24027604004,4442,3190,164,211,6,644,0,9,1252
24027605103,5462,3432,219,374,4,1122,0,26,2030
24027605104,5969,3222,190,433,5,1782,5,47,2747
24027605105,8129,3945,375,994,13,2213,8,51,4184
24027605106,4690,2751,187,413,1,1097,0,31,1939
24027605401,5263,2250,445,1660,9,458,10,42,3013
24027605403,4304,1659,442,1550,10,332,0,47,2645
24027605404,4483,2241,311,1204,5,482,0,37,2242
24027605502,4032,1762,285,1198,6,520,2,31,2270
24027605503,6287,2216,1020,1971,14,593,0,68,4071
24027605504,2541,1248,73,187,1,909,0,23,1293
24027605505,6140,2936,157,422,6,2369,0,29,3204
24027605601,7494,3429,678,2216,12,721,4,52,4065
24027605602,8185,4168,654,1892,11,958,5,58,4017
24027606601,2923,1668,265,587,4,218,1,5,1255
24027606603,7995,2660,1519,2614,16,545,9,101,5335
24027606604,4593,1730,603,1450,9,458,3,67,2863
24027606606,5301,1444,971,1766,20,758,5,37,3857
24027606607,4491,2069,606,1097,3,383,3,47,2422
24027606701,2682,1880,182,269,9,176,0,10,802
24027606704,6606,2437,763,2207,10,739,0,47,4169
24027606706,5431,2332,318,1357,16,1131,0,33,3099
24027606708,6328,2268,722,2203,3,749,1,30,4060
24027606803,5794,2974,420,1469,6,487,1,51,2820
24027606804,3229,1773,238,670,3,278,1,29,1456
24027606805,5221,2909,225,578,1,1225,0,34,2312
24027606807,2432,1081,135,468,4,601,1,11,1351
24027606808,5700,2409,360,1171,0,1421,0,58,3291
24027606901,7291,2263,1178,2507,16,957,1,44,5028
24027606904,4495,1124,546,1881,5,669,7,38,3371
24027606905,7553,2986,975,2275,25,846,1,71,4567
24027606906,6857,1864,1143,2310,9,1073,4,70,4993
24027606907,6547,1117,1234,2839,7,947,0,81,5430
24029950100,3529,2797,312,267,2,34,0,14,732
24029950200,4506,3412,269,629,3,14,0,17,1094
24029950300,5983,4061,345,1166,11,181,0,10,1922
24029950400,2789,2105,79,474,8,10,0,8,684
24029950500,2391,2009,56,215,0,11,0,13,382
24029990000,0,0,0,0,0,0,0,0,0
24031700101,4570,2758,662,434,11,402,2,55,1812
24031700103,5492,3260,622,478,8,832,3,35,2232
24031700104,5486,1814,1535,1321,0,546,0,52,3672
24031700105,6406,2042,1564,1521,7,928,1,53,4364
24031700204,2103,1532,378,59,0,42,1,15,571
24031700206,5708,3806,821,398,9,346,0,46,1902
24031700207,5804,2670,1386,896,9,487,0,41,3134
24031700208,2433,1560,432,166,10,110,0,19,873
24031700209,4451,3129,552,254,7,256,2,23,1322
24031700210,9416,2365,1027,1685,13,3904,2,82,7051
24031700306,7833,2360,1217,1865,13,1932,5,51,5473
24031700308,6221,2529,1277,1461,6,642,2,52,3692
24031700309,5807,1491,1393,1812,19,770,6,31,4316
24031700310,6962,2010,1410,2067,9,1026,1,86,4952
24031700313,3713,917,527,996,18,1070,0,11,2796
24031700314,3839,1035,395,584,0,1573,2,33,2804
24031700315,6324,1800,701,1066,2,2411,3,22,4524
24031700316,3851,918,561,820,1,1334,1,34,2933
24031700317,6673,2274,864,1254,2,1917,0,44,4399
24031700318,3290,1028,418,696,2,980,1,17,2262
24031700400,2352,1771,266,123,3,90,0,6,581
24031700500,7196,5185,713,399,13,442,0,50,2011
24031700604,6725,4583,479,331,9,969,0,25,2142
24031700606,4192,2076,268,155,4,1480,0,9,2116
24031700608,5800,2746,274,354,2,2129,0,22,3054
24031700610,1938,1194,246,103,3,286,0,12,744
24031700611,5816,1592,448,687,4,2793,5,43,4224
24031700613,6636,2302,713,1194,6,2066,8,37,4334
24031700614,5624,1428,1529,1519,21,812,0,60,4196
24031700615,2895,1963,195,188,2,398,2,8,932
24031700616,4573,2354,354,388,11,1198,11,51,2219
24031700617,2546,862,142,203,2,1191,0,12,1684
24031700618,5093,1584,253,264,1,2808,1,14,3509
24031700706,4691,1012,1295,1110,3,1037,6,50,3679
24031700710,6718,2017,2381,932,19,1022,0,55,4701
24031700711,6733,2469,1446,1074,10,1367,10,62,4264
24031700713,6081,572,3341,1266,23,656,0,49,5509
24031700715,6117,1365,2463,1193,7,806,0,56,4752
24031700718,5487,2574,557,881,6,1084,13,39,2913
24031700720,3150,732,1077,598,6,553,13,23,2418
24031700721,3200,676,1236,767,7,358,0,37,2524
24031700723,3756,1658,909,706,0,356,13,19,2098
24031700724,3279,318,1723,861,4,278,0,21,2961
24031700725,6270,700,3860,1124,19,367,2,64,5570
24031700726,3149,551,994,850,19,558,0,30,2598
24031700727,1793,520,913,148,0,156,1,12,1273
24031700728,2043,721,332,337,0,518,2,23,1322
24031700729,2579,548,772,576,3,559,0,21,2031
24031700730,5343,1493,1646,1000,6,897,1,75,3850
24031700731,4261,811,1743,1007,5,504,0,31,3450
24031700732,3361,456,1666,685,2,435,5,35,2905
24031700733,5480,1156,1730,1386,3,912,3,60,4324
24031700810,5277,1555,1616,1216,10,584,0,62,3722
24031700811,5010,951,1906,1433,12,446,0,26,4059
24031700812,4669,1509,1629,688,11,626,1,43,3160
24031700813,6353,1493,2497,1371,15,703,4,34,4860
24031700815,8255,1721,2411,2236,16,1444,5,92,6534
24031700818,6624,983,2249,2278,7,770,3,62,5641
24031700819,6585,1922,1815,1755,15,730,3,51,4663
24031700820,3097,542,1245,619,4,524,1,21,2555
24031700822,1771,369,597,344,1,345,1,21,1402
24031700823,3509,1778,470,358,13,696,0,27,1731
24031700824,2872,1855,294,135,3,363,1,29,1017
24031700826,5822,3949,379,239,6,932,3,46,1873
24031700828,2258,1250,104,99,0,681,0,4,1008
24031700829,3498,1502,326,276,0,1210,11,24,1996
24031700830,2376,401,442,868,5,515,2,21,1975
24031700832,3206,582,1476,660,7,371,0,34,2624
24031700833,4600,837,1768,892,10,860,4,26,3763
24031700834,5105,906,1569,1643,7,720,0,36,4199
24031700835,4388,1283,719,817,21,1315,1,33,3105
24031700836,1521,551,262,204,0,422,2,22,970
24031700837,7443,1486,2237,1087,18,2315,0,91,5957
24031700838,4720,2028,585,1004,6,801,2,43,2692
24031700839,4931,2055,555,665,8,1380,0,40,2876
24031700901,5213,2233,709,672,5,1348,1,44,2980
24031700902,3816,1214,1221,580,3,608,0,44,2602
24031700903,2377,688,926,420,3,220,0,20,1689
24031700904,4141,1213,938,547,14,1220,0,30,2928
24031700905,4149,1682,343,261,3,1695,0,26,2467
24031701001,5503,2829,832,528,1,977,0,44,2674
24031701002,4089,2705,340,244,5,565,0,24,1384
24031701004,5301,3026,580,611,12,655,6,35,2275
24031701005,3281,1947,281,161,0,702,0,9,1334
24031701006,5550,3082,356,215,7,1596,2,37,2468
24031701007,3129,1404,361,425,5,739,2,26,1725
24031701101,4705,1959,1463,290,11,711,5,52,2746
24031701102,6167,2220,2100,462,18,1029,3,61,3947
24031701201,6144,2469,1785,523,3,984,2,54,3675
24031701202,2785,2083,280,33,0,184,3,18,702
24031701205,7090,4861,610,420,4,836,0,46,2229
24031701206,6579,3666,574,290,9,1655,4,82,2913
24031701210,3977,2555,278,156,6,748,0,44,1422
24031701211,6350,2487,766,878,4,1742,4,48,3863
24031701212,2723,1647,337,181,3,357,2,16,1076
24031701214,3718,2060,458,385,5,606,0,35,1658
24031701215,4662,2648,517,436,4,785,2,33,2014
24031701216,5986,2921,586,741,7,1378,2,58,3065
24031701218,3050,1445,388,450,10,588,0,13,1605
24031701219,3879,952,1217,726,24,772,2,37,2927
24031701220,3970,1617,161,211,3,1788,1,34,2353
24031701221,4491,1676,230,531,9,1883,1,22,2815
24031701222,3784,2374,290,255,3,604,5,22,1410
24031701223,3158,1774,443,283,10,399,11,39,1384
24031701303,3789,2665,341,171,2,415,0,23,1124
24031701304,6045,4381,575,361,5,374,0,32,1664
24031701306,3000,2149,298,158,0,227,0,11,851
24031701307,4598,2191,465,665,6,999,2,31,2407
24031701308,4234,2074,414,618,6,913,0,26,2160
24031701312,6458,3976,673,703,12,698,1,40,2482
24031701313,3785,2024,571,500,5,442,1,19,1761
24031701314,2885,1453,431,461,2,363,0,10,1432
24031701315,4394,2278,427,781,9,653,0,29,2116
24031701316,6480,3842,668,914,5,684,3,48,2638
24031701317,4494,2919,356,412,5,550,3,21,1575
24031701407,5578,2143,795,1394,8,846,4,66,3435
24031701408,6706,2735,1076,1249,14,1215,6,79,3971
24031701409,4361,1556,575,1100,5,922,8,34,2805
24031701414,7592,1366,1119,3482,12,1207,3,64,6226
24031701415,7916,1811,1684,2754,10,1195,2,59,6105
24031701417,6168,709,808,3782,5,601,6,44,5459
24031701418,3524,505,385,1951,1,557,0,13,3019
24031701422,2902,95,474,2124,6,125,1,7,2807
24031701423,5118,388,768,3300,3,458,5,58,4730
24031701424,3464,721,839,1152,8,607,6,18,2743
24031701425,3717,1139,393,1778,0,305,0,3,2578
24031701426,5398,639,626,3153,14,735,1,37,4759
24031701427,3468,535,435,1589,2,744,3,19,2933
24031701503,7440,1828,1696,2398,5,1155,3,64,5612
24031701505,7010,1447,1368,3315,15,593,3,48,5563
24031701506,5144,1984,757,1555,0,563,0,30,3160
24031701507,5133,1749,637,1474,2,995,4,39,3384
24031701508,4142,254,524,2991,7,230,1,24,3888
24031701509,7181,726,2486,3294,7,452,0,43,6455
24031701601,2128,112,675,1008,0,260,0,26,2016
24031701602,6790,317,4118,1262,28,916,0,43,6473
24031701701,3524,2009,406,744,3,114,0,27,1515
24031701702,2274,528,627,867,0,104,0,23,1746
24031701703,3719,1242,779,1186,0,277,3,13,2477
24031701704,3033,1563,458,699,2,86,2,21,1470
24031701800,4869,1959,414,2014,9,200,2,20,2910
24031701900,3395,888,1708,558,9,66,0,20,2507
24031702000,5438,352,3591,1009,6,350,0,46,5086
24031702101,6021,533,2579,2033,5,674,0,36,5488
24031702102,3406,2532,281,230,0,140,0,30,874
24031702200,4361,2399,847,565,2,310,4,23,1962
24031702301,3551,651,1379,1236,2,133,0,20,2900
24031702302,4434,1712,928,1393,1,172,0,18,2722
24031702401,2722,1646,337,417,5,105,2,28,1076
24031702402,4665,1589,683,1885,3,223,2,41,3076
24031702501,4116,1500,395,1656,8,287,1,52,2616
24031702502,1731,443,238,808,2,128,0,16,1288
24031702503,4014,1447,407,1581,6,340,4,41,2567
24031702602,4769,1651,707,1706,5,444,6,45,3118
24031702603,2186,817,272,796,5,153,0,24,1369
24031702604,2821,1068,406,902,0,272,0,32,1753
24031702700,7380,2917,1536,1906,10,567,8,83,4463
24031702800,5264,2777,591,1169,1,339,2,60,2487
24031702900,5439,3417,477,854,4,315,0,44,2022
24031703000,1829,1143,259,163,4,113,0,16,686
24031703100,4481,1962,1310,609,8,354,1,50,2519
24031703201,7546,3075,2186,649,7,1184,3,64,4471
24031703202,5780,3370,1004,429,7,605,10,44,2410
24031703206,3951,1205,957,969,0,624,0,46,2746
24031703207,5906,1181,3103,1047,6,336,0,73,4725
24031703208,5425,3635,657,603,3,206,1,96,1790
24031703209,6618,1741,1878,1839,17,807,2,69,4877
24031703210,3760,1359,1087,680,5,391,0,35,2401
24031703213,6321,546,3035,1699,19,365,0,241,5775
24031703214,7345,821,3391,2228,15,398,2,142,6524
24031703215,3357,738,1203,897,1,326,2,35,2619
24031703216,3889,1739,548,1181,7,285,0,18,2150
24031703218,1963,1426,90,261,2,150,0,2,537
24031703219,3363,2363,154,498,2,271,3,17,1000
24031703220,5055,1064,1223,1930,3,562,0,52,3991
24031703221,4694,1411,818,1536,0,654,2,41,3283
24031703222,4737,825,1434,1567,4,685,2,41,3912
24031703223,6420,1585,1011,2114,5,1346,0,46,4835
24031703301,5064,1072,2647,343,14,745,0,47,3992
24031703302,4446,727,2482,390,2,634,0,61,3719
24031703401,5871,837,3312,559,10,933,1,53,5034
24031703402,4035,710,2086,417,1,659,0,47,3325
24031703403,3970,614,2464,330,8,402,2,38,3356
24031703404,3118,264,2171,341,2,237,0,23,2854
24031703501,6694,1056,2911,1770,20,728,3,48,5638
24031703502,3108,1558,716,353,0,266,0,36,1550
24031703601,4750,1992,1460,495,3,529,4,56,2758
24031703602,2928,1821,388,286,0,221,1,35,1107
24031703701,4053,590,2488,460,7,347,0,33,3463
24031703702,4147,1059,1853,459,2,549,0,44,3088
24031703800,4126,1064,1051,1423,2,378,0,37,3062
24031703901,3109,1752,427,409,4,281,3,27,1357
24031703902,7469,2228,2474,1634,8,766,6,56,5241
24031704000,7285,2807,2087,1319,11,670,6,54,4478
24031704100,4844,3767,410,227,4,174,0,24,1077
24031704200,2122,1402,324,143,2,142,0,8,720
24031704300,4088,3210,301,53,3,245,1,20,878
24031704401,3664,2128,305,334,1,616,7,13,1536
24031704403,1622,1055,156,103,3,212,0,20,567
24031704404,5733,3630,602,420,3,777,9,36,2103
24031704501,3742,2163,461,220,15,587,0,21,1579
24031704502,2786,1903,218,99,0,370,2,19,883
24031704503,4247,3056,318,125,1,469,0,36,1191
24031704600,5255,3552,518,105,8,726,0,27,1703
24031704700,3816,2997,253,55,2,300,0,32,819
24031704803,4318,2484,604,431,3,546,3,29,1834
24031704804,1886,1285,165,130,3,215,2,8,601
24031704805,2679,1630,254,215,2,480,0,12,1049
24031704806,4531,2602,508,358,6,753,0,32,1929
24031705000,5311,3670,545,304,6,447,10,36,1641
24031705100,5665,4151,409,467,4,309,0,30,1514
24031705200,3344,2693,199,140,3,125,4,21,651
24031705300,2049,1790,99,4,1,45,0,7,259
24031705400,2904,2360,150,25,4,160,0,19,544
24031705501,2377,1506,218,93,3,404,0,21,871
24031705502,4097,3203,293,105,0,269,4,43,894
24031705601,3057,2383,259,71,0,158,0,23,674
24031705602,4965,3334,509,311,1,530,0,43,1631
24031705701,4652,3284,410,204,0,457,0,28,1368
24031705702,4565,3652,397,62,4,188,0,30,913
24031705800,6489,4830,522,184,0,516,4,67,1659
24031705901,4501,3120,326,126,4,643,1,16,1381
24031705902,4402,2930,373,145,1,645,2,51,1472
24031705903,4616,3054,369,128,3,787,0,39,1562
24031706005,4664,2782,283,265,5,1102,0,42,1882
24031706007,7270,4089,395,360,0,2106,4,30,3181
24031706008,5301,3512,312,157,4,1070,0,22,1789
24031706009,5569,3554,414,298,7,1011,0,20,2015
24031706010,3147,1606,313,373,3,674,1,27,1541
24031706011,5578,3192,373,233,1,1484,0,47,2386
24031706012,3522,1556,540,517,3,674,0,32,1966
24031706013,2980,1942,209,130,3,531,0,10,1038
24033800102,3129,1085,727,1001,2,127,0,44,2044
24033800103,2454,490,701,988,11,148,0,18,1964
24033800105,4238,691,967,2092,9,283,3,26,3547
24033800106,3161,472,402,1865,15,265,1,34,2689
24033800108,4351,513,809,2622,18,197,2,52,3838
24033800109,3892,579,1569,1402,5,173,2,35,3313
24033800203,4883,2340,754,1048,4,426,0,26,2543
24033800206,4272,529,602,2692,24,221,0,22,3743
24033800209,4788,381,1843,2304,9,124,2,27,4407
24033800210,3689,225,688,2415,5,212,0,22,3464
24033800211,3008,543,446,1735,5,167,0,15,2465
24033800212,6374,933,479,3547,5,1110,1,47,5441
24033800213,4826,738,953,2316,6,569,11,40,4088
24033800216,4392,817,613,2248,2,502,0,35,3575
24033800217,4776,735,782,2748,11,267,1,29,4041
24033800218,5612,683,1353,3163,7,179,1,33,4929
24033800401,2592,1246,276,754,5,160,2,22,1346
24033800402,5205,2447,692,1469,2,258,0,38,2758
24033800403,3952,1503,392,1549,11,199,6,32,2449
24033800408,7307,910,1016,4740,5,345,0,42,6397
24033800409,6678,1637,703,3692,6,305,2,49,5041
24033800410,7030,1254,684,4460,10,343,3,32,5776
24033800411,4877,697,424,3174,4,397,1,30,4180
24033800412,4807,412,817,2774,5,597,3,25,4395
24033800413,4348,165,327,3605,5,140,0,4,4183
24033800504,4720,2493,563,1192,16,184,0,36,2227
24033800505,2737,1366,360,741,4,94,1,12,1371
24033800507,3967,914,243,2409,6,167,3,39,3053
24033800511,5222,1163,526,3002,11,196,3,57,4059
24033800513,6950,2072,571,3522,13,355,1,45,4878
24033800514,6586,453,281,5026,14,501,4,29,6133
24033800515,4336,905,365,2636,5,205,0,24,3431
24033800516,3889,677,238,2507,9,210,1,18,3212
24033800517,5622,351,228,4603,9,167,0,33,5271
24033800518,4176,309,188,3349,1,119,2,39,3867
24033800519,3994,718,278,2550,5,214,0,14,3276
24033800520,2440,113,141,2027,3,51,0,14,2327
24033800521,7885,194,252,7042,7,127,0,37,7691
24033800522,3841,75,106,3448,4,46,0,6,3766
24033800605,4867,452,288,3883,9,51,2,24,4415
24033800606,4778,228,129,4159,14,37,3,16,4550
24033800607,6200,286,324,5243,11,116,1,24,5914
24033800608,8212,259,279,7184,3,162,7,39,7953
24033800609,3655,276,311,2880,16,32,5,19,3379
24033800701,8802,379,505,7365,15,136,5,47,8423
24033800704,5406,455,212,4446,15,50,0,45,4951
24033800705,4236,352,162,3473,18,38,0,23,3884
24033800706,4011,207,287,3270,1,63,7,38,3804
24033800707,3617,410,312,2634,23,51,2,29,3207
24033800800,3446,1601,333,1221,10,33,2,24,1845
24033800900,1626,744,131,636,13,15,0,4,882
24033801003,6009,741,414,4373,52,143,3,28,5268
24033801004,5725,660,437,4216,18,99,0,26,5065
24033801005,4217,315,183,3454,10,83,2,23,3902
24033801006,3930,259,251,3189,4,49,2,21,3671
24033801105,1367,615,223,312,7,93,10,7,752
24033801106,1674,740,257,456,15,61,4,7,934
24033801207,4722,321,706,3420,13,103,0,18,4401
24033801208,4433,167,314,3709,2,84,0,35,4266
24033801209,4523,159,321,3732,8,121,0,34,4364
24033801210,4253,200,507,3229,15,116,0,31,4053
24033801211,3253,231,425,2314,8,137,0,17,3022
24033801212,3337,193,506,2449,12,55,2,17,3144
24033801213,3888,205,767,2707,3,92,0,18,3683
24033801214,4234,469,758,2767,19,63,0,38,3765
24033801215,2860,158,293,2221,13,60,2,27,2702
24033801216,3724,277,420,2800,19,68,2,18,3447
24033801217,3927,279,398,2972,6,130,0,18,3648
24033801302,2852,968,320,1241,17,114,0,26,1884
24033801305,6143,342,998,4139,3,392,3,77,5801
24033801307,3755,313,447,2531,4,299,3,31,3442
24033801308,3761,180,434,2619,3,349,0,26,3581
24033801309,3605,646,378,2171,5,178,4,36,2959
24033801310,7058,700,524,5164,18,322,3,39,6358
24033801311,8300,606,561,6363,18,305,11,66,7694
24033801312,3940,310,690,2524,8,264,1,34,3630
24033801313,3229,213,575,2119,8,217,4,8,3016
24033801404,6585,939,1116,3647,7,529,1,70,5646
24033801405,4865,267,1975,1871,2,569,5,41,4598
24033801406,3216,133,315,2537,24,81,4,8,3083
24033801407,6575,264,1203,4689,16,194,0,47,6311
24033801408,3329,107,314,2746,12,69,1,3,3222
24033801409,2719,122,696,1622,2,181,4,10,2597
24033801410,3416,293,572,1989,5,425,0,24,3123
24033801411,3359,206,663,1903,5,481,8,17,3153
24033801500,2680,104,845,1566,4,71,7,18,2576
24033801600,3054,31,561,2334,13,9,0,14,3023
24033801701,4441,160,510,3572,15,53,0,18,4281
24033801702,3984,144,349,3318,2,48,1,12,3840
24033801704,5506,61,482,4745,11,52,4,26,5445
24033801707,6882,157,2340,4159,6,67,2,30,6725
24033801709,5577,157,1109,4007,19,118,3,24,5420
24033801801,2000,58,218,1660,0,10,0,10,1942
24033801802,3896,82,283,3360,11,43,0,15,3814
24033801807,4557,63,240,4109,8,30,0,23,4494
24033801808,3761,57,295,3237,21,33,0,21,3704
24033801809,4107,107,420,3412,3,36,3,11,4000
24033801901,5125,371,663,3749,18,121,4,43,4754
24033801904,3547,196,588,2580,5,34,3,37,3351
24033801905,6771,436,601,5282,16,134,5,41,6335
24033801906,2352,242,470,1482,7,31,5,14,2110
24033801907,3605,122,284,3067,10,33,0,4,3483
24033801908,3781,73,139,3438,11,17,1,16,3708
24033802001,5576,120,463,4811,19,37,0,7,5456
24033802002,3714,56,328,3199,0,37,0,17,3658
24033802103,3202,114,390,2554,2,39,1,23,3088
24033802104,2178,95,230,1692,7,71,0,6,2083
24033802106,4576,80,282,4063,2,14,0,12,4496
24033802107,3976,48,190,3613,1,17,0,9,3928
24033802201,4215,283,806,2847,13,72,0,27,3932
24033802203,4691,154,662,3684,8,18,0,33,4537
24033802204,6185,93,508,5392,10,38,0,15,6092
24033802301,3688,132,450,2935,23,34,2,23,3556
24033802404,4687,56,187,4262,21,3,4,19,4631
24033802405,3916,91,267,3402,6,26,1,23,3825
24033802406,2450,68,434,1848,2,35,0,7,2382
24033802407,3611,84,161,3219,5,22,1,19,3527
24033802408,2320,48,169,1991,1,62,0,8,2272
24033802501,3231,52,213,2862,5,4,0,21,3179
24033802502,2318,28,274,1899,8,14,0,14,2290
24033802600,3318,55,671,2473,5,19,1,7,3263
24033802700,2675,61,560,1955,5,14,0,13,2614
24033802803,5939,141,481,5066,21,44,6,34,5798
24033802804,5689,76,332,5103,11,17,0,16,5613
24033802805,5264,86,745,4254,14,28,2,16,5178
24033802901,4006,81,839,2904,2,35,0,28,3925
24033803001,3119,34,574,2397,1,41,0,7,3085
24033803002,2791,23,275,2381,5,15,0,11,2768
24033803100,2688,67,618,1868,6,21,3,9,2621
24033803200,2860,43,494,2181,4,27,1,27,2817
24033803300,5004,103,1873,2807,11,53,1,38,4901
24033803403,6119,79,1288,4545,3,21,3,36,6040
24033803508,3971,88,700,2781,6,170,1,12,3883
24033803509,4175,82,791,2917,8,239,0,15,4093
24033803512,6711,169,374,5738,12,136,1,42,6542
24033803513,4894,63,161,4396,13,53,0,26,4831
24033803514,5436,161,218,4745,9,80,0,36,5275
24033803516,4887,231,267,3973,2,208,0,25,4656
24033803519,6212,159,364,5356,23,57,1,44,6053
24033803520,4351,222,300,3557,15,94,1,15,4129
24033803521,7592,575,311,6172,4,236,2,32,7017
24033803524,4691,58,342,4100,9,53,0,21,4633
24033803525,2354,29,81,2156,2,21,0,15,2325
24033803526,3496,56,112,3173,3,38,0,10,3440
24033803527,3043,58,98,2761,1,42,1,12,2985
24033803528,7396,152,248,6562,21,166,1,30,7244
24033803601,3663,29,581,2872,3,75,0,16,3634
24033803602,2220,15,460,1672,1,5,0,5,2205
24033803605,7464,543,3763,2698,4,264,2,51,6921
24033803606,6167,587,2588,2536,5,263,0,40,5580
24033803607,3672,257,1215,1981,0,114,0,7,3415
24033803608,6581,279,2700,3276,17,173,0,38,6302
24033803610,3527,225,1436,1618,6,124,4,22,3302
24033803612,3834,252,904,2402,12,124,0,26,3582
24033803613,6943,195,1847,4617,18,79,1,52,6748
24033803700,2950,245,1727,835,0,40,0,23,2705
24033803801,2872,147,1739,864,1,41,0,29,2725
24033803803,6062,223,3431,2074,12,152,0,22,5839
24033803900,4654,165,3567,795,5,37,0,9,4489
24033804001,5339,98,1422,3631,15,57,6,9,5241
24033804002,4532,218,2833,1271,11,72,0,23,4314
24033804101,3282,548,599,1909,9,80,0,12,2734
24033804102,6888,248,2661,3555,8,189,8,54,6640
24033804200,2980,1430,358,902,1,67,4,16,1550
24033804300,3677,112,1281,2116,4,67,0,14,3565
24033804400,2922,257,1512,847,10,210,5,22,2665
24033804600,3576,566,1623,1130,10,95,2,28,3010
24033804700,3537,1089,1080,1048,3,110,3,20,2448
24033804801,2648,96,924,1478,2,42,1,14,2552
24033804802,2970,105,1748,1012,3,34,5,21,2865
24033804900,3983,229,1164,2393,3,50,2,29,3754
24033805000,5906,162,2549,2924,7,78,1,34,5744
24033805101,4031,135,2926,837,0,58,0,27,3896
24033805201,4254,78,2416,1616,14,35,0,31,4176
24033805202,3865,92,1303,2322,3,81,1,12,3773
24033805500,3716,229,2510,753,5,109,0,11,3487
24033805601,6373,51,5981,228,12,47,2,30,6322
24033805602,5555,51,5117,277,13,43,3,22,5504
24033805700,6610,232,4783,1233,7,214,5,46,6378
24033805801,4745,129,3311,1073,2,139,0,31,4616
24033805802,4387,98,3235,867,3,97,0,34,4289
24033805904,3717,395,2175,818,9,226,0,13,3322
24033805906,3816,197,2184,1241,2,113,1,21,3619
24033805907,3346,96,1589,1461,3,142,1,10,3250
24033805908,3492,250,830,1983,2,255,0,30,3242
24033805909,5024,624,1489,2005,18,670,5,62,4400
24033806000,6345,705,3534,1675,16,208,1,35,5640
24033806100,4574,1359,1616,1273,10,114,1,40,3215
24033806400,3934,2338,409,377,3,579,0,15,1596
24033806501,5316,647,3390,956,4,186,0,38,4669
24033806601,4939,156,3641,956,4,56,0,44,4783
24033806602,5814,456,2450,1721,7,911,0,36,5358
24033806706,4083,677,894,1845,6,491,2,14,3406
24033806708,4248,1851,382,1518,7,288,0,39,2397
24033806710,5256,597,426,3353,8,649,4,35,4659
24033806711,4794,382,789,3136,4,283,0,19,4412
24033806712,3300,312,333,2248,4,217,0,34,2988
24033806713,4036,159,1318,2322,10,93,2,19,3877
24033806714,5649,411,1631,2573,18,788,2,32,5238
24033806800,4183,1637,1377,578,4,341,1,37,2546
24033806900,4393,1363,1780,531,12,462,3,26,3030
24033807000,9219,3760,1562,1606,19,1807,1,79,5459
24033807102,2763,1257,735,428,6,207,0,13,1506
24033807301,3693,754,786,1045,2,915,0,35,2939
24033807304,2266,342,1171,501,2,190,1,7,1924
24033807305,4075,303,2096,1251,13,305,0,29,3772
24033807404,5617,1048,2540,1162,11,624,2,32,4569
24033807405,6459,1699,2489,1368,13,585,0,90,4760
24033807407,6708,932,1738,2517,23,1187,0,63,5776
24033807408,5930,2283,978,1761,3,521,3,56,3647
24033807409,4002,307,1717,1524,9,332,4,17,3695
24033807410,5966,1767,1727,1999,12,334,0,26,4199
24033807500,7321,2226,2330,2147,23,175,5,70,5095
24033980000,15052,9105,942,1608,15,2646,0,53,5947
24035810100,2943,2335,185,283,7,7,0,14,608
24035810200,2587,1939,440,125,1,7,3,3,648
24035810300,4795,3857,244,402,5,37,0,26,938
24035810400,6418,5445,219,435,6,80,2,16,973
24035810500,4807,4113,158,324,3,26,0,14,694
24035810600,4830,4119,272,195,9,46,0,26,711
24035810700,4048,3025,306,443,11,67,2,16,1023
24035810800,6212,5502,190,149,3,105,3,25,710
24035810901,5614,4931,188,109,4,103,0,24,683
24035810902,2910,2656,65,27,5,45,0,12,254
24035811000,4710,3860,271,283,9,64,1,14,850
24035990000,0,0,0,0,0,0,0,0,0
24035990100,0,0,0,0,0,0,0,0,0
24035990200,0,0,0,0,0,0,0,0,0
24037875000,6323,5318,186,348,26,71,2,6,1005
24037875100,5371,4340,149,513,21,37,5,23,1031
24037875201,5614,4661,203,408,15,41,0,24,953
24037875202,5919,4832,156,536,21,28,2,21,1087
24037875300,3263,2653,41,383,10,24,0,14,610
24037875400,6761,5532,285,425,18,175,2,33,1229
24037875501,7514,5524,450,654,16,358,2,66,1990
24037875502,5125,3856,224,590,6,120,6,21,1269
24037875601,2369,1915,51,286,1,7,7,7,454
24037875602,7113,5371,379,568,26,313,5,39,1742
24037875700,7442,6452,187,278,15,105,1,33,990
24037875803,5609,3988,491,484,13,218,0,24,1621
24037875903,2619,1069,422,798,0,153,1,14,1550
24037875904,5216,1961,574,2089,20,210,3,21,3255
24037875905,2738,1584,171,637,4,96,5,14,1154
24037875906,5081,2695,421,1183,27,293,9,30,2386
24037876001,5506,1940,477,2323,28,276,6,28,3566
24037876003,3434,1856,495,689,3,139,1,35,1578
24037876004,6350,3315,579,1593,14,332,14,27,3035
24037876101,4781,3921,173,296,8,99,6,21,860
24037876102,3135,2431,137,275,15,88,0,11,704
24037876200,6494,5019,294,638,11,118,9,21,1475
24037990000,0,0,0,0,0,0,0,0,0
24039930101,6345,1519,316,4168,18,96,0,21,4826
24039930102,3977,2404,143,1216,7,37,0,9,1573
24039930200,1576,1337,37,125,2,5,0,0,239
24039930500,4177,3312,208,423,15,34,0,18,865
24039930600,2805,1664,170,815,2,34,0,9,1141
24039930800,5740,2650,201,2702,36,44,1,12,3090
24039990100,0,0,0,0,0,0,0,0,0
24041960100,4065,3474,151,251,2,15,0,21,591
24041960201,4375,3660,177,348,8,50,0,15,715
24041960300,3690,1882,581,987,5,99,0,21,1808
24041960400,5603,3288,1322,736,6,62,2,18,2315
24041960501,4640,3509,360,447,5,136,4,9,1131
24041960502,3927,2908,322,415,4,89,3,33,1019
24041960600,1805,1525,77,145,0,17,2,0,280
24041960700,3443,2907,115,283,6,18,0,18,536
24041960800,1846,1664,41,68,3,9,0,3,182
24041960900,4132,3248,206,506,6,41,0,24,884
24041990000,0,0,0,0,0,0,0,0,0
24043000100,3513,2672,226,333,4,59,5,25,841
24043000200,4097,2943,327,462,0,104,1,24,1154
24043000301,3617,2606,268,408,6,40,2,30,1011
24043000302,2805,1748,266,519,4,19,0,22,1057
24043000400,2198,943,195,809,8,12,0,13,1255
24043000500,5941,3367,595,1275,15,114,3,58,2574
24043000601,3109,1723,522,529,4,113,3,19,1386
24043000602,3455,2522,314,368,2,66,0,26,933
24043000700,3041,1912,237,576,1,19,0,27,1129
24043000800,3481,2377,285,522,9,14,2,18,1104
24043000900,3650,1983,422,856,12,41,3,36,1667
24043001001,4961,3581,442,415,4,87,5,33,1380
24043001002,4075,3230,267,284,4,96,2,17,845
24043010100,1088,986,31,22,4,10,0,1,102
24043010200,4424,4059,127,38,6,25,1,3,365
24043010300,7916,5885,611,704,17,287,1,28,2031
24043010401,4785,3337,330,673,9,198,0,28,1448
24043010402,6075,4093,780,687,8,153,4,20,1982
24043010600,5058,4733,76,37,4,28,2,9,325
24043010700,3370,3170,36,13,10,19,4,3,200
24043010802,2639,2328,81,83,1,44,1,9,311
24043010803,4514,3850,193,216,2,48,0,11,664
24043010901,6495,4430,573,751,7,391,9,33,2065
24043010902,3247,3021,70,26,7,12,0,8,226
24043011000,5360,1336,369,3605,21,18,3,0,4024
24043011100,6299,4676,517,610,14,160,0,33,1623
24043011202,4658,3387,307,570,4,99,4,24,1271
24043011203,5672,3754,410,842,4,308,3,32,1918
24043011204,3775,2663,259,449,7,164,1,22,1112
24043011301,5118,4436,271,124,13,46,0,19,682
24043011302,3839,3275,156,84,5,150,0,21,564
24043011400,6024,5311,234,124,4,69,2,25,713
24043011501,4354,3937,111,64,9,23,1,10,417
24043011502,3598,3280,103,44,8,15,0,17,318
24043011600,2722,2529,62,17,2,11,0,3,193
24043011700,5732,5140,216,102,14,21,1,24,592
24045000100,6002,1538,800,3218,18,60,3,22,4464
24045000200,1942,1081,133,593,2,27,0,1,861
24045000300,1283,54,88,1086,4,2,0,9,1229
24045000400,4244,2351,366,1187,8,63,4,23,1893
24045000500,3217,1065,633,1308,16,24,2,14,2152
24045010101,7349,4024,496,2129,18,272,4,34,3325
24045010102,3438,2146,185,798,1,128,4,11,1292
24045010200,6509,702,519,4986,28,28,0,9,5807
24045010300,8338,4980,316,2014,5,656,3,40,3358
24045010400,7600,5232,462,1351,29,215,2,34,2368
24045010501,5195,3023,286,1256,6,325,0,24,2172
24045010503,3459,1682,318,1112,11,145,3,19,1777
24045010504,4839,2352,407,1563,12,219,2,28,2487
24045010603,8052,5213,790,1230,9,435,3,59,2839
24045010604,5230,4341,273,279,12,82,1,13,889
24045010605,4272,3617,172,222,1,94,0,7,655
24045010606,4240,3589,90,259,3,72,3,22,651
24045010701,3982,3181,101,483,4,35,0,4,801
24045010703,4260,2519,298,984,10,144,5,38,1741
24045010704,4304,3139,139,799,4,34,0,10,1165
24045010800,5833,4511,219,729,11,60,0,22,1322
24047950000,1917,1550,187,68,2,36,0,10,367
24047950100,1845,1637,81,36,4,26,2,3,208
24047950300,3156,2804,144,33,4,60,0,8,352
24047950400,3394,3100,109,30,11,41,0,10,294
24047950600,3122,2836,72,70,12,27,1,27,286
24047950700,2495,2255,75,53,3,38,0,1,240
24047950800,5454,4724,160,313,11,84,1,13,730
24047950900,2351,1832,123,266,0,41,0,4,519
24047951000,4584,2803,331,1192,5,56,0,22,1781
24047951101,3569,3241,108,75,0,34,0,1,328
24047951102,3275,2915,102,65,0,64,0,17,360
24047951200,3088,2514,76,359,2,18,0,4,574
24047951300,2681,1440,119,931,4,37,0,9,1241
24047951400,3129,2463,90,371,7,68,1,9,666
24047951500,4995,2274,196,2179,16,61,0,23,2721
24047951700,3405,2995,105,125,6,48,0,5,410
24047980000,0,0,0,0,0,0,0,0,0
24047990000,0,0,0,0,0,0,0,0,0
24510010100,3197,2596,181,141,11,121,0,25,601
24510010200,3113,2317,319,214,5,121,0,15,796
24510010300,2316,1887,164,60,1,102,0,9,429
24510010400,2726,2100,218,121,4,154,0,6,626
24510010500,1790,1331,191,75,1,86,0,10,459
24510020100,1888,1292,205,153,3,120,0,5,596
24510020200,2181,1094,633,221,3,135,1,12,1087
24510020300,4779,3453,366,248,10,447,2,27,1326
24510030100,2083,301,282,1359,12,47,2,10,1782
24510030200,2944,1411,170,858,14,347,0,12,1533
24510040100,6821,2499,488,2180,7,1212,0,45,4322
24510040200,1107,398,73,406,0,179,2,16,709
24510060100,2872,752,904,1015,21,65,1,13,2120
24510060200,3266,1007,762,1244,9,86,0,10,2259
24510060300,1985,740,336,718,11,95,0,15,1245
24510060400,1903,441,279,837,7,222,0,28,1462
24510070100,2263,96,401,1644,6,23,0,3,2167
24510070200,2948,124,329,2345,11,24,0,10,2824
24510070300,882,70,45,731,1,12,0,0,812
24510070400,1548,181,27,1059,4,235,0,0,1367
24510080101,3336,724,79,2354,3,43,0,10,2612
24510080102,1902,60,48,1738,3,9,0,7,1842
24510080200,1154,29,68,1003,1,3,2,5,1125
24510080301,1549,31,112,1343,2,4,0,2,1518
24510080302,2576,61,73,2358,14,4,0,13,2515
24510080400,966,26,29,894,5,1,0,0,940
24510080500,1332,30,14,1214,2,0,0,13,1302
24510080600,1751,22,46,1636,1,7,0,3,1729
24510080700,865,14,24,779,1,4,0,6,851
24510080800,1902,101,59,1615,2,61,0,3,1801
24510090100,3661,451,59,2967,6,22,0,10,3210
24510090200,2763,411,83,2148,3,29,1,5,2352
24510090300,3963,958,152,2566,7,87,2,17,3005
24510090400,1500,139,117,1150,5,29,0,10,1361
24510090500,1685,271,117,1181,4,29,1,15,1414
24510090600,2555,61,72,2300,3,7,0,14,2494
24510090700,2479,47,52,2268,7,14,0,13,2432
24510090800,2359,79,71,2125,7,7,0,12,2280
24510090900,2405,31,48,2274,10,0,0,15,2374
24510100100,1934,35,37,1794,5,9,0,4,1899
24510100200,2715,89,40,2500,10,4,0,18,2626
24510100300,2085,247,63,1764,3,4,0,0,1838
24510110100,3484,1870,256,718,9,441,1,19,1614
24510110200,6288,3054,445,1723,8,728,1,28,3234
24510120100,4880,2734,228,360,0,1259,0,32,2146
24510120201,1946,1224,120,275,2,198,0,7,722
24510120202,6416,2547,696,573,9,2150,2,53,3869
24510120300,3759,1339,338,1716,6,135,3,17,2420
24510120400,1928,413,126,1280,4,22,0,7,1515
24510120500,2293,731,154,1177,4,93,1,10,1562
24510120600,2895,1025,247,1297,6,199,7,13,1870
24510120700,2678,1545,246,317,5,450,0,17,1133
24510130100,2620,235,76,2141,18,25,0,19,2385
24510130200,2000,334,45,1473,4,28,2,15,1666
24510130300,1828,134,52,1570,0,5,0,8,1694
24510130400,1624,71,35,1455,5,4,0,5,1553
24510130600,3770,3076,168,149,5,163,0,13,694
24510130700,5252,3902,188,500,6,432,1,24,1350
24510130803,2791,1762,155,373,7,363,1,19,1029
24510130804,1986,1575,90,125,6,74,0,12,411
24510130805,1108,208,33,746,3,52,0,5,900
24510130806,1256,864,66,222,10,32,0,6,392
24510140100,5034,2353,311,1494,4,596,0,34,2681
24510140200,2256,160,45,1949,7,17,2,17,2096
24510140300,2047,108,28,1809,4,10,4,5,1939
24510150100,2404,24,49,2246,3,11,1,8,2380
24510150200,1838,19,18,1753,2,0,1,8,1819
24510150300,1683,15,8,1625,3,6,0,2,1668
24510150400,3249,249,77,2543,2,274,0,18,3000
24510150500,1460,30,31,1343,0,9,3,3,1430
24510150600,2918,64,29,2733,8,4,0,10,2854
24510150701,1668,16,39,1565,1,8,0,7,1652
24510150702,2261,35,25,2105,7,5,0,10,2226
24510150800,4230,143,124,3788,10,11,1,54,4087
24510150900,3075,113,58,2791,4,25,0,11,2962
24510151000,4634,154,143,4175,16,29,0,14,4480
24510151100,5807,89,147,5320,25,30,5,18,5718
24510151200,3340,159,66,2995,14,9,3,9,3181
24510151300,3575,109,99,3226,7,2,1,20,3466
24510160100,1746,48,53,1584,0,14,1,2,1698
24510160200,1892,22,24,1773,0,11,0,23,1870
24510160300,1039,70,24,901,0,5,0,4,969
24510160400,1612,24,34,1482,7,12,3,9,1588
24510160500,3665,30,81,3461,6,8,0,11,3635
24510160600,2557,28,44,2407,10,1,0,14,2529
24510160700,4276,47,67,3993,4,4,0,9,4229
24510160801,3020,47,61,2800,8,2,2,6,2973
24510160802,2617,28,48,2478,4,3,0,6,2589
24510170100,1520,335,67,988,1,37,0,5,1185
24510170200,2917,138,55,2559,7,20,7,11,2779
24510170300,1696,44,51,1531,7,6,0,14,1652
24510180300,1777,439,144,1028,3,74,0,19,1338
24510190100,1626,51,85,1420,7,9,0,11,1575
24510190200,1706,450,221,923,6,16,2,9,1256
24510190300,1852,371,264,1090,9,35,1,2,1481
24510200100,1427,12,26,1336,0,5,0,5,1415
24510200200,2126,47,43,1957,3,8,2,9,2079
24510200300,1073,178,49,752,4,14,0,11,895
24510200400,1125,40,46,1000,7,0,0,2,1085
24510200500,2254,478,176,1444,10,34,0,7,1776
24510200600,2325,459,176,1513,9,41,0,13,1866
24510200701,3910,47,45,3728,11,8,1,6,3863
24510200702,1038,25,42,929,1,6,0,6,1013
24510200800,1987,201,67,1608,6,22,0,1,1786
24510210100,2177,698,143,1119,12,93,2,16,1479
24510210200,3012,850,165,1567,2,235,0,21,2162
24510220100,5008,3350,282,694,4,418,0,35,1658
24510230100,2424,1476,110,641,4,84,1,7,948
24510230200,2172,1797,112,82,2,73,0,12,375
24510230300,1617,1255,86,141,2,61,1,6,362
24510240100,3868,3179,188,145,5,173,3,26,689
24510240200,3269,2691,146,117,0,175,0,8,578
24510240300,2251,1841,107,95,0,123,0,1,410
24510240400,2723,2259,159,92,3,68,0,5,464
24510250101,3874,385,150,3127,0,89,0,25,3489
24510250102,2860,161,81,2484,0,45,0,11,2699
24510250103,3770,1968,247,1201,10,111,1,15,1802
24510250203,1640,62,76,1436,3,17,0,4,1578
24510250204,3853,31,42,3648,5,0,1,5,3822
24510250205,4983,606,2125,1937,6,129,0,24,4377
24510250206,2671,1356,426,642,4,107,0,27,1315
24510250207,2003,95,187,1597,4,30,0,15,1908
24510250301,2048,145,93,1690,9,11,0,18,1903
24510250303,2116,1041,292,584,9,59,0,9,1075
24510250401,3597,1224,1175,854,22,132,1,21,2373
24510250402,4717,1064,1321,2013,14,21,0,23,3653
24510250500,5142,1976,745,1955,11,66,4,37,3166
24510250600,23,13,7,1,0,0,0,0,10
24510260101,4671,1009,200,3235,6,41,2,13,3662
24510260102,4823,414,101,4086,19,23,1,37,4409
24510260201,4944,416,193,4085,18,96,0,16,4528
24510260202,5438,272,128,4801,8,81,1,19,5166
24510260203,2579,70,47,2340,1,25,2,11,2509
24510260301,4061,188,82,3637,5,5,3,16,3873
24510260302,5786,210,115,5276,19,13,0,23,5576
24510260303,1305,176,123,949,3,3,2,1,1129
24510260401,3528,1407,1828,91,9,37,0,24,2121
24510260402,2627,90,89,2307,9,46,0,16,2537
24510260403,1604,32,30,1473,4,11,0,11,1572
24510260404,2256,313,1414,328,8,132,0,8,1943
24510260501,5925,1961,3065,546,14,157,0,37,3964
24510260604,1692,204,531,862,6,24,2,11,1488
24510260605,5080,1756,2231,800,29,63,0,31,3324
24510260700,3321,1456,1307,282,9,147,1,12,1865
24510260800,2931,757,1739,307,13,38,0,11,2174
24510260900,3740,2798,318,195,14,243,0,12,942
24510261000,3084,782,1330,797,15,46,0,15,2302
24510261100,2149,1728,172,64,10,93,1,6,421
24510270101,1586,656,75,736,2,27,0,5,930
24510270102,3651,578,135,2743,14,31,0,36,3073
24510270200,1650,771,70,677,5,12,2,13,879
24510270301,2931,794,116,1816,6,45,3,34,2137
24510270302,1506,579,67,745,3,39,0,8,927
24510270401,4870,927,162,3558,9,36,2,20,3943
24510270402,3113,1101,85,1705,19,51,4,22,2012
24510270501,4249,1902,252,1805,5,86,5,20,2347
24510270502,4408,1457,192,2443,20,37,2,51,2951
24510270600,4509,1407,143,2678,23,31,1,29,3102
24510270701,2693,53,96,2433,1,19,1,17,2640
24510270702,2261,460,93,1596,5,14,0,7,1801
24510270703,2738,1180,187,1159,8,41,0,27,1558
24510270801,3817,360,149,3152,7,27,2,13,3457
24510270802,4647,140,137,4173,9,33,0,25,4507
24510270803,5697,278,101,5001,2,122,6,38,5419
24510270804,2654,1125,182,1121,5,100,2,21,1529
24510270805,4565,489,83,3746,3,50,1,13,4076
24510270901,3808,86,41,3538,4,10,0,26,3722
24510270902,3794,190,55,3296,4,137,2,14,3604
24510270903,4168,792,135,2395,2,654,0,24,3376
24510271001,2033,83,38,1814,2,6,0,14,1950
24510271002,3899,128,113,3516,12,1,0,25,3771
24510271101,2578,1081,192,725,1,434,1,12,1497
24510271102,4047,1991,358,366,0,1118,1,8,2056
24510271200,6121,4626,275,686,7,222,0,35,1495
24510271300,2660,2055,102,277,1,94,0,21,605
24510271400,3740,2643,162,274,0,464,0,29,1097
24510271501,4682,3494,160,587,5,164,0,55,1188
24510271503,883,681,42,89,1,43,0,3,202
24510271600,3745,128,98,3421,8,5,3,12,3617
24510271700,4523,211,143,4001,14,19,0,20,4312
24510271801,2654,51,54,2442,7,27,1,0,2603
24510271802,2199,26,44,2060,5,10,0,7,2173
24510271900,3473,683,157,2411,1,61,1,29,2790
24510272003,5990,3968,179,1395,3,104,0,153,2022
24510272004,3772,2413,114,997,3,111,0,42,1359
24510272005,3451,2449,189,635,0,23,0,44,1002
24510272006,3761,1691,244,1630,7,39,0,62,2070
24510272007,4336,1228,951,1917,8,52,0,75,3108
24510280101,2927,130,349,2311,11,31,0,11,2797
24510280102,5421,115,202,4890,12,21,5,29,5306
24510280200,3965,110,124,3510,12,24,3,75,3855
24510280301,3672,416,141,2912,8,49,0,18,3256
24510280302,2121,79,47,1889,2,10,0,24,2042
24510280401,3393,423,93,2706,5,27,0,17,2970
24510280402,1456,19,33,1367,2,1,0,4,1437
24510280403,4816,1093,208,3218,13,64,2,27,3723
24510280404,2708,124,54,2373,8,33,0,16,2584
24510280500,1941,57,51,1745,0,9,0,8,1884
24510280600,2951,64,56,2677,5,4,0,35,2887
25001010100,3664,3116,187,197,11,33,0,15,548
25001010206,3566,3234,77,46,3,35,4,30,332
25001010208,2454,2199,66,74,3,16,0,16,255
25001010304,2672,2407,57,89,3,26,0,17,265
25001010306,3080,2777,72,100,0,15,0,8,303
25001010400,3345,3035,82,66,7,32,0,20,310
25001010500,2962,2773,63,19,6,25,1,14,189
25001010600,3134,2859,122,68,2,22,0,12,275
25001010700,3460,3189,86,73,2,28,0,14,271
25001010800,4919,4604,95,33,4,44,2,17,315
25001010900,5399,4759,211,128,13,60,5,29,640
25001011002,4604,3917,158,187,13,20,0,73,687
25001011100,5075,4537,153,71,7,58,0,55,538
25001011200,3761,3394,68,81,10,28,0,45,367
25001011300,2569,2389,39,37,3,25,0,11,180
25001011400,3052,2810,66,55,5,21,0,18,242
25001011500,4132,3519,143,195,9,31,0,50,613
25001011600,3003,2334,137,258,14,32,2,37,669
25001011700,1918,1717,39,59,2,16,1,20,201
25001011801,2443,2310,46,5,5,16,0,2,133
25001011802,4460,3876,115,110,2,60,0,48,584
25001012001,5978,4949,170,320,4,101,1,121,1029
25001012002,3265,2500,176,143,11,75,3,82,765
25001012101,5608,4228,323,304,18,96,1,183,1380
25001012102,3269,2460,317,105,5,48,2,73,809
25001012200,5055,4664,95,32,23,40,0,11,391
25001012502,3709,2386,265,224,11,62,0,202,1323
25001012601,3298,2166,256,212,19,155,9,125,1132
25001012602,5668,2740,796,621,50,185,2,365,2928
25001012700,4642,3840,146,144,5,58,0,117,802
25001012800,4120,3419,120,123,16,54,0,73,701
25001012900,4373,3582,153,126,13,58,3,80,791
25001013002,2988,2689,73,24,2,36,0,40,299
25001013100,5969,5265,145,88,23,65,5,67,704
25001013200,5137,4547,146,63,22,72,0,48,590
25001013300,3275,3050,69,10,4,56,1,10,225
25001013400,3893,3667,58,12,2,29,2,17,226
25001013500,6884,6198,196,36,21,125,0,75,686
25001013600,6203,5491,155,57,11,142,0,40,712
25001013700,5435,4869,155,59,22,50,3,47,566
25001013800,5054,4521,80,63,14,111,0,64,533
25001013900,4890,4471,69,35,15,95,0,40,419
25001014002,4284,3848,86,62,41,42,5,33,436
25001014100,797,538,119,85,0,11,0,6,259
25001014300,4593,4234,96,35,4,63,0,12,359
25001014402,7201,6120,171,157,29,152,4,99,1081
25001014500,5481,4689,147,120,36,47,0,98,792
25001014600,4378,3637,132,117,49,86,0,109,741
25001014700,3646,3059,107,94,28,48,1,78,587
25001014800,3591,3058,80,105,22,52,2,75,533
25001014900,3627,3216,93,35,1,93,0,50,411
25001015001,4449,3571,114,138,158,64,0,92,878
25001015002,4147,3383,137,116,189,34,0,42,764
25001015100,4193,3652,104,79,47,56,1,58,541
25001015200,2267,2101,46,14,11,15,0,5,166
25001015300,3957,1998,431,500,42,64,5,260,1959
25001990000,0,0,0,0,0,0,0,0,0
25003900100,3406,2275,421,382,11,82,0,18,1131
25003900200,4260,2688,640,470,13,64,0,51,1572
25003900300,2848,2118,295,160,6,52,1,22,730
25003900400,4742,3860,278,285,7,26,3,30,882
25003900500,3266,2822,134,88,2,52,0,25,444
25003900600,4190,2534,519,689,14,43,0,43,1656
25003900700,2820,2466,124,85,4,15,0,18,354
25003900800,4781,4223,228,60,0,93,0,15,558
25003900900,5131,4003,488,273,5,54,1,48,1128
25003901100,3533,3007,151,152,1,71,1,13,526
25003911100,3038,2747,83,30,6,39,0,11,291
25003912100,6330,5812,161,56,2,60,0,16,518
25003913100,5095,4570,223,50,4,102,2,16,525
25003914100,5788,5083,304,54,6,138,2,24,705
25003920101,4501,3463,298,147,6,324,0,32,1038
25003920102,3012,2424,164,102,3,176,0,19,588
25003921300,4836,4063,238,180,7,32,0,55,773
25003921400,1462,1271,69,26,0,7,0,8,191
25003921500,2935,2569,104,50,6,30,0,9,366
25003922100,2629,2330,91,43,3,9,0,9,299
25003922200,3515,3205,91,40,2,16,0,6,310
25003922300,2022,1818,44,20,2,16,0,2,204
25003923100,3258,2995,79,22,2,31,5,0,263
25003924100,2018,1846,90,21,0,14,0,13,172
25003925101,1674,1451,116,35,0,10,0,4,223
25003925102,5498,4366,527,128,8,198,2,16,1132
25003926100,3327,2963,170,26,6,13,0,10,364
25003931100,1657,1567,19,6,0,11,0,0,90
25003931300,1339,1227,19,18,0,3,0,4,112
25003931400,1645,1541,29,5,0,1,0,4,104
25003932200,2425,2237,78,10,1,9,0,5,188
25003932300,1919,1799,29,9,2,10,0,9,120
25003933200,1522,1391,44,23,5,17,0,1,131
25003933300,1528,1425,31,9,8,6,0,6,103
25003933400,2623,2455,48,9,8,11,0,7,168
25003934200,1343,1221,46,9,1,12,0,5,122
25003934300,2018,1827,91,9,0,21,0,21,191
25003935100,2414,2203,59,19,1,34,0,12,211
25003935200,4950,4190,261,206,4,68,0,17,760
25003935300,3728,3208,180,58,9,29,1,8,520
25005600100,4030,3495,138,142,0,68,0,54,535
25005600202,4814,3803,213,306,2,175,1,67,1011
25005600203,6386,5318,218,323,12,238,0,33,1068
25005600204,4095,3263,156,294,6,174,0,28,832
25005610100,5359,4423,200,192,1,279,2,25,936
25005610202,5660,4817,149,162,8,303,0,28,843
25005610203,6818,5989,208,112,7,291,0,19,829
25005610204,6023,4544,287,482,0,442,1,37,1479
25005611101,5112,4441,187,133,4,98,0,27,671
25005611102,4977,4236,200,159,1,210,0,26,741
25005611201,2989,2669,68,66,2,53,0,23,320
25005611202,6124,5503,141,103,8,108,0,39,621
25005612100,4716,4092,90,166,0,133,0,32,624
25005612201,3886,3178,148,226,1,92,2,29,708
25005612202,6540,5464,210,302,6,192,1,50,1076
25005613100,6712,5496,269,331,10,105,3,79,1216
25005613300,7555,6430,349,271,5,78,0,100,1125
25005613400,3873,3065,264,208,14,26,4,64,808
25005613600,4178,2682,439,464,13,29,1,158,1496
25005613700,4566,3249,367,351,5,53,3,114,1317
25005613800,4893,2833,638,667,15,53,2,157,2060
25005613901,2925,1893,342,335,8,33,0,118,1032
25005613902,5763,4210,502,480,2,57,0,151,1553
25005614000,4612,2544,661,584,18,79,2,170,2068
25005614101,7093,5050,548,701,0,152,0,146,2043
25005614102,7238,5876,338,415,4,65,4,100,1362
25005615100,8101,7252,222,115,7,60,0,74,849
25005616100,6764,6162,144,64,4,57,0,47,602
25005617101,4910,4506,116,33,3,44,0,18,404
25005617102,4296,3934,74,46,3,18,0,30,362
25005630101,3256,2491,172,243,7,175,0,28,765
25005630102,4666,3812,285,166,7,206,0,27,854
25005630201,3048,2780,60,41,6,64,1,8,268
25005630202,5336,4510,200,79,7,318,0,19,826
25005630301,6292,5292,206,118,0,416,0,46,1000
25005630302,2866,2401,130,113,2,108,0,18,465
25005630400,5370,4283,197,146,0,521,0,25,1087
25005631101,3146,2434,236,139,13,137,0,34,712
25005631102,5399,4197,384,300,4,251,0,54,1202
25005631200,7552,6030,502,314,7,342,2,50,1522
25005631300,5557,4256,441,306,0,253,0,46,1301
25005631400,2889,1648,612,256,6,184,0,29,1241
25005631500,2888,2170,287,154,6,98,0,21,718
25005631600,4044,2314,838,343,10,272,0,45,1730
25005631700,6972,5731,337,323,2,258,3,56,1241
25005631800,8014,6312,503,423,23,379,3,75,1702
25005632100,6854,6162,209,33,6,146,0,54,692
25005632200,8677,7359,349,171,20,297,2,84,1318
25005633100,5880,5383,121,33,9,95,0,39,497
25005633200,6622,6041,198,56,7,103,0,28,581
25005640100,5888,4334,784,206,4,200,0,60,1554
25005640201,2631,1740,399,122,6,54,0,55,891
25005640202,3844,2713,466,153,16,145,3,73,1131
25005640300,4050,2563,918,166,6,119,0,56,1487
25005640400,2889,2242,300,93,5,57,0,28,647
25005640500,5454,3959,645,301,9,92,0,81,1495
25005640600,4891,3216,737,240,12,203,0,79,1675
25005640700,2914,2365,165,83,5,92,1,40,549
25005640800,3840,2529,488,207,6,218,0,70,1311
25005640901,5472,3337,1053,352,13,107,6,148,2135
25005641000,2407,1681,372,110,6,33,0,34,726
25005641101,1903,1105,442,160,3,27,0,37,798
25005641200,2978,1950,530,189,14,46,0,46,1028
25005641300,5544,3112,1313,354,13,225,0,99,2432
25005641400,3331,2048,615,201,6,119,4,72,1283
25005641500,2463,1863,246,102,3,60,0,42,600
25005641600,2336,1900,158,61,8,31,0,26,436
25005641700,5230,4182,499,156,2,120,0,35,1048
25005641800,2072,1581,170,111,4,39,1,30,491
25005641900,2431,1720,250,200,8,74,0,21,711
25005642000,3484,2225,630,278,8,91,0,40,1259
25005642100,4351,3233,375,341,9,84,0,71,1118
25005642200,3858,2796,553,196,12,59,0,43,1062
25005642300,2117,1891,67,29,0,43,1,21,226
25005642400,2878,2382,197,84,0,56,1,20,496
25005642500,4744,4079,210,148,7,81,0,43,665
25005644101,5999,5491,137,48,13,105,0,41,508
25005644102,5032,4614,117,40,4,41,1,32,418
25005644200,7272,6690,180,64,18,71,0,36,582
25005645101,5124,4716,117,31,2,48,2,17,408
25005645102,6057,5531,146,43,10,59,0,23,526
25005645103,5963,5539,113,18,2,62,0,16,424
25005646101,7837,7311,163,40,8,66,4,47,526
25005646103,5829,5444,108,29,9,39,2,24,385
25005646104,2673,2527,63,3,7,13,0,9,146
25005650101,5539,4663,361,92,5,46,1,86,876
25005650102,5120,3497,849,148,5,115,0,124,1623
25005650201,3169,2465,271,126,4,32,2,42,704
25005650202,2187,1673,281,61,1,3,0,65,514
25005650300,3461,2613,424,99,2,26,0,100,848
25005650400,4281,2625,998,175,12,33,0,80,1656
25005650500,3405,2296,596,122,16,18,0,97,1109
25005650600,3173,1753,920,93,7,8,0,163,1420
25005650700,3034,709,2002,88,8,13,0,64,2325
25005650800,3811,1708,1260,217,13,29,0,192,2103
25005650900,3140,1154,1347,171,5,28,4,120,1986
25005651001,3024,2159,266,139,7,130,0,127,865
25005651002,3866,2299,801,181,15,49,5,159,1567
25005651100,4522,1991,1521,256,20,39,0,201,2531
25005651200,2459,976,1030,147,1,27,0,39,1483
25005651300,2186,1138,487,164,12,38,2,79,1048
25005651400,3367,1655,763,215,6,26,0,235,1712
25005651500,3280,1331,994,225,11,36,5,228,1949
25005651600,3936,2100,690,317,28,39,5,222,1836
25005651700,2201,810,604,280,13,15,0,133,1391
25005651800,2065,1096,501,164,7,64,0,64,969
25005651900,2167,484,939,150,16,2,0,203,1683
25005652000,2868,1515,555,184,7,25,0,161,1353
25005652100,2764,1864,322,119,7,19,0,104,900
25005652200,2917,2296,207,80,10,22,3,49,621
25005652300,2930,1894,593,124,1,33,0,67,1036
25005652400,2745,1774,589,80,4,27,4,73,971
25005652500,3011,1335,1132,132,11,10,1,121,1676
25005652600,3209,1131,1523,148,4,19,0,112,2078
25005652700,3927,1872,1391,184,6,25,0,137,2055
25005652800,3315,2622,308,106,1,14,0,41,693
25005653101,7131,6143,237,90,5,212,0,98,988
25005653102,5250,4463,297,175,6,86,0,50,787
25005653203,5096,4461,172,53,13,108,1,68,635
25005653204,3373,2889,88,35,10,168,0,17,484
25005653301,5177,4771,109,28,3,93,0,34,406
25005653304,3281,3011,73,20,0,29,0,36,270
25005654100,7207,6649,162,31,5,46,0,73,558
25005654200,3352,3049,94,18,17,15,0,17,303
25005655100,4267,3876,119,13,6,42,0,45,391
25005655200,4488,3950,188,44,13,86,1,40,538
25005655300,3341,2978,127,28,14,31,1,23,363
25005655400,3828,3524,67,26,1,43,0,22,304
25005985500,4475,2862,384,615,2,157,0,25,1613
25005985600,5733,4902,230,211,9,158,4,50,831
25005990000,0,0,0,0,0,0,0,0,0
25007200100,4815,3575,153,201,24,49,0,190,1240
25007200200,5341,3918,134,386,55,56,6,218,1423
25007200300,5168,4248,146,114,13,45,1,158,920
25007200400,5276,4489,101,94,110,34,2,135,787
25007990000,0,0,0,0,0,0,0,0,0
25009201100,3334,3033,102,37,1,52,0,14,301
25009202101,2255,1948,141,20,6,45,0,18,307
25009202103,1735,1410,176,46,1,34,2,19,325
25009202104,4941,4038,433,137,1,117,3,44,903
25009202200,6188,5568,254,51,0,130,0,26,620
25009203100,7232,6589,276,46,4,109,1,22,643
25009203200,4668,4252,173,29,3,50,0,12,416
25009203301,4098,3711,141,31,10,70,0,20,387
25009203302,4443,4003,180,48,1,41,0,26,440
25009204101,4664,3255,830,219,3,123,0,23,1409
25009204102,5708,4220,793,298,3,134,5,18,1488
25009204200,5236,3589,1139,164,23,91,1,34,1647
25009204300,4076,1725,1982,176,6,61,0,31,2351
25009204400,3489,3007,249,35,3,47,0,24,482
25009204500,3537,2763,422,87,0,83,0,14,774
25009204600,5369,4136,693,122,3,90,2,63,1233
25009204701,6185,3710,1596,379,12,251,0,44,2475
25009204702,6208,4067,1079,347,4,375,3,79,2141
25009205100,6128,3318,1618,524,5,377,4,47,2810
25009205200,5925,2359,2313,507,3,491,3,40,3566
25009205300,4807,3232,958,252,4,150,2,44,1575
25009205400,4874,3801,481,179,10,152,1,35,1073
25009205500,5500,1391,2864,637,5,368,0,62,4109
25009205600,4422,1986,1359,576,12,254,1,42,2436
25009205700,5072,2346,1633,365,10,461,0,62,2726
25009205800,3725,791,2040,330,5,410,0,28,2934
25009205900,4798,1420,2250,490,5,424,0,49,3378
25009206000,3704,595,2281,515,4,214,0,17,3109
25009206100,4199,600,2611,562,4,289,0,48,3599
25009206200,5879,808,3884,633,6,316,0,89,5071
25009206300,4214,777,2393,490,3,345,3,43,3437
25009206400,6060,2072,2681,646,5,367,2,71,3988
25009206500,3747,699,2162,455,6,269,0,27,3048
25009206600,5116,2110,1851,526,0,304,0,83,3006
25009206700,4564,1807,1809,481,3,260,3,48,2757
25009206800,4425,1048,2358,604,6,200,1,79,3377
25009206900,4995,1766,1881,958,6,168,4,53,3229
25009207000,2289,586,1179,332,11,105,0,29,1703
25009207100,3807,424,2270,371,0,552,4,74,3383
25009207200,3003,600,1684,302,2,346,0,7,2403
25009208101,5402,3804,717,270,0,220,0,120,1598
25009208102,3542,2460,427,200,1,210,0,82,1082
25009208200,5530,4336,398,190,5,199,1,128,1194
25009208301,2678,2126,177,60,5,151,1,33,552
25009208302,4985,3894,399,170,3,208,0,99,1091
25009208401,2968,2328,184,80,7,173,0,52,640
25009208402,3514,2537,299,107,4,247,1,61,977
25009209100,7176,6015,243,86,0,535,0,44,1161
25009209200,5824,5226,158,24,1,220,0,30,598
25009210100,6880,6134,280,70,7,183,1,25,746
25009210200,5308,4767,184,100,3,98,0,20,541
25009210301,5176,4621,211,90,0,127,0,17,555
25009210302,4918,3705,390,263,4,202,0,80,1213
25009210401,3235,2128,414,316,3,72,0,95,1107
25009210402,4133,3380,326,95,0,87,1,40,753
25009210500,6946,5840,383,165,3,223,2,66,1106
25009210600,4424,3276,603,114,8,92,0,80,1148
25009210700,4446,2487,1047,190,6,100,1,253,1959
25009210800,4951,2709,1199,224,15,90,0,242,2242
25009210900,4064,3093,377,148,6,49,0,132,971
25009211100,4033,3502,187,77,0,91,1,33,531
25009211201,2605,2302,110,27,4,66,0,23,303
25009211202,3830,3405,137,76,0,61,0,30,425
25009211300,6916,6239,251,47,4,171,0,22,677
25009211401,4261,3421,285,137,10,142,0,33,840
25009211402,6442,5647,275,161,5,119,0,35,795
25009212101,5047,3984,597,139,4,146,0,38,1063
25009212102,4732,4256,125,29,3,185,0,30,476
25009213100,8203,7200,273,48,3,225,1,70,1003
25009214100,6569,5911,270,43,4,118,0,27,658
25009215101,4622,4023,125,48,7,256,0,14,599
25009215102,2939,2696,72,8,0,54,0,9,243
25009216100,4979,4354,227,84,3,198,2,16,625
25009217101,4797,4037,313,92,0,129,3,10,760
25009217102,3029,2487,177,95,2,127,0,17,542
25009217201,4237,3640,262,98,0,70,0,20,597
25009217202,3586,3220,125,52,0,63,0,12,366
25009217300,5281,3682,805,227,2,174,1,41,1599
25009217401,2423,1896,188,92,1,62,5,41,527
25009217402,3409,2832,206,110,7,57,0,32,577
25009217500,6420,5648,327,89,6,90,0,30,772
25009217601,4732,4312,131,23,2,84,0,25,420
25009217602,4756,4357,163,38,7,73,1,62,399
25009218100,5395,5034,120,7,1,57,0,27,361
25009220101,4014,3741,118,14,0,26,0,28,273
25009220102,2978,2771,54,36,0,41,0,8,207
25009221100,4348,4069,91,15,0,23,0,12,279
25009221300,4406,4119,113,10,2,49,0,25,287
25009221400,3415,2867,217,52,4,35,9,47,548
25009221500,3117,2482,310,43,10,71,0,60,635
25009221600,2641,2044,289,76,7,19,5,67,597
25009221700,2878,2463,157,27,7,49,0,43,415
25009221800,1773,1666,28,11,0,18,0,0,107
25009221901,3490,3232,78,22,0,43,0,9,258
25009221902,3661,3314,103,38,3,25,2,16,347
25009222100,3675,3398,101,16,0,35,0,13,277
25009223100,4149,3844,109,35,0,37,0,13,305
25009223200,3747,3320,129,24,0,79,0,38,427
25009223300,5889,5387,170,23,3,99,1,43,502
25009250100,3753,604,2839,139,5,60,0,59,3149
25009250200,6764,834,5565,148,11,68,0,58,5930
25009250300,2905,117,2662,63,8,24,0,6,2788
25009250400,4070,238,3680,76,6,6,0,40,3832
25009250500,4357,111,4166,31,1,3,1,23,4246
25009250600,6250,516,5514,126,2,16,0,35,5734
25009250700,5574,369,4984,110,14,28,0,45,5205
25009250800,9069,1571,6905,317,18,92,2,91,7498
25009250900,2255,56,2147,14,2,7,1,18,2199
25009251000,1895,127,1698,42,5,5,0,7,1768
25009251100,3018,431,2514,39,0,8,1,12,2587
25009251200,1474,107,1319,18,0,3,0,10,1367
25009251300,3893,195,3520,100,0,36,0,16,3698
25009251400,5520,514,4673,179,8,62,0,39,5006
25009251500,7275,833,5912,196,8,226,2,45,6442
25009251600,7164,777,5965,113,0,189,0,40,6387
25009251700,5809,913,4282,159,0,323,0,52,4896
25009251800,8098,2671,4557,218,8,391,2,64,5427
25009252101,4114,2244,1401,216,1,112,2,22,1870
25009252102,4418,3603,391,80,4,201,0,30,815
25009252201,3522,2403,802,109,2,101,0,22,1119
25009252202,3280,2631,335,58,3,109,0,26,649
25009252300,7496,3507,3172,335,5,226,0,68,3989
25009252400,4854,832,3562,217,3,92,0,54,4022
25009252501,4319,1886,1909,250,1,131,1,39,2433
25009252502,5046,3284,1158,253,8,176,0,23,1762
25009252601,7400,4903,1508,323,4,443,0,46,2497
25009252602,5469,3986,772,217,10,295,0,44,1483
25009252603,3141,2160,540,118,12,206,0,16,981
25009253100,6001,4668,723,144,4,257,0,15,1333
25009253201,3154,2492,293,55,4,183,3,20,662
25009253202,6861,4842,807,340,6,489,1,74,2019
25009253203,4166,3704,90,27,1,216,0,10,462
25009253204,6379,4794,334,135,7,888,0,27,1585
25009253205,4354,3819,183,45,0,162,1,24,535
25009254100,6602,4991,362,167,2,832,0,34,1611
25009254200,5475,4406,428,101,0,314,1,26,1069
25009254301,4274,3219,191,82,1,622,0,18,1055
25009254302,4661,3578,161,47,0,663,0,24,1083
25009254401,3674,2613,249,110,3,541,0,9,1061
25009254402,7992,5023,502,177,11,1935,3,55,2969
25009254403,3891,2950,136,42,1,612,0,9,941
25009260100,6149,2711,2601,404,20,124,1,59,3438
25009260200,3623,2200,1068,163,5,52,0,26,1423
25009260301,4722,3862,480,107,0,84,2,25,860
25009260302,3254,2892,141,54,2,37,0,18,362
25009260401,4169,3351,483,96,1,75,0,32,818
25009260402,7000,5368,985,160,7,223,0,28,1632
25009260500,4142,3270,510,131,3,44,1,23,872
25009260600,3702,1871,1383,146,14,73,0,74,1831
25009260700,4882,2864,1396,262,16,93,0,50,2018
25009260800,6132,2155,3323,286,27,61,0,77,3977
25009260900,5434,3067,1770,196,11,138,5,59,2367
25009261000,4400,3156,762,217,1,85,2,34,1244
25009261101,5028,4353,314,94,5,89,1,18,675
25009261102,5150,3808,782,186,2,123,1,44,1342
25009262100,6723,6128,197,47,4,49,0,25,595
25009263100,4500,4104,144,9,10,48,0,36,396
25009264100,6752,6229,192,37,6,65,2,25,523
25009265101,3848,3533,117,13,7,55,0,12,315
25009265102,4622,4214,134,22,0,46,0,10,408
25009266100,4742,4301,152,50,0,56,0,28,441
25009266200,5469,4803,249,79,20,53,0,23,666
25009266300,3780,3426,144,57,8,25,5,6,354
25009266400,3375,3042,130,29,4,33,0,17,333
25009267102,5051,4559,178,32,13,85,1,9,492
25009267103,1730,1591,34,9,5,6,0,17,139
25009267104,2455,2209,62,19,1,42,1,9,246
25009268100,2602,2426,62,10,0,28,0,7,176
25009268200,6940,6238,170,46,4,106,3,61,702
25009268300,4371,3987,130,46,0,59,0,21,384
25009268400,4376,4015,99,28,3,59,0,23,361
25009269100,6716,6226,156,27,3,70,0,31,490
25009270100,6161,5715,135,25,0,85,0,40,446
25009990100,0,0,0,0,0,0,0,0,0
25011040100,4409,3976,130,18,6,34,0,8,433
25011040200,4387,4028,102,25,4,36,2,14,359
25011040300,2866,2615,77,6,5,15,0,11,251
25011040400,3369,3007,81,19,14,20,0,24,362
25011040501,3899,3400,171,53,5,21,0,7,499
25011040502,3670,3235,143,44,6,51,0,24,435
25011040600,4565,3989,184,44,5,63,1,25,576
25011040701,4286,3489,422,75,11,33,0,29,797
25011040702,4294,3898,112,34,10,56,0,16,396
25011040800,5270,4190,248,127,3,449,0,35,1080
25011040900,5090,4373,279,86,5,81,3,18,717
25011041000,3483,2938,220,73,7,69,1,20,545
25011041100,3723,3328,138,43,6,65,0,18,395
25011041200,3017,2630,148,36,6,43,1,19,387
25011041301,2587,2074,231,64,7,43,1,25,513
25011041302,2016,1710,117,30,5,23,1,21,306
25011041400,2942,1984,614,152,2,44,0,13,958
25011041501,3456,3233,76,10,5,22,0,15,223
25011041502,3700,3367,99,24,9,18,0,20,333
25013800101,4089,1460,1687,720,7,62,2,20,2629
25013800102,4438,1227,2191,761,14,48,0,29,3211
25013800201,6577,2253,3308,658,8,120,3,33,4324
25013800202,1435,605,617,129,0,20,0,9,830
25013800300,4921,1398,2606,679,7,70,1,15,3523
25013800400,6632,1626,4010,709,9,50,0,34,5006
25013800500,3541,778,2327,300,0,33,2,21,2763
25013800600,2275,112,1924,176,3,19,1,9,2163
25013800700,3902,127,3365,332,0,23,1,13,3775
25013800800,1982,146,1652,148,0,1,2,11,1836
25013800900,4225,329,3395,400,10,22,1,10,3896
25013801101,1993,309,1275,317,7,24,0,17,1684
25013801102,1155,366,522,177,0,49,0,11,789
25013801200,2726,501,1600,539,8,12,1,12,2225
25013801300,4859,584,2468,1578,10,24,6,25,4275
25013801401,4269,307,2273,1452,7,30,13,25,3962
25013801402,2145,399,910,637,5,95,2,14,1746
25013801501,5523,1418,2063,1676,9,94,7,42,4105
25013801502,3403,768,1577,843,9,62,1,22,2635
25013801503,4225,1266,1680,960,12,121,2,24,2959
25013801601,4959,2679,979,954,2,106,2,24,2280
25013801602,5024,2292,1517,872,3,124,3,20,2732
25013801603,4122,2157,992,668,7,123,3,24,1965
25013801604,3723,2424,620,415,4,94,3,13,1299
25013801605,4566,1875,1510,804,4,159,0,11,2691
25013801700,7845,2198,2398,2838,17,101,9,57,5647
25013801800,4351,412,2552,1188,11,26,2,24,3939
25013801901,3954,345,2607,838,8,24,0,19,3609
25013801902,3556,535,2145,732,11,26,0,31,3021
25013802000,2736,272,1973,372,5,43,0,16,2464
25013802101,6176,2090,2501,1027,15,259,4,63,4086
25013802200,3594,485,2142,585,5,282,0,17,3109
25013802300,7033,908,3937,1378,10,552,2,45,6125
25013802400,3629,2186,698,374,6,244,0,13,1443
25013802500,6973,3762,1585,892,9,409,1,54,3211
25013802601,7351,2139,2918,1278,17,728,1,20,5212
25013802602,2022,1308,350,142,0,147,0,16,714
25013810100,6156,5281,345,125,16,112,1,14,875
25013810200,2950,2577,173,30,7,29,0,6,373
25013810300,3339,2815,277,80,2,29,0,6,524
25013810403,4033,3121,496,122,2,66,1,21,912
25013810404,3611,3164,236,53,3,33,0,6,447
25013810412,6018,5392,292,52,6,70,0,12,626
25013810414,7340,6093,719,242,6,75,0,9,1247
25013810601,4159,2938,729,147,8,156,4,7,1221
25013810602,2573,2258,161,36,0,42,0,0,315
25013810700,6247,4186,1427,277,22,63,5,31,2061
25013810800,4080,2358,1281,224,2,62,3,31,1722
25013810901,1989,774,970,123,9,11,1,17,1215
25013810902,4601,2770,1316,244,3,46,0,22,1831
25013811000,4862,3837,699,82,5,64,0,17,1025
25013811101,5150,2651,1925,272,6,50,6,39,2499
25013811102,5994,3182,2264,234,10,110,1,20,2812
25013811200,4767,3716,621,126,6,87,0,14,1051
25013811301,5578,4074,973,184,5,126,9,10,1504
25013811302,5560,4328,661,255,15,92,1,8,1232
25013811400,2290,211,2014,28,0,9,5,4,2079
25013811500,2202,145,1901,103,2,10,0,12,2057
25013811600,3501,300,3002,126,4,12,0,19,3201
25013811700,2050,353,1593,62,1,9,1,3,1697
25013811800,3990,1333,2293,136,4,42,13,20,2657
25013811900,3464,2766,411,95,0,70,3,13,698
25013812001,3450,1303,1899,123,3,36,2,13,2147
25013812002,4438,2112,2009,135,5,42,0,14,2326
25013812101,4921,3954,660,97,9,59,0,19,967
25013812103,3579,1522,1853,79,1,53,0,13,2057
25013812104,4353,2085,1962,114,10,48,0,39,2268
25013812201,4790,3189,806,203,12,405,1,22,1601
25013812202,3708,2465,704,191,5,210,1,12,1243
25013812300,6133,3368,1347,353,10,684,5,34,2765
25013812401,6365,5528,349,72,3,208,0,11,837
25013812403,3957,3086,443,126,0,129,0,11,871
25013812404,3882,3115,371,72,5,205,1,15,767
25013812500,7688,6074,1002,129,19,158,2,35,1614
25013812600,6639,5794,324,112,9,150,2,22,845
25013812701,3966,3025,576,53,8,143,0,19,941
25013812702,5242,3642,992,152,6,210,4,15,1600
25013812800,7112,6105,516,72,7,140,3,24,1007
25013812901,3092,2701,184,35,4,47,0,12,391
25013812902,4880,4436,177,29,13,62,1,16,444
25013812903,2215,1763,171,128,2,35,1,6,452
25013813001,2914,2674,89,4,16,14,0,9,240
25013813002,4000,3708,123,19,5,12,0,8,292
25013813101,5630,5142,185,16,7,54,2,10,488
25013813102,3602,3262,140,29,6,31,2,8,340
25013813204,3348,3015,117,30,1,71,1,9,333
25013813205,7254,6317,421,117,5,141,0,19,937
25013813206,3980,3411,268,66,0,98,0,15,569
25013813207,5302,4305,478,151,9,160,0,15,997
25013813208,2956,2514,152,56,7,106,0,19,442
25013813209,5852,5005,391,109,6,151,2,10,847
25013813301,7273,6209,324,106,4,370,4,31,1064
25013813303,4449,3672,147,67,0,415,0,26,777
25013813304,4131,3326,152,59,0,443,2,27,805
25013813401,5341,4415,366,139,1,255,0,12,926
25013813403,4156,3619,212,78,0,102,1,11,537
25013813404,6933,5986,299,165,1,258,0,15,947
25013813500,4966,4552,181,36,7,34,0,4,414
25013813601,8332,6989,537,249,4,223,1,32,1343
25013813602,6281,5576,247,114,4,124,0,17,705
25013813701,3358,3066,116,11,2,33,1,13,292
25013813702,4795,4392,136,41,13,28,1,31,403
25013813801,4435,4064,122,18,18,31,0,23,371
25013813802,3694,3309,118,27,9,31,0,5,385
25015820101,6295,5560,265,70,18,46,0,34,735
25015820102,3771,2957,505,63,11,25,10,7,814
25015820205,7658,6773,239,141,3,155,1,24,885
25015820206,3848,3439,138,41,4,51,2,16,409
25015820207,5124,4203,336,118,0,183,2,23,921
25015820300,7157,4132,764,377,14,1506,2,56,3025
25015820400,13131,7942,1146,864,14,2661,10,8,5189
25015820500,6739,4770,539,247,12,773,2,60,1969
25015820600,1641,781,205,197,7,330,0,5,860
25015820700,4458,2763,420,210,1,756,0,32,1695
25015820801,5558,3358,672,275,11,904,0,39,2200
25015820802,579,389,61,58,0,45,0,3,190
25015820900,6110,5356,286,80,6,186,0,6,754
25015821000,4446,3887,262,44,2,95,2,22,559
25015821101,7041,5797,608,154,13,168,1,25,1244
25015821200,2185,1166,195,159,0,529,0,13,1019
25015821300,4478,3833,242,87,0,141,0,22,645
25015821400,5325,4346,320,71,5,351,1,14,979
25015821500,3352,3094,81,25,9,27,3,13,258
25015821601,3611,2698,412,105,9,216,0,16,913
25015821602,3878,3092,403,96,2,59,0,25,786
25015821700,4031,3483,187,78,5,68,0,23,548
25015821901,3319,2622,217,85,1,206,0,22,697
25015821903,3639,2644,490,159,2,107,9,36,995
25015821904,2901,2274,252,66,5,107,0,13,627
25015822000,2152,1250,263,145,1,338,1,13,902
25015822200,6040,4991,473,95,9,190,0,26,1049
25015822300,5412,4568,427,53,11,100,3,38,844
25015822401,5822,5109,274,43,11,149,2,17,713
25015822402,4977,4112,401,85,7,165,2,16,865
25015822500,6224,5707,206,24,0,55,1,16,517
25015822601,2094,1893,71,12,0,10,0,8,201
25015822603,1622,1508,46,3,1,6,2,0,114
25015822607,4650,4280,134,24,8,17,0,20,370
25015822700,3040,2801,82,6,3,15,0,12,239
25017300100,3193,2913,123,18,3,16,1,12,280
25017301101,4210,3653,205,65,2,44,0,47,557
25017301102,4917,4413,196,32,9,57,1,18,504
25017310101,3472,1584,1181,275,5,195,4,50,1888
25017310102,2609,987,939,212,10,281,0,34,1622
25017310200,6537,2982,1788,741,0,613,1,99,3555
25017310300,6689,2711,2002,905,16,631,5,131,3978
25017310400,3429,1089,1360,368,3,343,0,66,2340
25017310500,3291,1551,573,308,0,669,5,54,1740
25017310601,6194,3271,916,371,10,1323,1,97,2923
25017310602,6358,3397,927,494,3,1194,3,83,2961
25017310700,4530,1329,1277,425,3,1084,4,144,3201
25017311100,2544,648,751,254,5,745,4,42,1896
25017311200,3217,572,631,189,2,1620,2,61,2645
25017311300,5207,1326,1457,356,4,1862,2,59,3881
25017311400,6550,2041,928,1089,9,1919,3,170,4509
25017311500,3224,1159,286,246,3,1326,0,39,2065
25017311600,5625,2490,561,246,0,1961,1,90,3135
25017311700,5190,1104,677,260,2,2833,0,75,4086
25017311800,3603,570,778,227,4,1800,2,42,3033
25017311900,3062,1138,881,278,4,405,0,134,1924
25017312000,3047,1075,958,264,3,387,4,132,1972
25017312100,3525,1162,956,394,8,597,0,156,2363
25017312200,4920,1851,886,353,5,1438,0,126,3069
25017312300,5277,2921,765,295,3,616,0,212,2356
25017312400,2505,877,931,177,0,306,2,79,1628
25017312501,4456,3022,569,213,4,371,0,70,1434
25017312502,4088,2966,337,151,5,324,1,123,1122
25017313101,6440,5076,307,130,0,623,1,50,1364
25017313102,5940,4890,254,208,8,362,0,50,1050
25017314101,6785,5075,490,448,2,482,0,33,1710
25017314102,7448,5689,578,427,10,460,0,65,1759
25017314200,5629,4252,522,327,2,263,0,51,1377
25017314301,9287,6983,675,556,4,626,0,89,2304
25017314302,3468,2884,192,82,2,163,2,28,584
25017315100,5740,4847,254,169,3,279,0,21,893
25017315200,8693,7280,437,235,4,394,0,68,1413
25017315401,4178,3575,177,137,2,163,0,21,603
25017315402,3316,2818,103,58,2,213,0,23,498
25017315403,1661,1489,28,30,0,33,0,3,172
25017315500,7754,6944,252,97,2,205,3,32,810
25017316101,5057,4470,161,87,4,161,1,32,587
25017316102,6152,5344,167,150,15,273,0,71,808
25017316201,4218,3549,97,135,2,314,0,19,669
25017316202,4440,3346,161,139,9,593,0,44,1094
25017316300,8441,6039,380,528,6,1046,0,98,2402
25017316400,7097,5476,448,336,4,560,2,50,1621
25017316500,6714,5135,368,260,4,647,0,61,1579
25017317101,6966,5124,408,187,8,920,0,39,1842
25017317102,4945,3666,234,182,6,655,0,39,1279
25017317103,5081,4260,136,42,0,454,0,23,821
25017317201,2897,2539,78,16,3,139,3,23,358
25017317202,3426,2917,63,33,0,306,0,7,509
25017317203,4253,3353,150,94,1,503,0,27,900
25017317301,2869,1941,163,136,5,503,0,22,928
25017317302,5955,4601,277,191,2,587,0,47,1354
25017318100,6825,4971,119,51,10,1450,2,19,1854
25017318200,4822,3238,150,63,2,1137,0,20,1584
25017318300,8327,5997,226,58,2,1724,1,30,2330
25017318400,4669,3318,138,48,10,962,0,13,1351
25017320102,5417,4387,146,40,0,616,1,46,1030
25017320105,2573,1929,142,23,1,383,0,6,644
25017320106,6392,5115,304,72,1,607,0,42,1277
25017320107,4376,2302,141,48,6,1736,0,26,2074
25017321100,7218,4651,785,217,9,414,0,439,2567
25017321200,6923,3960,977,200,9,390,0,589,2963
25017321301,4351,2072,1228,167,5,110,1,335,2279
25017321302,3656,2150,694,106,6,137,0,195,1506
25017321400,4239,2843,412,115,6,509,0,124,1396
25017321500,7791,4191,1832,262,5,297,1,513,3600
25017321600,7615,4829,703,227,10,593,1,462,2786
25017322100,4651,4066,166,58,0,105,0,54,585
25017322200,4462,3398,248,113,4,182,0,98,1064
25017322300,6281,4753,480,120,5,193,0,228,1528
25017322400,4698,3580,369,74,0,96,3,169,1118
25017323101,3819,3303,159,36,2,106,0,25,516
25017323102,3355,2848,100,29,1,205,0,19,507
25017324101,5567,4620,168,57,2,501,1,31,947
25017324102,4574,3808,160,71,10,325,3,26,766
25017325101,4010,3077,246,170,0,260,0,46,933
25017325102,4469,3360,335,253,9,169,2,37,1109
25017326101,4511,3775,186,57,3,291,1,21,736
25017326102,6804,5871,248,80,6,288,2,36,933
25017327101,3663,3253,114,51,6,76,0,18,410
25017327102,4339,3807,136,45,6,106,0,34,532
25017327103,3602,3206,125,42,4,52,1,43,396
25017328100,3358,2896,103,30,0,161,0,26,462
25017330101,3811,3468,99,7,2,114,0,12,343
25017330102,4925,4386,177,26,8,137,0,34,539
25017330201,2570,2271,73,18,0,125,1,13,299
25017330202,4248,3644,117,80,8,213,0,21,604
25017331101,3311,2735,81,41,3,263,1,25,576
25017331102,7073,6253,207,79,0,307,3,18,820
25017331200,5488,4727,148,93,6,279,5,37,761
25017331300,7477,6417,258,89,6,408,0,50,1060
25017332100,6063,4787,166,82,2,838,2,30,1276
25017332201,2111,1514,104,52,0,351,0,8,597
25017332202,6640,4090,327,419,3,1511,0,70,2550
25017332300,6955,4762,217,528,7,1210,0,27,2193
25017332401,2466,1919,104,53,2,321,0,10,547
25017332402,2142,1388,115,87,1,463,0,13,754
25017333100,7687,5998,267,367,2,667,0,79,1689
25017333200,5228,4159,253,245,17,253,3,77,1069
25017333300,4316,2937,452,257,0,190,1,145,1379
25017333400,6524,4770,483,323,6,526,0,104,1754
25017333501,5093,3981,278,197,0,336,0,66,1112
25017333502,3429,2420,323,166,4,187,0,112,1009
25017333601,1550,903,125,131,4,256,0,43,647
25017333602,7049,4578,421,472,3,1044,2,130,2471
25017334100,6999,6129,166,95,12,395,1,25,870
25017334200,4070,3586,127,65,5,141,3,31,484
25017334300,7768,6987,180,21,3,343,0,30,781
25017334400,6681,5551,215,137,3,468,0,53,1130
25017335100,6259,5528,226,111,5,158,0,40,731
25017335200,6273,5457,254,99,5,242,0,36,816
25017335301,4124,3399,185,69,4,245,0,39,725
25017335302,5309,4473,200,72,7,290,1,66,836
25017335400,5125,4366,281,59,0,208,0,16,759
25017336100,5758,4803,242,136,1,306,1,32,955
25017336201,3062,2700,103,27,2,105,0,16,362
25017336202,3416,2930,103,38,0,172,0,15,486
25017336300,6985,5813,277,142,6,454,4,52,1172
25017336402,4764,3707,259,189,2,318,0,36,1057
25017336403,3254,1965,217,239,3,600,1,38,1289
25017336404,2578,1818,152,167,3,260,1,45,760
25017337101,3220,2684,128,85,5,168,0,13,536
25017337102,5414,4495,212,122,5,354,0,21,919
25017337201,3370,2691,144,105,2,226,0,57,679
25017337202,5110,4358,152,98,0,275,1,40,752
25017337300,6130,4702,344,232,4,487,1,60,1428
25017338100,3204,2155,142,34,0,677,1,19,1049
25017338200,4271,2548,146,102,0,1237,2,54,1723
25017338300,3469,2856,117,30,0,290,0,22,613
25017338400,6167,4806,177,18,4,898,0,28,1361
25017338500,5859,4768,191,34,0,584,3,42,1091
25017339101,3267,2387,184,234,0,280,1,29,880
25017339102,3442,2847,122,102,0,190,0,45,595
25017339200,5700,4894,201,143,3,219,0,35,806
25017339300,2996,1732,127,715,0,173,0,35,1264
25017339400,3479,2537,176,239,4,311,0,45,942
25017339500,5662,3677,443,325,3,735,7,100,1985
25017339600,5454,3766,370,371,7,533,4,115,1688
25017339700,3916,2356,303,529,2,395,0,110,1560
25017339802,5485,2781,406,769,5,938,0,160,2704
25017339803,3383,1701,219,120,5,1160,0,49,1682
25017339804,2260,1242,148,181,4,389,0,128,1018
25017339900,5327,3325,465,431,4,625,0,167,2002
25017340000,2590,1609,215,318,2,233,0,45,981
25017340100,6698,4986,326,359,4,638,6,93,1712
25017341101,3850,1877,303,210,1,1178,0,64,1973
25017341102,5180,2444,348,440,6,1510,2,89,2736
25017341200,6988,2794,604,758,0,2228,4,211,4194
25017341301,4565,1343,239,329,4,2317,0,100,3222
25017341302,2273,808,139,419,2,781,0,29,1465
25017341400,6747,2352,870,1124,9,1576,6,252,4395
25017341500,5353,1573,776,1184,14,1219,0,184,3780
25017341600,6985,3280,722,923,6,1424,1,173,3705
25017341700,5607,2805,624,886,5,832,0,140,2802
25017341800,7075,2500,953,1504,5,1386,0,233,4575
25017341901,1515,651,218,209,2,256,1,46,864
25017341903,6888,2735,710,941,18,1674,0,222,4153
25017341904,3237,1349,385,501,4,739,0,93,1888
25017342101,5028,1871,1477,695,5,338,0,259,3157
25017342102,4718,1806,1078,724,9,291,2,301,2912
25017342201,6274,2012,1692,1101,10,400,0,482,4262
25017342202,4208,1454,1067,647,0,498,2,156,2754
25017342301,3242,1164,959,408,0,216,0,233,2078
25017342302,4548,1613,1226,603,5,376,0,307,2935
25017342401,4604,1470,1291,606,5,350,3,395,3134
25017342402,3664,1497,1006,340,3,443,2,139,2167
25017342501,4740,1473,1483,619,2,285,1,287,3267
25017342502,3080,939,1086,369,7,186,0,260,2141
25017342600,4969,1430,1625,817,9,309,0,291,3539
25017350105,1181,816,135,43,3,83,0,32,365
25017350106,1660,934,156,77,0,367,0,17,726
25017350107,1355,662,388,74,1,111,0,52,693
25017350108,4174,1833,987,603,3,362,0,83,2341
25017350109,2176,1006,432,190,6,173,2,128,1170
25017350201,2699,1489,543,209,9,246,0,42,1210
25017350202,3860,2657,387,167,5,317,0,82,1203
25017350300,2984,1983,298,158,1,275,0,59,1001
25017350400,5901,4680,284,122,9,472,0,27,1221
25017350500,1743,1408,86,41,0,125,3,6,335
25017350600,4788,3154,432,183,3,750,0,15,1634
25017350701,3000,2355,184,60,3,261,1,15,645
25017350702,3315,1847,377,608,13,258,0,36,1468
25017350800,2076,1524,112,108,0,195,0,20,552
25017350900,3531,2770,156,56,0,352,0,21,761
25017351001,4083,2914,285,74,5,602,3,23,1169
25017351002,3037,2359,148,86,0,262,0,24,678
25017351101,3775,2848,246,125,1,318,0,26,927
25017351102,1972,1456,125,63,0,211,0,20,516
25017351203,4631,3328,317,133,1,575,0,46,1303
25017351204,4295,2867,362,161,2,562,1,80,1428
25017351300,4406,2897,473,237,4,375,0,99,1509
25017351403,3943,1971,998,258,9,349,0,112,1972
25017351404,3996,1868,872,237,2,548,2,149,2128
25017351500,2464,1248,376,142,0,418,0,74,1216
25017352101,4271,2043,608,297,2,1093,2,49,2228
25017352102,2663,1695,192,103,1,524,3,32,968
25017352200,1999,1154,214,169,6,342,0,25,845
25017352300,4313,2363,481,275,7,959,0,28,1950
25017352400,1879,400,297,772,6,304,1,30,1479
25017352500,3466,1767,373,552,4,542,0,23,1699
25017352600,2817,1610,371,270,0,369,0,23,1207
25017352700,2009,1082,212,314,1,218,1,39,927
25017352800,1892,1089,229,150,6,247,1,38,803
25017352900,2869,2010,177,111,2,345,5,25,859
25017353000,2968,1686,284,308,3,506,0,20,1282
25017353101,3641,1600,416,483,13,896,3,29,2041
25017353102,6238,2220,804,356,23,2500,0,72,4018
25017353200,5242,2608,458,433,8,1471,2,29,2634
25017353300,3723,2489,257,281,2,427,0,23,1234
25017353600,5146,3186,412,293,4,943,3,59,1960
25017353700,5593,3146,489,379,7,1192,2,33,2447
25017353800,4177,2624,379,199,1,734,6,28,1553
25017353900,6139,2836,580,492,10,1772,3,49,3303
25017354000,4918,3203,350,218,7,864,4,35,1715
25017354100,2889,2008,239,165,5,343,1,27,881
25017354200,3008,2390,136,74,2,217,0,23,618
25017354300,3488,2205,250,408,8,389,2,23,1283
25017354400,1730,1278,126,69,3,130,0,5,452
25017354500,1937,1403,109,73,5,214,1,12,534
25017354601,1646,953,134,131,0,371,0,0,693
25017354602,4185,2113,322,1061,1,436,4,24,2072
25017354700,2859,1999,137,146,0,378,0,31,860
25017354800,2323,1666,168,119,2,233,0,15,657
25017354901,2876,1199,236,256,0,1028,0,13,1677
25017354902,5616,2001,475,1610,10,1240,4,36,3615
25017355000,3129,1997,217,363,2,352,0,27,1132
25017356100,3330,2528,180,37,0,350,0,8,802
25017356300,5332,3591,308,241,0,857,0,49,1741
25017356400,8136,6437,326,117,6,865,2,43,1699
25017356500,7067,5378,306,108,12,877,1,56,1689
25017356601,4783,3395,249,165,2,672,1,35,1388
25017356602,4284,3327,155,99,1,455,2,39,957
25017356701,6275,4772,293,156,3,737,0,18,1503
25017356703,3211,2500,102,61,2,346,0,17,711
25017356704,3890,2885,218,68,2,483,0,17,1005
25017357100,5480,3569,189,78,3,1380,0,36,1911
25017357200,3243,2393,111,38,1,517,0,32,850
25017357300,3117,2217,188,59,1,447,2,22,900
25017357400,2372,1815,95,17,0,323,0,14,557
25017357500,2255,1661,117,49,0,305,0,16,594
25017357600,2665,1712,154,66,3,572,2,27,953
25017357700,4139,2759,209,110,4,844,1,19,1380
25017357800,4024,2863,210,102,1,650,0,10,1161
25017358100,5282,3307,195,71,2,1394,0,30,1975
25017358300,6380,3259,278,158,2,2373,0,46,3121
25017358400,5285,3195,182,51,2,1563,0,35,2090
25017358500,5580,3070,168,46,9,2023,0,32,2510
25017358600,6319,3526,177,77,4,2162,0,39,2793
25017358700,5608,3162,180,56,2,1889,0,54,2446
25017359100,6544,4781,234,204,6,1025,0,21,1763
25017359301,0,0,0,0,0,0,0,0,0
25017359302,0,0,0,0,0,0,0,0,0
25017359303,7839,5797,282,161,9,1216,0,47,2042
25017359400,6754,3530,606,1086,3,1049,1,68,3224
25017360300,7014,5343,509,223,12,450,12,71,1671
25017361100,5726,5013,170,39,0,270,0,19,713
25017361200,6259,4820,389,308,0,438,3,34,1439
25017361300,6506,5296,302,115,1,463,1,35,1210
25017362100,5237,4129,166,35,0,594,2,29,1108
25017363103,3617,2445,113,83,3,811,3,24,1172
25017363104,6259,4170,193,125,6,1487,1,31,2089
25017363105,3781,1951,177,195,6,1117,0,90,1830
25017363106,3330,1577,195,132,2,1257,0,27,1753
25017363201,3317,2312,107,8,0,686,0,37,1005
25017363202,3717,2709,135,29,1,666,0,23,1008
25017364101,5631,4649,309,126,6,172,0,78,982
25017364102,5115,4272,288,84,0,191,1,47,843
25017365100,7918,6514,239,75,0,674,0,49,1404
25017365201,5949,4805,189,51,2,574,5,32,1144
25017365202,5067,4002,259,113,0,449,0,38,1065
25017366100,4952,3657,201,69,0,798,0,27,1295
25017366201,3750,3030,125,23,1,368,1,14,720
25017366202,5241,4016,215,27,7,721,5,20,1225
25017367100,4861,3582,166,63,8,848,0,30,1279
25017367200,6990,5186,320,178,1,1044,1,24,1804
25017368101,5782,3718,399,326,13,1115,5,34,2064
25017368102,4718,3250,410,298,1,605,1,19,1468
25017368200,4198,3029,495,258,0,283,0,22,1169
25017368300,5763,2917,1494,491,6,610,0,62,2846
25017368400,8606,5060,1002,643,4,1533,4,62,3546
25017368500,3419,1668,922,208,12,480,0,19,1751
25017368600,5856,3252,1596,363,11,377,1,50,2604
25017368700,2684,1069,1155,127,9,182,0,41,1615
25017368800,6169,3191,1420,378,10,861,4,80,2978
25017368901,5973,4247,420,381,0,753,0,30,1726
25017368902,3691,1405,1048,641,3,393,0,61,2286
25017369000,3300,2502,36,156,0,441,4,151,798
25017369100,5059,4062,322,176,4,293,1,30,997
25017370101,6807,4984,630,222,17,586,0,95,1823
25017370103,3544,2322,247,181,3,556,0,48,1222
25017370104,3734,2654,314,139,0,392,0,63,1080
25017370201,3798,3100,207,77,3,199,0,22,698
25017370202,4222,3449,236,119,2,198,0,62,773
25017370301,4531,3183,443,180,2,377,1,85,1348
25017370302,1572,1119,131,38,1,185,0,33,453
25017370401,3531,2490,254,148,4,414,0,50,1041
25017370402,1520,1082,120,40,2,163,0,32,438
25017370403,2070,1446,136,68,1,276,0,28,624
25017373100,5113,3520,308,111,3,819,2,51,1593
25017373200,4789,3065,426,129,4,834,0,76,1724
25017373300,3100,2219,121,61,2,517,0,29,881
25017373400,3319,2414,195,57,0,427,0,34,905
25017373500,6237,4761,166,209,2,764,0,71,1476
25017373600,6132,4185,230,498,1,986,0,87,1947
25017373700,3854,2968,129,53,0,466,0,31,886
25017373800,6066,4217,295,156,7,1082,9,41,1849
25017373901,3128,2156,138,69,0,606,4,16,972
25017373902,3876,2566,189,90,3,868,0,18,1310
25017374000,4808,3254,198,63,1,1080,2,12,1554
25017374100,4965,2890,236,233,6,1328,0,30,2075
25017374200,4311,3108,233,70,4,660,0,18,1203
25017374300,3772,2981,128,39,1,426,0,22,791
25017374400,5955,4399,230,88,5,871,1,63,1556
25017374500,4586,3188,330,187,3,613,1,58,1398
25017374600,5285,3783,362,148,0,728,1,30,1502
25017374700,4602,3074,296,115,6,865,0,37,1528
25017374800,5025,3555,283,178,1,741,5,41,1470
25017382100,5146,3991,194,102,4,588,0,37,1155
25017382200,5375,4436,255,82,0,339,1,36,939
25017382300,5917,4929,232,76,4,364,0,33,988
25017382400,5340,4439,208,83,3,336,0,56,901
25017382500,5664,4067,370,212,6,691,0,58,1597
25017382601,4794,2576,320,153,21,1420,0,111,2218
25017382602,4770,3547,183,75,4,693,0,90,1223
25017383101,4149,901,1442,181,5,56,0,931,3248
25017383102,5012,863,2283,626,2,74,0,561,4149
25017383200,6591,2264,2084,447,12,244,0,740,4327
25017383300,3191,1574,525,216,9,157,0,346,1617
25017383401,2499,955,549,144,3,94,0,499,1544
25017383402,3799,1374,741,205,5,236,0,761,2425
25017383501,4674,1947,1049,384,14,515,0,325,2727
25017383502,3932,2670,344,239,1,194,10,162,1262
25017383600,6341,3818,681,482,4,550,2,307,2523
25017383700,5308,3504,588,312,10,334,2,234,1804
25017383800,6356,4480,494,236,8,609,2,146,1876
25017383902,5466,4089,317,132,1,479,0,90,1377
25017383903,2665,2082,133,85,1,204,0,23,583
25017383904,5221,4095,325,192,4,302,0,68,1126
25017384003,5699,3272,519,313,4,992,0,196,2427
25017384004,1459,967,97,54,1,193,1,57,492
25017385101,2869,2159,142,51,0,336,0,37,710
25017385102,4972,3561,313,116,5,492,0,167,1411
25017385201,2837,1950,238,122,6,120,2,172,887
25017385203,4797,3181,290,165,6,705,0,177,1616
25017385204,3357,2040,174,60,12,805,0,96,1317
25017386100,4401,3594,149,27,2,335,1,36,807
25017387100,4379,3834,116,59,1,179,0,31,545
25017387201,6231,5030,203,74,4,552,2,100,1201
25017387202,4386,3757,193,39,2,200,0,36,629
25017388100,5506,3694,218,119,1,1186,1,38,1812
25017388200,7431,5488,780,575,11,203,6,42,1943
25017388300,6405,3085,1736,479,0,705,12,126,3320
25017980000,0,0,0,0,0,0,0,0,0
25019950100,1716,1468,109,46,3,27,1,9,248
25019950201,3683,2371,788,215,8,66,1,55,1312
25019950202,2996,1717,594,445,2,60,0,35,1279
25019950307,524,462,24,2,0,6,0,0,62
25019950400,3571,2295,709,272,6,89,0,45,1276
25019950500,1765,1576,88,26,0,15,0,5,189
25019990000,0,0,0,0,0,0,0,0,0
25021400100,5548,3566,460,233,5,954,0,30,1982
25021400201,3047,2043,154,43,0,640,0,20,1004
25021400202,3625,1888,294,217,0,1034,0,18,1737
25021400300,4310,2940,283,78,2,761,0,29,1370
25021400401,3890,2766,219,49,0,655,0,18,1124
25021400402,2045,1452,120,26,0,308,0,5,593
25021400500,5558,4039,317,106,5,775,4,35,1519
25021400600,5492,3837,363,80,1,928,3,31,1655
25021400700,3986,2679,267,84,8,699,0,36,1307
25021400800,6077,3791,403,124,2,1440,2,25,2286
25021400900,4354,2346,361,305,11,1078,0,29,2008
25021401000,3534,2209,312,233,1,553,0,16,1325
25021401100,4827,3287,314,137,3,825,0,41,1540
25021401201,5191,3204,314,155,0,1219,2,25,1987
25021401202,1707,1196,91,91,0,222,0,33,511
25021402101,3593,2848,279,161,1,162,0,18,745
25021402102,4402,2768,705,498,3,168,0,60,1634
25021402200,2217,1671,221,171,1,74,3,16,546
25021402300,4518,3844,243,134,5,155,0,10,674
25021402400,6341,4953,493,354,0,267,2,45,1388
25021402500,4293,3691,184,183,5,125,0,18,602
25021403100,7599,6310,280,62,1,649,1,31,1289
25021403300,4431,3741,167,47,1,279,0,17,690
25021403400,6961,5648,265,124,1,607,1,63,1313
25021403501,2851,2136,156,89,2,350,0,21,715
25021403502,4280,3193,173,90,3,639,0,21,1087
25021404100,4456,2958,332,102,0,857,0,5,1498
25021404201,3944,3343,128,16,0,313,0,14,601
25021404202,5040,3525,301,123,1,814,2,112,1515
25021404301,5813,4597,178,30,3,777,3,27,1216
25021404302,3825,2712,178,69,0,676,0,28,1113
25021404400,6472,4518,406,248,5,947,4,40,1954
25021405100,5923,4786,166,48,4,600,0,27,1137
25021406101,6081,5260,204,108,5,206,2,38,821
25021406102,6718,5937,202,33,1,284,0,13,781
25021407101,4419,3890,138,52,5,114,0,36,529
25021407102,4041,3556,152,59,8,120,1,16,485
25021408102,4932,4321,182,71,9,133,2,50,611
25021408103,3034,2636,77,56,3,119,0,39,398
25021408104,5149,4622,153,47,9,125,2,24,527
25021409101,5885,4567,476,526,11,112,0,23,1318
25021409102,5777,5242,126,70,3,194,0,9,535
25021410100,6813,5888,228,234,6,214,1,39,925
25021410300,4947,4132,175,186,1,246,0,38,815
25021410400,6858,5553,302,346,5,374,1,44,1305
25021411101,4665,3338,386,388,10,180,0,95,1327
25021411102,4670,4188,129,83,4,107,1,15,482
25021411200,7453,5941,310,194,5,665,1,89,1512
25021411301,6072,5477,155,48,2,215,1,31,595
25021411302,3523,2917,136,97,3,235,1,31,606
25021412100,6707,5709,191,59,2,529,0,20,998
25021412200,3899,3335,114,44,0,267,0,23,564
25021412300,5660,4418,159,160,0,682,0,32,1242
25021413100,6494,5059,373,415,11,329,0,62,1435
25021413201,4834,3779,238,324,4,252,0,54,1055
25021413202,2093,1668,142,156,3,54,0,14,425
25021413300,5083,4105,254,358,3,173,0,38,978
25021413401,3554,2835,260,194,0,91,1,39,719
25021413402,4901,2719,360,417,11,1102,2,51,2182
25021413500,4652,2767,697,435,0,350,0,115,1885
25021414100,5862,3578,184,292,4,1536,0,34,2284
25021414200,7549,5078,240,267,7,1608,0,39,2471
25021414300,5164,3750,180,177,4,787,1,60,1414
25021415101,4774,3706,171,233,7,435,0,27,1068
25021415103,4749,3323,229,488,0,452,0,41,1426
25021415104,3310,2470,135,291,2,232,6,31,840
25021415201,4020,2265,281,730,6,525,0,43,1755
25021415202,3263,2524,106,324,0,187,5,29,739
25021415300,4254,3484,155,158,1,308,0,19,770
25021416101,6274,5089,188,218,12,489,1,38,1185
25021416102,4005,2889,241,394,1,256,3,28,1116
25021416200,6913,3352,519,2168,21,358,0,88,3561
25021416300,5005,3534,270,702,4,192,4,42,1471
25021416400,6454,5478,179,99,4,487,0,19,976
25021417100,6010,3510,204,128,6,1969,0,20,2500
25021417201,4456,1466,175,171,10,2504,0,16,2990
25021417202,4059,1691,152,111,0,1997,0,23,2368
25021417300,3660,2662,139,182,2,565,0,20,998
25021417400,2656,2354,80,21,0,127,0,9,302
25021417501,5291,2329,187,137,3,2442,5,33,2962
25021417502,4716,1863,218,183,3,2302,0,33,2853
25021417601,5249,2557,235,159,2,2146,2,16,2692
25021417602,5402,2773,194,168,2,2102,0,19,2629
25021417702,2826,2203,107,104,3,295,0,27,623
25021417703,3004,1669,205,227,5,773,0,32,1335
25021417704,3689,1998,209,218,6,1065,0,41,1691
25021417801,5518,4496,220,201,16,374,0,54,1022
25021417802,3217,1333,243,261,6,1197,0,29,1884
25021417901,8127,4423,542,705,17,1971,2,100,3704
25021417902,3786,1919,263,253,4,1067,1,78,1867
25021418002,7444,3378,401,429,8,2844,0,76,4066
25021418003,2448,1259,210,209,2,593,2,53,1189
25021418004,5043,2392,286,435,4,1563,0,100,2651
25021418101,5121,3054,289,220,5,1359,2,36,2067
25021418102,3550,1890,262,405,4,748,2,82,1660
25021418201,6335,3808,394,522,9,1196,0,115,2527
25021419100,6329,4397,294,177,0,1179,0,69,1932
25021419200,5177,3781,249,166,7,709,0,34,1396
25021419300,4000,2448,274,349,8,680,0,75,1552
25021419400,3211,2247,127,107,5,558,0,50,964
25021419500,3481,2348,231,106,0,624,3,29,1133
25021419601,1600,967,113,120,0,309,0,26,633
25021419602,5913,4702,128,85,8,799,0,48,1211
25021419700,4716,3204,173,62,6,1148,0,34,1512
25021419800,4716,3331,271,103,0,733,6,75,1385
25021420101,4698,1270,528,1796,16,781,0,76,3428
25021420102,4122,1270,431,1370,6,776,0,79,2852
25021420201,3576,974,330,1481,7,507,0,87,2602
25021420202,7404,1736,938,3409,11,798,0,137,5668
25021420301,7295,2068,709,2960,16,874,2,174,5227
25021420302,7889,1971,862,3646,16,765,3,176,5918
25021421100,5410,3319,437,935,6,196,0,136,2091
25021421200,5995,4165,386,725,8,333,2,89,1830
25021422100,5354,4460,183,129,5,240,0,90,894
25021422201,2277,1568,96,92,0,413,0,20,709
25021422202,6961,5493,253,185,16,511,3,139,1468
25021422301,3432,2882,93,62,10,195,0,50,550
25021422303,5007,3020,320,608,6,632,1,97,1987
25021422304,2167,1863,72,37,0,75,2,23,304
25021422401,3573,2485,220,251,1,309,1,77,1088
25021422402,3889,3195,173,83,6,186,0,61,694
25021422501,4847,3498,276,471,10,282,0,88,1349
25021422502,5590,3883,354,453,14,374,2,138,1707
25021422600,6779,5821,231,119,12,287,0,67,958
25021422700,3804,3036,174,109,2,327,0,43,768
25021422800,3757,3261,119,50,0,160,0,27,496
25021423101,3849,3574,63,11,6,42,0,16,275
25021423102,4532,4203,128,18,5,56,0,7,329
25021440101,6608,5580,315,210,3,266,6,28,1028
25021440102,3337,2933,119,76,2,88,4,13,404
25021441202,3021,2723,80,32,5,74,0,20,298
25021441203,4112,3753,75,78,3,59,2,12,359
25021441204,5045,4432,152,46,5,200,0,19,613
25021442101,5797,4931,245,194,11,185,1,49,866
25021442103,7009,6045,172,64,0,513,3,24,964
25021442104,5565,4787,180,70,2,354,2,20,778
25021442105,1894,1537,89,59,2,134,2,10,357
25021442201,4362,3800,98,54,1,212,2,35,562
25021442203,4249,3486,209,117,0,263,6,34,763
25021442204,4385,3719,228,77,5,168,0,22,666
25021443103,4562,3941,201,76,10,93,0,39,621
25021443104,4763,4051,195,71,4,216,3,51,712
25021443105,2080,1791,62,27,7,80,0,14,289
25021443106,5540,4688,295,123,0,114,0,73,852
25021456101,4115,2478,213,755,5,313,1,90,1637
25021456102,5144,2998,414,951,0,247,1,135,2146
25021456200,4040,2284,299,909,2,295,0,60,1756
25021456301,2017,890,158,395,9,123,0,169,1127
25021456302,5537,3404,338,1024,9,259,2,158,2133
25021456401,2886,1874,223,350,6,99,0,115,1012
25021456402,5542,3943,279,691,2,249,2,80,1599
25021457100,4777,3036,311,887,5,196,0,106,1741
25021457200,5969,4985,182,40,2,509,1,39,984
25021980000,8,1,3,0,0,0,0,0,7
25023500101,3617,3294,83,25,7,33,0,32,323
25023500103,2231,2084,42,22,5,17,0,6,147
25023500104,4224,3858,98,26,4,57,5,20,366
25023501101,3516,3267,50,18,0,65,0,11,249
25023501102,9185,8280,279,79,4,213,0,37,905
25023501201,3881,3599,85,10,2,60,0,23,282
25023501203,2679,2484,46,5,2,36,0,6,195
25023501204,5023,4588,79,31,2,176,0,16,435
25023502101,6196,4821,243,262,8,153,0,237,1375
25023502102,5644,4682,225,219,7,96,1,126,962
25023502200,5963,5193,143,121,5,101,0,91,770
25023503101,7405,6746,132,69,2,152,0,75,659
25023503102,7428,6881,145,43,4,117,1,39,547
25023504101,5618,5083,129,42,0,150,1,31,535
25023504102,5733,5271,123,22,1,119,1,40,462
25023505102,5317,5003,79,16,0,41,1,14,314
25023505103,2636,2469,53,2,0,15,0,21,167
25023505104,4027,3715,57,16,3,30,0,64,312
25023505201,2563,2358,55,12,3,19,2,13,205
25023505202,4520,4263,56,15,5,20,0,24,257
25023506102,6324,5703,154,63,11,92,0,78,621
25023506103,2783,2610,39,11,1,25,1,11,173
25023506104,4148,3886,86,12,0,30,1,25,262
25023506202,2570,2461,44,10,0,9,1,5,109
25023506203,5256,4867,100,22,8,45,2,59,389
25023506205,1858,1779,33,0,0,2,0,2,79
25023506206,2886,2765,35,17,0,10,1,12,121
25023507101,5589,5187,116,22,0,83,0,25,402
25023507103,4534,4179,117,10,2,50,0,15,355
25023507104,5967,5547,113,35,13,87,0,17,420
25023508101,7078,6454,155,61,8,91,1,56,624
25023508102,4978,4624,77,28,5,35,1,27,354
25023508200,6305,5906,87,23,4,51,3,37,399
25023509101,7584,6965,166,64,2,108,0,49,619
25023509102,6124,5607,109,58,7,62,3,43,517
25023510100,4925,2341,488,1347,28,124,0,152,2584
25023510200,6999,2426,645,2296,26,203,4,384,4573
25023510300,4490,707,613,1503,5,124,2,420,3783
25023510400,4332,495,606,1476,20,66,0,432,3837
25023510501,3574,1102,384,1194,10,100,2,236,2472
25023510503,4571,1348,505,1985,8,112,0,163,3223
25023510504,2676,655,290,990,2,100,1,134,2021
25023510505,4247,1046,552,1743,4,133,0,266,3201
25023510600,3243,1774,228,732,2,161,1,52,1469
25023510700,6340,1642,647,2469,21,158,0,417,4698
25023510800,6900,822,864,2644,13,90,4,808,6078
25023510900,3042,477,487,1132,11,26,2,290,2565
25023511000,3346,567,529,1170,2,56,0,285,2779
25023511100,5571,2328,596,1676,4,147,0,227,3243
25023511200,5322,1656,685,1682,14,69,6,360,3666
25023511301,6312,1624,794,2294,11,86,2,422,4688
25023511302,3750,1350,522,1269,7,30,0,171,2400
25023511400,4520,572,854,1399,6,27,0,501,3948
25023511500,5139,534,715,1644,3,78,0,686,4605
25023511601,4487,694,578,1661,20,29,2,415,3793
25023511602,3908,1495,441,1153,4,64,2,197,2413
25023511701,5131,2222,508,1548,9,154,0,191,2909
25023511702,2818,1515,231,649,2,106,0,106,1303
25023520100,6854,5672,257,255,20,141,2,170,1182
25023520201,4079,3383,161,91,0,112,1,94,696
25023520202,6129,4963,242,315,6,172,6,119,1166
25023521101,4740,4166,150,106,5,63,0,60,574
25023521102,3344,2814,118,122,0,54,0,62,530
25023521201,3097,2482,151,144,5,44,0,66,615
25023521202,3940,3546,119,63,2,42,2,15,394
25023522101,4601,4152,105,44,2,48,0,70,449
25023522102,6038,5597,100,46,0,57,0,47,441
25023523100,3261,2817,103,94,8,33,1,37,444
25023523201,2998,2616,50,113,2,15,1,34,382
25023523203,4426,4035,119,47,2,42,0,34,391
25023523204,3755,3309,95,128,8,36,1,20,446
25023524101,3381,2906,99,120,3,50,0,22,475
25023524102,4326,3791,152,128,9,32,1,28,535
25023525101,7314,6031,293,377,3,203,0,59,1283
25023525104,6765,5922,145,252,11,90,0,74,843
25023525204,3934,3327,119,167,2,71,0,29,607
25023526100,7749,7187,143,66,16,30,2,66,562
25023530100,4447,3696,218,168,19,59,0,60,751
25023530200,3983,3149,140,98,13,37,0,166,834
25023530300,4118,3533,146,68,3,54,0,89,585
25023530400,5913,5394,119,49,6,74,2,47,519
25023530500,5744,5048,126,90,16,80,0,77,696
25023530600,6456,5368,337,329,1,56,3,136,1088
25023530700,5947,5502,123,55,8,76,0,26,445
25023530801,6209,5754,127,29,8,65,0,31,455
25023530802,4634,4223,73,41,3,25,0,35,411
25023530902,4512,4123,90,38,7,41,0,27,389
25023530903,5998,5313,190,97,4,93,0,49,685
25023530904,3256,2909,104,27,18,19,0,22,347
25023540101,4435,3952,118,68,4,56,1,32,483
25023540102,2642,2441,59,13,0,24,1,11,201
25023540103,4446,4120,80,20,2,64,0,28,326
25023541100,5717,5288,94,37,5,30,0,44,429
25023542101,7354,6667,134,100,5,58,2,81,687
25023542102,2659,2413,48,56,4,9,0,12,246
25023542200,6311,5686,154,85,6,32,0,62,625
25023542301,3586,3156,97,90,13,34,2,15,430
25023542302,4335,3679,164,130,10,81,0,50,656
25023543100,2930,2755,37,21,10,13,2,13,175
25023544100,5570,5048,102,63,8,43,0,52,522
25023544200,6075,5549,131,41,7,29,2,58,526
25023545100,6844,5605,184,155,21,46,0,180,1239
25023545200,6478,5182,276,147,25,57,2,193,1296
25023545300,4463,3650,126,105,24,46,1,144,813
25023545400,5518,4606,155,148,27,61,0,133,912
25023560100,6508,5956,149,25,17,55,4,56,552
25023561100,5347,4558,225,83,14,73,0,112,789
25023561400,6225,5144,212,426,5,96,1,63,1081
25023980200,1575,826,311,347,22,12,0,23,749
25023980300,2820,2039,187,408,0,67,0,31,781
25023990003,0,0,0,0,0,0,0,0,0
25025000101,1876,1211,183,83,7,274,0,39,665
25025000102,3714,1565,554,298,8,883,2,177,2149
25025000201,3953,2712,422,138,1,421,0,101,1241
25025000202,4148,2394,778,221,1,536,0,64,1754
25025000301,3136,2218,265,120,0,403,1,30,918
25025000302,3072,2022,233,91,0,550,3,52,1050
25025000401,5853,3717,445,177,6,1242,2,42,2136
25025000402,3644,2526,220,93,4,610,0,57,1118
25025000502,6986,5158,531,343,27,690,22,34,1828
25025000503,2418,1621,212,82,7,381,0,14,797
25025000505,2196,1383,243,142,0,328,0,23,813
25025000506,2895,2000,207,75,6,477,0,18,895
25025000601,3758,2333,402,93,3,686,1,49,1425
25025000603,1757,401,445,396,0,420,0,10,1356
25025000604,2591,1377,361,110,1,550,1,51,1214
25025000701,4517,2644,419,145,3,1045,0,47,1873
25025000703,2442,1250,248,99,3,726,0,15,1192
25025000704,5312,2669,699,287,2,1387,4,58,2643
25025000804,3813,1661,818,217,5,824,4,70,2152
25025000805,4616,2194,532,176,4,1437,0,64,2422
25025000806,1972,949,208,150,0,530,4,10,1023
25025000807,2282,1225,210,204,0,520,10,0,1057
25025010103,4697,2661,513,352,13,942,4,55,2036
25025010104,5063,3135,533,184,19,962,1,38,1928
25025010204,3443,1690,265,168,0,1097,12,32,1753
25025010205,4906,2343,417,217,7,1667,0,43,2563
25025010206,2154,1040,223,50,0,749,0,9,1114
25025010300,5186,3584,486,329,4,608,4,19,1602
25025010403,3179,1571,332,246,1,859,2,21,1608
25025010404,5747,3291,535,394,0,1247,24,19,2456
25025010405,6853,3793,547,683,5,1332,0,164,3060
25025010408,1438,821,194,39,0,311,0,8,617
25025010500,3876,2086,300,306,5,987,3,30,1790
25025010600,3529,2472,249,149,0,507,1,12,1057
25025010701,2543,1963,161,53,0,240,0,13,580
25025010702,2328,1856,157,52,4,154,0,14,472
25025010801,2856,2235,202,86,3,237,0,10,621
25025010802,3058,2453,139,44,4,281,0,20,605
25025020101,4235,3643,167,44,0,210,0,25,592
25025020200,3804,2870,269,166,1,329,1,13,934
25025020301,2166,1288,143,60,0,581,0,11,878
25025020302,1293,1007,100,42,0,90,0,8,286
25025020304,1906,1269,193,111,2,233,1,20,637
25025020305,3633,2376,277,167,7,625,0,54,1257
25025030100,2115,1842,101,26,0,85,2,5,273
25025030200,1815,1558,105,13,0,76,1,3,257
25025030301,1385,1154,52,4,0,140,3,10,231
25025030302,1844,1300,157,103,2,195,0,13,544
25025030400,4160,3511,233,69,6,171,0,26,649
25025030500,2715,2395,89,33,1,108,2,11,320
25025040100,2360,2051,99,17,3,94,0,16,309
25025040200,1594,837,380,197,4,91,1,12,757
25025040300,4525,3506,465,226,0,138,0,21,1019
25025040401,2922,2206,204,68,0,354,0,24,716
25025040600,3683,2981,202,89,2,266,1,6,702
25025040801,4036,2045,725,393,7,703,2,19,1991
25025050101,4917,1242,3058,176,2,253,7,43,3675
25025050200,5197,1467,3168,121,15,174,3,78,3730
25025050300,3258,1251,1207,283,5,354,0,32,2007
25025050400,2372,1090,969,41,2,119,1,60,1282
25025050500,2174,932,944,45,0,103,0,25,1242
25025050600,2074,701,1168,46,3,82,1,25,1373
25025050700,4520,1268,2699,122,10,122,1,140,3252
25025050901,4242,1091,2749,77,2,92,0,90,3151
25025051000,4317,1906,1907,128,2,154,0,71,2411
25025051101,6460,2741,2821,275,3,313,0,66,3719
25025051200,3454,2017,1000,85,1,149,0,48,1437
25025060101,3673,3400,128,15,2,55,0,6,273
25025060200,2328,2149,81,7,1,29,0,7,179
25025060301,3609,3368,89,32,0,45,0,18,241
25025060400,5195,4740,181,27,6,104,0,12,455
25025060501,4733,4167,184,31,2,207,2,18,566
25025060601,2006,1661,86,44,1,150,0,8,345
25025060602,331,265,10,10,2,33,0,0,66
25025060603,1502,1152,83,44,0,134,1,7,350
25025060604,2803,2110,176,95,0,250,0,56,693
25025060700,1689,229,831,341,3,142,4,37,1460
25025060800,4859,4201,233,45,11,247,1,13,658
25025061000,2416,1168,634,334,0,164,0,22,1248
25025061101,2710,516,1127,518,12,388,0,37,2194
25025061201,2013,1567,132,65,0,170,0,7,446
25025061202,0,0,0,0,0,0,0,0,0
25025061203,2686,1973,181,70,0,369,0,6,713
25025061204,937,787,45,11,0,64,0,3,150
25025070102,3687,2194,353,232,7,745,4,20,1493
25025070103,751,236,68,68,0,369,0,0,515
25025070104,2862,1852,144,51,2,667,0,16,1010
25025070201,3990,2230,261,179,0,1264,0,12,1760
25025070202,5460,1608,383,186,2,3107,4,16,3852
25025070301,2213,1687,163,50,0,207,0,13,526
25025070302,2090,1426,105,55,0,426,1,13,664
25025070402,3561,1473,278,374,3,1308,0,22,2088
25025070501,2223,1621,197,58,5,272,0,7,602
25025070502,3393,1544,865,254,3,629,1,15,1849
25025070600,2287,1805,131,99,1,127,0,9,482
25025070700,2527,1372,239,486,10,265,0,31,1155
25025070801,1056,571,96,174,0,142,1,6,485
25025070802,2685,1702,266,363,6,218,1,17,983
25025070901,1165,291,400,303,0,113,0,12,874
25025070902,2300,1203,398,331,2,239,0,7,1097
25025071101,4111,2077,547,596,16,679,5,33,2034
25025071201,3514,1452,809,593,4,497,0,29,2062
25025080100,2900,572,796,1012,2,46,1,114,2328
25025080300,2236,146,805,1045,1,80,1,33,2090
25025080401,3391,352,1341,1214,10,291,0,54,3039
25025080500,3288,308,1372,1234,0,255,2,25,2980
25025080601,4732,1749,687,732,5,1263,3,23,2983
25025080801,4282,1238,1414,940,9,533,1,51,3044
25025080900,4376,2194,355,319,2,1305,0,33,2182
25025081001,5695,1955,1064,639,7,1744,1,81,3740
25025081101,1484,806,158,154,0,299,0,4,678
25025081102,3165,1248,508,529,6,731,0,18,1917
25025081200,3506,577,1677,913,2,156,0,41,2929
25025081301,2394,336,1108,769,8,62,3,7,2058
25025081302,3080,255,1415,1186,9,65,0,27,2825
25025081400,3774,1172,684,1324,9,326,1,33,2602
25025081500,2449,406,631,1107,4,117,0,19,2043
25025081700,4141,254,1100,2337,22,158,0,65,3887
25025081800,3567,256,1084,1923,5,46,0,56,3311
25025081900,3671,127,1284,1983,6,33,0,57,3544
25025082000,3195,129,830,1882,8,32,1,73,3066
25025082100,5224,164,2079,2657,9,48,3,55,5060
25025090100,5171,133,1637,2930,41,61,0,100,5038
25025090200,2412,105,1099,933,0,56,0,50,2307
25025090300,3795,82,1469,1812,11,48,1,79,3713
25025090400,4101,168,1398,1712,5,140,2,165,3933
25025090600,2450,175,621,744,3,50,0,319,2275
25025090700,4673,2858,449,282,13,824,1,61,1815
25025090901,3600,1007,784,530,7,1114,5,25,2593
25025091001,3255,1766,311,275,5,702,0,27,1489
25025091100,4916,2528,430,430,8,1191,0,90,2388
25025091200,3140,1120,761,546,0,174,0,155,2020
25025091300,2626,297,568,716,2,109,0,432,2329
25025091400,2886,201,910,1205,15,33,2,197,2685
25025091500,4588,621,1083,1292,1,270,2,441,3967
25025091600,3200,462,639,684,13,927,0,128,2738
25025091700,3203,208,795,1311,13,155,0,195,2995
25025091800,3718,195,915,1567,8,121,0,248,3523
25025091900,4278,143,1089,2449,15,62,0,136,4135
25025092000,5180,403,1225,2218,10,651,3,150,4777
25025092101,6921,1900,919,1260,10,2386,0,110,5021
25025092200,3602,751,545,1255,19,665,4,78,2851
25025092300,3301,119,740,2033,16,131,0,58,3182
25025092400,6067,181,2281,2984,25,71,0,82,5886
25025100100,5722,151,1843,3209,18,64,0,117,5571
25025100200,2919,46,621,1963,9,33,0,62,2873
25025100300,3737,128,650,2505,10,98,0,56,3609
25025100400,5068,768,742,2749,12,351,2,103,4300
25025100500,6576,934,1421,3060,29,667,9,124,5642
25025100601,5342,2095,592,1100,8,1075,0,117,3247
25025100603,2172,1391,148,226,4,289,0,25,781
25025100700,4332,3729,121,140,0,200,0,23,603
25025100800,5791,3089,498,1050,3,802,1,72,2702
25025100900,4148,993,424,2089,7,364,0,53,3155
25025101001,5595,107,784,4340,8,16,3,51,5488
25025101002,5712,195,1205,3852,19,53,4,62,5517
25025101101,3522,108,752,2436,7,28,0,35,3414
25025101102,4766,59,874,3541,13,17,4,22,4707
25025110104,2177,433,1045,532,1,55,0,25,1744
25025110105,2120,1233,281,158,1,302,2,23,887
25025110106,1356,710,348,160,0,68,2,12,646
25025110201,2091,339,831,735,0,65,0,34,1752
25025110301,2500,1022,664,607,1,74,1,24,1478
25025110401,3625,1282,1144,902,3,125,1,16,2343
25025110403,4437,2122,1026,914,3,124,0,47,2315
25025110501,3302,2237,508,269,4,111,0,23,1065
25025110502,4000,2178,918,556,8,131,0,33,1822
25025110601,2639,2164,147,52,0,185,0,9,475
25025110607,5276,4074,456,269,2,227,0,42,1202
25025120103,1642,1296,88,58,0,88,0,8,346
25025120104,2373,1570,324,153,1,156,0,16,803
25025120105,2492,1896,173,120,5,148,3,12,596
25025120201,4360,2353,828,484,8,416,2,41,2007
25025120301,5120,2274,1590,637,3,296,0,50,2846
25025120400,6006,4349,598,348,10,371,0,48,1657
25025120500,2423,923,916,265,1,209,2,16,1500
25025120600,2566,1852,284,118,4,153,0,14,714
25025120700,2139,1271,283,171,1,301,3,11,868
25025130101,6048,4540,440,206,1,580,0,59,1508
25025130200,4708,3763,308,156,1,294,0,34,945
25025130300,4496,3543,322,165,3,304,0,21,953
25025130402,4833,3394,513,298,6,426,1,24,1439
25025130404,3073,1829,445,381,2,304,1,22,1244
25025130406,5639,1613,1379,2030,13,345,0,51,4026
25025140102,4958,1562,998,1984,5,139,2,54,3396
25025140105,3592,1131,1149,1083,4,77,0,24,2461
25025140106,2178,327,663,1000,3,72,1,18,1851
25025140107,2778,747,746,1032,10,57,1,18,2031
25025140201,2311,767,493,763,1,69,0,89,1544
25025140202,5824,2010,1425,1921,9,179,7,60,3814
25025140300,6843,920,1846,3681,13,78,2,58,5923
25025140400,7859,493,1660,5164,14,124,1,60,7366
25025160102,3823,385,2804,333,15,90,0,96,3438
25025160103,4646,682,3476,249,6,100,0,56,3964
25025160200,4154,393,3475,151,6,47,1,34,3761
25025160300,2753,1536,731,219,6,130,0,46,1217
25025160400,3878,817,2457,272,2,183,0,39,3061
25025160501,6105,733,4794,281,14,115,2,75,5372
25025160502,5604,1048,3780,314,11,212,2,78,4556
25025160601,4331,1205,2375,325,6,181,2,57,3126
25025160602,5493,1443,2934,523,3,241,1,168,4050
25025170101,4023,1768,1583,233,6,163,0,87,2255
25025170102,5015,1878,2246,242,8,249,3,168,3137
25025170200,5305,2806,1555,259,9,291,3,101,2499
25025170301,7045,4056,1933,238,2,383,0,129,2989
25025170302,4051,1728,761,435,2,418,2,205,2323
25025170400,5761,2574,2187,290,15,215,1,163,3187
25025170502,3407,2246,673,137,6,123,1,74,1161
25025170503,1698,958,477,54,2,92,0,38,740
25025170504,3157,1513,940,174,3,305,3,71,1644
25025170601,6247,2558,2872,178,2,229,0,172,3689
25025170701,2702,1199,1031,119,0,200,0,41,1503
25025170702,7995,1981,4544,363,2,595,1,232,6014
25025170800,5773,2684,2367,190,7,168,3,112,3089
25025180101,5804,4501,793,132,2,108,0,68,1303
25025180200,4326,3371,614,89,5,66,1,31,955
25025180301,3169,2726,260,24,0,35,0,30,443
25025180400,1928,1554,176,72,2,16,0,29,374
25025180500,4089,3093,570,95,16,64,4,45,996
25025980101,0,0,0,0,0,0,0,0,0
25025980300,113,42,10,55,2,2,0,0,71
25025980700,7,2,2,0,0,0,0,0,5
25025980900,125,72,13,24,0,11,0,0,53
25025981000,11,2,6,1,1,0,0,0,9
25025981100,97,27,44,19,0,0,2,1,70
25025981201,0,0,0,0,0,0,0,0,0
25025981202,6,1,2,0,0,0,0,1,5
25025981300,79,54,9,4,0,4,0,0,25
25025981501,13,5,6,0,0,1,0,0,8
25025981502,7,0,6,0,0,0,0,0,7
25025981600,2,0,1,0,0,0,0,0,2
25025981700,4,1,1,0,0,0,0,0,3
25025981800,23,15,2,2,0,0,0,0,8
25025981900,0,0,0,0,0,0,0,0,0
25025990101,0,0,0,0,0,0,0,0,0
25027700100,6315,5726,193,41,14,55,0,26,589
25027701101,4789,4178,244,66,4,53,2,25,611
25027701102,3634,3122,218,42,2,55,0,8,512
25027702201,1250,1176,16,2,1,8,0,3,74
25027702202,1941,1681,113,25,1,31,0,4,260
25027703100,4515,3893,309,43,7,43,0,14,622
25027703200,3639,3263,157,31,1,17,4,8,376
25027703300,3791,3319,199,45,9,30,0,13,472
25027704201,1726,1568,69,4,2,2,0,23,158
25027704202,1194,1088,43,3,0,4,0,18,106
25027705101,3687,3346,114,49,0,24,0,25,341
25027705102,4462,4038,179,52,4,19,5,13,424
25027706100,4328,3965,125,17,9,29,0,24,363
25027707100,4085,3213,471,91,7,65,0,30,872
25027707200,2120,1669,242,48,0,53,0,19,451
25027707300,4056,3265,486,72,10,58,0,13,791
25027707400,4904,4054,404,105,15,81,0,26,850
25027707500,6122,4525,741,383,20,141,6,35,1597
25027708100,8213,7387,357,86,10,93,0,36,826
25027709100,4356,3139,662,141,4,125,2,78,1217
25027709201,7812,5472,1266,369,8,228,0,99,2340
25027709203,3404,1980,603,347,4,154,0,78,1424
25027709204,4078,2475,797,266,1,162,1,103,1603
25027709400,4939,2437,1639,294,6,189,0,89,2502
25027709501,2134,1653,190,86,1,71,0,30,481
25027709502,6187,4306,748,523,13,205,4,102,1881
25027709600,2428,1200,640,257,2,49,0,145,1228
25027709701,5948,3729,1274,388,6,137,0,97,2219
25027709702,2496,1648,449,150,2,61,2,51,848
25027710100,3815,1696,1504,193,3,205,0,49,2119
25027710200,7039,4571,1485,370,10,250,0,62,2468
25027710300,3582,2271,729,209,4,157,1,26,1311
25027710400,2204,1358,525,73,5,130,0,16,846
25027710500,3395,1461,1434,220,3,95,3,20,1934
25027710601,3285,1331,1412,265,0,81,1,34,1954
25027710602,4013,1958,1442,243,16,138,0,31,2055
25027710700,1800,794,708,156,8,39,0,12,1006
25027710800,4785,2319,1634,433,26,97,0,52,2466
25027711000,3073,1502,1065,202,4,146,5,13,1571
25027711100,4955,3657,670,215,1,169,4,12,1298
25027712101,7349,6214,487,128,8,127,0,34,1135
25027712102,4433,3873,186,58,5,83,0,35,560
25027713100,8441,6309,969,569,13,156,0,73,2132
25027715100,5665,4903,149,16,0,269,0,49,762
25027716101,3701,2984,249,69,3,73,0,94,717
25027716102,4807,3290,994,126,8,81,0,52,1517
25027716200,2953,1967,608,86,4,28,0,72,986
25027716300,3967,2702,745,106,8,55,0,70,1265
25027717100,3158,2796,127,18,0,38,3,17,362
25027718100,4849,4210,148,28,7,250,0,47,639
25027719100,7985,7230,297,78,3,71,3,46,755
25027720100,3495,3192,107,27,1,39,0,7,303
25027721101,1851,1675,70,17,3,16,0,4,176
25027721103,5026,4471,202,70,0,94,2,14,555
25027721104,4023,3522,188,57,8,62,2,30,501
25027722100,5530,4996,190,55,8,43,3,24,534
25027723100,3663,3377,85,21,11,11,1,21,286
25027724100,3833,3492,123,25,1,25,0,14,341
25027725100,4735,4276,195,28,9,29,0,10,459
25027726100,6182,5457,363,94,4,31,5,14,725
25027726200,5810,4700,626,144,23,61,3,26,1110
25027727100,5004,4247,303,176,8,71,0,38,757
25027728100,5388,4598,249,96,7,242,2,10,790
25027728200,4045,3504,155,79,0,134,0,22,541
25027728300,4916,4356,175,90,8,123,0,19,560
25027728400,5556,4786,252,130,0,182,0,21,770
25027729100,5008,4119,380,211,5,117,0,36,889
25027729200,2869,2425,203,54,0,30,0,20,444
25027730100,6504,4018,807,981,10,339,4,71,2486
25027730200,6146,4171,661,623,8,344,0,71,1975
25027730300,5223,3372,722,589,8,181,2,128,1851
25027730401,5992,2415,1747,1418,7,200,0,54,3577
25027730402,2066,798,651,313,7,148,1,37,1268
25027730500,4166,2082,740,781,9,142,1,125,2084
25027730600,9298,7303,569,640,16,486,0,42,1995
25027730700,7367,5014,760,792,14,361,3,65,2353
25027730801,3823,3005,280,203,4,162,0,21,818
25027730802,2222,1637,290,91,2,112,0,18,585
25027730901,3728,2886,349,195,0,145,0,22,842
25027730902,4416,3193,440,369,6,226,0,23,1223
25027731001,2468,1262,340,484,2,258,1,13,1206
25027731002,7081,3249,1597,1033,8,757,4,97,3832
25027731101,4527,1873,1438,526,6,484,0,44,2654
25027731102,2857,1764,458,280,3,212,0,32,1093
25027731202,1375,996,110,209,1,24,0,0,379
25027731203,6090,2006,2438,582,12,831,1,28,4084
25027731204,2531,670,1079,314,0,356,1,22,1861
25027731300,4423,785,2465,575,13,418,0,58,3638
25027731400,5197,1009,2696,799,3,462,2,43,4188
25027731500,5443,1376,2660,831,16,248,2,52,4067
25027731601,4812,2456,1022,479,13,583,2,51,2356
25027731602,3267,2141,354,354,2,301,0,7,1126
25027731700,4059,1938,920,533,12,463,4,33,2121
25027731801,2825,1461,637,235,8,232,2,69,1364
25027731802,4118,925,2036,686,7,190,0,63,3193
25027731900,6351,1827,2545,1232,14,313,3,108,4524
25027732001,3439,693,1966,509,4,101,0,28,2746
25027732002,4348,2337,615,618,8,542,3,46,2011
25027732201,3264,1814,398,449,11,322,0,96,1450
25027732202,3683,2209,567,351,4,235,0,66,1474
25027732203,3212,1325,834,516,2,309,1,41,1887
25027732301,4835,3020,529,690,14,294,0,60,1815
25027732302,4716,2247,1127,784,7,246,0,67,2469
25027732400,8018,2274,3302,1497,21,331,0,190,5744
25027732500,2490,812,1024,290,8,229,4,32,1678
25027732600,5448,1702,2242,980,2,202,3,99,3746
25027732700,4699,1604,1460,1120,10,191,1,95,3095
25027732801,5374,3296,620,805,5,322,0,81,2078
25027732802,4620,2262,783,961,2,352,0,76,2358
25027732901,7444,3676,1543,1372,8,344,0,138,3768
25027732902,3299,2273,396,208,0,345,3,0,1026
25027733000,4273,1122,1643,569,12,704,0,37,3151
25027733101,2273,1330,341,219,1,195,0,48,943
25027733102,2708,1411,535,293,6,320,0,45,1297
25027735100,6645,5699,362,154,15,138,1,24,946
25027735200,4442,3357,449,224,3,118,1,44,1085
25027736100,2688,2315,132,44,4,98,0,18,373
25027736200,3985,3340,229,61,0,161,0,39,645
25027736300,2489,2056,214,51,0,64,0,8,433
25027736400,3113,2603,150,92,3,125,0,14,510
25027736500,4614,4091,166,53,4,104,0,11,523
25027737100,5381,4678,227,109,3,130,4,15,703
25027737200,1760,1494,115,53,1,16,0,12,266
25027737300,6690,5608,290,182,3,296,1,50,1082
25027738100,5014,3567,284,98,0,851,0,47,1447
25027738201,4446,3643,157,64,7,381,0,39,803
25027738202,6768,5578,217,121,2,524,0,29,1190
25027739101,5286,3387,220,42,2,1359,0,52,1899
25027739102,5232,2210,183,221,14,2367,0,43,3022
25027739201,3508,2013,198,131,2,843,0,108,1495
25027739202,3248,1944,165,73,5,869,0,30,1304
25027739300,4004,2728,197,138,4,686,1,34,1276
25027739401,6554,4227,259,171,3,1544,1,55,2327
25027739402,2548,1955,88,23,1,357,0,4,593
25027739500,7945,5801,300,113,5,1395,3,50,2144
25027740101,6227,4645,273,103,9,797,0,67,1582
25027740102,6266,4819,255,80,7,742,1,62,1447
25027740200,3248,2458,95,36,3,324,3,69,790
25027741101,4646,3543,169,58,0,634,2,68,1103
25027741102,5804,4343,204,48,3,884,5,43,1461
25027742300,4255,3185,305,86,16,339,0,72,1070
25027742401,5677,4150,159,39,2,1066,0,26,1527
25027742402,5046,1906,267,146,1,2545,0,46,3140
25027743100,8000,6928,279,62,0,337,5,55,1072
25027744102,5552,4269,401,142,6,131,0,184,1283
25027744103,2780,2070,192,40,6,125,0,141,710
25027744104,5167,3993,410,116,0,102,0,166,1174
25027744201,2824,1738,355,83,0,76,0,207,1086
25027744202,5339,3424,721,126,7,120,0,369,1915
25027744300,4450,1904,1102,119,2,57,1,561,2546
25027744400,4267,2647,556,63,11,66,0,395,1620
25027745100,6017,5279,264,48,6,106,0,69,738
25027746100,6228,5644,181,39,5,105,0,40,584
25027747101,5306,4758,208,51,4,67,0,25,548
25027747102,3902,3490,163,40,4,32,1,28,412
25027748100,3174,2915,86,26,0,26,0,16,259
25027749100,8371,7634,191,58,10,110,1,57,737
25027749200,5791,5113,261,50,9,59,3,48,678
25027750100,6152,5249,384,92,8,84,1,37,903
25027750200,7160,6453,274,42,1,84,1,27,707
25027750300,3023,2593,170,60,5,37,0,12,430
25027751101,6390,5790,191,63,5,76,2,36,600
25027751102,2967,2742,62,16,0,22,0,3,225
25027752101,5647,5135,177,46,3,53,2,31,512
25027752102,3336,3036,107,11,6,30,0,16,300
25027753100,7254,6177,484,136,10,99,0,55,1077
25027753200,6093,5426,322,62,4,52,1,24,667
25027754100,6778,5753,498,168,7,108,0,43,1025
25027754200,3769,2668,676,139,11,76,0,19,1101
25027754300,3099,1992,677,185,9,89,0,17,1107
25027754400,4130,3049,628,210,8,50,4,30,1081
25027755100,3450,2826,330,97,7,35,0,15,624
25027755201,4508,3973,227,62,8,65,0,39,535
25027755202,3963,2818,926,29,1,40,0,4,1145
25027756101,4538,4056,207,61,3,58,3,15,482
25027756102,8777,7983,332,57,10,85,0,34,794
25027757100,4630,2765,1500,82,15,81,0,27,1865
25027757200,2554,980,1417,41,9,26,2,0,1574
25027757300,3205,1325,1683,61,10,51,0,5,1880
25027757400,2813,1859,785,49,7,41,0,3,954
25027757500,4538,3130,1024,105,16,115,1,23,1408
25027758101,1684,1503,49,12,4,31,0,9,181
25027758103,4982,4354,219,77,12,91,7,7,628
25027758104,3201,2770,156,47,1,75,6,21,431
25027759100,2224,2002,95,21,1,33,0,1,222
25027760100,3439,3130,122,19,3,18,0,5,309
25027761100,4975,4480,215,28,4,25,0,17,495
25027761200,6589,3739,563,178,3,1625,0,123,2850
25027761300,3436,2815,204,90,1,178,0,23,621
25027761401,4185,3598,128,25,4,236,0,28,587
25027761402,2666,1746,254,335,24,213,0,12,920
26001000100,1690,1630,14,1,0,2,0,5,60
26001970100,2340,2168,46,13,16,5,1,12,172
26001970400,2833,2688,18,7,25,6,0,5,145
26001970500,1923,1797,25,1,10,1,0,0,126
26001970600,1381,1310,19,1,6,0,0,5,71
26001990000,0,0,0,0,0,0,0,0,0
26003000100,3322,2867,47,5,169,9,0,11,455
26003000200,2574,2269,39,6,96,11,0,12,305
26003000300,2946,2187,29,574,62,2,1,2,759
26003990000,0,0,0,0,0,0,0,0,0
26005030200,3566,3248,183,19,6,31,0,9,318
26005030301,3133,2913,115,14,4,20,0,0,220
26005030302,5079,4619,160,16,25,28,0,21,460
26005030402,6874,6111,278,63,43,62,1,41,763
26005030403,4302,3926,185,13,5,18,0,10,376
26005030404,3620,3330,95,22,24,8,2,9,290
26005030501,3190,2851,106,17,45,18,0,10,339
26005030502,4945,4309,232,60,53,22,0,24,636
26005030600,5196,4630,253,22,47,5,0,26,566
26005030702,5467,4935,217,18,14,31,0,18,532
26005030703,2659,1524,984,38,10,9,0,8,1135
26005030704,5149,3911,899,50,19,31,0,24,1238
26005030801,2276,2079,103,18,1,22,0,2,197
26005030802,3410,3042,218,8,14,27,0,14,368
26005030901,2800,2293,269,62,28,18,0,2,507
26005030902,2574,2041,402,8,4,6,1,18,533
26005031001,2750,1501,989,99,19,4,1,8,1249
26005031002,3266,2689,259,95,19,14,0,17,577
26005031101,3518,3187,96,36,15,17,0,15,331
26005031102,3160,2864,101,42,10,12,0,8,296
26005031200,5763,4918,294,158,26,53,7,32,845
26005031300,4899,4480,166,21,17,23,0,6,419
26005031800,4735,4353,143,29,11,29,0,17,382
26005031900,5236,4604,204,50,27,58,0,24,632
26005032000,5325,4737,221,61,21,28,1,10,588
26005032100,4663,4233,131,23,32,26,0,24,430
26005032200,5793,4218,970,261,10,116,6,19,1575
26005032401,1715,841,694,63,6,43,0,7,874
26005032402,3901,3411,275,31,6,47,1,10,490
26005032600,1538,1290,147,29,0,13,0,0,248
26005990000,0,0,0,0,0,0,0,0,0
26007000101,1398,1306,23,0,11,0,0,8,92
26007000102,3035,2859,30,3,6,3,0,2,176
26007000200,4191,3986,31,4,27,9,1,10,205
26007000300,3156,2964,37,10,6,5,3,2,192
26007000400,2925,2678,62,21,15,9,6,5,247
26007000500,1959,1756,49,9,10,5,0,15,203
26007000600,3271,3072,54,14,13,39,0,0,199
26007000700,2783,2613,36,11,3,18,0,16,170
26007000800,3203,2951,70,14,17,16,1,2,252
26007000900,2986,2821,25,13,12,8,1,7,165
26007990000,0,0,0,0,0,0,0,0,0
26009960100,2609,2404,80,3,12,6,2,0,205
26009960200,3306,3129,33,4,33,5,0,12,177
26009960300,2694,2495,50,2,26,9,1,6,199
26009960401,1133,1057,18,6,0,4,1,8,76
26009960402,2223,2068,42,5,16,10,0,6,155
26009960501,2055,1893,55,3,33,3,2,6,162
26009960502,1198,1137,17,2,10,1,2,1,61
26009960600,3228,3003,82,0,39,20,10,5,225
26009960701,3133,2888,43,9,19,8,0,7,245
26009960702,1852,1669,39,5,4,4,0,4,183
26009990000,0,0,0,0,0,0,0,0,0
26011970100,2153,2008,50,5,14,0,0,2,145
26011970200,3284,3088,47,5,15,8,0,16,196
26011970300,2726,2568,51,12,18,7,0,1,158
26011970400,2849,2646,49,4,19,8,0,4,203
26011970500,3990,3609,73,9,60,15,1,2,381
26011990000,0,0,0,0,0,0,0,0,0
26011990100,0,0,0,0,0,0,0,0,0
26013000100,4039,3254,31,3,412,12,3,7,785
26013000200,4119,2499,71,595,671,3,0,15,1620
26013990100,0,0,0,0,0,0,0,0,0
26015010100,5509,5046,168,17,22,16,0,19,463
26015010200,6102,5586,202,21,21,16,2,36,516
26015010301,3939,3457,203,42,14,25,1,15,482
26015010302,5392,4884,194,45,12,42,1,22,508
26015010401,3398,3051,161,17,17,11,0,0,347
26015010403,3089,2856,72,11,9,17,0,8,233
26015010404,2233,1962,92,38,16,6,2,3,271
26015010500,3334,2980,169,21,6,12,5,6,354
26015010601,3367,3061,95,5,19,10,0,8,306
26015010602,3204,2933,88,4,14,5,0,7,271
26015010700,4788,4455,118,14,19,9,0,24,333
26015010800,3405,3203,56,13,11,12,0,2,202
26015011301,4419,3951,191,12,24,31,0,11,468
26015011302,3745,3458,98,14,1,10,2,17,287
26015011401,2763,2480,115,10,8,3,2,12,283
26015011402,3736,3416,120,11,8,20,0,8,320
26017280300,1236,923,141,53,9,5,0,0,313
26017280400,2626,1957,297,133,16,13,0,5,669
26017280500,3296,2791,278,65,5,28,0,9,505
26017280600,2649,2065,294,81,21,6,0,15,584
26017280700,3142,2309,455,154,14,11,0,11,833
26017280800,3450,2873,293,59,13,17,0,22,577
26017280900,2748,2124,314,100,8,2,0,9,624
26017281000,3854,3177,327,70,27,25,0,14,677
26017281300,3068,2545,281,61,12,7,0,1,523
26017285100,3379,2998,178,44,2,27,0,0,381
26017285201,5812,5173,267,123,23,34,0,15,639
26017285202,3883,3479,158,46,17,20,0,6,404
26017285300,4576,4192,189,29,16,7,0,8,384
26017285400,3676,3302,145,59,13,66,0,4,374
26017285500,6764,6224,269,46,6,36,0,16,540
26017285600,7286,6657,207,40,21,33,0,25,629
26017285700,3923,3600,142,18,8,17,0,19,323
26017285800,6116,5497,268,80,9,61,0,6,619
26017285900,4792,4287,236,33,21,10,0,13,505
26017286000,3137,2864,114,15,5,16,0,8,273
26017286101,3706,3439,98,18,9,14,0,5,267
26017286102,3436,3162,90,4,18,18,0,14,274
26017286200,4687,4322,137,15,13,9,0,11,365
26017286300,3503,3166,121,23,23,5,0,8,337
26017286400,2523,2387,39,7,7,1,0,4,136
26017286500,1665,1215,194,113,0,19,0,3,450
26017286600,4923,4083,398,109,23,31,0,6,840
26017990000,0,0,0,0,0,0,0,0,0
26019000101,4796,4424,112,22,19,15,0,23,372
26019000102,3104,2837,66,10,38,17,0,9,267
26019000200,3160,2935,55,14,16,17,0,15,225
26019000300,1812,1681,35,6,17,11,0,5,131
26019000400,2119,1989,44,2,8,7,0,7,130
26019000500,2979,2731,79,2,66,4,0,6,248
26019990000,0,0,0,0,0,0,0,0,0
26021000300,1782,99,96,1534,2,2,1,6,1683
26021000400,1951,200,82,1561,9,8,2,9,1751
26021000500,1630,106,89,1366,6,0,2,10,1524
26021000600,3165,162,180,2697,6,0,0,18,3003
26021000700,2920,1702,103,890,12,37,1,10,1218
26021000801,2106,1766,64,69,0,95,0,13,340
26021000802,2778,2388,123,85,10,56,1,5,390
26021000900,2064,1595,124,94,5,152,3,2,469
26021001000,1827,1572,72,30,8,71,0,15,255
26021001100,4094,3469,172,121,7,141,0,23,625
26021001300,2076,1742,53,53,2,145,0,17,334
26021001400,4447,3688,210,149,15,200,0,12,759
26021001500,3214,2751,114,89,5,109,0,1,463
26021001600,2520,2241,83,45,0,54,3,8,279
26021001700,4748,3971,240,74,23,210,0,24,777
26021001800,5141,4203,228,132,13,305,2,21,938
26021001900,2128,1678,182,136,12,13,0,0,450
26021002000,3516,1004,150,2136,9,26,4,35,2512
26021002100,2605,795,290,1354,18,7,0,10,1810
26021002200,2544,192,171,2029,3,3,1,9,2352
26021002300,1931,570,421,827,14,8,0,0,1361
26021002400,1826,1432,114,175,6,3,0,2,394
26021002500,2378,1459,93,706,11,10,1,9,919
26021010100,3243,2757,143,108,19,23,2,20,486
26021010201,3995,3429,208,77,30,12,0,20,566
26021010202,2521,2205,93,32,14,13,0,4,316
26021010300,4705,3838,372,100,72,27,4,9,867
26021010400,2682,2292,202,25,12,11,0,6,390
26021010500,2177,1735,243,67,14,7,0,8,442
26021010600,4868,3698,503,240,22,137,2,26,1170
26021011000,2835,2519,146,11,8,13,1,9,316
26021011101,2396,2143,69,25,3,18,0,12,253
26021011102,3016,2653,111,47,9,52,1,5,363
26021011201,1509,1369,28,38,4,11,0,8,140
26021011202,1269,1188,13,3,8,3,0,4,81
26021011301,2055,1761,124,60,1,6,0,10,294
26021011302,2108,1877,119,13,7,19,3,11,231
26021011400,2324,2076,112,17,11,13,0,7,248
26021011500,1412,1319,19,8,10,5,0,6,93
26021011600,1832,1668,62,11,9,4,0,0,164
26021020100,2598,2350,35,28,12,10,0,7,248
26021020200,5138,4208,242,250,37,25,1,21,930
26021020300,2611,2354,53,20,29,11,0,17,257
26021020400,4197,3546,241,128,26,51,0,23,651
26021020500,3217,2067,304,536,30,16,0,6,1150
26021020600,3501,2849,169,194,11,22,3,18,652
26021020700,3119,2225,258,344,36,37,5,19,894
26021020900,3722,2931,212,252,28,46,0,18,791
26021021000,5105,3968,363,363,20,26,0,30,1137
26021021100,1931,1636,118,40,19,12,0,11,295
26021021200,1613,1401,67,32,6,8,2,0,212
26021021300,4891,1680,644,1418,14,732,51,47,3211
26021021400,4335,3076,483,360,23,134,13,27,1259
26021990000,0,0,0,0,0,0,0,0,0
26023950100,4027,3750,101,7,4,21,3,18,277
26023950200,3722,3329,95,27,28,13,0,1,393
26023950300,3741,3327,168,33,6,4,2,22,414
26023950800,4788,4506,112,23,3,15,3,40,282
26023950900,2102,1974,53,2,7,8,0,6,128
26023951000,2175,2066,34,7,4,21,0,1,109
26023951100,2997,2783,80,6,17,4,0,2,214
26023951200,4154,3322,624,11,23,25,0,7,832
26023951301,3248,2090,212,834,21,29,0,4,1158
26023951302,2255,2016,88,37,1,41,0,8,239
26023951400,4689,4067,329,55,6,40,0,7,622
26023951500,3247,2799,228,27,2,27,0,11,448
26023951600,3717,2996,459,55,10,18,2,8,721
26025000200,3930,2345,381,814,15,26,0,45,1585
26025000300,2025,495,146,1187,5,8,1,14,1530
26025000500,3366,1977,471,533,20,60,0,13,1389
26025000600,2824,1421,391,701,25,31,4,17,1403
26025000700,2955,1758,352,578,15,26,2,31,1197
26025000800,2948,2015,218,415,25,25,0,5,933
26025000900,3459,2435,181,599,18,36,0,20,1024
26025001000,4243,1632,263,1973,18,24,0,25,2611
26025001100,4294,2904,199,758,25,55,0,33,1390
26025001200,2445,1941,92,230,14,33,0,6,504
26025001300,4120,2844,249,335,20,364,0,5,1276
26025001400,4172,2868,245,313,33,416,3,36,1304
26025001500,5891,4189,246,209,21,968,0,19,1702
26025001600,2646,2052,155,114,7,147,0,15,594
26025001700,4574,3330,229,225,22,530,2,13,1244
26025001801,2175,1755,79,100,8,148,0,1,420
26025001802,3961,2444,250,791,28,142,0,10,1517
26025001900,4074,3570,156,78,23,43,0,11,504
26025002000,5029,4246,199,167,25,101,1,10,783
26025002100,1116,929,66,35,3,0,0,0,187
26025002200,3272,2953,87,50,10,15,0,6,319
26025002300,3712,3079,152,230,23,27,0,8,633
26025002400,2766,2311,133,145,12,12,0,11,455
26025002500,3425,2951,170,92,14,23,5,3,474
26025002600,2083,1290,117,357,11,161,2,23,793
26025002700,6440,5877,144,68,32,75,2,15,563
26025002800,4401,3980,102,32,96,7,1,20,421
26025002900,2981,2803,47,16,4,9,0,7,178
26025003000,2160,2031,35,8,3,1,2,5,129
26025003100,2896,2717,69,11,9,3,2,0,179
26025003200,2202,1932,72,88,10,2,0,10,270
26025003300,2123,1067,156,778,5,4,1,5,1056
26025003400,1992,1522,178,123,4,55,0,14,470
26025003500,2313,1531,219,365,9,35,0,12,782
26025003600,1973,762,132,919,7,0,0,16,1211
26025003700,4466,4164,100,28,15,8,0,8,302
26025003800,4194,3853,153,27,17,31,1,8,341
26025003900,4318,3877,183,41,17,37,0,9,441
26025004000,4115,3639,172,58,8,16,0,28,476
26025004100,2231,896,437,684,7,11,0,16,1335
26027001000,3750,3515,73,24,6,9,0,9,235
26027001100,2841,2505,115,28,20,24,0,12,336
26027001200,3319,3038,101,5,9,18,0,0,281
26027001500,3776,3244,176,138,20,11,0,12,532
26027001600,3748,2981,73,381,32,44,1,19,767
26027001701,2978,2688,80,36,14,4,1,13,290
26027001702,2121,1945,37,29,15,9,0,9,176
26027001801,3128,2827,97,41,4,48,0,7,301
26027001802,4618,4160,141,53,17,24,0,11,458
26027001901,2852,2184,252,163,49,8,5,5,668
26027001902,1778,1470,176,10,31,5,0,13,308
26027002000,4445,3590,224,163,77,13,1,18,855
26027002100,6086,4346,275,693,145,85,1,72,1740
26027002201,2630,1686,240,417,71,9,1,13,944
26027002202,3519,3130,101,91,11,5,1,5,389
26029000100,1743,1618,23,3,11,6,0,4,125
26029000200,1295,1203,17,0,17,8,1,5,92
26029000300,2297,2115,22,8,15,18,2,29,182
26029000400,2946,2672,31,8,72,15,0,19,274
26029000500,525,487,7,0,6,0,0,3,38
26029000800,2957,2713,69,17,42,17,2,5,244
26029000900,1796,1648,42,1,29,8,0,9,148
26029001000,2283,2090,42,6,40,3,0,2,193
26029001100,1781,1581,41,7,39,0,4,8,200
26029001200,3310,3055,58,8,54,15,0,15,255
26029001300,1440,1315,27,5,5,7,0,4,125
26029001400,1335,1215,20,0,14,14,0,3,120
26029001500,2346,2169,26,11,23,11,1,8,177
26029990000,0,0,0,0,0,0,0,0,0
26031960100,2890,2637,34,16,68,7,0,6,253
26031960200,2900,2383,54,25,151,11,0,10,517
26031960300,4160,3642,67,21,126,17,1,8,518
26031960401,2195,1997,20,4,47,10,0,5,198
26031960402,1247,1133,21,3,20,4,0,9,114
26031960500,2571,2325,28,10,64,6,0,7,246
26031960600,2516,2287,27,6,61,11,0,12,229
26031960700,3266,2972,49,1,76,8,0,1,294
26031960800,3834,3496,41,3,74,11,0,7,338
26031990000,0,0,0,0,0,0,0,0,0
26033970100,3000,2103,34,3,599,10,2,7,897
26033970200,3062,1795,61,23,794,16,0,10,1267
26033970300,3741,2790,98,73,446,44,1,13,951
26033970400,2437,1715,56,9,406,8,5,4,722
26033970500,4097,2770,110,24,705,49,0,10,1327
26033970601,2879,2142,31,7,408,24,0,5,737
26033970602,1883,752,28,5,911,1,0,0,1131
26033970700,1034,911,5,3,34,3,0,0,123
26033970800,5074,3608,133,721,313,7,0,23,1466
26033970900,3022,1635,86,222,697,17,2,3,1387
26033971000,2767,2353,41,0,182,9,0,8,414
26033971100,1469,1262,18,0,81,3,0,4,207
26033980100,0,0,0,0,0,0,0,0,0
26033980200,2320,708,56,1521,25,2,2,0,1612
26033980300,0,0,0,0,0,0,0,0,0
26033990000,0,0,0,0,0,0,0,0,0
26033990100,0,0,0,0,0,0,0,0,0
26035000100,1557,1448,23,7,13,1,0,2,109
26035000200,1390,1310,26,3,8,2,0,7,80
26035000300,2469,2256,57,9,17,3,0,6,213
26035000400,3783,3474,74,7,30,11,0,21,309
26035000500,1379,1301,22,3,5,1,0,0,78
26035000600,3966,3597,85,32,20,22,0,22,369
26035000700,3291,3101,64,11,17,2,0,7,190
26035000800,4299,4099,79,0,17,3,0,12,200
26035000900,2044,1858,55,9,13,3,0,6,186
26035001000,2736,2554,61,15,13,11,0,2,182
26035001301,2918,2688,51,42,23,9,0,0,230
26035001302,1024,942,24,2,5,4,0,3,82
26037010104,3848,2913,320,201,13,203,2,17,935
26037010105,3706,3247,174,58,4,49,1,20,459
26037010107,3857,3290,230,99,7,52,0,9,567
26037010108,4367,3799,227,61,14,67,3,21,568
26037010201,2091,1755,143,35,7,40,3,3,336
26037010203,1175,897,135,29,18,15,0,11,278
26037010204,2299,1954,151,37,6,23,2,6,345
26037010300,5563,4864,245,84,10,96,2,8,699
26037010400,5220,4808,188,36,13,30,1,7,412
26037010500,3549,3292,143,0,8,18,0,0,257
26037010600,2424,2258,76,7,0,1,0,7,166
26037010701,2143,1971,92,5,9,9,1,4,172
26037010702,2303,2060,125,5,4,6,0,17,243
26037010801,4099,3645,228,28,15,16,0,5,454
26037010802,3760,3356,162,24,17,27,2,12,404
26037010901,2758,2510,97,17,6,13,0,9,248
26037010902,4555,4188,153,18,14,30,0,2,367
26037011001,3669,3272,166,22,16,3,1,22,397
26037011002,3463,3188,98,8,14,10,0,9,275
26037011101,4173,3649,208,42,9,36,0,14,524
26037011105,2725,2168,169,82,11,135,4,11,557
26037011106,4228,3365,261,160,17,172,0,12,863
26037011200,3153,1466,149,582,2,819,1,15,1687
26039960100,1818,1708,27,5,13,3,2,0,110
26039960200,3277,2964,100,21,29,17,0,18,313
26039960300,3818,3525,95,22,20,19,0,6,293
26039960400,2055,1954,21,0,6,9,2,5,101
26039960500,2020,1875,49,9,15,7,0,0,145
26041970100,1630,1400,29,0,69,3,0,6,230
26041970200,2305,2098,28,2,61,1,0,5,207
26041970300,2314,2129,22,6,40,3,3,4,185
26041970400,5658,5224,40,8,96,30,1,19,434
26041970500,4401,4099,30,24,68,6,3,4,302
26041970600,4167,3763,78,3,60,11,0,14,404
26041970700,3770,3467,55,3,80,9,1,15,303
26041970800,4160,3735,59,19,107,32,0,4,425
26041970900,2486,2187,61,11,67,15,0,7,299
26041971000,2628,2308,84,6,69,17,0,4,320
26041971100,3384,3031,57,11,101,26,0,0,353
26041990000,0,0,0,0,0,0,0,0,0
26041990100,0,0,0,0,0,0,0,0,0
26043950100,1662,1595,15,0,5,3,0,1,67
26043950200,4229,3991,49,1,15,11,1,21,238
26043950300,4711,4444,66,7,32,14,1,1,267
26043950400,4252,3916,99,13,22,30,2,7,336
26043950500,3020,2756,71,4,13,34,0,1,264
26043950600,4369,4042,77,23,15,25,0,6,327
26043950700,3704,3454,63,13,15,30,0,6,250
26045020101,2844,2087,166,338,6,125,0,12,757
26045020102,3174,1914,289,672,5,110,0,9,1260
26045020103,4221,2697,412,665,27,164,3,16,1524
26045020104,3448,1956,449,618,8,150,0,9,1492
26045020201,2767,1546,217,617,12,229,0,8,1221
26045020202,4086,1520,444,1601,14,213,0,13,2566
26045020302,7106,5732,416,306,13,332,4,14,1374
26045020303,3577,2665,264,308,8,125,0,11,912
26045020305,1345,1095,93,67,3,31,0,5,250
26045020306,3587,2341,168,483,5,451,0,14,1246
26045020402,2861,2529,142,46,0,14,0,9,332
26045020403,2817,2415,203,29,7,15,1,12,402
26045020404,4401,3882,202,71,16,27,0,16,519
26045020500,3439,3123,132,13,9,11,1,11,316
26045020601,4104,3500,265,50,5,27,0,6,604
26045020602,3486,3236,103,17,10,20,0,15,250
26045020700,3997,3673,145,16,14,7,2,6,324
26045020800,4965,4576,150,27,23,17,0,26,389
26045020901,3373,2929,221,38,16,12,0,11,444
26045020902,4101,3619,227,45,10,16,0,15,482
26045021001,4471,3963,219,85,7,46,1,13,508
26045021002,4200,3815,172,29,4,36,0,10,385
26045021100,5277,4635,184,193,29,17,0,8,642
26045021201,3082,2778,119,39,4,9,0,11,304
26045021202,3313,2998,117,35,12,21,0,1,315
26045021301,3011,2650,156,21,5,17,0,8,361
26045021302,3015,2641,168,29,7,11,0,15,374
26045021401,4435,2659,472,882,18,100,0,25,1776
26045021402,4672,4026,212,123,10,91,1,17,646
26047970100,2168,1877,23,20,121,7,1,8,291
26047970201,2390,2064,26,9,109,10,4,7,326
26047970202,2997,2670,44,16,92,5,0,2,327
26047970301,2917,2646,37,4,94,11,1,3,271
26047970302,1583,1466,31,3,35,0,0,8,117
26047970400,2995,2727,56,17,79,18,2,11,268
26047970500,4936,4345,76,9,162,11,3,21,591
26047970600,6084,5516,106,16,102,53,6,22,568
26047970700,3660,3207,83,31,117,24,2,10,453
26047970800,4382,3841,110,34,163,34,3,5,541
26047990000,0,0,0,0,0,0,0,0,0
26049000100,2122,61,30,1954,4,0,0,11,2061
26049000200,1200,36,27,1072,4,0,1,7,1164
26049000300,2231,61,37,2042,3,2,0,17,2170
26049000400,1199,46,51,1050,3,1,0,19,1153
26049000500,1613,49,42,1450,1,0,2,2,1564
26049000600,1543,37,39,1373,5,4,0,5,1506
26049000700,1972,66,24,1780,0,2,0,0,1906
26049000800,672,16,18,613,0,2,0,1,656
26049000900,2385,180,45,2047,5,8,2,12,2205
26049001000,1459,63,20,1316,4,3,0,9,1396
26049001100,1510,46,48,1324,13,0,0,1,1464
26049001200,2615,188,42,2244,1,1,0,10,2427
26049001300,2353,289,61,1871,4,5,0,18,2064
26049001400,1178,237,55,799,4,5,0,15,941
26049001500,859,264,34,493,4,14,0,6,595
26049001600,4066,1491,194,2031,18,47,0,42,2575
26049001700,1310,75,21,1155,1,0,0,6,1235
26049001800,1649,287,38,1265,6,5,0,2,1362
26049001900,2126,937,162,871,15,8,3,10,1189
26049002000,633,48,17,532,0,2,2,1,585
26049002200,1317,770,219,215,3,6,0,5,547
26049002300,1401,829,195,230,13,4,1,8,572
26049002400,2549,1613,168,577,9,9,1,9,936
26049002600,2249,1398,254,364,13,11,4,21,851
26049002700,3142,2105,304,495,11,19,0,8,1037
26049002800,2381,1114,149,941,6,43,6,13,1267
26049002900,1757,551,76,987,4,31,0,15,1206
26049003000,3500,1803,252,1148,3,34,0,5,1697
26049003100,2095,134,42,1830,6,0,2,2,1961
26049003200,1868,137,34,1565,19,8,0,3,1731
26049003300,1845,488,71,1173,0,16,0,13,1357
26049003400,1881,265,34,1445,13,0,0,3,1616
26049003500,3039,1784,196,796,27,15,1,16,1255
26049003600,4953,2893,242,1394,24,39,0,42,2060
26049003700,2125,1148,158,615,15,17,0,15,977
26049003800,968,544,73,274,3,2,0,4,424
26049004000,3203,1947,201,764,15,12,0,21,1256
26049010110,2525,2176,127,55,10,13,0,1,349
26049010111,1372,1250,33,21,0,3,0,3,122
26049010112,2495,2190,109,40,17,6,0,2,305
26049010116,2855,2547,112,53,10,13,0,3,308
26049010117,3177,2729,128,108,20,5,0,1,448
26049010201,1756,1647,28,21,3,10,2,0,109
26049010202,1646,1523,23,36,3,3,0,0,123
26049010304,3125,805,138,1956,18,5,1,28,2320
26049010305,4451,847,167,3218,20,4,1,5,3604
26049010501,2398,1317,162,739,24,0,0,14,1081
26049010502,3644,2288,164,981,14,20,0,8,1356
26049010503,2223,1942,74,105,0,3,1,3,281
26049010504,4183,2527,164,1231,13,15,5,13,1656
26049010603,5600,4871,237,226,28,38,0,12,729
26049010604,2811,2469,86,72,4,42,0,0,342
26049010610,5536,4761,233,222,17,36,0,22,775
26049010700,5165,4557,138,150,28,69,5,14,608
26049010810,5269,2850,120,1801,8,262,0,43,2419
26049010811,2375,722,73,1438,5,19,0,14,1653
26049010812,3452,1646,122,1402,11,4,0,21,1806
26049010813,4496,2974,171,980,9,79,6,17,1522
26049010910,2957,2128,148,437,19,18,1,11,829
26049010911,4183,1136,100,2675,21,30,1,2,3047
26049010912,3155,2351,113,444,12,35,0,5,804
26049011010,5565,4298,279,549,16,31,2,20,1267
26049011102,6016,4681,196,578,12,259,3,26,1335
26049011103,4476,3513,110,419,9,244,0,8,963
26049011104,5775,4356,251,571,17,234,5,8,1419
26049011209,6375,4919,278,685,19,192,0,26,1456
26049011210,1929,1377,85,342,2,28,0,2,552
26049011211,5776,3928,273,1176,12,106,0,28,1848
26049011212,5741,4323,268,698,22,89,0,16,1418
26049011213,5742,4453,265,565,10,101,4,16,1289
26049011214,6107,4299,263,731,11,460,0,25,1808
26049011301,5014,3375,282,998,26,18,0,12,1639
26049011302,3344,2847,173,95,17,15,0,14,497
26049011401,3476,2396,197,630,23,16,0,8,1080
26049011402,4234,3396,189,332,18,78,0,29,838
26049011502,3221,2750,146,119,10,11,0,11,471
26049011503,5044,4266,245,197,15,22,0,10,778
26049011505,2492,1968,125,227,9,9,0,2,524
26049011508,2890,2329,116,285,6,1,0,10,561
26049011601,3086,2775,98,29,16,17,0,0,311
26049011611,2635,1995,104,330,4,23,6,13,640
26049011612,4470,3995,154,45,7,40,2,1,475
26049011710,2447,2146,111,24,4,17,1,6,301
26049011711,2696,2351,125,71,11,10,4,6,345
26049011712,3296,2905,125,60,16,14,1,9,391
26049011713,3589,2860,160,337,11,34,3,8,729
26049011714,3358,2991,122,37,15,27,0,8,367
26049011800,3096,2756,140,28,15,3,0,9,340
26049011901,2517,2172,103,92,12,6,1,8,345
26049011902,3378,2922,131,46,11,14,0,12,456
26049012003,2964,2376,171,153,23,12,3,15,588
26049012006,2580,2252,121,77,9,6,1,7,328
26049012007,1601,1389,75,32,3,4,0,8,212
26049012008,2970,2631,114,81,9,13,0,7,339
26049012009,2414,2189,72,13,9,7,0,7,225
26049012100,2566,2090,142,172,9,1,0,14,476
26049012201,2343,1931,98,173,13,13,0,6,412
26049012202,1216,338,58,737,12,1,0,6,878
26049012310,3170,2199,171,547,16,21,0,6,971
26049012311,1927,1368,89,349,12,5,0,7,559
26049012401,1795,1629,42,22,6,4,0,7,166
26049012402,2652,2422,67,7,8,8,0,6,230
26049012501,1930,1728,55,28,5,10,0,0,202
26049012503,2642,2226,106,156,14,5,0,3,416
26049012504,2068,1855,60,38,5,3,0,8,213
26049012601,3014,2660,111,49,16,6,0,0,354
26049012602,1743,1502,74,30,12,5,1,5,241
26049012603,2991,2690,87,52,9,1,1,8,301
26049012702,5898,4914,180,407,3,43,7,25,984
26049012703,3172,2899,64,44,2,3,0,14,273
26049012704,4287,3523,141,363,18,33,3,19,764
26049012801,4639,4196,139,37,12,12,0,7,443
26049012802,2025,1840,48,22,5,1,1,5,185
26049012904,6330,5376,200,396,17,48,9,18,954
26049012905,3737,2847,141,461,9,74,0,13,890
26049012906,2763,2233,127,188,6,81,0,6,530
26049012907,2465,2256,44,36,12,7,0,8,209
26049013001,2603,2406,49,6,16,16,2,3,197
26049013002,4488,4087,116,10,6,12,0,20,401
26049013110,2284,2092,59,22,5,5,0,7,192
26049013111,3221,2941,74,19,14,24,0,13,280
26049013112,4839,4409,145,38,21,48,1,12,430
26049013113,4142,3783,113,35,5,20,0,1,359
26049013202,5969,5263,239,113,11,46,2,24,706
26049013205,2677,2354,101,48,0,62,0,4,323
26049013206,3368,3090,98,22,13,12,0,10,278
26049013302,3654,3332,119,26,10,17,1,3,322
26049013303,2845,2622,56,10,6,35,3,9,223
26049013401,6330,5745,194,42,16,64,0,24,585
26049013402,2022,1839,60,25,3,0,1,8,183
26049013500,4889,2233,231,2082,20,22,0,11,2656
26049013600,1357,125,48,1106,2,4,0,16,1232
26049980000,19,8,3,4,0,1,0,0,11
26049980100,0,0,0,0,0,0,0,0,0
26051000101,1750,1662,18,0,6,3,0,4,88
26051000102,1363,1302,22,2,2,3,0,0,61
26051000200,1286,1219,21,4,2,1,0,0,67
26051000300,1847,1740,29,3,11,4,0,4,107
26051000400,3156,3002,40,3,16,5,0,2,154
26051000500,3642,3459,71,4,6,7,0,3,183
26051000600,1894,1764,42,3,11,6,0,13,130
26051000700,4703,4318,111,28,8,31,0,10,385
26051000800,3928,3651,104,20,20,6,0,4,277
26051000900,1817,1713,24,1,13,6,0,5,104
26053950200,2312,2191,26,4,9,6,0,2,121
26053950300,2313,2142,36,5,19,5,0,4,171
26053950500,2272,2070,49,14,30,6,0,2,202
26053950600,2772,2519,54,30,33,14,0,10,253
26053950700,2253,2134,27,11,15,1,2,3,119
26053950800,2458,1925,30,1,406,3,1,15,533
26053990000,0,0,0,0,0,0,0,0,0
26055550101,6082,5550,143,28,36,48,2,27,532
26055550102,2987,2701,76,19,49,21,0,11,286
26055550200,4332,4023,85,11,50,20,0,1,309
26055550300,6453,5965,124,28,37,23,1,11,488
26055550401,2633,2261,165,36,20,14,0,6,372
26055550402,4987,4576,122,12,30,18,0,17,411
26055550500,5900,5156,226,31,94,51,4,23,744
26055550601,2588,2347,61,20,26,15,5,14,241
26055550602,5693,5119,132,18,41,60,7,27,574
26055550603,2307,2092,55,4,28,5,0,2,215
26055550701,5412,4863,153,22,41,75,2,6,549
26055550702,5344,4637,252,52,66,79,4,5,707
26055550801,2154,1991,57,6,7,21,0,9,163
26055550802,4280,3948,112,8,8,22,1,17,332
26055550900,5323,4868,183,10,20,45,3,20,455
26055551000,4520,4047,147,62,36,44,3,8,473
26055551100,3849,3454,123,22,44,45,0,11,395
26055551200,3563,3161,104,37,62,21,1,16,402
26055551301,1540,1298,64,22,20,10,0,7,242
26055551302,4087,3425,266,47,72,80,4,7,662
26055551303,2896,2453,149,51,50,21,0,7,443
26055551400,5061,4632,117,19,31,38,4,26,429
26055551500,3247,2976,94,18,10,37,0,11,271
26055990000,0,0,0,0,0,0,0,0,0
26057000100,3957,3634,172,10,11,0,0,11,323
26057000200,4970,4530,241,42,13,10,0,19,440
26057000300,5058,4200,447,179,18,14,0,22,858
26057000400,3205,1382,151,1626,32,11,1,0,1823
26057000500,5792,4543,736,202,11,71,17,9,1249
26057000600,4173,3291,548,98,28,35,7,15,882
26057000700,3128,2840,179,16,2,1,0,0,288
26057000800,4204,3840,233,5,13,4,3,3,364
26057000900,3396,3124,169,7,16,5,0,8,272
26057001000,3878,3428,277,10,12,10,0,9,450
26059050101,2070,1885,79,3,2,21,0,0,185
26059050102,2439,2221,82,15,8,7,0,6,218
26059050200,3016,2784,87,8,16,0,0,1,232
26059050300,2423,2255,69,2,7,22,0,2,168
26059050400,4533,4238,101,25,8,4,1,4,295
26059050500,4361,3983,124,14,23,22,0,15,378
26059050600,3677,3415,92,24,7,15,0,5,262
26059050700,4849,4386,136,39,13,39,2,29,463
26059050800,2131,1927,75,13,3,7,1,4,204
26059050900,4928,4563,77,14,18,20,0,36,365
26059051000,4186,3833,105,17,17,12,2,12,353
26059051100,3644,3375,96,16,15,1,0,14,269
26059051200,3489,3280,49,6,6,6,0,9,209
26061000100,2721,2599,23,5,6,5,0,0,122
26061000200,2928,2769,41,8,16,3,0,7,159
26061000300,2213,2069,20,5,14,9,2,5,144
26061000400,3273,3058,37,9,6,10,1,32,215
26061000500,4005,3789,60,0,17,24,3,13,216
26061000600,3713,3263,96,67,29,69,4,9,450
26061000700,3129,2973,41,9,19,3,0,8,156
26061000800,7151,5843,255,139,31,504,2,34,1308
26061000900,4901,4362,78,24,9,207,7,30,539
26061001000,3327,3129,18,14,12,21,2,13,198
26061990000,0,0,0,0,0,0,0,0,0
26061990100,0,0,0,0,0,0,0,0,0
26063950100,1358,1228,93,7,0,2,1,1,130
26063950200,2057,1966,55,0,0,1,0,1,91
26063950300,2208,2111,18,3,0,7,0,1,97
26063950400,895,856,4,0,5,2,0,3,39
26063950500,2088,1979,44,6,8,3,0,2,109
26063950600,2571,2369,118,6,1,11,0,7,202
26063950700,3442,3242,103,10,5,7,0,14,200
26063950800,3417,3202,99,3,10,9,0,2,215
26063950900,3629,3463,77,5,2,7,1,3,166
26063951000,3799,3501,125,31,14,46,0,7,298
26063951100,2185,2053,52,6,11,11,0,1,132
26063951200,3758,3538,52,0,21,44,3,0,220
26063990000,0,0,0,0,0,0,0,0,0
26065000100,1804,1100,383,129,10,23,0,29,704
26065000400,2762,1592,342,550,2,61,0,17,1170
26065000600,1605,880,172,331,12,55,0,14,725
26065000700,2464,1254,321,610,14,73,0,25,1210
26065000800,2814,1196,764,518,27,44,0,53,1618
26065001000,2047,1499,185,171,12,57,1,7,548
26065001200,1958,1011,335,374,17,42,1,12,947
26065001703,4251,2140,432,1159,10,221,4,28,2111
26065002000,3063,1389,507,740,25,36,0,29,1674
26065002101,1863,830,336,491,20,27,0,33,1033
26065002200,1494,1143,150,84,6,15,0,1,351
26065002300,3405,2293,454,355,13,33,1,24,1112
26065002600,1953,1162,260,316,4,34,0,24,791
26065002700,3049,1733,537,463,14,72,2,11,1316
26065002800,2430,1652,365,234,11,16,0,5,778
26065002901,2872,1686,315,550,10,92,0,16,1186
26065002902,3805,1883,377,701,8,578,2,31,1922
26065003103,5933,4119,529,635,18,221,6,46,1814
26065003200,2055,1116,372,373,19,22,0,7,939
26065003301,3006,1562,428,682,15,102,1,25,1444
26065003302,2231,1479,217,317,3,99,0,3,752
26065003400,2402,1567,298,314,1,33,0,9,835
26065003500,2862,1706,524,384,10,60,0,14,1156
26065003601,3840,1143,503,1558,14,349,0,19,2697
26065003602,3410,1177,533,1167,10,266,1,20,2233
26065003700,5149,2335,832,1427,24,110,3,36,2814
26065003801,4079,2646,247,526,6,349,1,44,1433
26065003802,4152,2570,314,401,9,659,0,31,1582
26065003901,2101,1626,130,142,6,107,0,5,475
26065003902,4126,3100,229,424,7,155,0,22,1026
26065004000,4560,3607,273,145,10,292,1,38,953
26065004100,4566,3849,176,114,9,263,5,1,717
26065004301,4505,3503,257,215,14,279,4,6,1002
26065004302,2708,1878,144,108,2,451,0,0,830
26065004402,325,54,22,50,0,185,1,1,271
26065004403,2364,1493,123,220,0,435,13,10,871
26065004490,3914,2932,122,604,31,194,0,5,982
26065004491,1210,772,49,307,13,50,0,0,438
26065004492,3415,2177,157,905,15,102,0,19,1238
26065004493,1617,881,113,485,0,106,5,5,736
26065004494,3357,1950,148,841,0,349,13,0,1407
26065004500,3781,2340,335,384,13,438,0,19,1441
26065004600,4337,3398,197,200,4,296,0,22,939
26065004700,2864,2415,161,72,12,94,0,13,449
26065004801,4345,3288,327,205,5,278,0,28,1057
26065004802,3236,2705,158,93,6,102,1,13,531
26065004902,5321,3369,276,303,5,1071,1,24,1952
26065004903,2616,1245,118,110,14,1044,0,8,1371
26065004904,4648,3457,205,263,12,412,0,17,1191
26065005002,4103,3099,181,133,8,496,0,9,1004
26065005003,4217,2239,179,219,1,1350,1,12,1978
26065005004,3899,2250,154,197,2,1091,0,35,1649
26065005100,3288,1296,550,1003,5,157,0,17,1992
26065005201,5617,2352,778,1721,14,275,2,29,3265
26065005202,3720,2642,265,359,9,157,4,27,1078
26065005303,4673,2579,580,980,18,235,0,33,2094
26065005304,3148,1266,342,985,13,337,1,10,1882
26065005305,3564,2617,208,333,11,195,0,15,947
26065005306,3826,2416,341,633,20,130,1,9,1410
26065005401,3596,2775,233,276,9,31,0,20,821
26065005402,3421,2632,238,281,16,60,2,19,789
26065005501,5974,4736,379,238,23,233,2,19,1238
26065005502,6473,4973,403,517,12,221,1,28,1500
26065005600,2912,2541,170,31,6,30,0,7,371
26065005700,5120,4624,173,37,19,52,0,25,496
26065005800,5650,5040,213,46,12,52,0,36,610
26065005900,5600,5143,134,12,30,26,1,7,457
26065006001,3539,3207,135,17,7,3,0,16,332
26065006002,3533,3179,128,6,15,15,3,9,354
26065006100,4232,3806,185,21,13,17,0,16,426
26065006200,5390,4847,185,35,18,17,6,21,543
26065006301,4738,4062,244,167,7,42,1,14,676
26065006302,4159,3682,158,67,7,67,0,13,477
26065006401,4354,3824,236,48,5,63,1,1,530
26065006402,2997,2711,147,32,8,9,2,8,286
26065006500,3457,2195,446,445,15,100,1,18,1262
26065006600,2864,1527,454,545,21,83,0,23,1337
26065006700,3819,1447,490,1421,29,180,0,20,2372
26065006800,3720,1592,727,962,24,89,5,34,2128
26065007000,5725,3771,571,752,34,93,5,31,1954
26065980000,859,559,36,177,0,62,4,0,300
26065980100,19,10,3,0,0,4,0,0,9
26065980200,15,7,3,0,0,0,0,1,8
26065980300,5,3,1,0,0,0,0,0,2
26067030101,2726,2491,115,7,4,6,0,6,235
26067030102,3839,3533,157,14,13,9,0,6,306
26067030200,2847,2555,124,29,19,5,1,1,292
26067030300,3091,2692,229,13,10,9,0,16,399
26067030401,3647,3346,189,2,14,15,0,0,301
26067030402,3015,2767,118,14,14,9,0,3,248
26067031200,5042,4550,286,26,11,20,0,15,492
26067031301,5159,4729,166,24,19,28,0,11,430
26067031302,3261,2987,138,9,9,16,0,12,274
26067031400,5238,4815,149,20,16,17,0,19,423
26067031500,5392,5015,140,27,16,17,0,9,377
26067031600,5360,4722,335,41,14,28,0,6,638
26067031700,3701,3083,412,39,8,11,1,6,618
26067031900,6002,5488,265,25,14,19,1,4,514
26067032100,2951,1978,136,743,19,10,1,7,973
26067982200,5533,2866,405,2177,46,10,1,0,2667
26069000101,1345,1242,27,7,9,2,0,1,103
26069000102,1338,1146,95,27,5,6,0,2,192
26069000201,2618,2447,38,7,5,19,0,0,171
26069000202,1394,1295,36,7,3,9,0,2,99
26069000300,2691,2474,79,17,16,6,0,5,217
26069000400,3438,3077,113,46,11,35,3,22,361
26069000500,3518,3190,99,18,16,47,0,12,328
26069000600,2819,2639,39,16,21,20,0,5,180
26069000700,2736,2576,44,12,19,2,0,2,160
26069000800,1443,1376,10,5,9,0,0,5,67
26069000900,1897,1782,30,2,10,7,0,0,115
26069990000,0,0,0,0,0,0,0,0,0
26071000100,2357,2215,36,3,10,11,0,10,142
26071000200,1707,1591,27,1,16,3,0,8,116
26071000300,2643,2460,50,3,22,4,0,0,183
26071000400,2534,2299,56,15,35,16,0,8,235
26071000500,2390,2258,37,2,10,7,0,8,132
26073000100,3493,3235,80,8,37,9,0,6,258
26073000200,4984,4525,138,20,53,24,0,9,459
26073000300,4920,4562,121,27,31,10,0,4,358
26073000401,2168,1337,132,436,17,107,0,6,831
26073000402,2380,1995,93,69,31,104,0,12,385
26073000500,3211,2584,178,152,52,104,1,8,627
26073000600,4141,3122,244,187,103,263,1,9,1019
26073000701,2158,1498,190,172,46,61,0,19,660
26073000702,1957,1382,120,220,47,100,2,0,575
26073000703,2524,1978,128,265,8,34,1,11,546
26073000800,2627,2036,169,176,47,60,1,9,591
26073000900,4094,3619,217,18,85,13,0,11,475
26073940100,4321,3799,140,16,166,12,3,6,522
26073940200,5446,4150,280,25,657,17,1,24,1296
26073940300,5045,4001,262,69,329,96,4,20,1044
26073940400,3306,2617,223,105,100,29,1,7,689
26073940500,2406,1896,167,53,110,7,0,13,510
26073940600,5213,4634,124,58,106,66,2,8,579
26075000100,2750,2050,177,287,8,25,3,8,700
26075000200,2628,1664,168,529,12,10,1,2,964
26075000400,3948,2961,325,308,6,30,2,15,987
26075000500,1538,1116,98,185,0,28,0,7,422
26075000600,1234,771,50,312,3,22,0,9,463
26075000800,4396,3495,228,302,9,81,1,25,901
26075000900,3225,2238,161,517,12,55,0,17,987
26075001000,2095,933,182,680,11,18,0,8,1162
26075001100,1860,496,161,958,4,2,0,9,1364
26075001200,2339,1527,171,448,7,9,0,10,812
26075001300,2456,1017,139,1061,13,20,0,2,1439
26075005000,2332,1724,145,248,6,12,1,1,608
26075005100,4556,4028,150,94,4,26,1,7,528
26075005201,3285,2634,110,317,10,86,4,11,651
26075005202,3537,3119,97,71,7,86,2,17,418
26075005301,5231,3924,246,571,12,137,0,32,1307
26075005302,3602,3144,88,172,14,67,1,9,458
26075005400,6959,6194,292,123,19,60,3,8,765
26075005501,2601,2034,91,247,8,75,0,4,567
26075005502,2745,2068,150,284,4,21,0,9,677
26075005601,5241,4039,250,407,9,161,0,20,1202
26075005602,3236,2862,115,60,3,31,0,16,374
26075005700,3148,2598,125,137,6,98,1,6,550
26075005800,6133,3036,180,2811,87,17,2,0,3097
26075005900,2942,2405,97,233,11,9,0,14,537
26075006001,3607,3117,123,81,9,17,0,13,490
26075006002,3348,3045,78,42,11,8,0,8,303
26075006101,3133,2784,86,53,8,6,0,20,349
26075006102,3242,2893,107,37,15,15,0,4,349
26075006201,3229,2891,131,33,4,9,0,8,338
26075006202,3566,3288,84,19,6,17,0,2,278
26075006301,3059,2811,72,11,7,8,3,13,248
26075006304,2785,2593,74,6,7,10,0,1,192
26075006305,2356,2144,66,20,9,18,3,0,212
26075006306,2251,2071,39,14,4,11,0,12,180
26075006401,3038,2793,67,22,10,12,0,9,245
26075006403,3537,3238,98,27,5,5,0,11,299
26075006404,3296,3113,78,13,3,6,0,3,183
26075006500,6595,5885,186,140,23,41,0,5,710
26075006600,4760,4387,122,34,33,8,0,10,373
26075006701,5207,4747,162,57,17,18,0,24,460
26075006702,4700,4337,101,24,11,8,0,15,363
26075006801,3159,2905,84,16,11,10,0,15,254
26075006803,2656,2471,32,17,12,6,0,6,185
26075006804,5985,5496,139,37,18,25,2,10,489
26075006900,2840,2011,259,320,7,31,0,18,829
26077000100,2532,608,233,1425,10,19,0,21,1924
26077000201,2013,1357,120,303,12,76,0,14,656
26077000202,1094,192,90,714,1,5,0,6,902
26077000300,3952,385,212,3087,11,7,0,21,3567
26077000500,4494,2564,437,1039,11,141,2,37,1930
26077000601,4493,3061,307,627,27,95,1,39,1432
26077000900,1121,438,230,334,14,5,1,4,683
26077001001,2258,985,496,531,8,9,0,7,1273
26077001002,4178,1343,1039,1375,25,18,5,38,2835
26077001100,2224,1118,430,489,9,13,0,2,1106
26077001200,2967,2485,152,125,7,46,0,16,482
26077001300,1926,1404,61,283,10,22,3,22,522
26077001501,4513,3362,241,578,5,57,0,23,1151
26077001502,4995,3395,263,746,10,307,0,15,1600
26077001503,4626,3471,229,503,24,94,0,21,1155
26077001504,4872,3260,420,744,10,228,6,176,1612
26077001508,3291,2233,196,524,10,148,3,16,1058
26077001509,4164,2968,236,518,3,182,1,9,1196
26077001510,3452,2222,210,552,16,201,0,7,1230
26077001511,1977,710,187,850,6,18,0,35,1267
26077001601,2764,2171,70,265,0,62,0,3,593
26077001603,1643,1304,83,124,3,24,0,13,339
26077001604,1707,1370,65,134,0,43,1,17,337
26077001701,3437,2434,269,414,10,73,0,11,1003
26077001702,3779,2406,279,726,17,64,0,16,1373
26077001801,3269,2354,315,339,8,24,2,14,915
26077001802,4486,2995,374,682,5,54,1,28,1491
26077001803,2149,1356,220,350,14,6,2,6,793
26077001905,5447,4249,317,395,32,106,8,24,1198
26077001906,4673,3527,266,305,16,284,0,33,1146
26077001907,4200,3268,201,284,7,158,1,21,932
26077002002,4320,3709,163,82,20,174,0,14,611
26077002003,6513,4782,293,377,15,646,1,37,1731
26077002004,4214,3373,168,153,5,350,0,5,841
26077002005,4166,3029,185,496,10,186,0,27,1137
26077002102,3093,2693,148,31,9,58,0,4,400
26077002103,2263,1991,73,40,12,69,0,0,272
26077002104,5565,4996,180,93,10,82,0,26,569
26077002201,2115,1701,132,83,18,3,0,16,414
26077002203,3623,2871,184,229,16,99,0,21,752
26077002204,4277,3003,207,564,11,153,2,21,1274
26077002601,4832,4409,129,33,7,37,2,11,423
26077002701,3155,2848,80,33,15,32,0,15,307
26077002702,5557,4549,221,343,14,114,0,19,1008
26077002801,4404,4038,111,47,12,25,0,14,366
26077002802,6014,5016,219,375,14,49,0,29,998
26077002901,3805,3514,69,34,15,22,0,8,291
26077002906,1848,1322,62,325,4,55,1,5,526
26077002907,3767,1777,266,1270,4,187,0,17,1990
26077002908,4505,3730,142,270,1,139,0,20,775
26077002909,5338,3983,373,444,15,245,2,24,1355
26077002910,4268,3241,204,465,9,69,0,19,1027
26077002911,4027,2676,203,757,16,97,0,24,1351
26077003002,2369,2203,36,18,7,8,3,0,166
26077003005,5697,4903,150,183,20,132,1,34,794
26077003006,3596,3190,130,46,1,70,0,20,406
26077003007,6489,4831,290,224,27,778,1,23,1658
26077003008,1909,1626,58,29,0,96,0,2,283
26077003302,6387,5450,307,138,27,37,1,16,937
26077003400,3705,3392,148,22,11,5,0,20,313
26077003500,4437,3565,211,211,15,125,0,33,872
26077005501,4038,2502,255,887,10,29,0,22,1536
26077005502,5881,3213,487,1657,22,38,1,19,2668
26077006102,3801,3483,93,21,15,20,2,10,318
26077006103,5382,4746,182,103,13,50,3,16,636
26077006601,4445,4054,76,24,24,30,0,13,391
26077006701,2743,2438,87,34,10,4,0,25,305
26077006702,6426,5586,206,180,24,81,0,23,840
26079950201,2272,2072,59,5,20,0,0,9,200
26079950202,2818,2561,47,0,37,18,0,2,257
26079950300,4923,4500,113,14,24,20,0,17,423
26079950400,3984,3683,75,16,28,9,0,25,301
26079950601,2131,1987,37,5,12,7,0,6,144
26079950602,1811,1720,24,0,18,6,0,0,91
26081000100,2365,1882,148,153,4,39,0,0,483
26081000200,1640,1377,92,69,8,13,0,3,263
26081000300,5297,4249,268,220,15,322,2,20,1048
26081000400,3136,2625,196,106,15,37,0,15,511
26081000500,3971,3508,189,92,7,21,2,6,463
26081000600,4660,4066,278,58,10,61,6,21,594
26081000700,3164,2348,423,125,19,39,3,5,816
26081000800,3172,1573,834,510,27,23,1,15,1599
26081000900,3044,2092,384,339,10,14,0,20,952
26081001000,4478,2890,404,778,16,78,0,32,1588
26081001102,4352,2831,220,1029,8,64,2,14,1521
26081001103,3786,2125,268,1045,10,121,0,15,1661
26081001104,1899,1003,161,636,8,29,2,0,896
26081001200,3272,2371,305,327,13,69,1,7,901
26081001300,3601,1800,472,1004,23,26,2,9,1801
26081001400,2648,1837,246,353,10,76,5,5,811
26081001500,3751,1635,1195,657,17,33,2,33,2116
26081001600,5905,3419,1450,586,36,27,1,41,2486
26081001700,4434,3747,261,140,24,54,0,4,687
26081001801,4770,4058,295,113,10,63,2,14,712
26081001802,1609,1463,52,15,0,22,0,0,146
26081001900,5682,3522,1085,607,28,95,1,26,2160
26081002000,3211,2073,295,562,7,84,9,14,1138
26081002100,3076,2159,258,370,14,95,2,22,917
26081002200,5368,3762,610,577,20,79,8,27,1606
26081002300,4106,3502,201,181,14,47,1,23,604
26081002400,2940,2426,163,157,10,68,0,23,514
26081002500,4843,3550,459,489,15,75,0,26,1293
26081002600,4047,665,2572,664,10,30,0,11,3382
26081002700,3999,2462,747,456,35,40,0,25,1537
26081002800,2018,346,668,879,6,18,0,12,1672
26081002900,1526,924,176,355,0,17,0,4,602
26081003000,1725,822,214,570,8,11,1,11,903
26081003100,3579,463,774,2104,7,27,1,22,3116
26081003200,5180,1057,633,3176,28,16,0,24,4123
26081003300,3647,2460,180,725,4,47,0,11,1187
26081003400,5126,3610,340,759,6,125,0,24,1516
26081003500,5489,1786,663,2586,11,74,1,25,3703
26081003600,2360,269,761,1214,7,2,4,12,2091
26081003700,4486,889,1443,1830,15,42,0,31,3597
26081003800,4785,483,3520,589,25,22,1,16,4302
26081003900,3376,319,2488,409,11,27,0,30,3057
26081004000,3711,413,2860,342,5,11,2,9,3298
26081004100,4963,2945,762,902,9,74,0,20,2018
26081004200,3877,2522,321,739,4,61,0,29,1355
26081004300,3888,2789,240,611,6,78,2,21,1099
26081004400,7491,5775,338,753,14,323,2,45,1716
26081004501,3733,1979,318,1013,4,225,1,27,1754
26081004502,4338,2469,349,1084,6,241,0,18,1869
26081004600,6098,1958,732,2266,31,800,4,22,4140
26081010101,6027,5472,178,34,21,23,0,24,555
26081010102,2516,2351,54,9,8,8,1,0,165
26081010200,4334,3698,237,63,16,31,2,13,636
26081010301,5401,4530,664,18,12,14,0,14,871
26081010302,5924,5382,198,49,29,25,0,21,542
26081010401,5309,4568,494,17,9,14,0,24,741
26081010402,4086,3543,292,35,17,15,0,4,543
26081010601,4622,4217,154,15,17,24,3,18,405
26081010602,8312,7474,284,40,11,127,0,20,838
26081010700,5268,4705,218,30,18,41,1,11,563
26081010802,6123,5564,204,31,10,41,4,20,559
26081010803,6361,5821,191,36,5,51,2,6,540
26081010804,2623,2363,112,4,2,15,1,8,260
26081010902,3846,3514,99,18,5,20,0,15,332
26081010903,7155,6509,211,57,8,67,3,32,646
26081010904,7187,6530,198,60,12,64,1,26,657
26081011001,4112,3760,134,11,9,59,2,9,352
26081011002,4565,4105,164,34,8,55,0,9,460
26081011101,4492,4050,185,62,8,25,0,7,442
26081011102,5276,4707,194,56,9,77,0,23,569
26081011200,4113,3448,232,111,5,89,0,7,665
26081011301,4658,3959,201,161,11,61,0,8,699
26081011302,6530,5593,274,237,17,88,6,13,937
26081011401,2347,2010,208,21,9,13,1,4,337
26081011403,3084,2483,301,105,17,35,0,5,601
26081011405,3139,2653,244,65,10,22,0,11,486
26081011406,5509,2934,1290,811,17,103,0,25,2575
26081011501,2013,1411,141,113,12,249,0,3,602
26081011502,5286,4157,453,305,27,94,1,21,1129
26081011601,4378,3674,229,140,12,154,1,11,704
26081011602,3263,2908,153,43,5,36,2,15,355
26081011701,5768,4881,328,160,16,84,0,18,887
26081011702,4424,3797,247,111,8,84,0,14,627
26081011801,8270,6916,368,145,3,432,2,39,1354
26081011803,5130,3962,182,263,8,541,0,7,1168
26081011804,5166,4395,171,131,5,289,0,15,771
26081011901,6982,6256,179,60,8,182,0,33,726
26081011902,7406,6211,236,103,10,495,0,29,1195
26081012002,6387,5819,210,40,17,49,0,9,568
26081012003,7076,6427,224,57,14,49,0,19,649
26081012004,4985,4412,215,47,13,43,0,14,573
26081012201,7236,6100,149,136,10,516,5,27,1136
26081012202,7146,6284,232,74,6,228,1,23,862
26081012203,5285,4602,178,96,12,199,0,12,683
26081012300,3410,3073,101,28,6,46,0,12,337
26081012400,3956,3537,98,35,0,79,1,17,419
26081012500,4908,4399,149,58,4,88,0,8,509
26081012604,6739,3807,416,1006,6,1192,1,17,2932
26081012605,4215,3193,199,154,6,487,0,21,1022
26081012608,4057,2360,316,750,9,421,0,27,1697
26081012609,2975,1280,284,1003,2,240,0,21,1695
26081012610,2559,1521,202,430,15,276,0,16,1038
26081012611,2290,1102,284,502,8,287,0,1,1188
26081012612,3457,1733,368,980,6,210,0,11,1724
26081012702,5025,3062,388,793,8,543,2,5,1963
26081012703,5057,2690,578,1139,19,354,0,21,2367
26081012704,2355,682,173,1141,9,218,4,19,1673
26081012705,4616,2135,442,1074,11,756,0,19,2481
26081012800,4529,2630,425,667,14,568,0,23,1899
26081012901,5682,2428,1433,896,16,589,0,27,3254
26081012902,5268,2979,816,699,24,474,0,21,2289
26081013000,3801,2951,402,163,8,78,3,8,850
26081013100,5202,4182,432,227,17,97,3,8,1020
26081013200,7080,5982,394,182,32,142,1,16,1098
26081013300,5356,1660,3014,463,12,46,1,11,3696
26081013400,5751,3478,1424,446,26,77,0,12,2273
26081013500,4950,2078,2046,484,6,104,0,17,2872
26081013600,2075,1028,681,208,11,43,0,5,1047
26081013700,7371,3681,2315,756,23,200,0,36,3690
26081013801,1630,1024,258,228,6,15,1,7,606
26081013803,3310,1147,1194,669,13,142,0,11,2163
26081013804,3640,1953,1084,371,10,66,3,16,1687
26081013900,6376,4332,1038,522,24,140,7,14,2044
26081014000,6773,4072,1547,565,18,219,0,19,2701
26081014100,1986,1083,541,175,10,60,0,1,903
26081014200,3938,1795,1265,477,7,159,4,9,2143
26081014300,3125,1828,748,263,5,102,3,4,1297
26081014503,7153,5773,463,228,9,410,0,11,1380
26081014504,5288,4000,631,236,17,157,0,32,1288
26081014505,5089,3372,908,217,16,397,0,21,1717
26081014506,2721,2132,269,121,4,93,1,0,589
26081014603,4798,4156,174,48,5,230,2,9,642
26081014604,4775,4060,209,103,14,194,0,16,715
26081014605,6622,5717,349,69,33,169,2,15,905
26081014606,5900,5262,197,50,10,180,0,19,638
26081014701,4801,2716,878,635,36,124,3,18,2085
26081014703,5210,2545,752,1056,13,557,16,20,2665
26081014704,3036,2351,219,222,18,73,1,5,685
26081014803,3691,3268,150,52,14,83,0,8,423
26081014805,8220,6333,366,471,15,674,0,23,1887
26081014806,6056,5558,149,45,12,50,0,13,498
26081014808,2314,1843,129,104,14,99,0,13,471
26081014809,6341,3683,474,1275,17,596,1,18,2658
26081014810,5721,5111,180,79,10,122,0,26,610
26081014811,4034,3273,255,256,14,57,5,9,761
26083000100,2046,1948,27,4,1,0,0,5,98
26083980100,0,0,0,0,0,0,0,0,0
26083990100,0,0,0,0,0,0,0,0,0
26085960100,2200,2038,40,11,11,4,0,0,162
26085961100,4687,2838,1021,530,29,30,4,12,1849
26085961200,2427,1926,71,233,4,8,4,9,501
26085961300,2782,2558,63,21,21,3,0,3,224
26087330000,3642,3338,128,12,6,5,0,16,304
26087330500,2914,2718,79,8,11,4,0,0,196
26087331000,1773,1593,78,1,6,2,0,2,180
26087331500,2694,2470,79,10,15,7,1,2,224
26087332000,5764,5238,177,23,17,11,0,25,526
26087332500,3571,3299,116,11,5,3,0,16,272
26087333000,3148,2889,90,18,14,3,0,5,259
26087333500,5646,5127,202,19,20,20,0,18,519
26087334000,2470,2222,99,10,13,12,0,13,248
26087334500,2232,2042,38,3,14,16,0,0,190
26087336000,5227,4795,134,37,20,30,0,20,432
26087336500,997,334,22,625,11,0,0,0,663
26087337000,3614,3178,180,35,11,21,0,10,436
26087337500,4268,3735,188,29,13,41,0,4,533
26087338000,4972,4510,148,15,16,32,1,12,462
26087338500,4706,4236,204,10,15,16,2,14,470
26087339000,3115,2657,331,10,11,7,0,8,458
26087339500,3703,2323,1184,22,3,32,4,20,1380
26087340000,4129,3794,136,13,11,17,0,16,335
26087340500,2832,2481,191,5,5,13,0,23,351
26087341000,4799,4463,116,12,10,13,0,6,336
26087341500,4368,4014,134,16,19,28,0,1,354
26087342000,4547,4188,104,15,2,42,0,8,359
26087342100,3488,3227,86,7,9,21,0,11,261
26089970100,2008,1836,70,9,40,5,0,3,172
26089970201,2733,1862,268,13,426,12,0,13,871
26089970202,2606,2335,92,4,44,21,0,7,271
26089970300,2828,2564,155,10,6,17,0,2,264
26089970400,1621,1552,19,3,0,9,0,5,69
26089970501,2738,2525,70,5,21,13,0,2,213
26089970502,2282,2134,41,9,5,8,3,8,148
26089970601,3927,3518,168,10,25,16,1,14,409
26089970602,1558,1455,34,1,10,5,0,4,103
26089990000,0,0,0,0,0,0,0,0,0
26091060100,3662,3349,89,9,17,18,0,5,313
26091060301,4612,4185,161,14,17,19,0,8,427
26091060302,4098,3819,98,9,9,11,2,6,279
26091060401,3649,3276,128,11,9,1,0,11,373
26091060402,3035,2842,67,5,6,7,1,14,193
26091060500,3409,3050,196,12,17,6,0,7,359
26091060600,5743,4883,496,62,8,38,1,30,860
26091060701,3649,3115,305,27,5,21,0,8,534
26091060702,3906,3464,204,24,12,16,1,14,442
26091060800,3361,2915,212,27,12,13,0,10,446
26091061200,1769,1505,155,5,16,6,2,0,264
26091061301,3482,2161,974,164,25,9,0,3,1321
26091061302,3167,1889,906,163,16,13,1,12,1278
26091061400,3540,2720,544,110,22,23,0,8,820
26091061500,6214,4822,697,274,21,73,0,25,1392
26091061600,4094,2743,912,152,15,30,0,20,1351
26091061701,4900,3057,454,1145,34,29,0,10,1843
26091061702,4480,3686,458,83,7,36,0,16,794
26091061800,3914,3475,233,27,8,10,0,11,439
26091061900,4582,4119,233,26,8,4,0,20,463
26091062000,2726,2477,120,18,11,8,0,3,249
26091062100,4235,3871,163,9,18,11,0,7,364
26091062200,2478,2183,194,8,8,11,0,0,295
26091062300,5393,4786,259,24,14,36,0,31,607
26091062400,5325,4734,236,29,7,27,0,20,591
26093710100,2640,2434,74,19,5,22,1,4,206
26093710300,5488,4946,184,45,17,34,1,11,542
26093710500,1924,1725,64,6,8,24,0,3,199
26093710700,1934,1781,43,3,2,8,0,5,153
26093711000,4166,3864,95,11,6,18,0,13,302
26093712101,3093,2845,88,10,4,17,3,8,248
26093712102,2929,2732,67,4,18,4,2,2,197
26093712601,4961,4572,138,17,18,42,0,14,389
26093712602,3640,3298,126,14,11,36,3,11,342
26093713100,4723,4371,113,5,13,30,2,14,352
26093713300,1973,1795,60,13,3,26,1,13,178
26093713500,3865,3450,152,34,17,27,2,13,415
26093713700,4695,4252,133,31,6,38,1,18,443
26093720100,3608,3350,79,8,18,18,0,25,258
26093721100,3246,2990,71,7,9,24,2,10,256
26093722100,3231,2967,98,8,12,7,0,28,264
26093722300,2951,2608,128,9,16,11,3,5,343
26093722500,2420,2147,102,17,4,26,8,7,273
26093724001,2403,2159,100,17,4,15,0,5,244
26093724002,2485,2285,65,6,3,23,0,1,200
26093724003,2976,2633,148,11,8,31,1,11,343
26093725000,5300,4807,153,33,12,75,4,11,493
26093725101,4827,4131,293,86,17,39,42,5,696
26093730101,2937,2704,70,9,10,18,3,4,233
26093730102,4401,4015,135,8,3,67,1,6,386
26093730600,3877,3578,72,8,5,29,0,8,299
26093731100,3870,3600,43,2,4,10,0,0,270
26093732100,3333,3125,76,12,15,5,1,1,208
26093733100,1823,1696,56,5,10,5,0,3,127
26093733603,3399,3103,77,12,8,35,1,14,296
26093733604,2668,2491,46,9,2,14,0,8,177
26093740200,3828,3548,87,2,8,26,1,29,280
26093740300,2378,2165,52,10,6,16,0,14,213
26093740500,2343,2143,51,5,0,20,0,21,200
26093740600,3135,2849,82,18,13,38,0,14,286
26093740700,2701,2462,83,17,3,27,1,1,239
26093740800,2746,2520,80,12,3,31,1,0,226
26093740900,2013,1789,59,31,6,31,0,6,224
26093741100,2227,2000,76,19,7,27,10,4,227
26093741601,1788,1634,59,17,5,12,0,3,154
26093741602,3431,3181,93,9,1,46,2,6,250
26093742201,3055,2798,76,22,13,34,1,10,257
26093742202,2172,2010,42,7,13,18,3,5,162
26093742403,5485,4853,188,48,18,100,4,14,632
26093742500,2302,2150,53,4,3,6,3,2,152
26093742700,3687,3411,83,10,8,18,0,22,276
26093742900,3991,3694,109,19,8,45,1,11,297
26093743300,2527,2310,56,6,10,26,0,6,217
26093743400,3746,3437,107,10,4,24,0,10,309
26093743500,1940,1782,43,13,5,6,0,5,158
26093743600,2950,2705,60,4,7,19,0,9,245
26093743700,2701,2445,68,19,8,5,1,15,256
26093743800,3806,3554,63,11,10,26,1,9,252
26093743900,3589,3360,63,5,6,37,0,6,229
26093744200,3993,3558,156,44,12,67,1,3,435
26093744400,2049,1877,58,3,2,20,0,9,172
26093744600,2374,2020,52,178,10,31,0,3,354
26093744700,3005,2748,83,28,7,23,1,17,257
26093744800,4454,4086,105,14,12,52,0,21,368
26093744900,3664,3213,167,53,16,17,0,11,451
26095960100,3265,2698,56,8,243,2,0,5,567
26095960200,2074,1816,18,4,122,0,0,5,258
26095980000,0,0,0,0,0,0,0,0,0
26095990000,0,0,0,0,0,0,0,0,0
26097950100,1516,1269,21,2,93,4,0,18,247
26097950200,2318,1783,40,9,303,5,0,4,535
26097950300,1927,1673,24,3,107,4,0,4,254
26097950400,2739,1728,53,26,672,7,0,7,1011
26097950500,2334,1562,29,16,507,8,0,1,772
26097990000,0,0,0,0,0,0,0,0,0
26099206700,3767,3143,269,129,1,12,0,20,624
26099210000,4313,3917,118,36,7,6,0,15,396
26099211000,5875,5183,302,52,6,16,44,24,692
26099212000,5318,4985,87,15,12,28,0,0,333
26099214000,3051,2655,183,34,12,7,0,3,396
26099214500,4410,4152,91,15,12,22,0,3,258
26099215000,5564,5162,101,33,4,81,0,14,402
26099215201,5947,5518,124,41,7,64,0,19,429
26099215202,2826,2617,53,18,0,55,0,21,209
26099215300,4329,3786,151,112,4,52,0,14,543
26099215500,7595,6196,932,84,13,118,0,8,1399
26099216000,3780,3515,105,4,10,18,0,10,265
26099217000,2550,2372,50,11,9,7,0,2,178
26099218001,6097,4299,391,861,27,31,0,23,1798
26099218002,3472,2217,163,913,18,22,2,12,1255
26099220002,4524,3995,117,148,17,30,4,15,529
26099220003,5218,4697,112,138,19,47,0,3,521
26099220004,2375,2150,65,21,12,21,0,3,225
26099221100,7066,5832,274,479,13,61,3,13,1234
26099221200,5904,5192,149,232,4,56,0,13,712
26099221500,1257,1072,33,49,2,15,1,4,185
26099221800,5228,4537,128,228,3,87,0,6,691
26099222103,2824,2220,122,277,6,53,1,5,604
26099222104,3222,2334,276,354,8,16,0,4,888
26099222105,4807,4264,103,179,0,53,3,14,543
26099222106,4163,3107,171,584,10,51,1,4,1056
26099222500,3922,3585,116,42,8,25,2,13,337
26099222800,3119,2744,51,113,10,34,0,14,375
26099223401,7516,6160,211,509,6,268,1,17,1356
26099223402,5185,4362,189,183,9,190,2,7,823
26099223500,1729,1550,56,39,0,36,0,1,179
26099223801,4119,3797,82,33,1,96,1,10,322
26099223802,8272,7258,260,205,5,227,5,19,1014
26099223803,3509,3171,73,68,3,75,0,13,338
26099223901,5235,4579,105,138,3,190,0,13,656
26099223902,3687,3378,53,85,5,76,0,4,309
26099224001,9049,7317,225,445,10,635,1,40,1732
26099224002,5154,4324,140,240,6,170,0,11,830
26099224101,4430,3654,117,308,3,196,0,11,776
26099224102,4160,3498,114,183,7,210,1,0,662
26099224201,3858,3198,127,226,0,158,0,10,660
26099224202,5767,3809,410,1008,15,93,3,27,1958
26099224300,4809,4222,121,108,6,198,0,1,587
26099224400,4985,4428,105,136,6,127,0,4,557
26099224500,3823,3407,83,140,3,86,3,5,416
26099224600,6376,4930,388,573,11,167,2,23,1446
26099225100,3496,3012,127,118,5,84,0,21,484
26099225200,6826,5984,249,121,1,248,0,19,842
26099225300,4443,3919,143,134,14,86,0,5,524
26099225401,4519,3984,121,90,4,160,0,10,535
26099225402,3196,2931,55,22,6,90,0,5,265
26099225500,5559,4776,286,136,11,143,0,16,783
26099225600,4590,3681,199,241,13,210,0,24,909
26099225701,5424,3686,280,725,17,415,3,23,1738
26099225702,1503,1324,64,15,8,19,0,8,179
26099225800,7334,6067,234,187,9,516,1,13,1267
26099225900,5070,4547,104,89,2,121,0,13,523
26099226101,3402,3059,74,41,7,77,2,3,343
26099226102,4303,3797,112,78,6,165,0,8,506
26099226400,2664,2264,68,75,0,147,3,7,400
26099226700,5052,4369,199,112,12,161,0,4,683
26099227000,7054,6039,134,206,5,445,1,10,1015
26099227300,4973,4027,131,448,8,182,0,10,946
26099228000,3742,2953,90,262,10,254,0,38,789
26099228100,1503,1197,130,54,2,16,0,8,306
26099230000,4754,3619,120,542,5,309,0,12,1135
26099230200,5081,4469,118,127,7,133,1,29,612
26099230300,4545,3831,104,248,10,123,1,5,714
26099230400,3756,3258,135,92,6,97,1,14,498
26099230501,3798,2756,351,308,24,114,0,13,1042
26099230502,200,148,0,28,0,19,0,0,52
26099230602,6487,5295,97,87,3,865,0,10,1192
26099230603,4067,3357,67,178,8,369,0,13,710
26099230604,3499,2397,75,400,5,510,0,10,1102
26099230700,5259,4349,56,71,5,659,0,5,910
26099230800,5152,3859,202,340,18,407,1,18,1293
26099230901,4544,4036,142,117,6,79,2,19,508
26099230902,2966,2287,88,322,2,138,1,16,679
26099231000,4303,3659,133,187,5,139,0,14,644
26099231100,3697,2787,102,359,11,299,0,15,910
26099231200,3985,2994,116,318,6,321,3,10,991
26099231400,5895,4748,85,246,2,665,0,10,1147
26099231500,5413,4472,73,150,7,552,2,5,941
26099231600,4966,3705,116,365,13,587,0,8,1261
26099231700,6387,4769,81,386,3,941,0,9,1618
26099231800,4371,3596,64,221,4,323,0,19,775
26099231900,6010,4986,140,304,8,361,0,11,1024
26099232000,2356,1835,44,201,0,181,0,5,521
26099232100,6361,4358,132,1064,14,554,0,10,2003
26099232200,5401,3904,132,732,4,419,0,20,1497
26099232301,4874,3509,114,516,5,531,0,10,1365
26099232400,5752,4310,73,388,10,746,0,11,1442
26099232500,4693,3815,150,253,6,309,0,4,878
26099233000,5747,5022,161,159,3,185,0,12,725
26099240000,4554,2288,245,1610,17,19,1,36,2266
26099240300,4102,3438,124,281,4,57,0,15,664
26099240400,5415,4628,127,386,11,88,1,21,787
26099240500,2427,1809,93,364,4,27,0,0,618
26099240601,3508,2581,116,594,8,61,0,6,927
26099240602,3408,2976,52,177,3,57,0,11,432
26099240700,4277,3799,72,189,5,84,0,4,478
26099240801,1451,1274,32,73,0,9,0,6,177
26099240802,5102,3359,165,1204,6,62,3,29,1743
26099240900,1834,1593,36,69,7,16,1,5,241
26099241000,4536,2724,91,1411,14,96,2,11,1812
26099241200,4695,3433,146,756,10,61,0,14,1262
26099241300,2594,1587,64,663,0,150,0,7,1007
26099241400,3182,2825,70,126,4,43,0,8,357
26099241500,3537,2722,88,516,2,82,0,11,815
26099241600,2591,1492,82,827,8,58,1,5,1099
26099241700,4667,3236,258,692,8,96,2,27,1431
26099241800,5296,2642,151,2064,15,181,0,15,2654
26099241900,4879,3482,141,900,13,60,2,23,1397
26099242001,1265,1021,26,147,0,27,0,4,244
26099242002,1445,1202,17,156,8,23,0,2,243
26099242003,2418,1504,124,564,5,114,3,14,914
26099242100,2549,1229,77,1079,7,17,0,8,1320
26099242500,6895,5496,154,727,8,256,0,14,1399
26099243000,4662,3838,91,466,5,98,0,9,824
26099243501,2608,2176,95,166,5,72,3,6,432
26099243502,4048,2476,148,997,11,206,0,17,1572
26099244000,2568,2096,109,224,4,50,0,7,472
26099245000,3427,1511,112,1539,12,9,2,26,1916
26099245100,3891,2898,219,458,16,30,0,34,993
26099245200,2301,1475,103,591,3,6,0,8,826
26099245300,4530,3645,131,442,10,33,0,32,885
26099245400,1548,613,47,745,4,10,0,6,935
26099247100,833,580,84,90,2,2,0,1,253
26099247201,4104,3345,98,415,6,58,0,10,759
26099247202,2820,2528,71,112,12,9,0,8,292
26099247301,4682,3998,119,296,9,53,0,12,684
26099247302,1671,1547,38,5,2,15,0,6,124
26099247400,2205,2003,60,22,11,16,0,4,202
26099247500,1763,1374,57,209,3,21,1,6,389
26099247601,1682,840,62,668,3,13,0,11,842
26099247602,4552,3417,151,686,12,68,0,26,1135
26099250000,2176,1931,45,45,6,13,0,9,245
26099250100,2087,1856,52,75,6,9,0,11,231
26099250200,2654,2341,57,87,9,18,0,4,313
26099250300,3096,2641,76,244,6,26,0,14,455
26099250400,1402,1243,34,58,2,9,0,6,159
26099250500,2120,1901,43,67,5,19,4,3,219
26099250600,2823,2460,82,95,4,18,2,0,363
26099250700,2943,2619,74,89,3,23,3,13,324
26099250800,2865,2507,66,157,6,23,0,4,358
26099250900,2403,2138,70,42,3,28,1,2,265
26099251000,1639,1470,42,42,3,15,0,5,169
26099251100,1967,1788,58,27,0,24,0,1,179
26099251200,3294,2879,90,124,8,42,0,11,415
26099251300,2310,2069,74,45,2,20,0,4,241
26099251400,3065,2729,73,115,1,25,2,5,336
26099251500,1762,1470,57,143,1,19,0,3,292
26099251600,3163,2660,132,190,7,32,0,19,503
26099251700,2745,2186,108,268,7,36,0,9,559
26099251800,4231,2701,127,1130,7,71,0,25,1530
26099251900,2825,2276,103,246,9,30,0,13,549
26099252000,2475,2055,66,192,10,44,2,14,420
26099252100,2159,1826,71,126,5,22,0,5,333
26099252200,2747,2444,52,137,2,50,0,12,303
26099254000,1663,1386,50,98,2,22,0,3,277
26099254100,4307,3552,114,387,17,91,2,7,755
26099254200,4467,3567,136,369,13,120,2,8,900
26099254500,4289,3390,101,468,14,80,0,14,899
26099255000,4446,2819,125,1177,11,77,3,9,1627
26099255100,3109,2385,90,330,25,60,0,18,724
26099255200,4009,2025,83,1582,9,77,3,23,1984
26099255300,3922,2527,123,966,13,82,5,12,1395
26099255400,2674,2196,51,184,11,23,0,5,478
26099255500,1616,1236,46,209,3,34,0,5,380
26099255600,3311,2456,90,442,13,75,0,9,855
26099255700,1797,1305,42,271,4,30,0,10,492
26099255800,2530,1835,65,371,12,22,0,20,695
26099255900,1759,1320,69,209,5,16,1,7,439
26099256000,2108,1458,51,411,4,45,0,12,650
26099256100,2684,1903,59,489,7,43,0,7,781
26099256200,1853,1321,67,305,3,19,0,10,532
26099256300,1927,1041,69,671,4,35,0,12,886
26099256400,1441,1070,38,221,4,6,0,8,371
26099256500,1631,1105,37,375,0,23,0,9,526
26099256600,3244,1770,85,1028,12,131,0,19,1474
26099256700,1793,1163,81,379,8,41,0,9,630
26099256800,1856,1351,48,301,1,36,0,5,505
26099258000,2699,1176,66,1301,5,11,0,11,1523
26099258100,3874,2016,109,1510,8,36,0,12,1858
26099258200,3064,1583,79,1072,12,109,2,14,1481
26099258300,2708,1190,60,1251,5,49,0,20,1518
26099258400,5358,2501,124,2394,15,26,0,38,2857
26099258500,1986,609,57,1233,1,9,0,24,1377
26099258600,4814,1642,123,2759,12,20,4,14,3172
26099258700,2749,925,56,1545,4,57,0,23,1824
26099258800,4015,679,43,3107,9,32,0,21,3336
26099258900,3051,965,101,1784,6,12,0,21,2086
26099260000,3320,2701,78,234,15,140,0,5,619
26099260100,2963,2078,100,553,0,72,0,17,885
26099260200,2320,1962,52,94,9,110,0,6,358
26099260300,3038,2472,49,244,13,129,1,18,566
26099260400,4454,3366,91,439,5,342,0,18,1088
26099260600,2860,2235,72,213,11,165,0,17,625
26099260700,2941,2272,54,291,2,189,0,12,669
26099260800,2719,2132,38,161,4,295,0,5,587
26099260900,4846,2834,81,448,10,1290,0,22,2012
26099261000,4201,2384,97,673,0,922,0,7,1817
26099261100,5337,3367,88,1066,5,584,0,34,1970
26099261200,2833,2126,81,411,4,98,0,7,707
26099261300,2862,2314,56,255,15,123,0,15,548
26099261400,2772,2209,84,208,6,143,0,4,563
26099261500,3512,2423,66,736,4,166,0,14,1089
26099261601,1369,1068,30,146,2,79,1,1,301
26099261700,2330,1274,31,781,5,155,0,2,1056
26099261800,2901,2098,54,330,4,269,0,13,803
26099261900,2946,1962,79,459,1,289,0,9,984
26099262000,3470,2307,74,497,3,405,0,22,1163
26099262100,942,722,38,88,2,14,0,9,220
26099262200,4439,3162,100,283,14,714,0,10,1277
26099262300,4291,2429,60,852,8,760,0,16,1862
26099262400,3500,1969,57,469,5,832,0,16,1531
26099262500,5435,3207,148,910,15,887,0,32,2228
26099262600,2514,1581,62,546,7,211,0,17,933
26099262700,4992,2908,124,1295,10,454,0,11,2084
26099262800,2131,1273,71,609,1,85,0,2,858
26099262900,4168,2633,118,991,18,142,1,24,1535
26099263200,3042,1566,80,931,8,220,0,16,1476
26099263400,4035,2199,134,550,19,918,1,24,1836
26099263500,4524,2578,110,777,14,827,0,11,1946
26099263600,5128,2170,182,1807,9,704,6,31,2958
26099263700,5121,2205,204,1477,21,844,2,45,2916
26099263800,3097,1213,143,1320,19,149,7,22,1884
26099263900,3786,1650,176,1514,11,134,0,18,2136
26099264000,1969,665,59,1043,6,71,0,12,1304
26099264200,4061,1784,112,1747,14,96,0,27,2277
26099267600,1487,1070,29,196,1,107,0,4,417
26099268000,5853,3811,180,1140,28,310,3,32,2042
26099268100,2699,1507,81,794,11,159,1,10,1192
26099268200,3864,3445,81,78,9,34,2,15,419
26099268300,3100,1243,110,1457,5,51,4,24,1857
26099268400,3585,2047,85,1057,19,118,3,10,1538
26099980000,0,0,0,0,0,0,0,0,0
26099980100,0,0,0,0,0,0,0,0,0
26099982001,5,0,2,0,0,0,1,0,5
26099982002,22,19,2,0,0,0,0,0,3
26099982100,2,0,2,0,0,0,0,0,2
26099982200,9,0,2,5,0,0,0,0,9
26099982300,37,10,4,16,0,0,0,0,27
26099990100,0,0,0,0,0,0,0,0,0
26101000100,3795,3432,134,14,42,4,0,0,363
26101000200,1983,1795,81,5,15,4,0,11,188
26101000300,1984,1829,57,7,23,7,0,10,155
26101000400,2441,2070,74,14,156,5,0,5,371
26101000500,3728,2900,106,495,69,10,0,7,828
26101000600,1643,1513,43,6,25,6,0,3,130
26101000700,4006,3599,99,10,64,15,0,12,407
26101000800,3238,2814,146,28,39,18,2,8,424
26101000900,2214,1884,90,27,54,10,0,1,330
26101990000,0,0,0,0,0,0,0,0,0
26103000100,1886,1681,61,17,9,27,0,10,205
26103000200,2060,1865,50,18,15,18,0,7,195
26103000300,2115,1900,46,29,34,8,4,0,215
26103000400,1853,1657,53,20,13,18,0,3,196
26103000500,1262,1031,137,9,17,21,0,0,231
26103000600,2492,2114,112,43,53,17,0,13,378
26103000700,4216,3689,166,29,58,58,0,7,527
26103001100,1520,1373,10,4,25,12,0,5,147
26103001200,5469,4914,63,14,137,17,3,14,555
26103001300,3745,3441,40,10,64,13,1,3,304
26103001500,3076,2840,37,2,32,3,0,16,236
26103001600,2291,2109,43,6,25,16,0,4,182
26103001700,2266,2069,34,15,33,17,0,9,197
26103001800,2670,2469,34,8,34,2,0,4,201
26103001900,1524,1381,30,9,23,0,0,7,143
26103002000,2182,1989,28,3,38,1,5,10,193
26103002100,2903,2739,20,7,26,8,2,4,164
26103002200,3096,2909,38,6,28,4,0,12,187
26103002300,2105,1982,14,0,17,5,0,6,123
26103002400,3064,2570,100,50,70,13,0,15,494
26103002500,2320,2065,46,20,42,15,2,2,255
26103002600,2162,2002,22,4,38,11,0,5,160
26103002801,2908,2582,46,24,27,38,0,2,326
26103002802,2383,1730,57,423,59,9,0,2,653
26103002901,3531,3106,40,20,88,46,0,15,425
26103002902,918,831,17,0,6,3,0,3,87
26103990000,0,0,0,0,0,0,0,0,0
26105950100,2529,2295,77,10,18,3,0,6,234
26105950200,3659,3354,98,15,30,11,0,15,305
26105950300,3693,3428,101,7,19,21,3,13,265
26105950400,4328,3846,213,33,35,36,1,3,482
26105950500,3463,2935,242,29,41,23,1,14,528
26105950600,5143,4462,254,51,32,40,1,17,681
26105950700,3278,3027,90,9,32,12,0,3,251
26105950800,2959,2597,215,13,12,8,2,10,362
26105990000,0,0,0,0,0,0,0,0,0
26107960100,2490,2256,89,11,10,12,0,2,234
26107960200,2805,2562,43,22,32,6,3,20,243
26107960300,2890,2703,51,20,12,13,0,2,187
26107960400,4457,4056,94,38,18,17,0,11,401
26107960500,3454,2949,116,114,8,22,0,5,505
26107960600,3182,2615,132,129,8,107,6,16,567
26107960701,2317,1828,107,187,13,54,1,6,489
26107960702,3120,2855,62,19,13,22,4,8,265
26107960800,4921,4608,82,36,10,11,0,11,313
26107960900,3139,2811,38,59,29,8,0,11,328
26107961001,3295,3048,78,22,12,15,0,14,247
26107961002,2591,2424,57,8,12,13,0,3,167
26107981300,1053,806,77,107,13,12,0,9,247
26109960100,3460,3220,40,4,69,11,1,0,240
26109960200,4072,3278,93,0,553,10,0,5,794
26109960300,2335,2212,27,3,16,8,2,0,123
26109960400,3302,3153,30,3,18,16,1,3,149
26109960500,2917,2755,45,24,15,6,1,6,162
26109960600,3901,3537,131,30,22,22,0,15,364
26109960700,3515,3170,120,34,34,21,0,4,345
26109990000,0,0,0,0,0,0,0,0,0
26111290100,3496,3058,138,80,9,18,2,4,438
26111290200,3483,3076,135,36,4,53,0,9,407
26111290300,4024,3613,126,45,12,46,3,12,411
26111290400,1775,1557,57,22,3,23,0,5,218
26111290500,1913,1738,71,14,1,9,0,11,175
26111290600,2366,2027,102,91,9,12,2,7,339
26111290700,3682,2908,192,106,25,194,15,35,774
26111290800,5449,4828,218,52,10,106,10,22,621
26111290901,2931,2494,93,44,1,154,0,16,437
26111290902,5200,4277,219,120,17,305,2,19,923
26111291000,6264,5262,241,127,18,293,25,34,1002
26111291101,3538,3259,49,9,15,11,0,14,279
26111291103,4223,3807,100,41,7,64,0,14,416
26111291104,5672,4939,172,57,20,209,13,13,733
26111291200,5730,5119,144,43,11,123,11,24,611
26111291300,4217,3881,97,9,18,18,0,22,336
26111291400,4061,3651,182,9,35,19,0,17,410
26111291500,3985,3658,76,6,21,15,0,13,327
26111291601,2493,2328,53,7,8,7,0,7,165
26111291602,4625,4270,98,10,15,20,0,14,355
26111291700,4367,4075,96,14,34,11,0,8,292
26113960101,1823,1678,50,7,3,7,0,7,145
26113960102,2189,2023,68,2,14,4,0,0,166
26113960200,3235,2966,86,15,14,15,0,10,269
26113960300,4926,4618,156,7,9,13,0,2,308
26113960400,2879,2655,139,2,8,4,1,4,224
26115830100,3440,3055,135,50,15,14,0,11,385
26115830200,6450,5691,269,78,25,24,0,34,759
26115830300,3859,3458,126,58,12,10,1,19,401
26115830400,4001,3625,123,29,11,13,0,7,376
26115830500,3927,3501,81,146,8,10,1,22,426
26115830600,2984,2492,71,198,12,20,0,18,492
26115830700,3785,3336,139,86,17,14,0,11,449
26115830801,5381,4872,180,64,6,33,1,10,509
26115830802,2764,2583,40,6,3,13,0,4,181
26115830900,2701,2522,50,17,9,2,0,1,179
26115831000,3202,2908,74,60,8,13,0,3,294
26115831100,2850,2489,135,46,3,32,1,3,361
26115831201,3859,3144,216,192,12,13,0,12,715
26115831202,3693,3282,128,33,20,18,0,25,411
26115831300,5120,4379,407,60,24,31,0,15,741
26115831400,7032,5692,361,460,13,114,1,33,1340
26115831500,3364,3015,82,104,8,17,0,7,349
26115831600,3351,2781,225,136,4,39,0,10,570
26115831700,4119,3288,231,305,17,30,0,9,831
26115831800,1525,796,117,427,8,25,0,11,729
26115831900,1606,1098,113,225,13,12,4,12,508
26115832000,1820,1399,136,135,4,6,0,18,421
26115832100,3002,2323,197,201,13,17,0,4,679
26115832200,1756,1548,77,50,1,5,0,0,208
26115832300,4376,3698,230,142,19,11,2,20,678
26115832400,4315,3852,117,103,12,44,0,24,463
26115832500,4674,3854,218,247,21,44,0,21,820
26115832600,2034,1811,106,4,3,8,3,5,223
26115832700,2605,2406,56,2,2,7,0,5,199
26115832800,4783,4454,111,9,5,16,0,9,329
26115832900,4347,3982,121,16,11,11,2,4,365
26115833000,4590,4197,124,60,11,24,2,15,393
26115833100,5059,4637,152,17,8,33,0,16,422
26115833200,4103,3742,161,15,1,16,0,14,361
26115833300,6867,6294,233,37,8,76,1,12,573
26115833500,5138,4549,212,60,12,52,1,16,589
26115833600,3075,2679,161,44,12,3,0,4,396
26115833700,2606,2303,93,27,10,8,0,1,303
26115833800,5747,5170,232,57,5,47,4,15,577
26115833900,4899,4464,191,30,8,27,0,10,435
26115990000,0,0,0,0,0,0,0,0,0
26117970100,4195,3916,94,23,14,6,0,11,279
26117970200,3655,3263,190,19,18,23,2,5,392
26117970300,3327,3098,95,6,14,5,1,10,229
26117970400,3495,3177,145,19,6,2,0,5,318
26117970501,4631,4204,113,39,13,13,0,3,427
26117970502,3264,3003,75,14,13,9,3,15,261
26117970600,5271,4844,143,13,19,16,2,10,427
26117970700,5220,4845,139,16,12,16,0,10,375
26117970800,4478,4146,162,21,8,15,0,4,332
26117970900,3168,2926,112,4,8,12,1,10,242
26117971000,9542,6812,651,1861,26,41,0,11,2730
26117971100,5191,4631,240,25,20,17,3,10,560
26117971200,5847,5231,286,33,25,17,7,23,616
26117971300,5330,4784,252,25,16,33,4,9,546
26119910100,2238,2088,21,2,23,4,0,13,150
26119910200,1456,1335,31,3,13,9,0,5,121
26119910300,1784,1681,21,3,6,9,0,7,103
26119910400,2217,2096,17,4,21,2,0,4,121
26119910500,1458,1351,35,0,5,0,0,5,107
26121000100,4521,2124,407,1684,25,34,0,15,2397
26121000300,2881,822,301,1535,14,2,2,23,2059
26121000401,4907,2125,546,1830,34,11,0,27,2782
26121000402,4421,1803,200,2285,44,14,1,1,2618
26121000500,4906,1601,701,2210,31,8,1,19,3305
26121000601,1692,599,209,710,6,14,0,13,1093
26121000800,3274,2195,418,408,37,9,0,15,1079
26121000900,3435,2785,224,191,22,13,0,12,650
26121001000,1242,1147,22,22,5,5,0,1,95
26121001200,2189,261,112,1694,2,6,3,14,1928
26121001300,2200,131,64,1915,4,1,0,2,2069
26121001402,3644,860,198,2298,22,15,1,0,2784
26121001500,4093,3567,172,87,15,55,3,20,526
26121001600,2641,2330,70,28,11,9,0,7,311
26121001700,4985,4353,181,105,18,24,1,12,632
26121001800,4712,3993,196,210,46,22,1,10,719
26121001901,4115,3151,187,411,14,45,3,13,964
26121001902,4699,3565,340,411,40,23,2,14,1134
26121002000,3811,3270,246,30,38,7,0,10,541
26121002100,3246,2371,145,516,28,25,0,5,875
26121002200,4172,3242,236,400,30,69,2,10,930
26121002300,5719,4959,282,133,19,54,0,18,760
26121002400,3292,2779,132,161,8,47,1,9,513
26121002501,3307,2894,111,63,9,103,0,13,413
26121002502,4581,4056,199,107,10,16,3,7,525
26121002601,3530,2741,346,162,38,21,0,13,789
26121002602,4601,3762,229,253,14,96,0,14,839
26121002701,4681,4141,165,88,17,54,0,3,540
26121002702,3322,2808,193,85,49,17,0,4,514
26121002800,6572,5863,252,82,34,75,1,11,709
26121002900,5503,4988,255,27,20,17,0,15,515
26121003000,4420,3902,300,19,14,10,0,8,518
26121003100,5046,4297,328,51,52,14,0,7,749
26121003200,6097,5092,415,115,62,9,2,20,1005
26121003300,5123,4509,210,51,41,18,0,15,614
26121003400,4188,3627,197,97,29,9,3,5,561
26121003500,4157,3717,149,36,31,13,1,8,440
26121003600,6727,5793,299,107,53,39,0,17,934
26121003701,2037,1873,82,1,5,4,0,0,164
26121003702,3707,3239,185,50,15,23,0,18,468
26121003800,3444,3092,144,15,20,8,0,9,352
26121003900,1902,1693,104,5,15,2,0,18,209
26121004000,2146,1905,52,24,31,4,0,13,241
26121004200,4052,1797,389,1579,21,3,0,42,2255
26121004300,1884,319,90,1331,13,6,0,7,1565
26121990000,0,0,0,0,0,0,0,0,0
26123970100,4746,4244,121,107,33,9,0,16,502
26123970300,3750,3343,180,18,26,13,4,6,407
26123970400,5279,4688,319,20,21,37,0,13,591
26123970500,5017,4509,237,12,18,25,1,11,508
26123970600,4011,3726,102,20,5,8,0,12,285
26123970700,4416,3697,166,192,26,21,4,8,719
26123970800,3381,3060,104,13,29,7,1,6,321
26123970900,5160,4521,321,14,49,25,1,10,639
26123971000,4999,4435,303,13,12,19,1,13,564
26123971100,4295,3579,528,11,14,16,2,19,716
26123971200,4924,4113,588,4,23,9,0,12,811
26125120000,2972,2650,123,27,14,21,0,7,322
26125120300,3284,3047,58,20,6,25,0,15,237
26125121000,3977,3373,219,88,8,45,14,17,604
26125121400,4862,4247,219,49,2,106,2,13,615
26125121500,3492,3084,144,54,1,59,0,4,408
26125121700,5194,4666,200,18,2,39,1,20,528
26125121800,4894,4292,192,57,18,67,0,7,602
26125122200,3707,3342,88,25,12,60,0,20,365
26125122400,6836,5921,329,81,20,96,2,27,915
26125122700,3080,2754,112,33,9,14,0,7,326
26125122900,1761,1589,65,18,0,8,0,5,172
26125123000,2848,2521,117,44,17,27,1,6,327
26125123100,3064,2777,106,23,4,26,0,12,287
26125124000,6045,5308,200,139,21,73,0,15,737
26125124500,5997,5301,263,81,12,24,0,9,696
26125125000,3430,3056,128,23,3,23,1,15,374
26125125600,2758,2479,87,18,5,6,0,9,279
26125126200,2691,2426,76,26,10,40,0,19,265
26125126300,5152,4487,261,83,15,60,0,17,665
26125126400,3756,3371,125,39,10,46,1,11,385
26125126500,3104,2812,109,21,3,16,0,11,292
26125127000,5881,5316,183,52,18,71,0,26,565
26125127100,5714,5151,219,63,2,61,3,29,563
26125127200,1681,1543,45,22,4,22,0,2,138
26125127300,4718,4130,204,85,11,86,4,15,588
26125127400,1613,1418,110,5,3,12,0,0,195
26125127500,6627,5620,311,232,11,139,3,19,1007
26125127600,5076,4418,173,109,2,117,0,15,658
26125127700,6304,5006,602,193,17,147,1,15,1298
26125128000,3193,2782,111,42,12,41,2,16,411
26125128100,2697,2405,110,20,4,38,0,3,292
26125128200,3169,2748,140,57,0,90,0,16,421
26125128300,4495,3727,326,128,5,101,1,21,768
26125128400,3976,2911,365,240,8,226,0,9,1065
26125128500,3038,2664,143,63,4,37,0,10,374
26125128600,3538,3133,142,48,6,62,3,6,405
26125128700,2120,1792,115,45,0,65,0,12,328
26125128800,1697,1343,156,39,3,78,0,6,354
26125128900,7323,5375,432,244,4,872,2,25,1948
26125129000,2960,2599,167,29,5,42,0,5,361
26125130000,3428,2931,167,76,10,49,0,12,497
26125130100,2452,2187,60,31,5,28,0,6,265
26125130200,5396,4867,121,98,22,33,0,24,529
26125130300,4073,3496,228,73,8,47,1,18,577
26125130400,2873,2545,120,42,4,41,0,6,328
26125130500,2977,2720,81,26,3,9,0,10,257
26125130600,3056,2740,99,21,12,24,0,10,316
26125130700,6695,5905,235,129,20,136,0,9,790
26125131100,2205,2010,68,0,9,5,0,0,195
26125131300,4796,4403,148,29,12,45,2,7,393
26125131400,2219,2024,60,4,8,10,0,3,195
26125131500,3727,3483,63,17,5,18,0,7,244
26125131600,2456,2264,57,16,5,18,0,5,192
26125131800,3769,3451,109,24,6,7,0,8,318
26125132100,6347,5553,274,88,16,78,0,32,794
26125132500,3531,3202,73,31,15,19,0,15,329
26125132600,4223,3796,135,50,7,84,3,7,427
26125132700,2989,2702,60,32,7,31,0,18,287
26125133001,2807,2414,97,54,7,108,0,15,393
26125133002,3728,3250,117,60,5,126,0,23,478
26125133003,3991,2773,217,353,11,483,0,9,1218
26125133101,4749,2191,266,1617,20,426,1,41,2558
26125133102,1918,1087,130,505,6,111,1,1,831
26125134000,4987,4414,151,90,10,114,0,6,573
26125134300,4955,4344,162,58,14,101,5,23,611
26125134400,4701,4185,131,67,3,90,0,19,516
26125134500,3632,3063,139,98,0,157,0,20,569
26125134600,4019,3591,130,36,4,58,2,5,428
26125134700,3255,2520,180,260,11,92,4,14,735
26125134800,3083,2346,109,145,5,405,0,9,737
26125134900,3995,3216,166,219,11,205,0,17,779
26125135000,3481,2691,334,105,9,126,0,21,790
26125135100,5502,4925,137,86,9,82,3,34,577
26125135200,3515,2627,238,167,7,332,0,5,888
26125135300,5181,4537,164,127,8,114,0,13,644
26125136000,3333,1777,128,350,0,949,1,18,1556
26125136101,5674,2679,256,299,9,2220,0,17,2995
26125136102,4386,2564,240,816,5,539,2,29,1822
26125136300,5222,2935,213,361,8,1456,0,33,2287
26125136500,5650,3169,255,576,7,1428,0,13,2481
26125136601,4904,2301,244,406,3,1760,6,26,2603
26125136602,3574,1769,138,105,9,1406,0,13,1805
26125136700,6004,3745,191,428,0,1406,0,26,2259
26125136800,6298,4412,280,787,6,571,17,21,1886
26125137101,4160,2244,153,157,2,1420,0,26,1916
26125137102,8327,4215,365,404,21,2942,0,48,4112
26125137400,7154,4835,176,262,4,1571,1,18,2319
26125137700,1717,1446,57,41,0,115,0,5,271
26125137800,3326,2834,121,29,6,228,2,8,492
26125138100,6704,5374,232,106,15,624,2,35,1330
26125138301,4492,3788,236,71,11,174,2,21,704
26125138302,8366,6860,329,157,6,620,0,26,1506
26125138600,3553,2917,115,49,7,306,0,8,636
26125139201,3877,3443,115,59,9,103,0,0,434
26125139202,2883,2540,102,24,2,72,0,5,343
26125139400,5142,4555,161,47,7,133,0,15,587
26125140101,1605,1102,134,154,2,124,10,5,503
26125140301,4121,2048,353,743,20,740,0,40,2073
26125140303,3820,2513,155,336,10,641,2,13,1307
26125140500,2497,1551,257,356,0,172,0,11,946
26125140600,2420,1117,248,731,4,113,0,24,1303
26125140700,2765,1667,274,356,6,280,0,15,1098
26125140800,4655,2335,240,621,8,1251,3,33,2320
26125140900,4247,1297,1006,1686,9,91,0,13,2950
26125141001,2974,979,907,830,3,114,0,6,1995
26125141002,2668,650,396,1382,9,74,2,37,2018
26125141100,3143,1236,597,1022,12,80,3,16,1907
26125141200,3444,745,782,1463,19,205,0,4,2699
26125141300,4113,1523,1606,671,16,106,1,22,2590
26125141400,4724,1167,1637,1530,8,154,1,23,3557
26125141500,6243,831,1228,3804,13,60,0,36,5412
26125141600,4473,974,1181,1912,6,177,1,28,3499
26125141700,3198,776,1183,1023,11,76,0,7,2422
26125142000,2499,710,482,1124,10,31,5,11,1789
26125142100,1641,393,415,710,4,37,0,4,1248
26125142200,2991,328,420,2080,9,14,0,18,2663
26125142300,2298,286,236,1653,4,14,0,2,2012
26125142400,3472,283,427,2593,13,16,0,16,3189
26125142500,1899,355,162,1254,2,43,0,3,1544
26125142600,3542,1617,446,1122,18,82,0,31,1925
26125142700,4037,298,346,3187,10,34,0,18,3739
26125143500,5724,4837,333,172,6,111,3,16,887
26125144100,4117,3362,337,154,5,41,0,8,755
26125144200,4341,3693,274,72,16,53,0,2,648
26125144301,3644,3188,195,59,14,30,0,0,456
26125144400,4953,4055,343,195,16,104,0,14,898
26125144500,2978,2469,183,133,6,73,0,5,509
26125144600,3891,3278,242,89,12,64,0,21,613
26125144701,3158,2060,498,359,8,60,4,6,1098
26125144800,2577,1957,278,151,6,38,3,4,620
26125144900,4068,3033,326,404,3,105,3,23,1035
26125145100,2163,1886,105,53,3,21,0,5,277
26125145200,3556,2802,256,270,7,35,0,15,754
26125145300,4225,3519,280,165,11,45,0,25,706
26125145400,4150,2964,626,249,13,69,1,14,1186
26125145501,3490,2861,168,159,5,120,0,3,629
26125145502,3855,3074,247,224,19,95,2,7,781
26125145600,4629,3793,281,233,5,98,1,13,836
26125145700,2622,2037,273,112,10,55,0,19,585
26125145900,2711,1637,341,528,6,38,1,12,1074
26125150000,5338,3631,191,703,7,592,2,34,1707
26125150100,3573,2491,141,424,5,348,0,18,1082
26125150200,2821,2028,61,84,0,520,3,16,793
26125150300,5422,4050,150,341,5,617,0,39,1372
26125150400,2934,2278,96,76,0,350,0,16,656
26125150500,3073,2671,72,84,1,153,0,12,402
26125150600,2983,2277,79,145,8,365,0,14,706
26125150700,4598,3758,132,178,6,376,0,12,840
26125150800,4344,3437,126,233,8,332,5,27,907
26125150900,3691,2874,89,267,5,312,1,19,817
26125151000,5471,4895,139,54,6,173,0,22,576
26125152000,4460,3737,89,145,3,362,0,19,723
26125152600,3966,3509,122,72,5,118,0,16,457
26125152700,3110,2673,88,70,5,122,1,20,437
26125152900,4324,3570,191,178,16,209,0,19,754
26125153000,2301,1933,78,84,1,98,0,3,368
26125153100,2309,2006,71,46,0,79,0,12,303
26125153200,1952,1703,47,50,0,81,0,2,249
26125153300,3855,3195,137,86,2,219,0,22,660
26125154000,1723,1516,52,63,6,15,1,2,207
26125154100,2761,2342,84,159,0,62,0,11,419
26125154200,2764,2169,226,149,8,72,1,8,595
26125154500,2238,1783,46,125,2,179,1,9,455
26125154600,2823,2075,81,251,0,281,0,21,748
26125156000,2710,2171,79,215,3,151,0,8,539
26125156100,4482,3415,140,450,0,255,0,16,1067
26125156200,6922,5727,193,298,9,323,1,19,1195
26125156300,4118,3104,102,297,4,408,2,18,1014
26125156400,4030,3220,90,266,6,314,0,20,810
26125156500,4498,3193,66,765,5,315,0,18,1305
26125156900,3152,2051,83,668,1,180,10,33,1101
26125157000,2324,1777,46,259,3,127,1,18,547
26125157100,1907,1265,52,357,3,138,1,16,642
26125157200,3799,2660,61,696,4,240,0,9,1139
26125157300,3317,2210,90,576,5,342,0,5,1107
26125157400,2547,1881,34,293,0,293,0,7,666
26125157500,3037,2039,57,603,4,206,3,28,998
26125157600,4531,2975,66,816,0,528,0,22,1556
26125157700,2628,1672,22,353,0,488,0,6,956
26125157800,3551,1970,69,854,5,538,0,17,1581
26125157900,2754,1854,85,439,4,284,0,23,900
26125158000,3844,3233,126,214,1,129,0,11,611
26125158100,3324,2601,101,366,9,102,0,20,723
26125158200,3431,2957,121,139,5,70,0,4,474
26125159000,4287,3385,129,318,4,261,0,28,902
26125160000,4088,1236,91,2548,9,34,2,17,2852
26125160300,3346,660,131,2236,5,185,3,14,2686
26125160400,2865,314,51,2284,2,98,0,12,2551
26125160500,4265,1578,132,2169,15,173,6,25,2687
26125160600,4805,1549,232,2557,7,170,0,29,3256
26125160700,1615,341,15,1188,1,16,0,0,1274
26125160800,4025,944,32,2780,4,156,1,23,3081
26125160900,4382,781,97,3060,11,249,0,47,3601
26125161000,2119,279,29,1646,9,59,0,30,1840
26125161100,3930,738,67,2951,11,48,0,13,3192
26125161200,5005,756,62,3900,4,80,0,25,4249
26125161300,3693,1147,118,2173,5,82,1,28,2546
26125161400,3923,1844,27,1856,4,31,0,68,2079
26125161500,1891,266,29,1486,0,28,1,15,1625
26125161600,2997,590,141,2018,2,120,7,30,2407
26125161700,2768,584,37,2003,3,32,0,20,2184
26125161800,4222,548,51,3373,9,60,1,16,3674
26125161900,2384,491,106,1633,3,41,8,24,1893
26125162000,4063,986,49,2867,4,29,0,48,3077
26125162100,3504,82,36,3244,8,33,0,13,3422
26125162200,1219,51,22,1084,0,12,0,10,1168
26125162300,3908,292,66,3377,5,22,1,19,3616
26125162400,2028,370,61,1476,1,18,0,12,1658
26125162500,3661,935,118,2352,19,48,4,14,2726
26125165000,3004,2296,109,264,6,158,0,21,708
26125165100,4271,3212,185,448,2,239,0,15,1059
26125165200,4322,1398,80,399,23,2290,3,17,2924
26125166000,2489,1667,60,539,6,112,2,18,822
26125166100,3329,2111,88,852,1,169,0,16,1218
26125166200,2937,2334,64,293,1,153,0,9,603
26125166400,3346,2424,108,365,5,281,1,13,922
26125166500,2958,2109,84,418,4,176,3,12,849
26125166600,3494,1854,101,839,0,564,0,7,1640
26125166700,2493,1308,43,712,2,332,0,23,1185
26125166800,3412,1925,88,1047,1,166,2,17,1487
26125166900,3529,2363,100,604,7,283,1,15,1166
26125167000,5534,3494,139,731,12,940,0,29,2040
26125167300,3723,2430,259,647,10,190,0,15,1293
26125167400,5054,3053,277,1155,10,231,3,32,2001
26125167500,5790,3655,207,1140,9,532,2,16,2135
26125167800,4978,3040,188,881,4,680,1,21,1938
26125167900,2879,1867,82,557,2,280,0,5,1012
26125168100,2375,1565,71,275,2,389,0,6,810
26125168400,3742,2252,107,510,6,723,2,13,1490
26125168500,2776,1508,58,598,1,503,0,14,1268
26125168601,2734,1243,69,400,5,915,0,8,1491
26125168602,3664,2253,78,569,8,544,0,15,1411
26125168700,3660,1943,91,674,3,838,0,18,1717
26125168800,2414,1754,81,297,1,200,2,7,660
26125168901,4121,660,112,546,8,2690,0,37,3461
26125168902,2555,791,85,619,2,976,1,8,1764
26125170000,2553,2294,92,24,0,30,0,5,259
26125170100,2806,2475,88,57,2,46,0,6,331
26125170200,3380,2970,104,65,4,76,0,17,410
26125170300,2663,2326,68,65,4,63,0,6,337
26125170400,3792,3343,90,130,5,51,0,4,449
26125171000,5056,3764,115,810,8,91,0,79,1292
26125171100,3370,1476,112,1503,3,92,1,23,1894
26125171200,2235,1360,77,581,6,62,0,9,875
26125171300,2994,530,60,2240,6,18,0,15,2464
26125171400,6441,1841,100,4170,9,65,2,40,4600
26125171500,4896,236,62,4416,5,21,0,16,4660
26125171600,2424,960,47,1260,7,20,2,9,1464
26125172400,2144,554,75,1348,3,65,5,4,1590
26125172500,2374,115,39,2110,0,9,0,28,2259
26125173000,4333,3566,194,252,10,81,0,16,767
26125173100,1580,1363,65,38,6,46,0,6,217
26125173200,2680,2298,91,124,4,41,2,13,382
26125173300,1479,1163,49,113,2,45,1,5,316
26125173400,5072,4030,266,334,7,117,0,18,1042
26125173500,2663,2134,104,175,5,65,0,21,529
26125173600,1383,1080,73,126,2,17,0,10,303
26125175000,2780,2199,101,259,8,49,1,0,581
26125175100,4494,3350,166,527,30,68,0,8,1144
26125175200,3821,2789,204,503,13,64,0,21,1032
26125175300,3888,2749,183,521,19,64,0,31,1139
26125180000,2532,2208,89,38,1,61,6,5,324
26125180100,2754,2419,82,47,7,59,0,13,335
26125180200,3365,2951,114,48,5,78,4,12,414
26125180300,2738,2453,71,45,1,46,5,5,285
26125181001,3410,1676,164,736,5,681,0,27,1734
26125181100,2828,2386,105,97,10,101,0,12,442
26125181200,6425,5068,160,294,5,566,1,28,1357
26125181300,5521,4388,197,373,10,268,0,9,1133
26125181400,2847,2313,116,138,10,104,0,9,534
26125181500,2338,1903,105,152,9,45,0,9,435
26125181600,5099,3913,185,411,24,225,0,18,1186
26125183000,3715,2915,166,244,9,233,0,10,800
26125183100,4480,3889,147,58,7,104,2,28,591
26125183200,3364,2825,111,150,1,101,0,12,539
26125183300,2964,2524,105,80,7,121,1,10,440
26125183400,2498,2149,71,134,9,52,0,3,349
26125183500,2064,1521,73,267,0,105,1,5,543
26125183600,4356,3679,125,232,4,119,0,23,677
26125183700,5379,4658,199,159,2,126,5,31,721
26125183800,4598,3896,180,160,2,118,0,11,702
26125183900,2356,2052,108,39,7,60,1,5,304
26125184000,2959,2587,104,72,8,62,1,4,372
26125184100,2867,2471,86,85,0,90,0,22,396
26125184200,4174,3532,155,120,7,153,1,12,642
26125184300,2809,2438,122,60,2,69,1,2,371
26125184400,2630,2221,84,98,5,83,0,19,409
26125184500,2358,2009,93,51,4,110,0,7,349
26125184600,3080,2605,140,61,6,132,0,3,475
26125184700,1560,1353,71,27,1,42,0,2,207
26125187000,2627,2335,77,41,1,31,0,5,292
26125188001,3881,3523,105,32,0,46,0,23,358
26125188100,2507,2351,41,13,1,29,0,13,156
26125190200,4746,4067,219,63,3,164,3,30,679
26125190400,3786,3399,109,45,7,80,0,6,387
26125190500,2633,2238,89,26,7,144,0,8,395
26125190700,5205,3752,292,153,6,760,0,20,1453
26125190800,3697,2936,129,99,1,402,0,5,761
26125191000,1765,1515,89,26,7,37,0,9,250
26125191100,2479,1983,136,131,0,125,0,5,496
26125191200,4690,3806,236,119,9,352,1,2,884
26125191300,4101,3221,160,62,4,488,0,6,880
26125192000,6186,4992,254,183,1,533,1,10,1194
26125192200,6059,4779,217,120,5,687,0,14,1280
26125192400,4984,4136,190,114,2,363,0,4,848
26125192500,3129,2235,124,99,3,530,2,6,894
26125192700,3202,2247,182,135,0,509,0,14,955
26125193000,3266,2628,164,98,1,216,0,13,638
26125193100,3859,2977,161,102,4,446,0,12,882
26125193300,4812,3143,278,355,17,820,5,20,1669
26125193400,4564,3184,208,65,3,941,0,13,1380
26125193500,3487,2322,373,139,19,321,2,18,1165
26125193600,2744,2115,107,55,3,337,0,7,629
26125193700,4718,3246,243,129,17,839,0,26,1472
26125194000,5739,2516,341,369,22,2297,0,23,3223
26125194100,3132,2420,102,70,0,397,0,20,712
26125194200,2063,1465,102,59,1,344,0,5,598
26125194300,4422,2950,217,228,9,849,3,24,1472
26125194400,3859,3027,107,161,8,410,0,14,832
26125194500,1282,1104,50,51,1,36,1,2,178
26125194600,4431,3205,185,149,9,659,0,10,1226
26125196000,6345,4152,198,155,6,1591,0,38,2193
26125196100,6573,4458,243,372,6,1193,7,29,2115
26125196200,4055,2852,104,135,8,818,0,18,1203
26125196300,3862,2708,109,113,0,775,1,9,1154
26125196400,4015,2660,79,111,6,1014,0,11,1355
26125196500,5591,3113,166,198,2,1940,0,7,2478
26125196600,2402,1699,73,27,0,501,0,13,703
26125196700,2861,2319,110,35,3,251,0,16,542
26125196800,4699,2279,89,81,3,2119,0,4,2420
26125196900,3765,2002,105,100,2,1408,0,5,1763
26125197000,5147,3217,159,149,0,1423,0,21,1930
26125197100,2987,1854,101,68,2,847,0,17,1133
26125197200,3846,2375,124,153,0,1060,0,7,1471
26125197300,4810,3690,175,206,5,556,0,7,1120
26125197400,2356,1814,143,114,1,161,0,12,542
26125197500,4136,1955,260,365,9,1408,0,12,2181
26125197600,1944,1002,94,132,8,627,0,3,942
26125197701,5304,2295,210,256,12,2390,1,24,3009
26125197702,2270,840,89,123,15,1150,0,8,1430
26125197900,3837,2659,96,174,7,728,0,23,1178
26125198000,3914,2210,103,131,7,1327,0,22,1704
26125198100,2575,1640,124,224,6,501,0,6,935
26125981000,0,0,0,0,0,0,0,0,0
26125981100,0,0,0,0,0,0,0,0,0
26125981200,0,0,0,0,0,0,0,0,0
26125981300,2742,1952,100,517,6,66,0,0,790
26125981400,3,0,1,2,0,0,0,0,3
26125981500,94,51,17,14,0,7,1,0,43
26125981600,0,0,0,0,0,0,0,0,0
26127010300,7111,4935,1768,36,50,25,1,28,2176
26127010400,4081,2887,989,33,28,16,2,12,1194
26127010500,3037,2331,529,15,32,5,1,13,706
26127010600,5614,4954,365,22,47,16,0,15,660
26127010800,2876,2580,170,11,19,4,0,0,296
26127010900,2280,2031,168,5,10,3,0,11,249
26127011000,1660,1473,119,1,9,0,0,0,187
26127990000,0,0,0,0,0,0,0,0,0
26129950100,2256,2094,46,2,12,5,1,6,162
26129950200,3185,2993,52,3,19,12,1,12,192
26129950300,1563,1465,35,0,4,3,1,9,98
26129950400,2986,2800,64,2,9,3,1,8,186
26129950500,4609,4263,116,29,22,23,2,2,346
26129950600,2640,2452,48,10,15,6,0,7,188
26129950901,1736,1557,42,8,11,0,2,9,179
26129950902,1795,1644,34,5,16,5,0,5,151
26131970100,1611,1517,17,2,21,5,0,1,94
26131970200,2431,2265,33,2,8,10,1,9,166
26131970300,1774,1652,18,4,31,5,1,0,122
26131990100,0,0,0,0,0,0,0,0,0
26133970100,3986,3743,50,8,26,5,0,10,243
26133970200,4063,3836,41,11,23,11,0,9,227
26133970300,3197,2990,44,16,34,4,2,0,207
26133970400,3164,2878,84,29,14,1,0,5,286
26133970501,2120,1972,47,9,8,2,2,2,148
26133970502,2052,1878,49,28,23,0,0,1,174
26133970600,4309,3891,85,54,14,11,2,34,418
26135970201,1544,1447,22,0,5,1,0,1,97
26135970202,1665,1557,29,1,7,0,0,0,108
26135970300,1642,1544,35,2,3,3,0,2,98
26135970400,1936,1806,46,3,11,1,0,2,130
26135970500,1432,1330,22,2,8,0,0,6,102
26137950100,2805,2596,47,13,20,5,0,0,209
26137950200,5721,5278,90,7,48,21,0,10,443
26137950300,5936,5400,136,52,44,30,0,22,536
26137950400,2160,2055,23,0,3,1,0,0,105
26137950500,3830,3519,82,15,23,15,0,19,311
26137950600,4639,4308,68,13,13,19,0,9,331
26139020100,5286,4797,267,35,12,15,0,15,489
26139020200,4828,4226,264,65,19,22,3,17,602
26139020400,4572,4151,144,38,14,31,0,0,421
26139020501,3625,3268,128,15,13,53,1,12,357
26139020503,3847,3462,109,32,15,50,0,6,385
26139020504,2627,2377,83,35,17,26,0,13,250
26139020600,3317,3006,93,27,23,41,0,9,311
26139020900,4623,4112,188,39,27,45,0,19,511
26139021000,5614,5081,138,70,20,103,0,5,533
26139021100,4920,4544,120,24,9,39,0,14,376
26139021201,6016,5218,341,53,29,78,0,13,798
26139021203,4036,3564,133,32,26,111,0,5,472
26139021204,3004,2572,144,57,20,57,0,11,432
26139021301,3343,3033,91,0,7,30,3,17,310
26139021303,2737,2385,189,17,13,23,0,5,352
26139021304,5936,5419,205,21,12,63,0,30,517
26139021401,3441,3026,121,66,18,32,0,8,415
26139021402,5361,4935,131,44,16,43,5,20,426
26139021501,4906,4437,156,41,9,96,1,16,469
26139021502,3889,3301,271,86,8,111,0,10,588
26139021603,4603,4126,178,44,7,46,0,14,477
26139021604,7033,6316,341,50,12,60,1,11,717
26139021605,3965,3558,162,35,5,52,0,27,407
26139021606,4969,4447,211,64,7,46,2,9,522
26139021700,5275,4699,219,52,5,75,4,19,576
26139021801,4837,4217,280,53,18,65,2,9,620
26139021802,4686,4263,165,51,7,41,0,5,423
26139021901,5129,4676,178,39,2,36,0,7,453
26139021903,5175,3937,741,55,9,261,0,11,1238
26139021904,3206,3015,81,18,0,9,3,3,191
26139022001,6106,4762,840,71,20,132,0,26,1344
26139022002,4107,3615,234,44,11,86,2,6,492
26139022103,1497,1336,80,4,1,19,1,2,161
26139022105,5994,4116,1303,82,8,300,0,2,1878
26139022106,3873,3392,250,21,6,74,0,17,481
26139022107,1231,1030,121,6,0,28,0,2,201
26139022108,6030,5340,370,36,7,72,0,16,690
26139022206,4792,3612,533,55,3,445,5,18,1180
26139022207,4035,1974,1089,161,22,602,0,30,2061
26139022208,4934,1705,2427,136,14,460,20,16,3229
26139022600,2222,1867,219,27,0,26,0,2,355
26139022900,6336,5314,553,94,7,135,0,28,1022
26139023001,7654,6830,339,85,12,123,5,21,824
26139023003,4242,3380,448,49,0,203,0,2,862
26139023004,4163,3767,169,26,4,50,0,16,396
26139023101,5538,3027,1421,98,8,745,1,3,2511
26139023102,6330,3087,2122,291,8,520,8,19,3243
26139023200,2565,2374,78,5,10,8,0,2,191
26139023500,5264,4777,154,23,3,80,0,21,487
26139023600,2492,2303,69,9,4,31,0,0,189
26139024300,5327,4753,286,40,8,61,2,15,574
26139024401,6043,5093,428,184,17,27,0,26,950
26139024402,4499,3900,382,38,3,31,1,13,599
26139024501,5477,4372,454,258,5,94,0,24,1105
26139024502,7267,5797,340,643,59,245,0,29,1470
26139024600,7288,6400,329,177,16,89,0,16,888
26139024901,3687,2172,1133,119,5,80,3,22,1515
26139024902,2986,2529,214,77,4,79,0,0,457
26139025101,3642,1847,1272,69,1,287,1,23,1795
26139025102,3654,2452,785,106,10,156,0,10,1202
26139025200,5727,3550,1294,275,18,333,2,13,2177
26139025500,4366,3621,265,50,0,277,0,8,745
26139025700,5971,4272,1108,215,13,106,9,19,1699
26139025800,6055,2986,2401,239,20,131,10,24,3069
26139990000,0,0,0,0,0,0,0,0,0
26141950100,1795,1709,21,2,7,6,0,7,86
26141950200,2669,2504,43,7,12,20,0,7,165
26141950300,2063,1939,19,6,16,16,0,0,124
26141950400,2436,2256,20,5,25,6,0,6,180
26141950500,2608,2505,38,5,5,4,0,6,103
26141950600,1411,1369,13,3,2,0,0,0,42
26141990000,0,0,0,0,0,0,0,0,0
26143970100,1712,1599,29,4,2,9,1,1,113
26143970200,1746,1580,44,4,16,0,0,16,166
26143970300,2878,2639,77,19,3,12,1,5,239
26143970401,1144,1098,16,0,2,3,1,3,46
26143970402,688,639,8,0,7,1,1,1,49
26143970500,1017,959,14,0,3,0,3,3,58
26143970600,2138,2003,43,9,7,2,0,1,135
26143970700,2477,2306,33,3,13,15,0,9,171
26143971001,1637,1553,32,3,5,0,2,0,84
26143971002,1034,961,25,0,6,4,0,0,73
26143971003,1524,1423,33,0,6,11,1,2,101
26143971100,2711,2572,33,4,9,3,0,4,139
26143971200,2753,2551,47,14,15,16,0,2,202
26145000100,653,73,69,471,6,1,0,6,580
26145000200,1382,35,90,1161,3,3,0,14,1347
26145000400,982,250,132,554,0,20,0,2,732
26145000600,1477,230,250,932,0,0,0,0,1247
26145000700,1330,152,258,846,0,4,0,0,1178
26145000800,2258,88,226,1841,2,1,7,7,2170
26145000900,2812,210,274,2215,0,2,1,13,2602
26145001000,3314,324,511,2357,10,5,0,8,2990
26145001100,2804,279,567,1734,8,4,0,18,2525
26145001200,2820,1280,552,753,17,6,0,58,1540
26145001300,2173,952,406,668,9,19,1,8,1221
26145001400,2628,1490,427,542,11,3,0,20,1138
26145001500,3669,2011,670,703,5,22,0,21,1658
26145001600,3434,1527,635,1062,10,12,0,17,1907
26145001700,1751,795,240,576,3,23,1,11,956
26145001800,1415,607,177,522,11,8,5,18,808
26145001900,1740,776,398,420,0,14,1,20,964
26145002000,3351,1697,553,856,17,19,0,16,1654
26145002100,4154,2406,551,954,9,18,1,14,1748
26145010101,6028,4720,295,789,22,33,2,13,1308
26145010102,4578,4117,183,34,16,29,2,12,461
26145010200,4911,4010,268,360,3,96,0,94,901
26145010303,3566,2777,245,262,3,145,4,4,789
26145010304,5013,3133,502,834,9,262,39,27,1880
26145010305,3392,2592,193,212,0,259,0,16,800
26145010306,5187,3741,318,483,7,415,1,20,1446
26145010401,2635,1715,265,516,15,44,0,6,920
26145010402,5695,4240,586,541,12,104,0,35,1455
26145010404,2707,1985,276,247,9,66,3,18,722
26145010405,2845,1962,232,378,1,147,2,18,883
26145010501,2603,2050,173,215,7,46,0,16,553
26145010502,5612,4163,514,596,5,117,3,19,1449
26145010600,2484,1368,392,567,2,19,0,9,1116
26145010700,5750,3886,852,701,18,14,1,16,1864
26145010800,2197,1429,229,425,4,10,0,8,768
26145011001,3070,569,330,2013,10,9,0,22,2501
26145011002,2339,185,141,1896,16,0,0,1,2154
26145011100,1649,1317,110,136,8,0,0,1,332
26145011200,1874,1756,65,4,4,6,0,2,118
26145011301,3133,2920,97,21,7,15,0,0,213
26145011302,3749,3446,111,33,12,53,0,9,303
26145011500,2539,1236,408,760,15,15,0,9,1303
26145011600,3664,1536,322,1602,9,12,0,15,2128
26145011701,1660,1338,146,94,4,4,0,6,322
26145011702,2241,1951,147,31,14,17,0,4,290
26145011800,1975,1309,266,280,3,4,4,11,666
26145011901,1792,1631,98,5,1,2,2,3,161
26145011902,2277,2101,92,0,9,0,0,9,176
26145012001,3550,3108,240,65,5,22,0,0,442
26145012002,3824,3424,126,40,3,109,0,8,400
26145012003,4557,4105,226,49,10,51,1,3,452
26145012100,3955,3676,138,6,1,3,0,9,279
26145012200,1618,1490,61,4,6,0,0,9,128
26145012300,2892,2718,97,9,0,4,1,3,174
26145012400,1842,1692,58,3,7,0,0,9,150
26145012500,3829,3557,133,9,3,9,1,3,272
26145012600,3421,3067,169,17,10,3,2,8,354
26145012700,4649,4215,252,17,7,23,0,6,434
26145012900,4722,4272,189,56,10,4,0,8,450
26145013000,4065,3686,137,19,14,8,0,9,379
26145013100,5888,5347,236,52,20,10,0,0,541
26147620000,4719,3062,377,755,40,25,4,26,1657
26147621000,3488,2668,191,337,25,17,0,12,820
26147622000,4047,3085,316,310,25,32,0,10,962
26147623000,2986,2218,222,227,16,9,0,19,768
26147624000,1598,1182,66,195,22,3,0,14,416
26147625001,1486,1219,62,80,10,3,2,5,267
26147626001,1938,1563,98,90,6,15,0,5,375
26147627000,2542,2240,84,83,4,20,2,7,302
26147628000,3481,2880,187,125,26,28,0,16,601
26147629000,2678,2346,86,97,5,38,0,8,332
26147630100,1359,1246,27,32,3,17,0,3,113
26147630400,5900,5297,211,84,9,48,0,10,603
26147631100,1931,1739,59,31,5,19,0,1,192
26147631600,2052,1836,62,33,4,40,0,3,216
26147632000,4077,3672,141,33,15,21,1,17,405
26147633100,2828,2560,102,14,10,7,0,11,268
26147633200,2695,2488,67,23,4,7,1,4,207
26147634100,3804,3414,107,57,8,16,0,6,390
26147634600,5805,5283,194,41,13,22,0,15,522
26147635000,6216,5502,224,152,22,24,0,16,714
26147636000,4576,3459,253,526,31,18,0,14,1117
26147637100,3940,3674,91,20,5,39,0,11,266
26147637200,3821,3473,149,20,10,9,1,13,348
26147637300,2236,2037,62,29,8,28,0,1,199
26147640100,2296,2129,36,12,7,40,0,7,167
26147640200,2442,2275,49,11,2,16,0,1,167
26147640600,2347,2184,42,7,14,8,0,4,163
26147641000,3509,3293,56,17,4,12,0,4,216
26147642000,5464,4993,133,38,10,38,0,33,471
26147643000,3704,3483,71,21,11,15,0,3,221
26147644000,4228,3900,94,23,22,13,0,19,328
26147645000,3257,3047,57,8,10,9,0,4,210
26147646000,4510,4171,66,10,13,7,0,20,339
26147647000,2977,2838,34,5,8,10,0,15,139
26147648000,959,926,3,1,6,2,0,2,33
26147649000,4196,3900,71,5,28,6,0,16,296
26147650100,3952,3566,111,61,13,6,2,6,386
26147650200,1015,947,21,4,5,4,0,2,68
26147651100,1871,1768,35,2,1,3,0,8,103
26147651200,2122,1903,105,8,12,5,0,9,219
26147651600,4112,3794,98,20,16,13,0,15,318
26147652100,2405,2286,33,12,3,7,0,0,119
26147652600,3180,2942,52,57,8,6,0,9,238
26147655100,4917,4603,143,10,7,11,0,0,314
26147655600,3319,3138,73,12,4,12,0,9,181
26147657100,1987,1566,355,3,3,5,0,0,421
26147657200,5362,4948,207,8,14,23,0,6,414
26147658100,2515,2363,69,7,6,10,0,0,152
26147658500,3514,3280,53,11,8,22,0,4,234
26147989000,20,10,0,6,0,1,0,0,10
26147990000,0,0,0,0,0,0,0,0,0
26149040100,3640,3148,134,115,17,52,1,6,492
26149040200,1909,1334,174,260,5,8,0,7,575
26149040300,2933,2364,140,181,10,33,0,15,569
26149040400,2236,1565,182,292,8,24,3,10,671
26149040500,2901,2177,491,31,2,67,0,14,724
26149040600,3140,1973,796,65,8,12,0,9,1167
26149040700,3160,1751,1131,42,8,16,0,11,1409
26149040800,3321,2234,884,42,2,27,0,9,1087
26149040900,4098,3689,143,51,10,23,0,15,409
26149041000,3528,3320,71,24,11,8,0,7,208
26149041101,4104,3655,235,26,11,22,0,12,449
26149041102,3194,2910,99,32,8,20,0,7,284
26149041200,2950,2644,94,64,5,9,0,2,306
26149041301,3224,3018,46,23,8,23,3,13,206
26149041302,3380,3210,63,11,2,7,1,1,170
26149041400,4997,4450,239,34,18,20,0,21,547
26149041500,4381,3867,228,32,7,30,1,11,514
26149041600,3843,3365,277,16,11,13,0,4,478
26151970100,1667,1551,68,0,8,8,0,0,116
26151970200,2442,2354,37,2,5,0,0,1,88
26151970300,3452,3223,121,7,11,0,0,12,229
26151970400,3835,3455,207,5,10,12,0,7,380
26151970500,2301,2120,58,6,6,10,0,5,181
26151970600,2037,1913,71,5,4,6,0,0,124
26151970700,1300,1227,40,3,0,4,0,0,73
26151970800,5774,5061,440,21,15,8,0,19,713
26151970900,4913,4500,170,60,7,16,2,19,413
26151971000,4292,3906,162,19,13,9,0,21,386
26151971100,3492,3195,149,6,14,3,0,4,297
26151971200,5106,4704,151,17,19,8,0,10,402
26151990000,0,0,0,0,0,0,0,0,0
26153000100,2513,2061,19,4,268,0,0,4,452
26153000200,2455,2149,21,0,150,0,0,0,306
26153000300,3079,2517,56,6,281,15,1,1,562
26153990000,0,0,0,0,0,0,0,0,0
26155030100,5694,5360,116,25,18,13,0,11,334
26155030200,3449,3195,84,18,3,19,0,15,254
26155030300,5744,5226,207,25,9,26,0,1,518
26155030400,2862,2603,129,15,11,14,2,6,259
26155030500,3370,3013,149,28,14,25,3,7,357
26155030600,1786,1535,91,51,7,5,1,9,251
26155030700,2208,1992,93,16,0,1,0,11,216
26155030800,3319,2952,159,14,10,7,0,9,367
26155031301,4088,3782,108,0,21,15,1,8,306
26155031302,4048,3770,84,6,18,17,0,17,278
26155031401,6231,5711,169,25,25,31,0,14,520
26155031402,3687,3312,110,32,6,8,0,29,375
26155031501,3565,3250,64,13,12,22,5,16,315
26155031502,2667,2399,77,16,12,18,0,8,268
26155031600,3528,3230,98,14,11,16,0,7,298
26155031700,4068,3730,112,12,18,32,0,6,338
26155031800,4024,3743,98,5,13,8,3,4,281
26155031900,3756,3436,76,4,15,11,4,10,320
26157000100,4283,3975,143,12,13,10,3,4,308
26157000200,3039,2804,109,6,7,5,0,5,235
26157000300,3057,2758,163,10,10,3,0,10,299
26157000400,3298,3068,101,10,8,9,3,11,230
26157000500,5064,4674,135,11,16,11,1,14,390
26157000600,4565,3958,291,51,16,35,0,3,607
26157000700,3325,2964,110,38,17,13,0,4,361
26157000800,3643,3408,102,10,5,18,0,8,235
26157000900,5201,4533,236,180,14,11,0,18,668
26157001000,5274,4854,139,12,18,7,0,29,420
26157001100,3429,3130,85,33,12,9,3,19,299
26157001200,4367,4072,85,15,23,8,1,3,295
26157001300,4778,4413,109,14,15,16,1,4,365
26157990000,0,0,0,0,0,0,0,0,0
26159010101,4357,3814,226,63,15,8,4,15,543
26159010102,2418,2209,91,9,6,6,0,4,209
26159010201,3444,2524,518,166,30,15,2,12,920
26159010202,2518,1951,400,48,7,0,2,11,567
26159010300,1823,1568,53,95,13,15,0,7,255
26159010400,2482,1714,186,402,14,15,0,16,768
26159010500,3696,2620,465,321,17,46,0,21,1076
26159010600,2510,1031,834,466,11,15,4,12,1479
26159010901,3833,3340,217,29,19,14,3,25,493
26159010902,3981,3561,128,57,19,33,0,2,420
26159011003,3939,3443,184,48,17,35,2,22,496
26159011004,3631,3034,374,37,18,9,0,5,597
26159011300,4522,3203,970,38,27,7,0,17,1319
26159011400,4303,2667,1280,54,93,8,1,11,1636
26159011500,3338,2518,617,28,50,6,0,15,820
26159011601,3823,3054,410,53,45,17,0,21,769
26159011602,2320,2070,117,9,5,9,0,3,250
26159011801,2516,2098,169,64,19,22,2,15,418
26159011802,4365,3739,310,62,36,24,1,8,626
26159011900,5855,5091,245,77,13,62,2,26,764
26159012001,4008,2675,857,203,63,16,1,17,1333
26159012002,1905,1476,315,19,15,2,3,0,429
26159990000,0,0,0,0,0,0,0,0,0
26161400100,1958,1155,108,56,6,525,4,12,803
26161400300,4212,2788,271,113,3,815,1,69,1424
26161400400,3014,2482,144,73,0,139,2,9,532
26161400500,7235,5059,457,270,9,1059,0,36,2176
26161400600,5090,3843,358,155,5,425,1,18,1247
26161400700,2569,1914,121,193,3,173,0,11,655
26161400800,3410,2153,264,109,5,707,0,15,1257
26161402100,2917,1784,200,130,6,637,0,14,1133
26161402201,5503,3148,323,250,2,1424,1,56,2355
26161402300,2813,1916,99,64,5,534,0,18,897
26161402500,2311,1225,104,57,1,751,1,8,1086
26161402601,4091,2202,234,227,2,1150,0,43,1889
26161402700,5396,3067,252,188,2,1588,1,21,2329
26161403100,1542,1202,54,42,2,121,3,10,340
26161403200,3369,2628,146,187,1,143,1,19,741
26161403300,4220,3143,220,309,4,258,4,28,1077
26161403400,3114,2589,135,84,2,120,2,16,525
26161403500,3026,2368,166,163,9,124,0,26,658
26161403600,5818,2264,189,305,2,2773,0,32,3554
26161403800,3153,1726,159,570,7,479,1,29,1427
26161404100,3069,2460,152,121,4,117,0,14,609
26161404200,1983,1131,166,393,1,128,0,13,852
26161404300,2696,2236,114,72,1,98,0,13,460
26161404400,2275,1756,99,79,2,196,2,5,519
26161404500,4421,2564,288,396,13,890,2,24,1857
26161404600,4751,3282,295,325,2,539,1,16,1469
26161405100,2264,1366,218,342,0,132,2,14,898
26161405200,4897,3561,251,205,4,575,0,32,1336
26161405300,5133,3825,215,90,8,646,4,19,1308
26161405400,2048,1568,140,111,1,84,0,12,480
26161405500,2365,1310,151,410,10,278,1,13,1055
26161405600,4544,1989,321,1170,1,764,1,47,2555
26161406000,3673,2293,145,115,3,944,0,16,1380
26161407000,5215,3837,184,174,4,672,0,26,1378
26161407400,6466,2334,613,2790,14,163,0,48,4132
26161407600,3151,1599,159,1000,1,205,5,15,1552
26161410100,3306,1175,373,1248,6,246,5,14,2131
26161410200,3145,2120,192,439,7,151,4,31,1025
26161410300,3871,2793,227,525,10,75,0,20,1078
26161410400,3584,2225,295,661,10,163,6,21,1359
26161410500,2153,951,151,805,1,92,0,15,1202
26161410600,3007,844,174,1729,0,35,3,23,2163
26161410700,1454,685,107,549,7,35,0,9,769
26161410800,1711,966,156,411,3,36,0,16,745
26161410900,1433,1153,69,76,1,20,0,11,280
26161411000,2490,1615,197,401,14,95,5,22,875
26161411200,2665,746,124,1522,15,58,0,8,1919
26161411700,2331,1470,117,517,5,27,3,11,861
26161411900,3743,2009,392,997,8,46,0,20,1734
26161412000,3728,2192,214,964,7,58,5,20,1536
26161412100,3732,2009,277,1071,19,35,1,31,1723
26161412300,2990,693,222,1876,9,11,0,27,2297
26161412600,2602,1646,147,553,5,73,0,7,956
26161412700,4983,2680,267,1538,6,102,1,44,2303
26161413000,3635,1756,164,1358,15,33,0,39,1879
26161413200,5190,2939,270,1420,15,122,1,25,2251
26161413401,4607,2440,238,1288,4,296,0,32,2167
26161413402,5586,3141,360,1451,9,206,0,30,2445
26161413403,1962,1414,99,247,0,91,1,10,548
26161414000,3193,1259,239,805,14,690,0,23,1934
26161414200,2930,1628,280,436,11,378,0,18,1302
26161414300,3025,1269,487,573,5,521,1,9,1756
26161414500,3073,1637,129,474,1,600,5,16,1436
26161414700,1584,1073,84,95,5,256,3,12,511
26161414900,3704,1936,172,155,0,1233,3,10,1768
26161415200,2407,1345,188,324,5,384,2,11,1062
26161415400,2123,1410,216,143,15,240,1,7,713
26161415600,2594,1953,53,88,5,350,0,6,641
26161415800,3608,2531,130,138,8,610,0,26,1077
26161416000,3686,1845,686,364,3,531,0,22,1841
26161416200,5169,4024,191,265,4,367,0,18,1145
26161420000,3745,2897,138,430,4,41,1,16,848
26161420200,3338,2777,130,189,17,19,0,22,561
26161421100,3865,3310,185,84,14,33,0,13,555
26161422201,3582,3132,123,30,3,107,0,21,450
26161422202,3923,3219,420,55,8,55,0,10,704
26161423400,6368,5517,225,94,9,203,1,20,851
26161423600,2606,2220,95,64,2,85,3,9,386
26161425000,4380,3435,398,127,3,173,4,15,945
26161426001,2252,1984,72,46,9,39,0,3,268
26161426002,2036,1686,75,30,4,120,3,4,350
26161431000,4626,4224,156,25,14,21,0,16,402
26161432000,4764,4391,106,17,9,39,0,21,373
26161444000,6696,6101,177,42,8,71,0,19,595
26161445000,2656,2348,63,71,7,14,0,17,308
26161446200,2252,2046,74,18,3,22,0,3,206
26161446400,3215,2894,104,19,7,71,0,5,321
26161447000,3311,2959,91,43,9,47,0,18,352
26161448000,4024,3544,170,38,6,81,1,8,480
26161453000,5212,4306,145,103,8,351,6,13,906
26161454001,1257,1142,30,15,2,18,0,11,115
26161454002,3719,3241,174,20,3,109,1,16,478
26161455000,5072,3362,464,296,6,518,3,28,1710
26161456000,5914,3783,340,373,6,1014,3,34,2131
26161461000,7371,6619,206,41,16,123,0,37,752
26161464000,7018,6031,244,232,24,133,0,26,987
26161465001,2136,1889,101,20,13,11,0,1,247
26161465002,3810,3343,142,46,14,34,0,12,467
26161466000,2604,2329,80,16,4,55,0,8,275
26161980101,6052,3932,333,561,12,943,6,38,2120
26161980102,3713,2782,123,433,1,123,34,65,931
26161980200,0,0,0,0,0,0,0,0,0
26161980300,2012,1156,64,713,48,11,0,7,856
26161980400,0,0,0,0,0,0,0,0,0
26161980500,2376,1668,147,158,4,174,27,34,708
26161980600,1603,601,128,831,19,17,0,0,1002
26161984000,34,13,6,1,2,0,0,0,21
26163500100,3996,198,48,3648,3,11,0,7,3798
26163500200,3037,86,57,2790,6,10,1,6,2951
26163500300,2149,99,52,1903,0,30,0,4,2050
26163500400,751,25,7,700,0,0,0,4,726
26163500500,1507,28,18,1416,6,1,0,9,1479
26163500600,2692,64,44,2486,3,18,2,10,2628
26163500700,4109,130,65,3782,7,2,0,8,3979
26163500800,2569,110,21,2329,0,8,0,9,2459
26163500900,3706,74,47,3485,4,6,0,14,3632
26163501000,2945,70,17,2748,2,10,0,7,2875
26163501100,3328,70,28,3131,7,2,1,16,3258
26163501200,1609,47,13,1496,7,0,0,5,1562
26163501300,3078,88,51,2848,4,1,0,14,2990
26163501400,3624,284,59,3152,7,8,0,13,3340
26163501500,4056,307,37,3569,11,18,0,15,3749
26163501600,1955,263,42,1582,0,10,1,5,1692
26163501700,2218,431,52,1636,6,7,0,7,1787
26163501800,4117,655,98,3155,7,20,2,23,3462
26163501900,2490,101,46,2246,2,5,0,15,2389
26163502000,1858,68,25,1719,0,3,0,5,1790
26163502600,3321,47,64,3078,11,10,0,21,3274
26163502700,2359,124,44,2119,13,4,0,5,2235
26163503100,2996,188,25,2688,5,3,0,6,2808
26163503200,3002,129,57,2700,6,11,0,15,2873
26163503300,3407,90,41,3136,1,10,0,21,3317
26163503400,886,35,17,755,2,51,0,5,851
26163503500,2709,78,31,2486,11,54,0,0,2631
26163503600,1476,32,28,1307,1,56,2,3,1444
26163503900,1730,40,30,1570,2,4,0,17,1690
26163504000,1093,32,20,999,0,2,0,4,1061
26163504100,1173,15,14,1109,5,0,0,6,1158
26163504200,1644,39,14,1538,6,1,0,5,1605
26163504300,1834,34,15,1734,3,3,0,2,1800
26163504400,1416,24,16,1321,11,0,0,6,1392
26163505100,2888,170,37,2603,3,3,0,2,2718
26163505200,2943,50,32,2780,5,4,0,18,2893
26163505400,1927,46,35,1765,3,24,0,11,1881
26163505600,4078,93,28,3771,20,6,4,18,3985
26163505700,2936,109,41,2704,1,4,0,8,2827
26163505800,3337,1634,24,1436,2,53,0,15,1703
26163506100,1875,58,22,1737,8,8,0,6,1817
26163506200,1814,52,43,1662,5,2,0,9,1762
26163506300,1860,80,24,1695,0,1,0,23,1780
26163506400,842,118,17,665,1,5,0,2,724
26163506500,1963,55,65,1792,0,1,0,6,1908
26163506600,2713,83,53,2461,1,1,0,13,2630
26163506700,1023,27,10,960,0,3,0,1,996
26163506800,3904,116,52,3588,13,6,3,16,3788
26163506900,3579,76,35,3374,8,0,0,9,3503
26163507000,2720,23,31,2580,2,4,0,15,2697
26163507100,2266,30,32,2105,4,2,0,1,2236
26163507200,1003,18,22,924,1,5,0,0,985
26163507300,2285,40,38,2117,8,0,0,8,2245
26163507400,2488,54,25,2322,5,2,0,11,2434
26163507500,2221,64,27,2041,5,3,0,15,2157
26163508000,1098,100,14,902,10,5,0,13,998
26163508100,1271,150,40,1019,5,7,0,8,1121
26163509000,1975,223,56,1567,3,7,0,15,1752
26163509100,4563,575,36,993,2,2750,0,14,3988
26163510600,5499,1447,41,1146,10,2639,0,14,4052
26163511200,1188,134,31,969,2,3,1,0,1054
26163511300,2231,881,34,1016,6,139,0,12,1350
26163511400,2005,227,53,1629,6,14,1,5,1778
26163511900,1559,314,45,1097,1,34,0,12,1245
26163512800,2415,149,64,2126,0,1,0,10,2266
26163513200,1504,290,38,1080,4,13,0,5,1214
26163513300,1971,295,51,1527,5,17,0,20,1676
26163513700,2982,72,33,2792,7,11,0,10,2910
26163513800,2367,170,39,2047,6,5,0,12,2197
26163513900,1556,36,12,1452,1,5,0,3,1520
26163514100,1732,32,19,1627,2,5,0,8,1700
26163514200,1828,31,25,1701,10,2,1,7,1797
26163514300,2163,70,18,2001,16,8,0,2,2093
26163514500,861,14,3,817,2,0,0,0,847
26163515200,1315,184,53,1013,0,11,3,7,1131
26163515300,2708,596,64,1871,6,30,0,11,2112
26163515400,1358,741,56,465,4,14,1,16,617
26163515700,4618,714,85,3582,7,67,1,28,3904
26163516000,2235,177,44,1916,7,13,0,6,2058
26163516400,1097,308,45,666,3,26,0,12,789
26163516500,2560,1026,91,1224,2,101,0,8,1534
26163516600,2377,83,25,2190,7,6,0,6,2294
26163516700,3218,68,38,3027,4,12,0,10,3150
26163516800,569,50,20,468,3,0,2,1,519
26163516900,2111,191,23,1828,0,7,0,1,1920
26163517000,2978,1225,120,1230,9,246,0,17,1753
26163517100,1552,487,55,885,4,82,1,4,1065
26163517200,1758,1020,151,432,4,88,0,11,738
26163517300,2131,718,62,1215,9,62,0,5,1413
26163517500,2856,445,43,2050,5,217,1,12,2411
26163518000,2280,639,73,1380,1,98,0,10,1641
26163518900,2121,87,32,1941,5,13,0,7,2034
26163519000,1091,90,16,923,3,5,0,8,1001
26163519100,1037,213,50,714,7,9,1,0,824
26163519200,1440,49,4,1333,5,2,3,6,1391
26163519300,1208,106,18,1028,3,2,2,7,1102
26163520200,3650,2002,99,837,15,527,5,29,1648
26163520300,2622,1043,81,714,11,652,4,14,1579
26163520400,1940,619,70,1070,4,72,0,33,1321
26163520700,3151,1682,184,947,9,183,0,17,1469
26163520800,1242,488,67,480,5,125,5,10,754
26163521100,1544,339,712,418,12,8,1,6,1205
26163521400,1403,719,166,391,1,37,2,11,684
26163521500,1354,243,113,890,0,3,0,15,1111
26163521800,1466,47,9,1347,3,8,0,8,1419
26163521900,2943,978,106,1659,5,57,0,33,1965
26163522000,1789,64,31,1641,4,0,1,13,1725
26163522300,1193,38,13,1086,9,0,0,4,1155
26163522400,924,66,11,803,0,3,0,7,858
26163522500,1442,167,23,1191,3,2,0,17,1275
26163522800,1186,74,205,847,0,7,0,4,1112
26163523100,1336,253,820,218,2,3,0,4,1083
26163523200,3247,406,2620,141,3,7,0,8,2841
26163523300,2914,296,2345,193,8,3,0,10,2618
26163523400,2196,533,990,570,4,9,0,7,1663
26163523800,3759,578,2890,202,6,6,0,3,3181
26163524001,2553,313,2044,110,16,2,1,7,2240
26163524101,3730,517,2769,332,12,5,0,9,3213
26163524200,4366,604,3460,208,18,8,0,12,3762
26163524300,2626,427,2011,116,9,5,1,5,2199
26163524500,83,44,22,14,0,1,0,1,39
26163524600,1401,371,730,228,9,7,0,0,1030
26163524700,3768,63,416,3124,13,0,2,29,3705
26163524800,2586,98,335,2033,7,0,1,9,2488
26163525400,1795,120,760,856,2,8,0,8,1675
26163525700,4403,564,3552,175,12,14,0,14,3839
26163525800,1781,214,1407,96,5,7,1,3,1567
26163525900,2610,280,1752,511,10,6,0,16,2330
26163526000,3043,1532,1257,126,4,21,0,15,1511
26163526100,2753,1695,767,94,1,23,0,15,1058
26163526200,3026,1022,1749,124,4,9,0,16,2004
26163526300,3345,331,2739,224,10,4,0,4,3014
26163526400,1417,73,1078,224,7,3,0,3,1344
26163526500,1796,39,489,1201,4,3,0,16,1757
26163527900,1835,47,289,1443,9,0,0,7,1788
26163530100,2336,91,32,2139,2,2,0,22,2245
26163530200,3546,592,77,2707,6,62,0,3,2954
26163530300,1341,9,17,1259,6,0,0,7,1332
26163530400,1283,7,15,1233,7,0,1,4,1276
26163530500,2253,106,64,1974,0,14,0,7,2147
26163530800,1394,25,36,1281,2,2,0,0,1369
26163530900,1698,36,22,1561,6,8,0,8,1662
26163531100,946,19,16,879,3,0,2,1,927
26163531200,2242,403,49,1661,6,16,0,11,1839
26163531300,1153,47,22,1033,0,3,0,13,1106
26163531400,1518,75,10,1369,0,10,0,6,1443
26163531501,1276,62,22,1126,0,2,0,12,1214
26163531502,809,12,9,745,0,0,1,0,797
26163531600,1644,29,15,1544,3,1,0,4,1615
26163531700,1645,22,21,1539,1,4,1,13,1623
26163531800,1500,20,31,1404,0,0,0,2,1480
26163531900,866,45,16,752,8,1,0,8,821
26163532100,2162,402,55,1569,10,19,0,7,1760
26163532400,1569,176,41,1259,6,8,0,10,1393
26163532600,2068,216,36,1615,0,95,1,19,1852
26163532700,558,33,7,498,0,3,0,3,525
26163533000,1426,179,54,1146,0,2,0,4,1247
26163533100,1388,82,34,1223,4,3,0,6,1306
26163533200,1104,17,24,1016,3,3,0,4,1087
26163533300,1196,55,37,1047,3,3,0,16,1141
26163533400,2215,59,37,2046,0,8,0,6,2156
26163533600,1390,42,98,1200,5,0,0,10,1348
26163533800,1921,47,84,1707,6,1,0,7,1874
26163533900,3356,753,104,2210,5,111,2,22,2603
26163534100,1691,9,24,1592,1,0,0,18,1682
26163534200,2991,26,51,2808,9,0,0,23,2965
26163534300,1087,13,28,988,8,1,0,11,1074
26163534400,1474,13,23,1379,3,1,0,10,1461
26163534700,3056,82,100,2746,6,2,0,14,2974
26163534800,2205,24,179,1884,2,4,0,2,2181
26163535000,2411,57,57,2192,4,4,0,17,2354
26163535100,1717,18,18,1656,2,2,0,7,1699
26163535200,2019,26,35,1879,2,1,0,5,1993
26163535300,3950,47,32,3693,7,2,0,23,3903
26163535600,3727,202,64,3329,0,8,0,25,3525
26163535700,1313,18,51,1205,0,3,0,11,1295
26163535800,3944,131,137,3519,15,6,1,11,3813
26163536100,3327,89,43,3059,4,0,0,28,3238
26163536200,2165,34,20,2040,0,6,0,8,2131
26163536300,2736,22,31,2575,11,0,0,17,2714
26163536400,2145,21,25,2055,0,1,0,1,2124
26163536500,2097,28,16,1945,0,5,0,9,2069
26163536600,2535,25,47,2398,0,0,0,17,2510
26163536700,1055,9,10,989,11,0,0,2,1046
26163536800,1667,5,15,1602,2,4,1,5,1662
26163536900,3374,47,28,3178,4,5,0,12,3327
26163537000,3334,45,19,3165,0,2,0,18,3289
26163537100,1946,28,36,1833,0,3,1,1,1918
26163537200,583,10,7,548,3,0,0,0,573
26163537300,1987,29,38,1822,0,0,3,15,1958
26163537500,2714,37,13,2567,5,0,4,20,2677
26163537600,3365,62,58,3137,0,10,0,16,3303
26163537700,2874,34,38,2696,7,1,0,9,2840
26163537800,1545,25,10,1465,4,0,0,7,1520
26163538100,2136,366,41,1622,0,11,6,14,1770
26163538200,1972,354,53,1462,8,19,1,10,1618
26163538300,2162,154,29,1870,2,10,12,12,2008
26163538400,3330,582,82,2457,1,24,0,16,2748
26163538500,5184,169,83,4690,13,14,0,49,5015
26163538600,4758,124,57,4388,7,5,0,42,4634
26163538700,3823,51,50,3631,1,1,0,12,3772
26163538800,1549,24,8,1478,1,0,0,5,1525
26163538900,3465,81,44,3249,0,3,0,11,3384
26163539000,2769,55,23,2588,7,7,0,14,2714
26163539100,1788,32,20,1666,6,1,0,6,1756
26163539200,4863,73,55,4568,2,11,0,25,4790
26163539300,3793,39,39,3577,12,3,0,37,3754
26163539400,3707,46,51,3487,12,1,1,20,3661
26163539500,2921,31,23,2796,5,6,0,12,2890
26163539600,3197,39,31,3017,11,2,0,12,3158
26163539700,2072,29,31,1943,6,0,0,4,2043
26163540100,3201,39,27,3026,10,1,0,12,3162
26163540200,3183,21,32,3020,3,1,0,22,3162
26163540300,3746,27,29,3541,11,11,0,21,3719
26163540400,2632,52,29,2458,9,5,0,9,2580
26163540500,3466,40,30,3265,3,4,0,22,3426
26163540600,3274,66,49,3035,8,0,0,34,3208
26163540700,3193,74,30,2974,3,14,0,12,3119
26163540800,2110,28,17,1965,4,3,2,16,2082
26163540900,3420,33,22,3276,7,6,0,10,3387
26163541000,3775,48,51,3548,4,2,1,17,3727
26163541100,2921,54,38,2699,11,6,0,23,2867
26163541200,2046,98,38,1832,4,4,0,9,1948
26163541300,2664,385,66,2084,10,5,0,19,2279
26163541400,2642,275,55,2155,7,11,0,13,2367
26163541500,3625,90,33,3376,16,1,0,11,3535
26163541700,2538,47,36,2378,6,0,0,8,2491
26163541800,2533,280,73,1997,11,31,0,28,2253
26163542100,4547,53,30,4321,6,5,0,8,4494
26163542200,3644,71,13,3440,10,3,0,17,3573
26163542300,2255,40,32,2096,3,2,0,21,2215
26163542400,2651,45,27,2487,22,1,2,10,2606
26163542500,2475,80,46,2236,6,5,2,28,2395
26163542600,3168,22,41,3023,2,5,0,9,3146
26163542900,3319,265,52,2879,13,12,0,20,3054
26163543000,1778,156,23,1538,2,0,0,14,1622
26163543100,2455,174,24,2147,4,16,0,20,2281
26163543200,3008,76,47,2784,6,3,0,22,2932
26163543300,3315,89,45,3112,3,0,0,17,3226
26163543400,3132,71,46,2945,3,1,0,13,3061
26163543500,1210,85,60,1005,4,6,1,4,1125
26163543700,1785,87,62,1523,17,0,0,15,1698
26163543900,785,89,24,638,5,0,0,5,696
26163544000,2534,132,19,2289,4,12,0,7,2402
26163544100,2222,105,35,1994,4,4,1,7,2117
26163544200,2005,185,57,1636,5,0,0,7,1820
26163544300,2428,468,42,1800,3,12,0,11,1960
26163544800,1775,195,63,1391,10,9,0,16,1580
26163545100,1026,22,8,956,0,0,0,2,1004
26163545200,2641,44,36,2467,2,0,0,19,2597
26163545500,3878,1068,230,2311,16,28,1,14,2810
26163545600,5319,3211,637,1168,6,38,0,33,2108
26163545700,2925,934,617,1224,14,10,0,10,1991
26163545800,5518,1610,1115,2494,20,27,0,58,3908
26163545900,3758,396,374,2817,13,3,0,33,3362
26163546000,2925,151,168,2467,10,10,0,12,2774
26163546100,3952,289,154,3352,6,13,0,21,3663
26163546201,3067,622,131,2174,6,17,2,18,2445
26163546301,1792,126,42,1544,6,12,1,8,1666
26163546600,1996,43,35,1806,6,0,1,10,1953
26163546700,2816,71,47,2603,3,4,0,1,2745
26163547000,3512,58,47,3315,7,5,1,10,3454
26163547100,4714,84,49,4403,12,3,0,25,4630
26163547200,3982,99,121,3627,8,4,0,10,3883
26163550100,3945,3226,97,339,6,111,0,19,719
26163550200,4109,3227,173,355,13,108,0,26,882
26163550300,3541,3141,119,93,5,64,0,1,400
26163550400,1648,1424,47,83,4,43,0,0,224
26163550500,4030,3663,109,97,9,43,0,2,367
26163550600,2696,2477,61,22,4,50,0,7,219
26163550700,5817,5258,162,120,5,79,3,35,559
26163550800,1635,1408,50,66,4,49,0,0,227
26163550900,2570,2289,59,28,2,124,0,5,281
26163551100,5347,4738,129,210,4,100,0,8,609
26163551200,3982,2995,135,579,6,64,0,18,987
26163551300,4383,1769,98,2257,8,73,0,20,2614
26163551400,4431,1099,104,3011,4,40,0,16,3332
26163551500,2441,661,44,1608,6,20,0,9,1780
26163551600,4237,672,54,3323,22,8,0,16,3565
26163551700,3399,2970,105,116,0,93,2,19,429
26163551800,3759,3061,121,327,2,98,3,14,698
26163552000,3701,1410,30,188,11,1921,0,14,2291
26163552100,5760,2273,50,1367,9,1685,1,30,3487
26163552200,4685,3089,60,277,4,985,3,35,1596
26163552300,4656,2570,63,181,7,1599,0,20,2086
26163552400,3524,1813,32,414,2,966,1,22,1711
26163552801,6102,4672,83,387,3,471,2,69,1430
26163553000,918,45,6,814,6,8,0,13,873
26163553100,1295,75,22,1125,1,9,0,9,1220
26163553200,572,23,2,516,0,1,0,4,549
26163553601,1931,148,48,1647,13,4,1,4,1783
26163553800,1370,116,43,1154,2,21,2,1,1254
26163554100,4247,1920,176,1814,29,23,2,22,2327
26163554200,3160,1797,151,941,10,20,0,22,1363
26163554300,5157,2897,218,1669,9,41,0,22,2260
26163554400,3404,1252,156,1738,14,35,2,18,2152
26163554500,2766,1314,110,1122,14,21,0,22,1452
26163554600,3756,2264,146,1074,10,12,2,34,1492
26163554700,3297,1495,133,1486,7,37,1,16,1802
26163554800,3611,1152,100,2175,2,27,0,22,2459
26163554900,3352,1161,112,1858,4,47,0,11,2191
26163555100,4697,2486,198,1648,11,55,0,8,2211
26163555300,3402,916,121,2128,9,44,0,19,2486
26163555401,2918,380,75,2349,4,23,4,16,2538
26163555500,3050,904,87,1923,6,19,1,8,2146
26163555600,2687,1229,95,1238,2,18,1,18,1458
26163556100,3360,2487,178,375,8,105,0,28,873
26163556200,2783,2067,108,370,5,128,0,9,716
26163556300,3263,2622,95,191,6,229,0,14,641
26163556400,4508,3728,103,195,3,318,2,12,780
26163556500,2172,1813,47,118,0,121,0,5,359
26163556600,3427,3054,92,52,2,117,0,10,373
26163556700,2680,2297,111,67,0,121,1,6,383
26163556800,1810,1615,58,21,1,48,0,7,195
26163556900,3686,2955,159,183,7,211,0,25,731
26163557000,3074,2206,146,383,7,164,0,12,868
26163557100,2626,1947,131,295,10,120,0,9,679
26163557200,2081,1826,65,59,3,30,0,10,255
26163557300,2220,1933,63,79,4,38,0,8,287
26163557400,3363,2985,133,32,4,47,1,6,378
26163557500,3922,3504,122,51,8,92,0,7,418
26163557600,3039,2728,108,50,13,52,0,11,311
26163557700,4258,3830,135,60,4,63,0,14,428
26163557901,4431,3997,131,97,8,73,1,0,434
26163558000,4296,3771,193,98,5,56,0,17,525
26163558100,3451,2916,130,147,3,78,0,9,535
26163558200,4461,3439,193,479,7,167,0,27,1022
26163558301,1906,1494,87,185,7,41,0,3,412
26163558400,3903,3235,117,189,6,180,1,17,668
26163558500,3863,3397,117,105,13,77,0,7,466
26163558600,1926,1629,74,45,3,73,0,0,297
26163558700,2729,2442,63,38,12,38,0,11,287
26163558800,2743,2408,126,39,9,59,0,5,335
26163558900,1866,1594,69,82,9,31,0,4,272
26163559000,2710,2321,111,99,7,48,2,5,389
26163559100,2626,2074,117,198,9,41,0,15,552
26163559200,2096,1711,98,83,6,39,1,9,385
26163559800,2891,77,54,2620,12,4,0,15,2814
26163560100,2793,2561,51,15,1,80,4,10,232
26163560201,2034,1397,142,155,4,242,0,15,637
26163560202,3562,2637,136,150,0,516,0,24,925
26163560300,3598,2634,129,143,2,520,0,11,964
26163560400,6471,5587,207,93,5,363,0,20,884
26163561200,7688,4144,248,222,7,2825,2,18,3544
26163561301,4350,3307,146,71,3,654,0,24,1043
26163561302,4055,2974,105,118,0,702,0,13,1081
26163561600,4056,3590,149,53,6,103,0,17,466
26163561700,2366,1909,126,86,7,101,1,3,457
26163561900,7117,5894,253,139,5,569,0,20,1223
26163562300,2173,1908,60,49,3,96,0,8,265
26163562400,5439,4836,162,58,10,177,0,20,603
26163562500,1975,1723,49,59,2,63,0,4,252
26163562600,3764,3368,120,27,1,83,0,9,396
26163562700,3631,3260,109,34,7,65,0,14,371
26163562800,3461,3004,136,68,2,136,1,13,457
26163562900,3326,2922,100,73,7,73,0,10,404
26163563200,3022,1716,114,700,6,304,3,5,1306
26163563300,3023,1946,114,365,8,460,0,9,1077
26163563400,5019,3895,171,324,6,324,0,11,1124
26163563500,6023,4662,237,213,9,584,0,32,1361
26163563600,2078,1547,98,96,7,262,0,1,531
26163563700,1928,1158,79,187,1,414,0,15,770
26163563800,2954,2227,128,239,9,192,0,13,727
26163563900,2650,1711,71,275,1,469,0,13,939
26163564000,2044,1089,88,481,3,276,0,22,955
26163564100,4541,2365,140,522,16,1242,0,36,2176
26163564200,3944,2800,122,386,8,444,2,10,1144
26163564300,2689,1862,122,223,4,355,0,20,827
26163564401,6131,4073,175,296,5,1346,0,24,2058
26163564402,6452,2970,263,556,3,2386,0,12,3482
26163564501,6122,4014,231,371,10,1207,0,27,2108
26163564502,3670,2054,108,350,5,1019,0,9,1616
26163564503,3498,1722,105,822,8,730,0,15,1776
26163564504,8340,4154,395,1131,18,2259,3,41,4186
26163564600,7112,4381,232,372,4,1788,0,33,2731
26163564700,4849,2423,206,890,9,1078,1,17,2426
26163564800,4819,3148,199,563,9,673,0,35,1671
26163564900,2557,1528,182,607,6,20,2,7,1029
26163565001,5194,2880,169,580,15,1316,0,16,2314
26163565100,3691,1880,152,1050,8,412,0,16,1811
26163565200,5239,2990,185,1096,12,738,0,26,2249
26163565301,1927,618,40,990,2,168,1,13,1309
26163565302,4478,1884,175,1667,8,517,0,41,2594
26163565600,2088,1733,88,111,1,44,0,5,355
26163565700,3529,2398,155,531,8,236,0,11,1131
26163565800,3751,2717,214,536,10,54,2,13,1034
26163565900,2626,1864,125,455,10,44,0,4,762
26163566400,1118,539,31,449,8,11,2,6,579
26163566500,2376,1347,120,666,13,72,0,26,1029
26163566600,2036,1316,73,500,8,24,0,15,720
26163566700,3977,2823,245,495,18,75,1,19,1154
26163566800,3057,1944,185,660,16,28,0,21,1113
26163566900,5149,3000,218,1377,13,152,0,33,2149
26163567000,3505,1149,227,1890,19,34,0,18,2356
26163567100,3721,2645,228,586,13,58,2,16,1076
26163567201,3577,2981,159,191,10,39,0,23,596
26163567202,3106,2151,104,651,9,73,0,17,955
26163567300,4643,3564,180,506,29,109,0,18,1079
26163567400,2732,2308,103,167,8,57,1,12,424
26163567800,4992,3118,210,1234,17,132,2,24,1874
26163567900,2905,2222,164,249,16,85,0,6,683
26163568000,2266,1593,103,342,15,116,1,4,673
26163568200,3838,2942,158,377,7,115,0,12,896
26163568300,4259,2679,247,864,31,59,2,14,1580
26163568400,3799,2959,141,383,19,57,0,7,840
26163568500,4489,2523,281,1262,27,35,0,18,1966
26163568700,3806,1994,180,1247,11,108,0,11,1812
26163568800,3756,1349,151,1804,4,249,1,28,2407
26163568900,2697,2012,90,315,10,143,0,4,685
26163569100,2504,2112,111,92,7,25,0,12,392
26163569200,2747,2204,163,166,4,32,1,5,543
26163569300,3688,3015,146,249,11,62,0,7,673
26163569400,2857,2324,100,233,11,37,2,19,533
26163569500,2791,2378,119,123,18,10,0,9,413
26163569600,3497,2948,181,127,8,44,3,17,549
26163569700,4328,3627,170,223,20,42,0,11,701
26163569800,2494,2062,94,169,8,24,0,5,432
26163569900,2474,1919,109,239,9,30,0,5,555
26163570100,4107,1206,121,2405,8,130,0,18,2901
26163570200,3043,851,90,1952,8,1,2,6,2192
26163570400,5360,1078,197,3690,18,17,1,55,4282
26163570500,3646,611,104,2688,23,20,0,21,3035
26163570600,2192,88,41,1922,8,12,0,11,2104
26163570800,2935,194,106,2444,8,9,0,14,2741
26163570900,2560,244,77,2099,5,4,0,21,2316
26163571000,2245,290,62,1784,5,4,0,7,1955
26163571500,5226,4335,100,522,5,64,1,18,891
26163571600,1929,1576,72,172,1,30,1,4,353
26163571700,2758,1859,125,608,1,47,0,15,899
26163571800,3640,2638,218,530,4,101,0,12,1002
26163571900,3035,2309,148,412,7,52,0,3,726
26163572000,2213,1955,74,69,1,26,0,1,258
26163572100,7106,6220,229,267,11,92,0,39,886
26163572200,7155,6344,153,346,12,107,0,32,811
26163572400,1512,1136,97,171,10,9,0,4,376
26163572500,1906,1101,116,488,8,38,0,16,805
26163572600,5439,3642,520,843,23,76,0,27,1797
26163572700,4624,3516,370,404,24,51,0,35,1108
26163572800,5929,4403,560,463,43,93,2,25,1526
26163572900,2660,1985,223,224,9,18,2,11,675
26163573000,3340,3086,60,66,0,46,1,6,254
26163573100,4820,3841,76,506,3,205,0,13,979
26163573300,4463,4093,57,33,3,57,0,12,370
26163573400,5706,5045,126,274,8,27,0,34,661
26163573501,5119,4522,44,96,0,87,0,55,597
26163573600,7392,6727,121,182,4,48,1,47,665
26163573701,2070,1875,32,38,1,9,0,39,195
26163573702,7178,6682,78,65,4,40,0,41,496
26163573800,5715,5214,68,89,0,50,0,17,501
26163573900,6018,5558,120,42,4,77,0,9,460
26163574000,6694,6058,92,94,3,66,1,48,636
26163574100,4875,4176,85,355,0,46,0,22,699
26163574203,3265,1919,95,577,0,542,0,18,1346
26163574301,3774,2822,124,187,7,521,0,33,952
26163574600,5352,4686,260,114,10,94,0,25,666
26163574700,4979,4368,281,78,1,70,2,23,611
26163574800,4588,4076,229,57,11,50,2,12,512
26163574900,1895,1582,68,115,3,73,0,10,313
26163575000,4702,3853,343,163,5,118,2,13,849
26163575100,2712,2152,197,175,7,55,0,3,560
26163575200,4389,3347,260,449,3,112,1,19,1042
26163575300,3804,3092,275,179,8,38,0,12,712
26163575401,3437,2775,278,174,10,47,3,9,662
26163575500,4184,3333,328,240,1,62,0,21,851
26163575600,1861,1498,128,113,7,37,0,12,363
26163576001,1922,1154,316,274,4,53,0,7,768
26163576100,6260,4546,1005,293,17,113,5,13,1714
26163576200,2566,2079,270,73,0,21,0,18,487
26163576300,2383,1932,259,67,5,28,1,2,451
26163576400,3596,2981,365,67,19,19,0,11,615
26163576500,3901,3226,403,43,4,22,1,18,675
26163576600,4361,3479,506,167,12,25,2,0,882
26163576700,3649,2946,358,134,16,67,0,11,703
26163577000,4419,1819,1351,1011,18,26,0,23,2600
26163577100,3251,1436,1264,356,19,17,0,20,1815
26163577200,3495,1808,1143,271,2,33,1,31,1687
26163577300,3386,2094,862,196,15,12,3,26,1292
26163577400,3613,2190,966,281,3,11,6,4,1423
26163577500,3591,2126,962,246,14,33,5,13,1465
26163577600,4006,2450,967,302,26,10,1,18,1556
26163577700,2437,1675,474,157,7,8,0,18,762
26163577800,5173,3433,1167,259,20,17,6,17,1740
26163577900,4206,2915,773,303,5,25,1,9,1291
26163578000,2668,1706,451,311,7,16,1,21,962
26163578500,6408,4179,1165,576,13,70,0,23,2229
26163578600,6443,3804,1316,752,25,91,2,58,2639
26163579100,1734,744,408,462,3,4,0,9,990
26163579200,3060,1201,681,931,22,6,0,18,1859
26163579300,2430,54,165,2113,4,1,0,13,2376
26163579501,1520,656,364,360,19,5,0,12,864
26163579600,3318,135,235,2799,2,7,0,22,3183
26163579700,2966,1204,820,725,11,13,0,13,1762
26163579800,1494,710,278,366,3,6,0,13,784
26163579900,5789,4425,249,456,4,456,4,15,1364
26163580100,1920,1584,136,80,10,9,0,6,336
26163580200,2818,2377,230,60,12,12,1,14,441
26163580300,2765,2348,224,48,8,9,2,12,417
26163580400,2594,2244,160,32,3,14,1,8,350
26163580500,2953,2622,185,20,2,4,0,7,331
26163580600,3105,2601,275,41,14,19,0,7,504
26163580700,3484,2933,239,72,14,35,2,9,551
26163580800,1511,1305,96,31,6,9,0,6,206
26163580900,3908,3328,246,83,18,17,1,10,580
26163581101,3849,2573,402,521,8,144,0,13,1276
26163581200,3736,2901,296,222,13,177,0,8,835
26163581500,2385,1896,220,93,1,25,0,11,489
26163581600,5811,3981,546,686,20,282,0,30,1830
26163581800,2665,2151,239,81,9,15,0,17,514
26163581900,4614,3718,480,129,19,21,5,14,896
26163582000,3049,2058,247,501,11,59,1,17,991
26163582100,3894,3257,313,50,28,36,0,12,637
26163583001,2568,1922,245,157,14,27,0,15,646
26163583101,3963,2870,346,403,14,41,0,11,1093
26163583200,2924,2252,231,213,8,14,0,7,672
26163583300,2562,1997,217,143,14,28,2,7,565
26163583400,4987,3904,451,275,18,37,2,18,1083
26163583500,2695,2109,237,152,10,31,2,0,586
26163583600,2593,2049,207,138,8,28,6,14,544
26163583700,3705,2623,310,453,24,47,2,33,1082
26163583800,4540,3230,298,666,12,115,1,11,1310
26163583900,4056,2157,240,1303,11,105,4,25,1899
26163584000,4670,2691,344,1286,13,68,0,22,1979
26163584100,1822,1452,153,93,13,15,0,3,370
26163584200,3619,1996,247,1102,6,82,0,17,1623
26163584300,2054,1075,116,645,6,89,2,12,979
26163584400,3166,1900,313,594,15,143,1,7,1266
26163584501,2636,1693,214,496,8,95,0,12,943
26163584600,2014,897,158,666,2,188,0,3,1117
26163584700,2511,1787,217,263,7,74,0,8,724
26163584801,3311,726,244,2104,14,44,0,15,2585
26163584802,2907,1073,201,1397,3,80,0,14,1834
26163585500,1822,1241,88,324,6,10,1,10,581
26163585600,3948,577,114,2982,6,62,1,26,3371
26163585700,2095,705,94,1139,8,10,1,3,1390
26163585800,4955,1534,218,2842,12,34,1,29,3421
26163585900,3169,1735,150,1034,14,8,4,27,1434
26163586201,7088,2857,340,3218,31,187,2,62,4231
26163586300,2056,1642,98,138,5,15,0,7,414
26163587000,4008,2822,165,737,12,36,0,5,1186
26163587900,7015,3012,221,3075,10,266,0,45,4003
26163588001,3290,1494,146,1294,10,199,0,14,1796
26163588002,2871,1767,153,676,14,43,4,5,1104
26163588101,1370,955,119,167,8,11,0,3,415
26163588102,1265,977,53,159,1,19,0,1,288
26163588200,3134,1545,184,1168,5,52,0,11,1589
26163588300,5708,4012,237,1008,14,74,2,38,1696
26163588400,5722,3408,180,1675,14,95,0,22,2314
26163589300,3609,2926,102,328,20,19,0,7,683
26163589401,2405,2004,103,123,8,2,0,5,401
26163589402,3646,2503,175,626,15,9,4,21,1143
26163590401,7844,6502,441,387,33,41,0,27,1342
26163590500,6570,5442,345,298,16,71,2,33,1128
26163590600,2477,2124,120,75,2,46,0,13,353
26163591501,3912,2257,263,789,7,392,0,13,1655
26163591502,3475,2103,232,497,10,473,0,18,1372
26163591600,2287,1419,194,383,0,155,1,19,868
26163591700,7337,5647,460,576,13,357,0,20,1690
26163591800,6189,4324,442,673,11,404,0,10,1865
26163591900,5305,4115,342,441,34,99,0,10,1190
26163592000,4689,3732,259,280,11,135,1,16,957
26163593001,5451,4272,338,458,20,117,0,13,1179
26163593200,3931,3045,302,254,7,138,0,10,886
26163593301,3541,2689,292,275,6,59,0,8,852
26163594000,2532,2151,145,100,6,14,0,6,381
26163594100,4387,3948,188,26,15,29,0,15,439
26163594200,2520,2252,108,11,13,21,0,13,268
26163594300,3141,2781,168,23,13,21,0,12,360
26163594401,2857,2425,174,87,10,17,1,4,432
26163594500,3082,2588,188,126,12,34,0,10,494
26163595000,3790,3296,223,37,24,14,0,8,494
26163595100,5527,4464,305,358,13,127,0,30,1063
26163595201,3164,2566,151,254,7,52,1,5,598
26163596100,3670,3362,106,19,8,54,0,19,308
26163596200,4321,3807,205,31,2,114,0,9,514
26163596300,2797,2486,127,11,4,59,0,6,311
26163597000,4997,4251,222,198,17,50,0,19,746
26163598000,3240,2884,120,47,16,24,2,4,356
26163599001,5274,4272,301,332,18,51,2,27,1002
26163599100,5247,4287,323,246,10,28,4,9,960
26163981700,0,0,0,0,0,0,0,0,0
26163981800,0,0,0,0,0,0,0,0,0
26163981901,0,0,0,0,0,0,0,0,0
26163981902,0,0,0,0,0,0,0,0,0
26163982000,20,18,1,0,0,0,0,0,2
26163982101,7,0,0,4,0,0,0,0,7
26163982102,11,7,1,0,0,0,0,0,4
26163982200,9,7,0,0,0,0,0,0,2
26163982301,25,12,7,4,0,0,0,1,13
26163982302,0,0,0,0,0,0,0,0,0
26163982400,99,57,16,18,0,0,0,2,42
26163982500,0,0,0,0,0,0,0,0,0
26163982600,7,4,1,0,0,0,0,0,3
26163982700,11,9,0,0,0,0,0,0,2
26163982900,0,0,0,0,0,0,0,0,0
26163983100,0,0,0,0,0,0,0,0,0
26163983200,0,0,0,0,0,0,0,0,0
26163983301,0,0,0,0,0,0,0,0,0
26163983302,0,0,0,0,0,0,0,0,0
26163983400,256,217,3,23,0,6,0,0,39
26163983600,9,5,0,0,3,0,0,0,4
26163983700,0,0,0,0,0,0,0,0,0
26163983800,0,0,0,0,0,0,0,0,0
26163983901,6,1,2,1,0,1,0,0,5
26163983902,0,0,0,0,0,0,0,0,0
26163983903,0,0,0,0,0,0,0,0,0
26163984100,4,0,2,0,0,0,0,0,4
26163984200,0,0,0,0,0,0,0,0,0
26163985000,19,0,9,10,0,0,0,0,19
26163985100,154,63,4,79,0,2,0,2,91
26163985200,3,1,1,0,0,0,0,0,2
26163985300,220,92,7,91,3,8,0,1,128
26163985400,16,16,0,0,0,0,0,0,0
26163985500,0,0,0,0,0,0,0,0,0
26163985600,0,0,0,0,0,0,0,0,0
26163985700,0,0,0,0,0,0,0,0,0
26163985800,0,0,0,0,0,0,0,0,0
26163985900,0,0,0,0,0,0,0,0,0
26163986100,3,1,0,0,0,0,0,0,2
26163986200,0,0,0,0,0,0,0,0,0
26163986300,29,11,8,7,0,0,0,0,18
26163986400,50,48,0,0,0,0,0,0,2
26163986501,0,0,0,0,0,0,0,0,0
26163986502,0,0,0,0,0,0,0,0,0
26163986600,0,0,0,0,0,0,0,0,0
26163987000,7,0,0,3,0,0,1,1,7
26163990100,0,0,0,0,0,0,0,0,0
26163990200,0,0,0,0,0,0,0,0,0
26165380100,5121,4731,116,24,19,10,1,10,390
26165380200,5083,4601,113,24,42,18,0,24,482
26165380300,2695,2467,47,9,17,6,0,13,228
26165380400,4779,4458,96,20,13,29,0,16,321
26165380500,6684,6166,126,25,25,48,0,14,518
26165380600,3169,2842,121,18,17,24,0,9,327
26165380700,2771,2479,69,18,15,27,0,16,292
26165380800,3371,3039,102,49,15,24,0,10,332
27001770100,2244,2117,25,2,33,5,0,2,127
27001770200,2278,2124,14,6,34,2,0,1,154
27001770300,3298,3064,59,24,42,15,0,7,234
27001770401,1308,1160,24,4,74,0,1,2,148
27001770402,1562,1282,45,8,160,0,0,9,280
27001790501,1887,1773,11,12,22,5,0,4,114
27001790503,1749,1664,26,0,1,1,0,0,85
27001790504,1371,1295,16,2,10,10,0,0,76
27003050107,3108,2808,70,25,12,31,0,17,300
27003050108,5510,4780,193,77,32,95,0,24,730
27003050109,5510,4897,132,28,21,147,6,15,613
27003050110,2661,2336,73,15,10,87,0,15,325
27003050111,3615,3254,85,24,20,72,0,6,361
27003050114,3063,2727,62,19,12,85,0,10,336
27003050115,5866,5236,108,29,19,227,0,16,630
27003050116,4536,4155,92,32,16,72,6,5,381
27003050208,3191,2577,130,146,14,169,0,18,614
27003050210,4159,3688,49,18,23,220,0,12,471
27003050215,4133,3529,125,45,6,208,1,20,604
27003050216,6042,5336,128,36,12,240,0,25,706
27003050217,3499,3124,75,56,1,100,0,16,375
27003050218,3220,2851,78,36,9,62,0,13,369
27003050219,2947,2587,72,60,8,84,0,9,360
27003050220,6827,5830,195,239,37,187,0,34,997
27003050222,5581,4810,151,179,10,204,1,16,771
27003050223,2972,2655,57,80,7,69,0,6,317
27003050224,3886,3341,77,141,7,132,0,34,545
27003050226,3159,2575,94,228,10,111,0,0,584
27003050227,4587,3766,137,330,13,150,3,10,821
27003050228,6767,4979,392,767,24,212,4,21,1788
27003050229,5516,4402,155,482,123,138,0,15,1114
27003050230,2891,2531,73,19,8,141,0,7,360
27003050232,3896,3426,124,19,20,116,0,17,470
27003050233,3087,2678,80,48,11,97,0,14,409
27003050234,3295,2989,60,22,8,90,0,0,306
27003050235,2994,2564,130,13,11,124,0,13,430
27003050236,4321,3892,90,27,7,169,0,6,429
27003050237,5584,4767,148,242,13,181,1,15,817
27003050238,4485,3897,118,176,7,82,1,4,588
27003050239,2851,2473,74,87,6,103,0,1,378
27003050240,3315,2713,111,174,14,130,0,6,602
27003050241,2960,2570,98,70,10,68,0,18,390
27003050401,3012,2219,129,283,27,137,2,7,793
27003050402,3585,2909,119,274,11,83,0,7,676
27003050501,3184,2655,141,129,30,49,0,17,529
27003050504,2547,2006,167,139,16,70,0,8,541
27003050505,5593,4197,293,568,31,204,3,19,1396
27003050602,2540,1922,138,207,15,118,0,11,618
27003050605,5798,4429,208,398,36,397,0,24,1369
27003050606,2010,1543,77,189,8,65,1,9,467
27003050607,4539,3205,244,490,31,220,2,27,1334
27003050608,4810,3054,406,666,27,362,0,13,1756
27003050609,3919,3025,155,343,25,161,2,13,894
27003050611,3630,2723,111,326,21,229,6,10,907
27003050612,2873,2098,139,269,18,228,0,16,775
27003050702,3194,2520,129,224,22,120,0,16,674
27003050704,4779,3527,238,436,26,255,0,21,1252
27003050706,3503,2168,204,715,37,156,0,25,1335
27003050707,6233,4635,233,549,18,513,0,30,1598
27003050709,2519,1863,134,189,9,168,0,18,656
27003050710,3564,2346,171,601,24,228,0,10,1218
27003050711,5129,3833,200,429,8,377,4,9,1296
27003050712,4559,3296,207,516,35,280,0,25,1263
27003050807,4303,2781,562,324,34,317,0,18,1522
27003050808,2193,1713,148,90,16,108,0,11,480
27003050810,4745,3241,483,414,39,356,1,12,1504
27003050811,3008,2354,205,137,11,105,0,16,654
27003050816,6769,5255,180,372,21,559,0,17,1514
27003050818,7828,6032,190,519,12,709,2,33,1796
27003050819,5574,4341,165,222,14,581,2,15,1233
27003050820,3357,2542,85,276,8,287,0,6,815
27003050821,4885,3485,169,347,9,629,0,12,1400
27003050822,2967,2130,122,406,19,138,0,13,837
27003050823,4137,3137,154,260,21,315,1,24,1000
27003050824,4037,2971,222,320,16,328,1,12,1066
27003050825,3148,2140,127,347,3,386,1,4,1008
27003050826,3690,2510,374,344,6,301,0,20,1180
27003050827,2509,1643,120,240,7,360,5,25,866
27003050828,3318,2106,530,114,32,356,0,10,1212
27003050829,3754,2727,110,242,8,462,3,16,1027
27003050901,2248,1690,138,183,13,88,1,4,558
27003050902,5025,4194,170,215,18,205,0,15,831
27003051001,3040,2053,163,475,37,192,2,8,987
27003051002,3943,2747,350,397,19,221,0,33,1196
27003051101,5254,3245,413,871,25,343,0,29,2009
27003051102,4774,2723,1076,451,33,274,4,18,2051
27003051103,3606,1784,340,932,46,309,0,23,1822
27003051201,3958,1793,364,1130,29,332,3,35,2165
27003051202,3943,2271,360,867,27,227,3,12,1672
27003051203,5493,3696,344,732,22,401,0,23,1797
27003051206,2562,1441,385,350,43,157,0,15,1121
27003051302,4698,2419,537,1136,42,304,3,18,2279
27003051304,2428,1324,454,379,33,101,3,14,1104
27003051305,3511,1575,955,486,43,257,0,33,1936
27003051400,5737,2684,812,1613,64,255,5,32,3053
27003051501,3335,1626,489,849,35,163,0,6,1709
27003051502,3222,2050,423,388,51,143,4,20,1172
27003051600,5334,4866,108,21,20,66,6,6,468
27005450100,3199,2971,27,14,41,10,0,5,228
27005450200,2247,2118,28,5,11,4,0,5,129
27005450300,5258,4627,87,40,152,19,0,3,631
27005450400,2754,2421,28,6,77,11,0,12,333
27005450500,4813,3843,159,90,272,52,4,24,970
27005450600,3433,2996,64,28,108,22,0,8,437
27005450700,3339,3061,29,8,61,23,1,12,278
27005450800,2527,2300,42,4,26,2,1,13,227
27005450900,3660,3397,60,5,34,13,2,4,263
27005940000,3953,1911,51,0,1635,0,1,14,2042
27007450101,2303,1754,64,9,257,6,2,12,549
27007450102,4792,4169,78,23,162,21,0,14,623
27007450201,1489,1308,28,8,67,6,0,0,181
27007450202,5611,4632,118,46,447,53,0,24,979
27007450300,4613,4151,35,9,92,27,6,22,462
27007450400,2904,2544,45,10,103,6,3,7,360
27007450500,1732,1608,14,0,27,7,3,6,124
27007450600,5018,3570,240,244,610,55,1,18,1448
27007450703,1946,1137,70,66,505,46,0,5,809
27007450704,3693,2806,167,33,423,22,0,9,887
27007450705,2118,1759,37,26,153,10,0,2,359
27007450706,2336,1692,70,41,330,9,0,6,644
27007940001,5506,85,98,1,5244,0,0,1,5421
27007940002,2167,1230,44,3,778,0,0,8,937
27009020100,5999,5706,86,19,24,13,0,2,293
27009020202,2815,2726,30,3,1,2,0,0,89
27009020203,2991,2824,56,16,1,7,1,4,167
27009020205,3402,3203,59,17,10,16,0,3,199
27009020206,2583,2359,69,25,7,27,2,10,224
27009020300,3949,3710,67,16,16,34,1,9,239
27009021102,4565,3912,189,142,22,70,2,35,653
27009021103,3512,2981,135,123,29,57,2,3,531
27009021104,4735,4203,121,55,25,104,0,6,532
27009021201,6828,4197,404,1575,49,133,0,37,2631
27011950100,1358,1282,22,4,9,2,3,1,76
27011950200,1732,1626,29,11,13,4,1,32,106
27011950300,2076,1901,89,4,12,6,0,1,175
27013170100,5448,4963,165,89,6,36,1,14,485
27013170200,8140,7087,271,303,25,182,5,16,1053
27013170300,3040,2442,229,140,12,42,2,12,598
27013170400,4167,3479,151,283,14,87,0,13,688
27013170500,4636,3563,316,355,19,174,2,16,1073
27013170600,2373,1689,214,275,18,49,0,7,684
27013170700,2554,1878,192,245,20,68,0,6,676
27013170800,4943,4211,199,259,9,60,0,29,732
27013170900,2988,2773,60,41,6,16,1,9,215
27013171000,3500,3252,111,28,8,8,0,6,248
27013171101,6002,4273,428,561,20,441,3,49,1729
27013171202,7391,5312,457,891,22,353,8,26,2079
27013171300,3787,3595,59,12,10,22,0,11,192
27013171400,3382,3146,99,19,2,11,0,6,236
27013171500,2618,2417,77,12,9,7,1,8,201
27013171600,4143,3142,193,360,8,278,1,19,1001
27015960101,1893,1721,80,17,1,10,0,1,172
27015960102,1274,1144,61,6,5,3,3,0,130
27015960200,4565,4276,125,35,7,39,0,11,289
27015960300,3232,2993,121,22,4,11,0,0,239
27015960400,4740,4538,111,13,7,24,1,8,202
27015960500,3685,3073,496,12,3,23,2,0,612
27015960600,3103,2891,147,6,12,7,0,0,212
27015960700,3420,3332,30,7,0,9,0,0,88
27017070100,5340,4638,72,29,212,59,2,8,702
27017070200,4145,3553,78,54,174,14,7,11,592
27017070300,5612,5283,65,11,52,25,1,10,329
27017070401,3606,3152,83,15,147,18,1,13,454
27017070402,4265,3909,53,12,76,8,0,11,356
27017070501,3647,2833,120,403,130,5,0,21,814
27017070502,3132,2910,32,5,22,9,1,2,222
27017070600,3375,3167,26,14,27,10,0,5,208
27017940000,3085,1465,83,13,1308,5,0,4,1620
27019090101,3077,2908,50,5,3,18,0,7,169
27019090102,3001,2726,105,51,6,10,0,1,275
27019090200,4687,4346,98,26,4,50,0,20,341
27019090302,6412,5708,269,62,11,111,1,21,704
27019090303,3773,3426,125,34,15,24,0,3,347
27019090304,3144,2932,73,12,3,26,0,9,212
27019090401,7624,6850,216,73,8,201,0,12,774
27019090402,6500,5852,138,71,1,175,1,17,648
27019090501,2750,2429,79,25,5,102,0,5,321
27019090502,3056,2664,110,18,3,148,0,4,392
27019090503,2606,2258,76,31,1,115,1,9,348
27019090601,4000,3289,270,79,12,193,1,17,711
27019090602,2949,2599,112,10,2,93,0,15,350
27019090702,3723,2858,116,25,4,546,0,13,865
27019090703,4728,3976,155,158,6,267,3,16,752
27019090704,2139,1827,39,11,2,140,0,19,312
27019090801,7300,5771,626,252,20,265,2,30,1529
27019090802,2371,2124,46,6,5,103,0,6,247
27019090901,3188,2541,403,36,11,79,0,10,647
27019090902,2044,1816,76,15,5,66,0,5,228
27019091001,5280,3083,1245,551,31,124,2,13,2197
27019091002,6768,5431,282,380,15,392,0,5,1337
27019091100,7554,6519,253,141,8,321,3,14,1035
27019091201,5112,4614,253,73,9,28,1,9,498
27019091202,3136,2896,93,28,3,20,0,4,240
27021940001,4214,3259,76,7,686,21,0,10,955
27021940002,3344,743,74,8,2252,2,0,9,2601
27021960100,2002,1776,15,3,67,4,0,1,226
27021960200,2375,1878,31,6,330,8,0,5,497
27021960301,1000,964,3,0,3,6,0,2,36
27021960302,1282,1213,9,0,10,6,0,11,69
27021960600,3123,2868,37,11,23,23,0,2,255
27021960700,4539,4260,64,9,29,19,0,18,279
27021960801,3651,3448,49,10,10,4,0,11,203
27021960803,2100,1972,24,7,8,6,0,10,128
27021960804,2436,2294,44,3,6,12,0,17,142
27023950300,2047,1810,88,21,62,1,0,8,237
27023950400,2344,2135,108,10,1,5,27,14,209
27023950500,2302,1826,196,7,2,9,219,4,476
27023950601,3005,2326,493,21,12,11,49,9,679
27023950602,2900,2376,358,16,25,18,1,14,524
27025110100,4170,3884,58,10,9,44,0,20,286
27025110201,2728,1850,127,525,95,22,0,1,878
27025110202,4463,4035,91,20,31,77,2,11,428
27025110301,4084,3624,126,31,41,56,0,13,460
27025110302,6703,5933,202,85,26,162,0,30,770
27025110402,4589,4083,155,37,14,82,1,20,506
27025110403,5122,4652,141,18,11,89,0,14,470
27025110404,4279,3850,142,32,16,42,0,15,429
27025110501,4128,3838,96,17,12,20,0,5,290
27025110503,4373,4057,69,24,9,36,0,8,316
27025110504,2391,2265,34,0,1,20,0,12,126
27025110600,5421,4945,117,20,17,77,0,21,476
27025110700,4170,3788,93,26,27,41,0,15,382
27027020300,3003,2382,213,112,61,55,1,8,621
27027020400,3875,2969,200,268,98,136,8,7,906
27027020500,5122,4522,175,111,77,46,0,2,600
27027020600,4384,3478,250,275,102,64,0,28,906
27027020700,2638,2201,179,59,58,20,0,2,437
27027030106,2123,1862,112,22,39,6,0,0,261
27027030107,1667,1560,45,0,5,6,0,5,107
27027030108,5695,3756,346,1157,125,40,0,14,1939
27027030109,3890,3187,214,213,51,59,0,2,703
27027030110,5567,4870,147,249,42,51,0,26,697
27027030111,5016,4105,254,259,60,75,2,2,911
27027030112,4648,3911,261,156,69,23,0,16,737
27027030201,5915,5538,104,4,45,8,0,5,377
27027030202,5014,4746,66,6,19,14,2,2,268
27027030300,4045,3068,322,160,135,114,3,7,977
27027030400,2716,2269,123,90,46,47,0,8,447
27029000100,2580,2198,27,9,185,11,2,4,382
27029000200,2827,2153,31,7,431,5,0,8,674
27029000300,3117,2800,43,3,136,7,0,10,317
27031480101,1522,983,22,5,397,8,1,8,539
27031480102,1926,1744,52,15,21,24,0,6,182
27031480200,2152,1943,49,5,32,16,0,11,209
27031990000,0,0,0,0,0,0,0,0,0
27033270100,2758,2093,305,18,5,247,5,9,665
27033270200,2311,2145,73,1,5,25,0,11,166
27033270300,3199,2744,223,54,8,38,12,12,455
27033270400,3249,2436,514,62,7,51,63,21,813
27035950100,2065,1985,13,0,7,5,0,5,80
27035950204,1992,1924,12,7,4,0,1,6,68
27035950401,4181,3945,35,12,21,14,5,5,236
27035950402,1613,1551,14,0,3,7,0,13,62
27035950501,2643,2537,23,7,0,8,3,6,106
27035950502,2763,2634,24,4,3,8,0,11,129
27035950701,2725,2553,36,9,27,11,0,10,172
27035950702,3047,2858,33,13,29,11,2,9,189
27035950801,1846,1764,16,4,19,3,0,7,82
27035950802,2936,2725,33,20,24,6,0,11,211
27035950901,2998,2838,36,7,13,16,0,17,160
27035950902,2587,2401,42,6,13,10,0,10,186
27035951000,4217,3703,94,40,85,24,3,22,514
27035951100,4868,4217,118,97,116,31,0,2,651
27035951200,2843,2566,66,21,35,12,0,17,277
27035951301,5384,4931,76,38,24,69,0,46,453
27035951303,3968,3539,112,57,73,32,1,12,429
27035951304,2522,2308,38,19,23,35,0,4,214
27035951400,5341,5028,57,15,34,19,2,6,313
27035951600,2559,2351,14,7,56,6,0,2,208
27035951700,3025,2894,20,0,14,5,2,19,131
27037060101,3776,2319,819,227,26,155,1,24,1457
27037060102,2890,2062,483,147,15,41,0,11,828
27037060103,2793,2278,270,65,14,53,7,22,515
27037060104,5849,3753,1127,494,20,188,6,13,2096
27037060105,5307,2754,1472,659,38,158,0,15,2553
27037060201,2670,1841,370,191,9,111,3,11,829
27037060202,3534,2640,409,173,8,75,1,8,894
27037060301,4437,2993,670,349,33,97,6,39,1444
27037060302,3654,2638,491,206,14,115,0,8,1016
27037060401,2601,1791,445,124,18,66,1,17,810
27037060402,3594,2334,693,251,32,101,2,9,1260
27037060502,4489,3052,656,353,22,132,2,39,1437
27037060503,4994,3359,906,270,19,117,8,64,1635
27037060505,6704,4125,905,714,29,599,5,33,2579
27037060506,5499,4124,513,371,11,200,0,25,1375
27037060507,3285,2565,240,184,10,121,3,3,720
27037060508,5886,4659,628,67,26,245,4,15,1227
27037060509,5735,4482,604,186,18,194,2,22,1253
27037060603,4590,4085,170,55,0,75,2,24,505
27037060604,3394,3073,109,19,10,62,0,14,321
27037060605,1850,1466,118,72,9,71,0,11,384
27037060606,2902,2585,104,53,4,70,0,9,317
27037060709,5898,3602,669,884,31,368,1,40,2296
27037060710,4468,2208,753,862,19,334,19,39,2260
27037060711,4821,2973,501,868,21,190,4,25,1848
27037060713,3211,2336,203,340,16,118,1,11,875
27037060714,4594,3265,289,469,15,302,0,21,1329
27037060716,3650,2614,197,272,3,388,0,4,1036
27037060717,2408,1592,162,281,9,247,0,23,816
27037060721,2671,1774,195,294,19,256,1,10,897
27037060725,4314,2578,388,806,20,284,1,16,1736
27037060726,3158,1824,207,532,17,402,1,18,1334
27037060727,3570,2146,345,359,21,523,3,14,1424
27037060728,5477,3820,274,252,5,887,4,16,1657
27037060729,3930,3019,150,141,4,438,0,2,911
27037060731,5142,4015,240,209,8,373,2,29,1127
27037060732,5526,4458,208,246,20,360,0,26,1068
27037060733,4118,2876,209,506,10,274,5,34,1242
27037060734,4683,3530,259,215,3,481,0,7,1153
27037060735,5113,3269,410,698,30,404,5,36,1844
27037060737,5078,3028,631,863,11,279,3,31,2050
27037060738,3771,2199,534,625,7,217,1,30,1572
27037060739,5857,3318,1543,372,20,348,8,12,2539
27037060742,3704,3026,169,162,3,145,1,23,678
27037060743,1544,658,188,507,4,111,0,12,886
27037060744,1688,1311,82,63,4,173,0,1,377
27037060745,4719,2621,441,1170,7,279,8,20,2098
27037060746,3524,2252,558,352,13,168,0,18,1272
27037060747,3818,2315,308,708,24,232,1,41,1503
27037060748,3583,2198,214,681,10,309,5,30,1385
27037060749,1558,1086,100,144,10,136,0,9,472
27037060750,4361,2816,397,594,6,325,0,11,1545
27037060751,2609,2024,94,127,8,241,0,7,585
27037060752,3335,2799,99,78,3,209,0,9,536
27037060753,2340,1236,239,621,5,117,0,16,1104
27037060754,4931,2910,616,875,18,225,3,22,2021
27037060805,3671,1480,1269,549,14,148,0,15,2191
27037060806,5813,4547,357,315,20,232,0,18,1266
27037060811,5632,4076,499,519,29,214,0,43,1556
27037060812,6085,4157,571,705,29,257,8,22,1928
27037060813,4752,3777,413,110,11,228,1,22,975
27037060814,6051,4935,304,218,17,282,1,44,1116
27037060815,5376,4363,244,266,8,254,1,32,1013
27037060816,6776,5617,234,140,21,464,1,33,1159
27037060819,6341,5160,272,245,13,332,3,29,1181
27037060822,1416,1165,39,63,8,54,0,0,251
27037060823,4297,3486,174,121,12,302,0,13,811
27037060824,3609,2908,145,186,6,164,2,12,701
27037060828,5335,3114,433,883,24,557,3,40,2221
27037060829,3948,2275,295,558,9,567,0,23,1673
27037060830,4146,3028,259,374,37,171,0,22,1118
27037060831,7174,5507,269,279,20,698,0,16,1667
27037060832,5436,3817,713,217,16,352,2,48,1619
27037060833,4362,3251,159,303,16,430,1,14,1111
27037060834,2837,2480,108,39,4,72,1,1,357
27037060835,5642,4730,245,208,13,188,0,34,912
27037060836,5015,3640,489,270,18,302,0,49,1375
27037060837,5582,4458,257,309,10,273,0,26,1124
27037060838,4431,3410,242,378,14,187,0,18,1021
27037060839,5263,3455,244,437,7,847,0,51,1808
27037060840,3408,2868,135,98,17,114,0,11,540
27037060841,3466,2827,173,156,2,135,0,24,639
27037060902,4495,3917,115,100,10,146,1,23,578
27037060904,3797,3077,159,292,26,58,3,16,720
27037060905,5974,4772,357,270,11,191,0,35,1202
27037060906,3212,2694,126,96,9,132,0,12,518
27037060907,8103,6545,397,256,19,439,6,51,1558
27037061001,4283,3908,125,17,12,97,0,6,375
27037061003,2674,2152,102,111,2,162,3,13,522
27037061005,2356,1759,139,255,5,51,3,12,597
27037061007,4800,3740,294,252,17,260,0,21,1060
27037061008,2294,1765,308,69,11,27,0,25,529
27037061009,7316,5708,291,345,15,550,2,51,1608
27037061010,3575,2875,91,137,1,291,0,20,700
27037061011,2635,2244,102,54,4,147,0,10,391
27037061102,4560,3893,186,203,41,52,5,7,667
27037061105,2502,2216,109,45,3,21,0,10,286
27037061106,2839,2536,91,73,7,24,0,3,303
27037061109,3239,2724,143,124,23,35,0,8,515
27037061110,3100,2659,150,40,18,57,0,15,441
27037061111,3083,2877,61,17,6,30,0,8,206
27037061112,3279,2961,83,22,22,40,6,12,318
27037061401,3111,2856,65,12,10,29,0,13,255
27037061402,3774,3542,76,20,4,17,0,4,232
27037061501,2357,2220,70,6,9,3,0,3,137
27037061502,3055,2784,49,23,1,60,1,7,271
27039950100,4445,4149,112,20,4,16,0,24,296
27039950200,4030,3388,397,33,14,40,1,4,642
27039950300,2320,2046,164,11,5,7,0,19,274
27039950400,3546,3327,71,11,8,9,0,11,219
27039950500,6526,5897,313,51,6,32,0,7,629
27041450100,3307,3219,30,0,7,6,0,0,88
27041450200,3780,3609,53,7,10,10,0,11,171
27041450500,4905,4635,79,21,18,35,0,0,270
27041450601,3497,3173,123,60,5,17,1,10,324
27041450602,3120,2852,104,42,8,12,2,1,268
27041450702,2894,2690,79,31,2,19,3,6,204
27041450703,2475,2229,86,10,14,40,1,5,246
27041450704,3204,2924,102,25,17,40,0,0,280
27041450800,3660,3479,60,12,9,5,3,11,181
27041450900,3627,3478,25,9,8,24,1,10,149
27041451000,4537,4341,74,6,6,19,0,6,196
27043460100,1830,1720,46,5,6,1,0,3,110
27043460200,2139,1885,156,12,7,7,0,8,254
27043460300,1799,1647,110,2,4,0,0,9,152
27043460400,3175,2730,328,16,22,12,0,9,445
27043460500,2317,2126,116,10,11,7,0,6,191
27043460600,2661,2294,257,10,8,18,0,4,367
27045960100,3430,3280,30,15,0,21,1,18,150
27045960200,4767,4504,109,20,0,13,0,8,263
27045960300,3560,3350,26,30,1,18,0,12,210
27045960400,3238,3096,44,12,1,9,0,16,142
27045960500,3161,3003,68,17,3,3,0,5,158
27045960600,3072,2940,64,4,2,7,1,6,132
27047180100,2851,2599,106,18,3,5,0,27,252
27047180200,2594,2431,69,12,3,4,0,12,163
27047180300,3352,3051,143,40,0,13,0,4,301
27047180400,3216,2758,267,36,6,70,0,6,458
27047180500,4350,3536,483,24,18,183,3,3,814
27047180600,4049,2493,886,109,26,377,0,9,1556
27047180700,2440,2156,108,0,1,124,0,6,284
27047180800,2452,1588,483,115,11,165,0,5,864
27047180900,3416,2436,571,102,7,171,0,5,980
27047181000,2175,2023,67,4,1,23,2,2,152
27049080101,4036,3471,247,98,43,37,3,5,565
27049080102,5889,5087,281,150,66,70,3,15,802
27049080201,3015,2431,198,169,37,29,7,14,584
27049080202,4299,3550,184,67,274,34,2,22,749
27049080300,4140,3889,93,7,21,14,3,16,251
27049080400,4165,3752,244,9,37,9,2,12,413
27049080500,3518,3294,60,10,8,23,2,17,224
27049080600,4795,4431,106,12,15,39,4,15,364
27049080700,3412,3101,177,26,11,5,0,4,311
27049080800,4517,4093,107,75,11,45,2,17,424
27049080900,5796,5417,100,38,17,43,5,18,379
27051070100,3310,3106,60,6,13,11,5,2,204
27051070200,2764,2593,75,7,14,3,2,2,171
27053000101,3351,1097,363,970,29,635,3,19,2254
27053000102,5178,1812,543,1637,73,656,0,43,3366
27053000300,3264,2112,221,530,31,85,2,37,1152
27053000601,4760,3497,528,320,47,96,2,15,1263
27053000603,2955,2356,201,102,24,95,0,17,599
27053001100,2219,1511,284,218,9,49,2,16,708
27053001700,2482,1281,348,696,14,48,0,11,1201
27053002200,1695,202,250,845,40,267,0,4,1493
27053002400,2746,1970,169,420,17,46,0,9,776
27053002700,2816,494,313,1443,39,305,2,17,2322
27053003200,1844,528,154,876,11,123,0,9,1316
27053003300,2633,216,267,1613,38,330,1,9,2417
27053003801,3085,2013,239,319,21,295,2,11,1072
27053003802,3462,2645,133,165,10,365,6,16,817
27053005901,3069,1171,242,1371,62,95,7,26,1898
27053005902,3619,725,634,1913,104,57,4,34,2894
27053006800,4211,2466,453,838,36,143,1,18,1745
27053007700,5710,3343,562,1197,49,294,7,14,2367
27053007801,1972,574,449,747,43,78,3,13,1398
27053008100,3497,2823,202,147,9,112,2,23,674
27053008200,4277,1854,794,1336,41,63,1,17,2423
27053008300,2106,593,869,454,25,83,3,17,1513
27053008400,2896,810,1084,713,18,55,1,26,2086
27053008500,4069,1648,1477,544,59,91,1,26,2421
27053009500,2865,1182,776,545,48,97,1,21,1683
27053009600,3321,2074,425,436,37,76,5,21,1247
27053010600,2844,2489,91,26,2,82,0,10,355
27053010700,2491,2176,71,24,0,67,1,9,315
27053011000,3539,2711,272,244,30,77,1,1,828
27053011703,4274,3686,133,83,22,103,4,28,588
27053011704,3379,2667,230,167,3,69,0,21,712
27053011800,4721,3905,266,150,31,117,0,14,816
27053011998,4292,3371,248,294,32,85,0,20,921
27053012001,6331,5130,324,309,13,195,0,14,1201
27053012003,5290,2920,759,1054,33,152,1,28,2370
27053012101,3004,1522,536,588,66,70,0,23,1482
27053012102,2935,2063,351,221,24,71,0,4,872
27053020101,3386,2830,110,88,9,169,0,11,556
27053020102,2226,1884,78,89,2,84,0,6,342
27053020201,2996,773,301,1271,28,479,5,16,2223
27053020202,5278,1429,830,1955,43,745,0,9,3849
27053020301,2973,1083,320,713,28,641,0,19,1890
27053020302,2670,829,224,963,11,444,0,11,1841
27053020303,4361,1489,577,722,23,1327,0,31,2872
27053020304,3841,989,712,1029,21,862,0,24,2852
27053020400,5169,2007,600,1438,38,766,1,29,3162
27053020500,4090,1546,719,843,40,661,1,18,2544
27053020600,2404,960,391,406,13,476,0,5,1444
27053020700,4342,2671,375,716,18,286,2,29,1671
27053020801,2167,1385,233,257,5,115,0,24,782
27053020804,3037,1833,446,499,14,84,0,15,1204
27053020902,2314,1697,188,174,11,108,0,17,617
27053020903,3263,2354,283,276,17,111,0,12,909
27053021001,5835,4018,358,816,32,263,0,41,1817
27053021002,2104,1374,129,390,4,49,0,22,730
27053021100,1957,1320,145,282,11,64,1,19,637
27053021200,4532,3411,269,408,18,122,0,35,1121
27053021300,4853,2930,323,1075,20,149,0,30,1923
27053021400,3304,2153,233,480,27,110,2,34,1151
27053021501,4550,2765,306,1063,31,169,0,20,1785
27053021502,3965,1634,325,1606,22,170,0,26,2331
27053021503,5203,3191,481,968,20,243,1,35,2012
27053021504,3717,2579,253,501,18,144,2,13,1138
27053021505,4819,3152,315,765,19,230,5,31,1667
27053021601,4573,3575,224,350,6,184,0,27,998
27053021602,5984,4581,224,658,21,188,0,29,1403
27053021700,5160,4184,183,253,9,230,0,35,976
27053021800,2351,1967,62,68,11,86,0,18,384
27053021900,4484,3729,163,183,7,161,0,22,755
27053022000,2119,1712,105,82,11,123,1,14,407
27053022101,2990,2071,187,244,13,297,5,27,919
27053022102,2647,1931,198,236,17,120,6,25,716
27053022200,4888,3894,204,291,11,252,7,18,994
27053022301,2506,2090,111,126,12,62,0,10,416
27053022302,3315,1875,332,742,27,155,1,20,1440
27053022400,3863,2818,251,409,49,112,2,24,1045
27053022700,3632,2708,242,342,12,129,4,19,924
27053022801,2235,2035,41,6,4,52,0,11,200
27053022802,3703,2904,212,272,10,125,1,31,799
27053022901,5635,4604,183,325,31,265,0,27,1031
27053022902,1837,1654,80,18,0,18,0,1,183
27053023000,4609,3737,201,247,23,173,1,24,872
27053023100,1943,1674,58,11,0,64,0,15,269
27053023201,2357,1666,131,281,8,153,0,16,691
27053023202,3926,1810,284,1084,16,488,9,24,2116
27053023300,6362,4466,464,809,20,220,0,33,1896
27053023401,4521,2843,465,727,14,209,0,20,1678
27053023402,1913,1048,113,608,5,44,0,9,865
27053023501,3864,3070,126,132,11,279,0,28,794
27053023502,6434,5356,243,141,12,363,4,34,1078
27053023600,3900,3481,120,15,7,103,0,30,419
27053023700,5366,4668,123,47,3,293,1,8,698
27053023801,5439,4572,193,134,15,239,0,9,867
27053023802,3064,2503,121,93,4,158,0,15,561
27053023901,3715,3060,136,66,4,281,0,13,655
27053023902,2071,1578,85,57,0,263,0,0,493
27053023903,3513,2596,94,177,1,484,2,22,917
27053024003,4886,2771,391,300,7,1200,0,34,2115
27053024004,4473,3125,140,437,10,627,0,15,1348
27053024005,2748,1932,130,251,15,303,0,5,816
27053024006,2078,1772,42,31,2,152,0,3,306
27053024100,3432,2358,433,273,12,166,2,15,1074
27053024200,3190,2516,264,127,4,117,0,8,674
27053024300,4510,2595,547,328,26,762,3,21,1915
27053024400,4335,2884,518,537,32,161,0,27,1451
27053024500,2328,1686,318,93,3,111,1,18,642
27053024600,4069,2527,570,513,23,236,8,14,1542
27053024700,3433,2204,554,260,19,171,0,49,1229
27053024801,2576,1306,686,253,17,161,2,39,1270
27053024802,3106,1179,1145,450,34,139,1,23,1927
27053024903,2378,793,734,465,19,149,0,23,1585
27053024904,3637,1790,1052,292,14,273,0,9,1847
27053025100,3343,1780,488,632,19,258,5,14,1563
27053025201,5225,1709,1652,1204,51,301,5,50,3516
27053025205,5234,2998,756,826,41,334,2,39,2236
27053025301,3208,2606,112,182,7,163,5,4,602
27053025302,4438,2576,555,565,28,462,0,26,1862
27053025401,4165,2188,949,419,36,334,2,41,1977
27053025403,4089,2231,614,672,14,279,0,24,1858
27053025601,2679,1775,303,193,8,273,0,5,904
27053025603,3849,3012,223,166,8,227,7,14,837
27053025605,3874,2900,305,222,6,248,5,10,974
27053025702,4989,3757,298,428,16,270,1,27,1232
27053025703,2329,1803,51,249,0,142,0,2,526
27053025704,4894,3374,401,440,8,409,3,35,1520
27053025801,3448,2318,314,386,3,231,0,17,1130
27053025802,2443,2028,124,61,7,90,0,14,415
27053025803,3296,2335,233,348,9,195,0,15,961
27053025805,2931,2414,98,69,120,78,2,10,517
27053025905,3745,3297,77,62,6,159,0,11,448
27053025906,6099,4449,325,576,15,413,0,13,1650
27053025907,4952,4046,174,143,8,362,1,36,906
27053025908,4026,3347,137,108,9,227,2,27,679
27053025909,3024,2215,117,351,16,151,3,23,809
27053026005,4005,2918,168,466,5,216,7,17,1087
27053026006,3126,2144,194,343,5,285,0,15,982
27053026007,5072,3522,268,594,12,443,6,27,1550
27053026013,4571,3752,186,70,5,340,0,6,819
27053026014,5214,4248,169,204,2,324,3,26,966
27053026015,5548,4001,365,373,4,531,0,35,1547
27053026019,5123,1665,378,664,21,2169,1,23,3458
27053026020,4848,3109,167,873,17,491,0,12,1739
27053026021,4136,3343,148,55,0,389,0,16,793
27053026023,3810,2466,274,377,12,490,0,11,1344
27053026024,3644,2963,127,153,3,240,0,23,681
27053026025,2800,2160,64,42,2,419,0,5,640
27053026026,4868,3223,155,119,11,1189,0,8,1645
27053026027,4267,3449,182,144,4,312,0,12,818
27053026028,3166,1743,125,113,3,1052,0,12,1423
27053026101,3487,2982,133,169,0,66,0,7,505
27053026103,2830,2486,92,62,11,67,1,9,344
27053026104,4433,3244,209,574,9,175,1,26,1189
27053026201,3240,2856,96,43,2,83,0,10,384
27053026202,2936,2559,67,56,6,101,2,7,377
27053026205,3295,2856,86,35,1,136,0,10,439
27053026206,3320,2976,90,48,2,63,0,7,344
27053026207,4140,3190,258,288,5,206,1,19,950
27053026208,3141,2788,66,62,4,78,1,9,353
27053026301,3820,3326,127,58,1,147,1,3,494
27053026302,3417,3078,93,12,3,64,0,7,339
27053026403,3551,2349,97,360,14,608,0,21,1202
27053026404,5598,4821,156,136,10,238,0,33,777
27053026405,2501,1857,114,191,8,214,2,9,644
27053026406,4072,3019,266,346,12,234,0,13,1053
27053026505,3581,2878,100,154,9,253,7,23,703
27053026507,5185,3910,296,461,14,284,0,13,1275
27053026508,4930,4013,160,295,0,237,0,12,917
27053026509,4497,3861,127,141,1,174,0,9,636
27053026510,3439,2636,118,304,12,239,0,14,803
27053026511,3532,2090,386,684,11,177,0,23,1442
27053026514,4801,2935,283,489,16,828,9,13,1866
27053026515,2072,1656,75,121,5,99,0,0,416
27053026516,3931,3142,234,208,21,156,4,14,789
27053026605,4207,3250,116,56,7,608,0,26,957
27053026606,5030,4165,173,201,6,260,1,27,865
27053026609,3009,2605,93,57,6,107,0,16,404
27053026610,4411,3693,147,189,22,150,0,20,718
27053026611,4902,3533,186,607,6,344,1,15,1369
27053026614,3925,3160,146,141,13,302,0,6,765
27053026615,7806,5318,223,470,21,1407,1,22,2488
27053026616,9818,5469,297,402,4,3193,0,34,4349
27053026617,2287,1693,47,89,4,393,0,0,594
27053026702,2688,2135,134,176,7,53,0,5,553
27053026706,3360,2835,118,122,8,101,0,25,525
27053026707,5188,4215,175,258,34,178,0,41,973
27053026708,5399,4451,191,253,9,218,2,19,948
27053026711,3068,2459,130,232,15,102,0,5,609
27053026712,3233,2339,181,400,6,109,2,20,894
27053026713,4190,3379,183,199,17,202,3,13,811
27053026717,6408,4504,228,709,29,588,1,39,1904
27053026718,3725,2917,86,256,2,226,0,11,808
27053026719,5783,4852,129,184,3,375,3,18,931
27053026720,5143,4012,175,169,7,534,1,18,1131
27053026721,2833,2473,66,78,5,89,0,14,360
27053026722,5286,3565,138,321,3,1026,0,13,1721
27053026723,4647,3610,134,215,3,490,0,17,1037
27053026724,4134,2846,184,424,24,473,5,25,1288
27053026725,3591,2743,159,302,14,241,0,6,848
27053026726,4265,3092,172,362,12,394,0,33,1173
27053026807,5977,3089,579,1594,23,438,1,9,2888
27053026809,4834,697,1145,2382,16,410,3,7,4137
27053026811,6398,1936,479,2133,27,1415,0,30,4462
27053026812,8840,4483,395,1650,26,1804,0,36,4357
27053026814,7225,2195,608,1970,42,1997,6,57,5030
27053026815,5648,2315,439,1235,38,1308,0,27,3333
27053026816,7087,2047,614,2401,35,1657,0,44,5040
27053026818,5255,1551,533,1737,35,1132,0,30,3704
27053026819,4578,695,359,2764,18,514,0,11,3883
27053026822,5158,3122,175,887,12,707,0,21,2036
27053026823,5133,2508,216,1039,9,1113,3,12,2625
27053026824,6023,3532,196,1050,3,925,0,27,2491
27053026825,3337,1462,172,643,13,850,0,13,1875
27053026826,4452,2445,119,795,16,834,0,25,2007
27053026827,2078,490,178,879,11,430,0,12,1588
27053026828,4455,1017,382,2069,27,727,1,42,3438
27053026903,4696,3791,143,315,15,181,0,25,905
27053026906,7580,5746,334,602,39,438,0,42,1834
27053026907,5596,4529,143,423,16,243,0,18,1067
27053026908,6047,4616,227,604,29,278,1,23,1431
27053026910,7212,5720,700,236,18,214,0,32,1492
27053026911,5250,4506,130,216,14,164,0,32,744
27053026912,8711,7920,160,146,4,175,4,38,791
27053027001,3358,3031,103,25,6,33,0,6,327
27053027002,5498,5034,159,36,12,60,0,16,464
27053027101,7483,6127,179,148,5,710,1,16,1356
27053027102,6185,4978,330,27,14,623,0,23,1207
27053027202,1741,1511,96,19,3,31,0,9,230
27053027203,3691,3372,64,51,10,60,0,5,319
27053027204,3867,3553,85,17,4,44,0,22,314
27053027205,3037,2780,83,8,5,65,2,13,257
27053027300,4434,3856,155,129,6,128,0,32,578
27053027400,4283,3986,92,9,1,53,0,25,297
27053027501,4523,3982,215,72,11,84,0,11,541
27053027503,4376,3964,132,29,1,85,1,15,412
27053027504,3403,3056,91,19,1,97,0,5,347
27053027601,4057,3533,126,87,27,59,0,19,524
27053027602,5341,4722,223,33,9,112,0,13,619
27053027701,3789,3501,81,15,5,31,0,10,288
27053027702,2307,2080,67,24,5,34,0,7,227
27053027703,4473,4035,120,35,1,93,0,16,438
27053100200,3764,1692,333,1122,67,249,1,21,2072
27053100400,3388,837,509,1347,67,353,1,38,2551
27053100500,1978,1366,142,218,14,104,3,15,612
27053100700,3139,1441,351,849,48,189,5,9,1698
27053100800,4209,1130,511,1784,80,403,0,10,3079
27053100900,5005,1091,762,2156,60,575,0,31,3914
27053101200,4913,3851,320,230,36,184,3,21,1062
27053101300,1887,304,295,898,30,243,3,7,1583
27053101600,3174,521,360,1626,59,389,3,27,2653
27053101800,4153,2187,729,862,66,85,6,13,1966
27053101900,2833,1967,315,298,19,75,0,6,866
27053102000,2317,646,216,1054,20,216,0,6,1671
27053102100,2809,428,291,1473,51,347,1,24,2381
27053102500,2746,1933,238,337,27,55,0,11,813
27053102600,2023,1259,281,234,35,60,0,9,764
27053102800,2999,486,298,1519,73,425,3,13,2513
27053103000,1779,1377,126,115,14,52,0,11,402
27053103100,2161,1479,215,252,15,66,0,10,682
27053103400,3063,257,316,2309,26,54,1,8,2806
27053103600,3093,2593,105,116,6,134,0,11,500
27053103700,4282,3110,241,344,39,314,0,16,1172
27053103900,4320,3126,190,174,24,583,0,16,1194
27053104001,2756,1787,133,425,23,221,0,10,969
27053104002,4309,2870,283,337,32,528,0,21,1439
27053104100,3245,1128,346,1257,30,261,5,12,2117
27053104400,2576,1299,166,611,42,348,4,8,1277
27053104801,4314,180,91,3791,8,168,0,17,4134
27053104802,4709,2348,332,1037,46,707,0,17,2361
27053104901,6900,4873,408,360,19,978,0,2,2027
27053104902,6121,2845,278,857,7,1856,1,13,3276
27053105100,2768,2339,100,90,3,71,0,10,429
27053105201,3008,2221,162,279,11,173,0,24,787
27053105204,2865,1713,167,581,29,191,0,18,1152
27053105400,4440,2619,297,912,72,305,0,36,1821
27053105500,3822,3173,146,149,11,128,0,26,649
27053105600,4920,3025,403,905,40,233,0,36,1895
27053105700,3062,1603,232,849,65,120,4,17,1459
27053106000,3431,587,588,1763,263,88,6,19,2844
27053106200,3817,1272,183,2063,44,100,0,5,2545
27053106400,1817,837,56,793,17,48,4,0,980
27053106500,4872,4161,150,107,14,199,0,20,711
27053106600,2517,2106,118,62,1,85,6,15,411
27053106700,5075,3879,346,314,31,179,0,32,1196
27053106900,2842,1690,286,482,61,129,1,9,1152
27053107000,3971,1922,695,950,27,155,0,31,2049
27053107400,1799,1018,260,347,41,38,0,10,781
27053107500,1882,1462,63,124,32,60,0,17,420
27053107600,3566,2927,202,152,19,88,3,14,639
27053108000,3585,2893,202,138,19,143,0,20,692
27053108600,2944,1193,1116,335,70,49,0,11,1751
27053108700,4013,2200,519,826,73,115,1,35,1813
27053108800,3698,2079,575,607,104,95,0,20,1619
27053108900,2310,1832,158,91,13,65,0,2,478
27053109000,1805,1543,64,57,7,37,0,8,262
27053109100,4998,4202,196,141,14,169,4,25,796
27053109200,3473,2687,232,275,15,74,0,20,786
27053109300,4032,2709,591,372,30,97,0,25,1323
27053109400,2192,519,829,616,48,92,0,9,1673
27053109700,2311,1285,531,246,38,63,2,7,1026
27053109800,4412,3648,192,125,5,147,2,16,764
27053109900,4034,3129,324,218,37,94,1,29,905
27053110000,1683,490,560,481,8,56,1,13,1193
27053110100,2845,1981,318,187,57,109,1,16,864
27053110200,3667,2819,285,220,52,77,3,16,848
27053110400,3351,2107,268,617,67,87,0,11,1244
27053110500,5250,4259,296,281,35,116,1,11,991
27053110800,4331,3430,276,237,26,112,1,3,901
27053110900,3497,2048,355,701,17,94,2,31,1449
27053111100,3375,2653,309,128,29,55,0,21,722
27053111200,3333,2907,95,48,13,97,1,3,426
27053111300,5210,4448,170,165,18,125,3,26,762
27053111400,4014,3443,134,111,6,100,0,28,571
27053111500,5651,4527,282,428,17,103,0,9,1124
27053111600,3214,2621,110,163,6,63,2,29,593
27053122500,3584,2560,178,490,4,110,0,33,1024
27053122600,2447,1980,126,127,16,71,0,11,467
27053125500,3707,2085,566,521,13,304,2,22,1622
27053125600,5233,3099,216,388,25,1211,7,27,2134
27053125700,3852,696,553,1611,64,685,0,41,3156
27053125800,5208,1098,1883,1784,138,90,0,40,4110
27053125900,4904,754,1651,1396,741,154,0,27,4150
27053126000,5056,1040,1313,2338,76,101,4,16,4016
27053126101,2746,1780,103,197,10,547,0,16,966
27053126102,6867,4518,330,1005,136,579,4,41,2349
27053126201,3153,2109,157,529,75,112,2,25,1044
27053126202,4387,3659,169,127,7,262,1,16,728
27053126300,2679,574,255,1430,34,229,1,10,2105
27053980000,8,4,2,0,1,0,0,1,4
27053980100,432,253,15,126,7,6,2,1,179
27055020100,5796,5363,94,37,15,62,4,9,433
27055020200,3463,3335,19,6,11,14,0,9,128
27055020300,2597,2478,21,8,4,6,0,10,119
27055020500,3318,3140,52,32,7,14,0,2,178
27055020900,3669,3524,57,7,5,5,0,1,145
27057070100,5036,4298,79,15,323,15,5,20,738
27057070200,2255,2103,42,2,14,5,2,10,152
27057070300,1991,1880,6,3,37,5,1,3,111
27057070400,2904,2655,53,11,46,8,1,6,249
27057070500,3007,2782,42,17,23,12,3,2,225
27057070600,3886,3304,231,26,100,21,0,12,582
27057070700,2265,2117,36,8,17,0,0,3,148
27059130100,3553,3331,55,14,10,23,2,19,222
27059130200,3523,3198,70,22,16,16,6,19,325
27059130302,2897,2714,42,10,19,18,0,3,183
27059130303,5853,5308,124,71,31,82,0,15,545
27059130304,4099,3613,122,65,39,86,5,8,486
27059130400,3979,3655,67,7,21,89,0,13,324
27059130501,5290,4928,73,10,16,34,0,36,362
27059130502,7925,7055,270,100,41,113,0,19,870
27059130600,4016,3757,73,15,8,27,0,22,259
27061480101,1074,966,17,4,9,7,0,1,108
27061480102,1406,1301,14,0,11,1,1,4,105
27061480301,1368,1265,13,2,26,3,0,0,103
27061480302,2008,1661,44,7,143,5,0,11,347
27061480303,911,854,11,1,0,3,0,5,57
27061480401,1470,1340,27,20,27,1,0,3,130
27061480402,1376,1290,12,2,8,0,0,11,86
27061480403,850,807,9,0,5,0,0,1,43
27061480500,2464,2254,36,5,20,10,1,0,210
27061480600,2783,2590,34,0,29,4,0,6,193
27061480701,1589,1478,22,0,2,6,0,7,111
27061480702,3545,3309,37,3,34,3,0,13,236
27061480801,2433,2279,15,4,13,13,0,17,154
27061480803,1743,1510,22,14,57,8,0,13,233
27061480804,2053,1897,26,7,26,23,0,4,156
27061480805,2541,2295,37,16,36,26,0,2,246
27061480901,1724,1542,31,19,21,3,0,0,182
27061480902,5061,4547,82,52,93,10,0,15,514
27061481001,2116,1908,33,10,33,3,0,1,208
27061481002,3857,3475,66,7,48,11,0,10,382
27061940000,2642,1598,30,1,856,5,0,1,1044
27063480100,2175,2082,49,3,4,8,0,2,93
27063480200,2078,1862,152,14,1,19,0,1,216
27063480300,2353,2190,61,19,5,10,0,0,163
27063480400,3383,2892,139,84,12,85,0,20,491
27065480100,3409,3172,49,11,35,5,0,4,237
27065480200,3689,3468,54,14,18,24,0,4,221
27065480300,3975,3663,74,24,37,13,0,1,312
27065480400,4959,4651,61,16,23,38,0,6,308
27067770900,2962,1603,600,635,14,42,0,7,1359
27067780100,2639,2487,64,8,9,6,2,8,152
27067780200,2374,2299,26,1,3,3,1,2,75
27067780300,4189,3954,101,11,6,15,0,7,235
27067780400,3654,3386,148,9,7,4,1,9,268
27067780500,5180,2767,1540,555,20,161,10,9,2413
27067780600,5238,4480,420,86,10,61,0,17,758
27067780700,4083,2986,691,133,8,153,0,7,1097
27067780800,2230,963,807,322,4,37,22,10,1267
27067781000,5585,3284,1229,840,20,86,0,14,2301
27067781100,2691,2471,109,1,11,12,1,6,220
27067781200,2907,2623,181,17,3,6,0,2,284
27069090100,2362,2238,28,1,9,10,3,14,124
27069090200,1845,1736,55,0,6,7,3,0,109
27071790100,1934,1742,25,5,48,3,2,5,192
27071790201,2234,2026,38,26,30,0,2,6,208
27071790202,2798,2468,43,13,85,12,2,5,330
27071790300,2889,2640,40,0,92,9,0,3,249
27071790500,2207,2044,21,0,23,10,6,11,163
27073180100,2237,2070,71,17,2,16,0,0,167
27073180200,1652,1596,20,0,1,5,0,2,56
27073180300,2830,2578,111,15,7,19,0,14,252
27075370101,1869,1769,10,0,11,6,0,15,100
27075370102,2812,2667,32,0,5,17,0,4,145
27075370300,2378,2249,27,4,10,14,0,4,129
27075370400,3846,3596,44,7,24,18,0,7,250
27075990100,0,0,0,0,0,0,0,0,0
27077460300,1536,1407,23,10,14,8,0,5,129
27077460401,1302,1205,20,0,5,8,0,4,97
27077460402,925,885,13,2,0,1,0,4,40
27079950101,3582,3310,99,23,13,31,2,13,272
27079950102,3798,3602,65,8,0,14,2,1,196
27079950200,4680,3818,563,103,10,23,6,16,862
27079950300,4722,4222,285,26,17,19,6,16,500
27079950400,3666,3405,79,35,19,5,1,0,261
27079950500,4239,3380,685,29,3,23,2,5,859
27079950600,3987,3726,96,38,5,19,1,7,261
27081201001,2944,2840,45,5,6,8,0,0,104
27081201002,2696,2528,62,5,5,14,0,3,168
27083360100,3538,3277,144,28,18,6,0,0,261
27083360200,3206,2940,151,24,0,24,0,14,266
27083360300,5588,3928,553,380,15,524,1,8,1660
27083360400,4256,3479,317,159,16,149,2,8,777
27083360500,3848,2653,424,309,24,290,0,8,1195
27083360600,2773,2653,35,3,1,18,0,3,120
27083360700,2060,1605,120,3,10,252,0,0,455
27085950100,5378,4958,209,32,14,12,3,12,420
27085950200,4036,3804,94,5,10,24,5,11,232
27085950301,3408,3011,189,37,13,54,3,5,397
27085950302,3098,2745,185,26,7,16,0,5,353
27085950401,5831,5074,406,66,24,46,12,11,757
27085950402,1864,1664,81,14,9,13,1,7,200
27085950500,2715,2535,105,4,3,4,1,5,180
27085950600,4639,4190,310,15,12,18,0,3,449
27085950700,5802,4578,976,27,10,43,2,5,1224
27087940100,2945,1276,95,4,1169,7,0,8,1669
27087940300,2466,1002,59,4,1087,0,0,9,1464
27089080100,2212,2081,39,6,1,12,0,7,131
27089080200,2196,2100,38,0,6,0,0,0,96
27089080300,1987,1801,125,0,1,0,0,1,186
27089080400,2645,2350,188,6,21,7,0,14,295
27091790100,2930,2744,89,7,5,6,2,7,186
27091790200,2475,2341,73,4,1,6,0,8,134
27091790300,2318,2188,64,5,3,5,0,13,130
27091790400,1722,1613,57,4,2,0,0,3,109
27091790501,1799,1651,83,9,3,16,1,1,148
27091790502,4423,4009,238,30,5,41,2,6,414
27091790600,4358,3401,716,53,13,18,1,8,957
27093560100,5207,4943,84,11,10,10,0,10,264
27093560200,5164,4864,108,13,11,14,0,18,300
27093560300,3827,3409,253,30,6,12,1,6,418
27093560400,3015,2547,342,26,5,3,0,3,468
27093560500,3214,3093,47,5,5,13,1,0,121
27093560600,2973,2762,116,8,0,7,0,12,211
27095170400,5510,5135,82,11,28,32,0,19,375
27095170500,4541,4203,65,14,42,18,2,17,338
27095170600,2851,2655,43,3,5,23,1,15,196
27095170700,5765,5207,149,29,66,24,0,26,558
27095970100,2179,1827,27,1,239,6,0,4,352
27095970200,2885,1603,80,15,1004,13,1,11,1282
27095970300,2728,2501,35,5,82,8,2,6,227
27097780100,3180,2977,68,5,26,20,0,1,203
27097780200,3883,3698,58,8,7,8,0,0,185
27097780300,6410,6006,126,18,19,13,0,26,404
27097780400,2591,2497,20,3,5,0,0,0,94
27097780500,5181,4956,92,4,13,12,1,8,225
27097780600,5672,5196,134,71,20,37,2,11,476
27097780700,2667,2435,57,62,17,7,2,2,232
27097780800,4426,4267,78,8,4,5,0,9,159
27099000100,2371,1853,198,103,3,146,14,3,518
27099000200,2962,2159,328,94,6,290,3,10,803
27099000300,5154,2757,1300,373,9,445,88,24,2397
27099000410,4890,2724,1156,357,18,416,79,13,2166
27099000600,3190,2227,567,116,0,184,0,10,963
27099000800,3841,2467,744,141,6,299,52,15,1374
27099000900,4505,3350,395,386,2,224,17,3,1155
27099001000,3465,3172,159,12,7,14,2,19,293
27099001200,1867,1781,32,8,1,9,0,3,86
27099001300,4382,4093,139,15,4,12,0,17,289
27099001400,3402,3221,63,8,1,13,0,6,181
27101900100,1849,1795,17,0,0,3,2,1,54
27101900200,3221,2770,263,9,8,95,0,1,451
27101900300,3109,2918,102,17,1,7,1,5,191
27103480100,3428,3306,35,3,2,8,0,9,122
27103480200,6585,5883,158,264,38,66,0,2,702
27103480300,4912,3928,531,259,18,41,0,9,984
27103480400,5753,4476,485,379,46,223,9,6,1277
27103480501,7013,5891,269,508,14,113,1,27,1122
27103480502,3256,2818,151,59,11,83,0,8,438
27103480600,3507,2985,171,200,12,24,0,10,522
27105105100,2728,2352,250,18,10,27,0,2,376
27105105200,3068,2748,197,12,12,35,7,5,320
27105105300,2341,2055,215,2,6,8,3,0,286
27105105400,4911,1102,2691,460,14,535,9,8,3809
27105105500,3711,977,2151,173,13,325,8,12,2734
27105105600,5531,2913,1767,313,11,399,14,15,2618
27107960100,2463,2201,66,2,59,9,0,13,262
27107960200,1812,1576,99,7,30,7,0,1,236
27107960300,2166,1925,123,8,26,2,0,18,241
27109000100,1565,1116,48,125,3,209,3,7,449
27109000200,5699,3475,636,835,57,418,1,16,2224
27109000300,3133,2073,284,383,11,159,0,5,1060
27109000400,2948,2322,155,38,9,288,2,6,626
27109000500,2951,1815,270,301,12,358,3,27,1136
27109000600,4584,3280,348,451,19,278,2,31,1304
27109000901,6876,4325,1172,743,20,291,1,17,2551
27109000902,3795,2709,310,540,3,107,2,10,1086
27109000903,4489,3878,209,57,2,172,1,13,611
27109001000,5264,3637,538,581,9,226,0,23,1627
27109001100,3722,2951,209,202,8,170,1,22,771
27109001201,4796,3904,196,96,3,378,1,14,892
27109001202,3973,2999,386,105,6,288,3,18,974
27109001203,7064,5803,223,110,6,599,2,13,1261
27109001301,5181,3557,213,398,7,725,1,27,1624
27109001302,4562,3898,126,127,6,257,0,6,664
27109001401,4654,3172,284,635,20,273,1,20,1482
27109001403,7640,5605,278,593,18,817,5,24,2035
27109001404,7099,5123,255,646,9,736,4,12,1976
27109001501,3025,2351,153,197,8,158,10,9,674
27109001502,2407,1979,122,101,4,97,2,1,428
27109001503,2311,1928,81,113,5,98,1,4,383
27109001601,4856,3427,318,668,14,203,4,28,1429
27109001602,3025,2333,221,110,3,223,5,14,692
27109001603,4564,3626,184,63,3,495,1,16,938
27109001701,4814,2524,360,1095,13,557,1,26,2290
27109001702,4784,2922,370,854,21,375,0,10,1862
27109001703,5726,4453,200,383,16,460,1,20,1273
27109001800,5579,5091,144,51,6,83,1,14,488
27109001901,3925,3562,102,22,4,66,4,13,363
27109001902,4835,4383,175,36,10,69,0,20,452
27109002000,6591,6181,126,35,1,25,1,10,410
27109002100,6868,6188,258,71,23,39,0,18,680
27109002200,3830,3645,40,14,1,31,0,1,185
27109002300,5712,4523,202,180,20,462,2,33,1189
27111960102,2787,2664,38,9,7,5,0,2,123
27111960103,2334,2220,26,2,10,2,0,8,114
27111960300,3526,1971,895,421,22,101,0,7,1555
27111960400,2255,2141,39,5,2,10,0,7,114
27111960500,5765,4963,444,64,60,38,1,9,802
27111960600,4578,4325,77,7,31,6,0,12,253
27111960700,2516,2367,42,9,7,6,0,3,149
27111960800,3149,2955,52,19,1,7,2,7,194
27111960900,5853,5209,169,111,44,68,5,13,644
27111961000,4896,4388,130,81,55,34,5,16,508
27111961100,4471,4170,64,64,18,18,0,7,301
27111961200,2464,2341,34,15,5,5,0,17,123
27111961300,4084,3878,55,13,1,7,0,1,206
27111961400,2604,2458,48,3,5,7,2,7,146
27111961500,3257,3066,48,4,4,1,2,13,191
27111961600,2308,2202,29,1,8,9,0,8,106
27111961700,3234,3044,26,15,4,10,0,12,190
27113090100,2411,2226,41,8,34,21,1,11,185
27113090200,2548,2077,176,101,29,24,1,13,471
27113090300,2122,1990,49,3,8,4,2,11,132
27113090400,2932,2540,178,18,51,27,0,4,392
27113090500,3979,3408,227,47,44,45,2,9,571
27115950100,2387,2208,26,4,19,15,0,9,179
27115950200,2913,2644,50,52,26,13,0,14,269
27115950300,2671,2429,53,15,28,18,0,9,242
27115950401,963,715,19,2,183,5,0,0,248
27115950402,3596,2665,218,301,203,45,0,4,931
27115950500,4770,4138,97,26,197,63,0,17,632
27115950600,4684,4070,106,33,236,50,0,15,614
27115950700,3443,3146,63,22,31,18,1,5,297
27115950800,3449,3104,81,15,43,37,0,25,345
27117460100,1589,1457,87,0,13,3,0,0,132
27117460200,1725,1392,202,31,28,13,0,0,333
27117460300,2511,1957,313,65,43,25,0,7,554
27117460400,1624,1445,95,5,14,14,0,6,179
27117460500,1975,1806,107,6,2,11,0,6,169
27119020100,4732,3478,369,538,67,37,0,12,1254
27119020200,1489,1143,115,132,33,7,1,4,346
27119020300,3199,2952,95,16,23,9,0,3,247
27119020400,2041,1935,50,0,9,4,0,0,106
27119020500,2591,2379,107,3,12,4,0,20,212
27119020600,5657,4326,803,214,53,57,0,4,1331
27119020700,2120,1598,315,35,50,8,3,8,522
27119020800,2166,2028,36,6,16,7,0,4,138
27119020900,3691,3432,63,9,37,7,0,13,259
27119021000,3506,3267,46,5,76,16,0,3,239
27121970100,2322,2260,25,6,0,3,0,0,62
27121970200,2931,2785,44,7,6,12,0,9,146
27121970300,2598,2476,34,6,12,15,0,8,122
27121970400,3457,3230,88,15,9,20,0,3,227
27123030100,4598,3460,246,200,10,447,0,18,1138
27123030201,5090,4141,252,246,12,197,2,22,949
27123030202,2056,1386,98,288,15,167,0,7,670
27123030300,5788,4595,259,332,23,260,2,19,1193
27123030400,6253,2023,570,1513,68,1746,0,42,4230
27123030500,6312,990,536,1752,34,2727,0,19,5322
27123030601,6067,888,911,1052,40,2957,0,13,5179
27123030602,4395,1923,407,361,26,1408,5,20,2472
27123030702,5651,2192,604,433,35,2100,2,24,3459
27123030703,4702,1389,480,320,25,2288,0,14,3313
27123030704,4756,1125,714,804,20,1850,1,22,3631
27123030800,5632,1541,574,795,39,2383,1,25,4091
27123030900,3808,915,420,711,37,1509,1,15,2893
27123031000,4657,1076,618,797,49,1867,0,31,3581
27123031100,4423,1751,458,463,31,1511,0,9,2672
27123031200,2991,1722,233,534,17,238,0,28,1269
27123031300,2441,562,267,593,35,840,0,4,1879
27123031400,3114,773,466,771,23,942,0,16,2341
27123031500,3136,551,430,888,49,1099,0,25,2585
27123031600,4573,918,673,641,48,2080,1,18,3655
27123031701,2954,657,408,536,38,1159,1,18,2297
27123031702,6380,1022,988,1832,72,2202,2,20,5358
27123031801,5330,1428,1020,679,38,1897,0,15,3902
27123031802,4422,1874,665,375,34,1213,0,32,2548
27123031900,3169,1585,127,847,27,398,1,23,1584
27123032000,2767,1818,206,456,28,73,0,18,949
27123032100,3190,1874,256,680,70,158,0,14,1316
27123032200,2557,1741,154,336,26,131,0,16,816
27123032300,3589,2215,214,689,28,171,0,12,1374
27123032400,3010,879,290,1032,34,603,1,20,2131
27123032500,4301,1005,507,1304,21,1177,3,13,3296
27123032600,3319,499,425,854,40,1378,3,20,2820
27123032700,2776,395,228,773,19,1213,1,8,2381
27123033000,2302,537,286,732,29,580,0,8,1765
27123033100,1816,667,258,317,5,475,0,3,1149
27123033200,4009,2438,212,778,16,357,3,20,1571
27123033300,3178,2450,250,165,15,103,23,18,728
27123033400,3519,1758,197,1121,24,247,1,17,1761
27123033500,3435,634,253,1830,8,437,0,32,2801
27123033600,1602,70,17,1287,3,169,0,4,1532
27123033700,1786,302,180,921,10,287,5,11,1484
27123033800,1827,863,129,606,7,85,0,12,964
27123033900,1584,737,84,560,5,106,0,10,847
27123034000,1742,1197,76,326,13,37,0,9,545
27123034201,3574,2457,214,453,47,207,2,19,1117
27123034203,2850,1811,163,536,26,175,1,10,1039
27123034204,2871,1733,197,629,39,161,3,14,1138
27123034400,2198,945,272,452,25,344,0,7,1253
27123034500,4303,1318,565,765,33,1325,0,24,2985
27123034601,5714,1789,577,847,27,2202,0,27,3925
27123034602,4609,1142,814,393,41,2013,0,23,3467
27123034701,4804,1368,770,771,33,1621,1,21,3436
27123034702,4274,1441,601,687,44,1273,1,19,2833
27123034900,5355,4634,196,118,3,203,2,84,721
27123035000,2610,2236,112,70,9,69,3,11,374
27123035100,3456,2620,188,140,4,316,7,21,836
27123035200,3414,2859,145,92,5,124,2,15,555
27123035300,3950,3054,184,315,13,122,4,31,896
27123035500,2292,1872,123,130,17,52,2,7,420
27123035700,2560,2173,130,43,4,79,0,5,387
27123035800,3052,2571,137,128,9,62,1,11,481
27123035900,898,559,81,122,7,87,0,2,339
27123036000,2781,1902,204,425,18,90,0,20,879
27123036100,1607,262,444,429,21,394,0,4,1345
27123036300,4087,3463,176,90,9,168,5,4,624
27123036400,4013,3389,182,129,16,122,0,20,624
27123036500,3985,3337,145,132,22,177,4,7,648
27123036600,4449,3807,167,101,9,113,1,27,642
27123036700,5135,3881,305,407,42,204,1,21,1254
27123036800,2344,1718,227,170,22,65,3,7,626
27123036900,2392,1717,180,248,27,67,1,15,675
27123037000,2841,1925,450,144,29,62,0,20,916
27123037100,5073,2461,1020,984,74,259,0,27,2612
27123037200,6061,2286,2076,977,62,285,0,59,3775
27123037402,4128,1680,396,692,18,1142,1,9,2448
27123037403,6832,2509,456,2373,19,1172,0,16,4323
27123037500,5286,3983,208,554,13,208,3,30,1303
27123037601,4165,3201,215,358,16,159,3,23,964
27123037603,3105,942,392,1572,7,85,1,12,2163
27123037604,2373,1346,164,622,9,111,0,8,1027
27123040101,2877,2480,120,42,10,101,0,9,397
27123040102,4124,3694,139,23,3,86,4,15,430
27123040200,1920,1775,45,9,4,20,2,0,145
27123040301,1803,1601,57,13,18,51,0,7,202
27123040302,5250,4270,278,183,11,278,5,18,980
27123040401,3577,2862,187,165,11,154,1,9,715
27123040402,5987,4414,443,429,18,396,0,21,1573
27123040502,2612,2228,114,82,13,53,0,15,384
27123040503,3572,2985,155,128,11,151,1,3,587
27123040504,4110,3324,246,138,12,251,1,8,786
27123040601,5859,5001,139,41,7,449,0,16,858
27123040603,5177,4270,160,145,10,346,2,23,907
27123040605,3527,2763,159,90,3,380,0,7,764
27123040606,4208,2494,288,578,11,647,0,17,1714
27123040704,6045,4456,235,329,18,695,0,15,1589
27123040705,4278,3151,194,149,9,558,9,14,1127
27123040706,4876,3837,146,113,10,548,0,16,1039
27123040707,4555,3860,114,81,10,290,0,13,695
27123040708,3751,2833,142,231,7,413,1,23,918
27123040709,3416,2860,80,63,10,251,0,6,556
27123040801,3587,2465,473,96,5,390,1,17,1122
27123040804,2111,1821,66,35,3,84,0,0,290
27123040805,4241,3640,150,88,3,147,3,21,601
27123040901,2223,1555,152,150,4,238,2,9,668
27123040902,4286,2370,739,450,31,398,14,20,1916
27123041001,3461,2684,142,277,7,204,0,2,777
27123041002,3484,2277,251,405,16,376,3,12,1207
27123041103,3645,2135,181,765,21,366,0,13,1510
27123041104,3157,2417,109,183,3,272,2,10,740
27123041105,5961,4638,200,350,14,453,3,24,1323
27123041106,3889,2718,202,422,12,333,0,12,1171
27123041107,6242,3951,488,915,31,493,4,18,2291
27123041200,4205,2408,449,879,24,218,0,20,1797
27123041301,3859,2586,190,487,11,367,1,11,1273
27123041302,4232,3406,184,215,20,245,4,10,826
27123041400,5817,3904,424,759,16,446,0,16,1913
27123041500,5392,4349,175,239,16,361,1,20,1043
27123041601,6235,4366,343,617,24,586,2,23,1869
27123041602,3836,2074,269,408,18,894,6,17,1762
27123041700,2978,2366,146,128,11,170,0,7,612
27123041800,3905,2758,211,329,21,368,7,18,1147
27123041900,3503,2591,116,416,9,186,0,16,912
27123042001,1866,1046,67,122,14,503,0,9,820
27123042002,2271,1554,122,222,7,262,0,7,717
27123042101,6052,3297,880,685,24,868,0,24,2755
27123042102,4747,2899,285,417,10,854,3,19,1848
27123042201,1504,706,174,117,2,446,0,3,798
27123042202,5351,2730,408,581,20,1363,0,16,2621
27123042301,3059,1988,145,173,14,619,0,20,1071
27123042302,5246,2794,449,468,10,1291,0,6,2452
27123042401,6482,3679,399,833,33,1143,2,25,2803
27123042402,6649,3492,644,954,31,1173,8,34,3157
27123042501,5965,3203,1026,581,17,848,2,26,2762
27123042503,3248,2305,148,193,4,432,0,23,943
27123042504,4248,2364,321,686,25,632,3,21,1884
27123042601,4647,2679,338,537,17,796,0,20,1968
27123042602,2292,1770,100,108,17,179,0,6,522
27123042700,5425,3347,343,526,31,898,0,21,2078
27123042800,2513,419,146,1005,10,811,0,6,2094
27123042900,3989,2952,187,467,20,142,6,5,1037
27123043001,4574,3953,159,113,11,135,0,16,621
27123043002,2003,1706,70,40,6,77,0,17,297
27123980000,0,0,0,0,0,0,0,0,0
27125010100,1835,1683,41,9,32,1,1,7,152
27125010200,2100,1942,62,6,25,4,2,7,158
27127750100,2830,2117,130,2,455,3,0,4,713
27127750200,3256,2700,135,18,193,37,0,5,556
27127750300,2114,1732,116,35,117,10,1,3,382
27127750400,2829,2698,42,3,7,13,0,0,131
27127750500,2676,2275,42,15,2,309,0,2,401
27127750600,1720,1601,31,3,0,42,0,2,119
27129790100,2614,2305,178,7,1,5,0,8,309
27129790200,1821,1669,104,14,3,4,0,1,152
27129790300,1823,1657,97,5,13,10,0,4,166
27129790400,2642,2095,394,6,56,21,4,0,547
27129790500,3086,2678,296,24,4,3,0,6,408
27129790600,2737,2362,250,4,26,18,1,8,375
27131070101,3411,3166,68,12,5,17,0,18,245
27131070102,4270,3765,182,50,12,58,3,6,505
27131070200,5676,5252,130,31,12,68,0,21,424
27131070300,4445,4091,180,14,3,29,0,17,354
27131070400,4315,4072,88,10,2,13,0,16,243
27131070501,4092,3030,297,138,0,355,0,137,1062
27131070503,3386,3038,145,35,8,52,0,9,348
27131070504,3942,3248,334,111,6,52,1,14,694
27131070601,4120,2631,1141,91,6,66,3,20,1489
27131070602,4933,3156,806,238,44,461,3,114,1777
27131070701,3069,1775,281,763,140,7,0,0,1294
27131070702,4095,3014,475,400,11,54,0,7,1081
27131070801,3854,2609,250,774,6,86,0,15,1245
27131070802,4036,2942,361,558,7,43,0,8,1094
27131070901,5690,3647,1116,572,14,143,0,17,2043
27131070902,3763,2087,929,556,21,50,0,6,1676
27133570100,2347,2221,50,2,12,2,4,0,126
27133570200,4212,3822,207,28,8,23,4,0,390
27133570300,3145,2843,107,20,28,37,2,0,302
27135970100,4002,3211,73,17,174,291,1,10,791
27135970200,2101,1983,24,6,3,15,3,12,118
27135970300,3995,3667,95,37,30,48,2,19,328
27135970400,3523,3200,37,16,20,33,3,8,323
27135970500,1710,1639,9,9,2,11,1,7,71
27137000100,4340,3994,76,20,38,34,1,8,346
27137000200,4602,4239,87,33,30,45,1,14,363
27137000301,5140,4369,118,173,78,74,2,15,771
27137000302,3360,2811,114,182,69,57,0,4,549
27137000400,5206,4547,113,111,27,179,2,12,659
27137000500,3365,2994,52,20,23,72,0,23,371
27137000600,5216,4794,67,28,31,50,2,16,422
27137000700,2958,2663,50,22,7,92,0,9,295
27137000900,3598,3105,63,61,81,60,0,11,493
27137001000,2094,1822,53,51,28,32,0,14,272
27137001100,1574,1359,46,21,18,51,0,6,215
27137001200,1628,1250,47,101,43,38,0,8,378
27137001300,1803,1411,56,98,77,39,0,9,392
27137001400,2410,1941,91,110,69,41,4,12,469
27137001600,1446,983,49,148,100,24,3,6,463
27137001700,1300,1013,45,88,33,28,0,3,287
27137001800,2280,1428,93,232,267,41,1,2,852
27137001900,2010,1383,71,192,179,43,0,8,627
27137002000,1294,1048,26,69,41,30,2,7,246
27137002200,1166,1033,17,27,8,19,0,5,133
27137002300,4136,3738,52,29,52,49,0,16,398
27137002400,1053,886,32,34,18,15,3,4,167
27137002600,2032,1650,70,42,59,16,3,7,382
27137002900,1606,1484,12,2,32,14,0,3,122
27137003000,1437,1232,41,29,38,7,1,4,205
27137003300,2430,1975,75,103,77,22,1,0,455
27137003400,1428,1203,30,52,38,3,0,2,225
27137003600,1635,1468,38,7,30,3,0,0,167
27137003700,2002,1631,36,51,81,20,0,7,371
27137003800,2951,2621,50,18,89,11,2,7,330
27137010100,2946,2675,49,15,35,22,0,4,271
27137010200,1618,1499,13,5,16,6,0,3,119
27137010301,4795,4350,74,34,28,79,1,18,445
27137010302,4758,4363,45,28,33,70,0,4,395
27137010400,3501,3235,36,11,17,8,0,9,266
27137010500,3837,3649,25,3,9,12,0,2,188
27137010601,2881,2690,39,9,12,22,2,16,191
27137010602,3682,3466,40,7,21,3,0,11,216
27137011101,1493,1370,22,5,29,1,1,8,123
27137011102,5580,5162,58,19,89,8,3,21,418
27137011200,3187,2499,42,42,429,4,0,3,688
27137011300,2103,1980,24,7,7,6,0,4,123
27137011401,1509,1451,4,1,7,4,0,3,58
27137011402,1657,1584,17,2,13,3,0,0,73
27137012100,4803,4483,44,22,20,20,0,14,320
27137012200,1908,1653,46,35,33,5,3,3,255
27137012300,2526,2276,52,31,18,22,4,10,250
27137012400,4382,3929,72,112,40,25,2,5,453
27137012500,2635,2396,40,35,22,5,2,5,239
27137012600,4775,4286,111,63,56,13,0,14,489
27137012700,2336,2153,40,13,16,4,0,7,183
27137012800,2920,2708,14,19,37,14,0,5,212
27137013000,2029,1765,42,68,50,16,0,1,264
27137013100,2403,1926,60,72,149,10,2,9,477
27137013200,3989,3608,62,54,67,17,1,11,381
27137013300,3493,3149,53,45,55,9,0,15,344
27137013400,2896,2737,27,7,13,14,0,5,159
27137013500,1687,1584,28,2,17,7,0,5,103
27137013600,1853,1706,17,3,20,3,0,6,147
27137013800,1678,1570,17,9,13,3,0,0,108
27137013900,2307,2170,12,7,7,8,0,6,137
27137014000,2020,1885,30,0,9,2,0,7,135
27137014100,1397,1313,11,6,11,4,0,2,84
27137015100,2904,2741,27,3,28,12,0,7,163
27137015200,3418,3235,21,4,39,5,0,10,183
27137015300,3265,2900,65,128,29,18,0,13,365
27137015401,1964,1878,16,2,2,1,2,10,86
27137015402,1208,1110,17,0,42,4,0,0,98
27137015501,1390,1283,15,0,48,7,1,3,107
27137015502,1200,807,16,2,314,1,0,0,393
27137015503,896,541,17,2,304,0,0,3,355
27137015600,2967,2005,86,295,209,29,0,22,962
27137015700,4213,3046,243,598,56,132,6,23,1167
27137015800,3722,3221,44,96,75,34,0,10,501
27137990100,0,0,0,0,0,0,0,0,0
27139080100,2325,1303,185,363,13,314,16,19,1022
27139080201,2914,2389,73,83,10,253,0,4,525
27139080202,5975,4439,241,410,12,609,0,19,1536
27139080204,3868,3024,199,170,13,279,0,18,844
27139080206,4318,3092,186,448,12,388,0,22,1226
27139080207,5417,4486,177,165,21,327,4,24,931
27139080208,3343,1630,226,997,18,324,0,7,1713
27139080209,4305,3230,239,187,25,414,3,19,1075
27139080303,5948,3616,946,732,77,319,0,19,2332
27139080304,7231,4133,328,697,35,1700,0,23,3098
27139080305,6931,4936,515,467,46,657,2,16,1995
27139080306,2942,2089,127,130,9,436,2,19,853
27139080307,6697,4040,348,808,57,1086,0,33,2657
27139080400,4130,2331,864,552,34,119,3,28,1799
27139080500,2711,1991,236,191,127,40,2,1,720
27139080600,4876,3389,519,280,28,410,3,23,1487
27139080700,4206,2424,954,224,18,401,0,27,1782
27139080801,6611,5368,652,145,41,95,6,40,1243
27139080802,2269,2094,52,5,5,30,2,20,175
27139080903,8831,7045,293,156,492,494,7,19,1786
27139080905,5943,4960,163,221,32,318,0,31,983
27139080906,5397,4606,190,136,54,170,2,8,791
27139080907,3200,2741,107,88,46,91,0,10,459
27139080908,4510,3600,196,145,53,182,4,38,910
27139081001,5135,4669,112,32,7,105,0,29,466
27139081002,3756,3496,60,21,8,45,2,13,260
27139081101,3050,2855,42,7,18,15,0,10,195
27139081102,2184,2018,26,6,2,39,0,10,166
27139081103,6187,5488,209,74,7,128,2,18,699
27139081200,6501,5994,161,37,34,63,0,12,507
27139081301,3250,2907,107,43,24,27,1,4,343
27139081302,5967,5247,275,117,28,61,3,24,720
27141030103,4098,3812,78,18,10,21,1,11,286
27141030104,3783,3500,63,11,8,34,0,15,283
27141030105,4758,4303,123,31,15,55,3,11,455
27141030106,7667,6974,180,63,13,68,2,21,693
27141030201,4620,4342,73,20,13,32,2,6,278
27141030202,2953,2756,38,6,8,19,0,11,197
27141030301,2986,2825,27,15,14,24,0,3,161
27141030302,3227,3029,40,14,4,32,1,5,198
27141030405,3782,3489,99,28,8,27,1,20,293
27141030406,6118,5308,248,131,16,112,0,21,810
27141030407,4366,4044,99,20,17,31,1,4,322
27141030408,5581,5240,80,28,7,20,0,15,341
27141030409,5103,4508,167,121,16,64,0,19,595
27141030410,5397,4517,271,174,22,86,0,38,880
27141030503,6938,5482,420,504,77,136,5,25,1456
27141030504,5506,4920,162,102,11,62,1,21,586
27141030505,7734,6604,235,317,22,189,0,13,1130
27141030506,4969,4317,164,136,24,59,0,24,652
27141031500,7597,4791,253,1909,85,206,5,30,2806
27143170198,4271,3973,115,13,24,21,1,2,298
27143170200,3483,3130,235,16,6,16,5,5,353
27143170300,3244,2550,586,19,0,20,3,5,694
27143170400,3838,3289,379,33,0,15,1,13,549
27145000301,3567,2342,169,682,8,132,3,27,1225
27145000303,2396,1497,129,306,11,344,5,18,899
27145000304,5586,2207,154,2716,30,232,6,31,3379
27145000401,6387,3284,269,2376,25,173,3,20,3103
27145000402,5756,5124,124,161,12,161,0,11,632
27145000501,2158,1665,186,170,16,26,2,10,493
27145000502,5928,3194,380,2017,24,147,1,11,2734
27145000601,3391,2275,129,677,28,72,2,13,1116
27145000602,2922,2172,135,337,18,54,2,15,750
27145000701,2885,2250,135,218,16,87,0,20,635
27145000801,3766,2741,211,497,45,44,7,33,1025
27145000901,4833,3281,172,1007,29,117,11,23,1552
27145001002,6213,5002,267,359,8,308,2,14,1211
27145001003,3986,3320,139,198,15,200,4,3,666
27145010101,8086,7376,177,83,17,149,0,2,710
27145010103,4782,4165,130,89,28,131,0,11,617
27145010104,5676,4904,182,170,11,187,2,14,772
27145010200,5801,5586,54,16,2,23,2,8,215
27145010401,3888,3723,61,10,4,7,0,9,165
27145010402,4179,3939,119,13,0,18,0,6,240
27145010403,3100,3037,16,5,0,0,0,5,63
27145010500,3778,3554,174,3,2,5,0,9,224
27145010600,3960,2846,1039,16,4,5,0,7,1114
27145010900,3615,3434,114,12,0,8,0,1,181
27145011000,3832,3556,102,18,13,12,0,0,276
27145011101,3242,3095,70,11,6,5,0,3,147
27145011102,3797,3628,100,5,0,14,0,5,169
27145011201,3192,3051,47,15,1,3,5,7,141
27145011202,3220,3089,24,7,4,4,0,22,131
27145011302,6906,6372,331,17,11,13,0,17,534
27145011305,3364,2992,111,79,4,96,0,9,372
27145011306,2768,2473,226,9,3,6,0,5,295
27145011307,1683,1392,92,80,5,77,0,2,291
27145011308,6061,4900,491,398,17,87,0,10,1161
27145011400,5034,4381,126,272,10,67,3,29,653
27145011500,6531,5889,445,39,8,20,1,4,642
27145011600,2023,1540,121,136,4,125,0,1,483
27147960100,5017,4229,398,210,9,39,0,10,788
27147960200,6311,5582,410,92,7,44,1,18,729
27147960300,6419,4875,771,507,8,68,1,6,1544
27147960400,4351,2887,788,389,7,118,11,5,1464
27147960500,2832,2699,43,4,3,9,0,5,133
27147960600,3571,3055,288,77,5,24,3,7,516
27147960700,5295,4771,260,58,17,20,1,1,524
27147960800,3610,3278,182,22,9,8,1,6,332
27149480100,2319,2155,101,0,4,0,0,12,164
27149480200,3873,3093,423,60,75,52,1,11,780
27149480300,3479,2845,462,24,31,16,0,17,634
27151960100,2491,2106,297,9,12,14,0,0,385
27151960200,3572,3123,247,51,5,42,0,0,449
27151960300,1623,1533,50,7,2,7,0,0,90
27151960400,2152,1856,68,12,7,15,133,5,296
27153790100,3300,3017,95,20,23,10,0,22,283
27153790200,2768,2631,30,8,16,4,1,6,137
27153790300,3188,2968,117,14,11,13,0,3,220
27153790400,3409,3061,194,14,8,13,0,7,348
27153790500,2514,2381,69,3,7,1,0,11,133
27153790600,4127,2300,1626,21,4,34,71,13,1827
27153790700,4038,3933,34,15,3,10,0,3,105
27153790800,1918,1826,43,0,4,12,0,0,92
27155460100,2043,1804,126,20,28,0,0,2,239
27155460200,1317,1047,71,1,155,0,0,3,270
27157490100,2834,2624,67,35,9,10,4,0,210
27157490200,3290,3176,23,13,1,10,1,4,114
27157490300,4090,3734,181,25,3,26,1,6,356
27157490400,4306,4111,74,9,11,13,0,8,195
27157490500,3259,3038,118,16,5,17,0,0,221
27157490600,3608,3238,245,23,3,21,0,2,370
27159480100,3477,3273,47,5,12,8,3,5,204
27159480200,5468,5128,91,39,19,21,1,8,340
27159480300,5120,4643,135,74,42,25,5,6,477
27161790100,3541,3316,81,14,4,9,5,6,225
27161790200,2617,2455,67,16,3,7,0,2,162
27161790300,3065,2887,100,5,0,10,1,6,178
27161790400,5550,4770,368,133,11,46,3,7,780
27161790500,4195,3110,655,168,96,39,3,0,1085
27163070103,5957,4906,327,169,30,177,0,19,1051
27163070104,2952,2617,107,30,16,32,1,8,335
27163070105,4147,3840,100,10,9,48,3,9,307
27163070107,3758,3235,125,100,17,115,0,16,523
27163070108,3797,3319,123,33,4,169,0,14,478
27163070204,6736,6017,183,81,24,174,2,32,719
27163070205,3984,3696,80,10,6,23,0,20,288
27163070206,3334,3129,41,9,6,30,7,18,205
27163070207,5002,4271,186,108,14,201,0,10,731
27163070208,4028,3394,169,111,15,151,0,33,634
27163070301,1689,1527,51,12,2,43,0,14,162
27163070303,4781,4294,96,107,2,111,0,12,487
27163070304,5180,4468,167,157,12,87,0,28,712
27163070403,3777,3458,82,9,2,61,0,31,319
27163070404,4346,3975,101,37,0,77,0,10,371
27163070405,5097,4522,152,30,12,171,0,22,575
27163070406,6245,4683,611,166,45,461,1,22,1562
27163070501,3526,3240,100,12,6,32,3,2,286
27163070502,4035,3637,125,35,12,31,4,12,398
27163070602,2808,2532,73,20,8,32,0,14,276
27163070603,2450,2016,105,139,13,58,0,8,434
27163070604,3961,3504,127,37,9,76,0,8,457
27163070703,3282,2747,104,84,18,141,2,22,535
27163070704,2510,2257,62,23,12,38,0,6,253
27163070705,3976,3506,95,28,6,201,0,7,470
27163070706,3395,3122,82,13,13,67,0,8,273
27163070801,1523,495,79,755,146,0,0,0,1028
27163070802,378,117,31,184,40,0,0,0,261
27163070906,5211,3490,304,550,0,632,0,13,1721
27163070907,5359,3214,414,817,22,589,0,30,2145
27163070909,5617,3974,300,307,19,802,4,14,1643
27163070910,5141,3351,693,283,38,513,2,22,1790
27163070911,4736,3120,316,471,8,575,5,15,1616
27163070912,3082,1861,153,424,14,419,1,13,1221
27163071001,5089,3226,371,528,10,663,4,22,1863
27163071003,3797,2557,300,370,44,284,0,12,1240
27163071006,5053,3396,248,555,16,634,3,21,1657
27163071010,5169,3729,236,358,12,590,0,10,1440
27163071011,2943,2347,104,89,0,231,0,1,596
27163071012,5143,3489,326,596,24,416,0,22,1654
27163071013,5201,3950,286,317,8,354,0,13,1251
27163071014,4129,3118,163,246,1,434,1,5,1011
27163071016,4477,3479,208,178,10,429,3,9,998
27163071019,13470,9728,600,425,38,1976,2,49,3742
27163071020,4274,3079,185,297,9,519,0,21,1195
27163071021,4789,3133,198,715,22,453,1,16,1656
27163071022,3610,2546,157,271,6,428,3,11,1064
27163071023,5093,3343,247,439,3,770,0,33,1750
27163071024,2558,1996,113,136,9,183,0,14,562
27163071025,4104,2902,161,350,11,476,2,11,1202
27163071101,3445,3185,89,3,2,34,0,10,260
27163071102,4758,4241,147,28,9,154,1,24,517
27163071207,8830,7008,550,298,25,496,5,25,1822
27163071208,5242,3939,436,232,20,310,2,15,1303
27163071209,5938,4431,336,437,10,370,3,11,1507
27163071210,5712,3831,511,611,23,418,2,22,1881
27163071211,5323,3807,227,325,23,690,1,27,1516
27163071300,5520,4073,450,218,34,403,0,24,1447
27163071400,8101,6210,581,416,30,478,4,29,1891
27165950100,3503,2590,826,20,1,8,0,4,913
27165950200,4862,2670,2044,16,12,25,0,11,2192
27165950300,2888,2429,357,6,0,53,0,0,459
27167950100,3080,2890,75,11,23,0,0,1,190
27167950200,3426,3028,136,30,64,8,1,4,398
27169670101,4299,3951,113,35,6,55,0,12,348
27169670102,3049,2742,180,16,3,35,0,3,307
27169670200,3224,2772,143,50,6,108,0,13,452
27169670301,2836,2244,130,184,11,130,0,10,592
27169670302,3376,3008,151,62,5,88,0,2,368
27169670400,4185,3726,150,95,9,57,0,8,459
27169670500,5195,4577,148,130,14,140,0,17,618
27169670600,3932,3484,131,99,5,69,0,11,448
27169670700,3636,3250,85,104,7,42,0,13,386
27169670801,2296,2152,46,3,8,16,0,6,144
27169670802,4847,4540,46,55,4,55,0,5,307
27169670900,3516,3153,183,30,3,34,0,2,363
27169671000,5280,4579,383,29,3,104,0,22,701
27171100101,8453,7331,336,190,24,189,4,34,1122
27171100102,9983,8596,250,447,17,175,3,36,1387
27171100202,1547,1474,21,11,1,12,0,1,73
27171100203,5801,4816,527,104,25,73,3,27,985
27171100205,4060,3482,244,82,7,61,0,13,578
27171100206,6356,5376,441,112,5,115,3,29,980
27171100300,5849,5461,90,32,15,21,0,46,388
27171100401,1921,1842,17,4,2,8,0,7,79
27171100402,3367,3080,110,18,7,17,1,10,287
27171100500,4770,4550,50,1,10,19,0,21,220
27171100701,6632,6048,191,49,20,70,3,18,584
27171100704,4672,4045,230,57,26,59,0,12,627
27171100705,3467,3151,68,69,1,44,0,12,316
27171100706,5464,5203,62,29,7,16,2,13,261
27171100707,3480,3267,63,15,1,9,0,5,213
27171100803,6884,5946,231,274,14,134,1,21,938
27171100804,7584,6312,257,395,11,218,4,33,1272
27171100805,6960,6164,226,162,9,113,8,23,796
27171100806,4306,3780,86,140,15,115,0,15,526
27171100807,4841,4192,141,111,20,163,0,12,649
27171100900,7456,6770,218,96,14,75,0,11,686
27171101001,4831,4544,79,5,2,28,0,33,287
27171101002,4538,4084,161,19,17,42,0,16,454
27171101101,7320,6578,279,100,27,69,3,19,742
27171101102,1508,1373,42,21,4,8,0,1,135
27171101200,4133,3852,98,21,14,10,0,22,281
27171101300,5154,4714,179,41,16,14,0,18,440
27173970100,2999,2431,134,27,231,7,0,1,568
27173970200,2362,2207,93,8,5,2,0,1,155
27173970300,2302,2101,116,3,21,4,0,0,201
27173970400,1865,1669,105,10,19,15,1,2,196
28001000101,4080,1750,656,1515,8,75,2,9,2330
28001000102,2493,1550,19,863,8,7,0,1,943
28001000200,3614,541,40,2932,9,0,4,5,3073
28001000300,1788,82,9,1659,0,0,1,1,1706
28001000400,2783,61,16,2620,6,4,0,8,2722
28001000500,3696,1165,72,2374,13,4,0,0,2531
28001000600,2118,984,26,1056,0,3,0,0,1134
28001000700,1703,1028,38,603,0,4,0,0,675
28001000800,3266,1165,65,1919,9,15,0,8,2101
28001000900,3997,2600,71,1168,3,53,0,3,1397
28003950100,5443,4878,128,205,3,45,5,2,565
28003950201,3241,1746,310,1029,10,15,0,7,1495
28003950202,3613,2998,116,330,7,57,1,5,615
28003950300,3282,2643,159,337,9,14,7,6,639
28003950401,2864,2736,36,21,5,1,0,8,128
28003950402,1945,1860,18,28,3,5,1,5,85
28003950501,3982,3077,91,663,5,13,0,8,905
28003950502,2510,764,267,1336,7,21,3,3,1746
28003950600,3794,3522,70,31,7,4,2,3,272
28003950700,4066,3514,53,336,5,5,0,3,552
28005950100,4877,3338,40,1356,12,30,0,2,1539
28005950200,3401,1890,53,1383,3,1,0,3,1511
28005950301,2064,1056,17,935,3,0,0,7,1008
28005950302,2378,1150,19,1161,7,0,0,6,1228
28007060100,2424,1732,26,610,5,6,0,1,692
28007060200,2308,1809,48,377,6,23,0,0,499
28007060300,3095,1214,26,1798,2,4,1,7,1881
28007060400,2735,1881,38,734,7,14,2,12,854
28007060500,3926,1581,127,2060,8,42,0,15,2345
28007060600,3401,1193,66,2063,1,8,1,2,2208
28009950101,2664,974,87,1503,0,1,0,18,1690
28009950102,2758,1714,33,886,4,0,0,13,1044
28009950200,2224,1877,25,265,2,0,0,7,347
28011950100,3088,369,49,2618,1,2,0,4,2719
28011950200,2516,338,49,2065,2,6,0,1,2178
28011950300,2904,235,26,2576,0,7,0,8,2669
28011950400,3784,997,146,2582,6,14,0,0,2787
28011950500,5104,2288,215,2438,8,18,0,12,2816
28011950601,2841,2129,94,391,3,90,0,14,712
28011950602,3781,2947,108,532,0,112,0,5,834
28011950701,4053,445,89,3416,2,4,0,5,3608
28011950702,2914,198,18,2639,0,9,0,3,2716
28013950100,3598,3092,112,315,4,10,0,3,506
28013950200,1516,704,49,706,5,1,0,3,812
28013950300,2943,2086,48,700,2,3,0,3,857
28013950400,2805,1750,444,541,0,3,0,2,1055
28013950500,2404,1030,94,1182,4,0,0,7,1374
28015950100,4923,3795,79,902,4,16,0,9,1128
28015950201,3632,1650,44,1838,10,6,0,9,1982
28015950202,1443,1084,31,290,1,7,0,0,359
28017950100,3651,1050,42,2458,4,3,0,5,2601
28017950200,3506,2169,172,1071,0,3,0,3,1337
28017950300,4783,2330,325,1995,4,11,0,5,2453
28017950401,2221,987,25,1157,5,9,0,0,1234
28017950402,2945,2048,78,726,0,15,0,2,897
28019950100,2458,2144,29,230,5,3,0,0,314
28019950200,4105,2589,65,1337,6,3,0,6,1516
28019950300,1683,826,23,765,4,0,0,1,857
28021950100,3133,605,29,2456,5,0,0,3,2528
28021950200,1194,115,6,1052,0,0,0,0,1079
28021950300,4808,254,37,4451,3,0,0,5,4554
28023950100,4010,3031,20,866,0,2,2,6,979
28023950201,3939,3074,38,720,3,1,1,6,865
28023950202,1789,1036,16,689,2,0,3,4,753
28023950300,3214,1226,27,1877,2,0,0,1,1988
28023950400,2663,1583,31,951,9,5,0,7,1080
28025950100,5246,2216,41,2860,2,14,0,4,3030
28025950200,2278,1045,16,1169,9,6,0,3,1233
28025950300,3216,553,24,2560,10,14,1,3,2663
28025950400,4131,1590,35,2404,14,14,0,6,2541
28025950500,3765,1792,70,1792,0,9,0,21,1973
28027950100,2995,329,16,2606,3,1,0,2,2666
28027950200,2545,1511,113,816,3,48,0,16,1034
28027950300,2678,956,31,1627,13,3,0,6,1722
28027950400,3433,864,76,2386,4,14,0,12,2569
28027950500,4493,550,69,3750,3,32,0,7,3943
28027950600,955,27,12,893,0,3,0,1,928
28027950700,4291,48,33,4131,0,11,0,0,4243
28029950101,2517,813,143,1479,0,15,3,4,1704
28029950102,3178,736,130,2242,1,7,0,1,2442
28029950200,4996,2717,182,1963,7,11,7,10,2279
28029950300,4392,2024,78,2169,1,11,4,8,2368
28029950400,4485,477,300,3540,2,36,4,6,4008
28029950501,3139,2302,133,628,3,18,4,9,837
28029950502,2700,1706,82,827,3,20,2,5,994
28029950600,2961,1396,63,1416,0,3,0,0,1565
28031950100,4724,2001,77,2533,1,8,0,6,2723
28031950200,2000,656,94,1182,0,11,2,1,1344
28031950300,4242,2044,64,2032,3,25,0,7,2198
28031950401,3807,3138,82,474,6,29,2,9,669
28031950402,3567,3208,101,163,10,10,0,12,359
28033070101,2933,1318,291,1215,0,38,1,11,1615
28033070102,4513,2564,281,1404,13,46,6,12,1949
28033070210,6784,2307,517,3635,9,63,1,20,4477
28033070221,4289,2475,242,1299,6,27,1,19,1814
28033070222,4639,2433,240,1635,9,80,2,16,2206
28033070310,3656,1689,492,1306,8,23,2,10,1967
28033070322,3669,1579,206,1678,4,39,5,7,2090
28033070323,5687,1323,337,3774,4,66,1,30,4364
28033070324,4677,1800,399,2229,7,7,7,13,2877
28033070325,2884,1257,395,1077,5,13,2,13,1627
28033070411,1590,1053,84,374,4,7,1,2,537
28033070412,4064,1555,186,2102,10,48,9,38,2509
28033070421,3203,1637,324,1083,4,26,5,5,1566
28033070422,2443,1478,163,658,0,27,0,8,965
28033070521,3477,1904,437,925,1,42,5,14,1573
28033070522,4120,2588,184,1116,8,40,6,7,1532
28033070523,7391,3069,471,3329,14,233,12,23,4322
28033070524,3792,2407,130,1057,6,66,0,10,1385
28033070610,2715,1164,108,1301,1,28,0,5,1551
28033070631,4365,2751,145,1103,8,207,0,16,1614
28033070632,4368,2715,198,1169,4,147,2,13,1653
28033070633,5186,4202,133,492,10,158,5,21,984
28033070634,1733,1101,52,495,1,30,0,8,632
28033070635,7750,4685,282,2135,9,292,6,41,3065
28033070721,6249,3361,264,2291,13,113,0,16,2888
28033070722,6728,5255,263,812,8,159,0,21,1473
28033070723,5205,2406,162,2333,10,97,0,4,2799
28033070724,2914,1742,111,832,5,121,0,12,1172
28033070811,6436,3103,299,2640,12,109,14,27,3333
28033070812,5333,2557,333,2138,11,64,6,25,2776
28033070821,5115,3551,217,1004,7,75,3,42,1564
28033070822,4852,2760,369,1413,7,50,3,20,2092
28033070830,7336,4270,350,2263,18,156,16,28,3066
28033070900,5967,4820,168,728,16,18,3,8,1147
28033071001,6040,5160,168,384,12,123,7,3,880
28033071002,4936,4202,155,328,3,57,0,32,734
28033071121,4459,3413,483,350,5,31,1,9,1046
28033071122,2661,2307,67,149,6,25,3,1,354
28033071123,4115,3518,97,327,12,18,0,5,597
28033071124,3850,2346,258,1087,2,39,2,9,1504
28033071200,3190,2641,100,302,6,15,0,8,549
28035000200,2525,1451,121,841,4,8,0,9,1074
28035000300,3019,763,191,1920,2,21,4,11,2256
28035000500,1099,171,124,768,4,1,2,7,928
28035000601,3528,219,184,3023,2,9,0,11,3309
28035000602,3222,265,73,2797,0,20,2,8,2957
28035000700,3019,1912,115,833,10,38,0,6,1107
28035000800,5872,4019,206,1413,8,70,0,19,1853
28035000900,5080,2445,219,1985,13,247,1,118,2635
28035001000,4441,1589,221,2435,8,70,2,18,2852
28035001100,3558,652,166,2563,8,56,8,10,2906
28035010101,6769,5423,207,839,10,47,0,15,1346
28035010103,2113,1757,47,203,7,5,0,6,356
28035010104,4440,3729,147,369,11,10,0,4,711
28035010201,2976,1626,97,1137,4,34,4,5,1350
28035010202,3790,1909,88,1627,11,17,1,0,1881
28035010300,3554,2574,181,581,7,11,1,9,980
28035010400,4287,3003,342,721,8,41,0,10,1284
28035010500,4497,1839,245,2256,10,42,0,10,2658
28035010601,4322,3846,73,209,27,22,0,19,476
28035010602,4068,3550,71,247,19,8,2,8,518
28035010700,1979,379,140,1384,4,12,2,8,1600
28037950101,1877,1011,21,808,2,0,0,3,866
28037950102,3260,2741,22,425,0,7,0,3,519
28037950200,2538,1158,17,1330,0,1,0,6,1380
28039950101,6568,6026,184,103,14,23,0,19,542
28039950102,4840,4427,156,87,22,13,0,4,413
28039950200,2521,1636,91,661,10,14,0,9,885
28039950302,3096,2530,83,376,5,7,0,2,566
28039950303,3301,2909,91,161,18,9,1,1,392
28039950304,4024,3401,67,386,16,11,0,6,623
28041950101,3091,2881,47,41,14,1,0,4,210
28041950102,4608,2090,46,2401,5,6,1,2,2518
28041950201,3119,2645,45,327,19,9,2,3,474
28041950202,2712,2193,33,374,22,5,0,2,519
28043950101,1824,1192,18,549,2,3,2,1,632
28043950102,3895,2521,50,1183,9,9,0,2,1374
28043950201,1922,1511,47,312,4,2,0,1,411
28043950202,3431,2159,34,1122,8,14,0,4,1272
28043950300,2907,587,43,2207,0,2,0,4,2320
28043950400,2550,348,46,2079,4,0,0,11,2202
28043950500,5100,2940,72,1900,2,54,0,3,2160
28045030101,1974,1596,79,210,2,5,0,15,378
28045030102,2824,1762,125,756,12,45,1,7,1062
28045030201,1522,1269,68,115,10,13,0,5,253
28045030202,1418,1238,64,40,0,2,0,1,180
28045030203,3199,2237,144,578,12,40,4,15,962
28045030301,2162,1788,79,163,14,31,0,9,374
28045030302,2182,1725,108,225,10,12,0,6,457
28045030303,3447,2394,157,536,34,66,0,19,1053
28045030304,1972,1353,90,379,19,16,0,16,619
28045030400,1989,1532,58,250,27,8,0,3,457
28045030501,3020,2548,137,135,11,34,0,9,472
28045030502,2381,2025,123,89,8,47,0,4,356
28045030503,4172,3588,182,111,20,49,2,21,584
28045030603,2634,2479,50,20,9,7,0,1,155
28045030604,4887,4288,203,129,28,21,2,16,599
28045030605,4279,3794,156,123,14,18,0,13,485
28045030606,1991,1725,95,52,14,10,0,6,266
28045990000,0,0,0,0,0,0,0,0,0
28047000600,1496,1127,166,113,2,18,0,5,369
28047000900,2925,1632,427,481,6,179,22,19,1293
28047001203,2688,1732,222,435,7,94,16,3,956
28047001204,2932,1542,395,737,17,92,0,6,1390
28047001205,2861,2052,241,324,10,98,0,16,809
28047001206,1443,562,118,653,6,22,2,9,881
28047001207,2037,802,208,870,4,31,2,20,1235
28047001301,1239,610,150,345,7,29,0,6,629
28047001302,1875,1211,135,364,2,38,0,7,664
28047001401,1399,1165,56,120,0,17,1,0,234
28047001402,1034,779,51,133,0,16,3,0,255
28047001503,1610,971,141,361,12,29,0,2,639
28047001504,1929,1425,125,239,5,37,5,7,504
28047001505,2444,1719,121,384,1,65,1,6,725
28047001506,2580,1219,385,778,13,43,0,6,1361
28047001600,3714,3292,118,107,2,27,5,6,422
28047001701,2561,1034,139,1223,10,34,3,8,1527
28047001702,1173,737,76,295,2,12,0,0,436
28047001703,2285,1066,191,858,16,27,0,0,1219
28047001800,2614,367,75,2066,2,12,0,3,2247
28047001900,2870,1307,199,1206,14,13,0,5,1563
28047002001,1369,627,87,550,9,11,5,10,742
28047002002,1951,528,166,1108,7,6,7,4,1423
28047002300,2117,608,97,1244,8,29,5,8,1509
28047002401,1691,349,86,1149,5,9,4,5,1342
28047002402,2706,144,56,2408,10,1,0,4,2562
28047002500,1835,1077,286,262,7,86,17,4,758
28047002600,3799,786,187,2626,24,27,2,18,3013
28047002701,3373,2529,174,424,12,47,3,13,844
28047002702,3425,2487,248,333,12,148,0,13,938
28047002801,1535,1189,86,118,3,37,0,11,346
28047002802,1569,1340,55,41,0,42,0,7,229
28047002900,1724,1492,49,109,3,17,0,2,232
28047003001,2032,637,107,1008,8,124,6,5,1395
28047003002,2003,1450,100,299,7,36,0,11,553
28047003103,2361,1166,141,864,9,26,8,17,1195
28047003104,3090,2186,113,605,11,24,3,18,904
28047003105,3817,3137,145,214,46,89,3,7,680
28047003106,2730,2319,114,65,7,69,2,5,411
28047003107,2706,1901,111,370,14,92,3,8,805
28047003208,4332,1509,654,1963,4,70,8,11,2823
28047003209,4968,2514,219,1897,14,60,10,27,2454
28047003210,1897,731,128,848,24,43,28,4,1166
28047003211,2105,860,170,859,8,67,0,30,1245
28047003212,2319,1021,137,958,12,51,1,7,1298
28047003213,3867,2175,219,1138,31,54,3,14,1692
28047003214,1652,706,205,581,8,43,4,8,946
28047003215,4666,1842,296,2112,12,116,2,20,2824
28047003216,2251,1571,112,397,17,59,0,10,680
28047003217,2845,1586,167,812,12,85,3,10,1259
28047003305,2150,1124,146,602,5,151,1,11,1026
28047003306,1676,980,119,338,3,127,3,4,696
28047003307,611,474,15,64,1,26,1,4,137
28047003308,3172,1528,399,649,7,406,2,13,1644
28047003309,4079,2605,393,593,15,239,6,5,1474
28047003310,1157,759,98,158,4,42,0,3,398
28047003311,2614,1826,209,357,4,80,3,12,788
28047003312,2057,1336,157,329,2,96,1,11,721
28047003313,2138,1619,99,165,11,93,0,24,519
28047003403,2488,2095,126,87,3,41,0,14,393
28047003405,5736,3337,341,1029,18,624,10,10,2399
28047003406,3478,2285,153,681,4,130,3,18,1193
28047003407,4674,3627,262,381,14,120,0,13,1047
28047003408,2151,1912,72,47,8,18,0,1,239
28047003409,3567,3005,147,171,29,25,1,5,562
28047003506,3288,2929,92,73,23,14,0,3,359
28047003507,3956,2816,219,631,23,60,0,19,1140
28047003508,3708,2764,156,523,9,36,4,23,944
28047003509,4223,2433,226,1125,17,174,13,4,1790
28047003510,4094,2667,220,827,17,71,5,17,1427
28047003511,2477,2215,78,69,11,12,0,9,262
28047003512,3423,2986,129,130,12,7,0,2,437
28047003513,1513,1338,32,37,11,5,0,4,175
28047003514,6029,4620,298,626,17,67,3,31,1409
28047003600,1132,503,174,333,1,95,1,4,629
28047003700,3670,1739,350,1239,10,100,8,11,1931
28047003800,1134,874,70,114,5,16,2,7,260
28047003901,1130,255,230,496,8,59,0,3,875
28047003902,2218,1244,239,502,1,107,1,9,974
28047004000,2403,368,272,1295,11,371,2,0,2035
28047980000,31,11,1,18,0,0,0,0,20
28047990000,0,0,0,0,0,0,0,0,0
28049000100,4793,2181,140,2291,8,43,0,14,2612
28049000200,5491,3807,119,1368,1,49,2,16,1684
28049000301,2147,91,73,1947,1,4,0,2,2056
28049000302,4047,204,80,3648,0,27,1,17,3843
28049000400,3136,939,139,1966,1,16,0,8,2197
28049000500,5106,66,54,4882,4,6,0,15,5040
28049000600,2918,20,22,2836,2,3,0,0,2898
28049000700,5019,191,69,4645,8,2,0,21,4828
28049000800,3950,41,39,3798,4,0,0,4,3909
28049000900,1594,14,1,1556,0,2,0,0,1580
28049001000,1190,3,8,1159,1,0,0,3,1187
28049001100,1539,79,17,1384,3,0,0,7,1460
28049001200,1629,3,5,1573,5,2,0,2,1626
28049001300,4557,2684,134,1478,4,102,1,11,1873
28049001400,3380,2942,58,245,3,53,0,5,438
28049001500,3384,2637,89,471,17,84,1,11,747
28049001600,3360,1084,146,1977,9,70,0,0,2276
28049002100,2698,56,26,2526,4,3,0,9,2642
28049002200,1870,92,53,1670,3,0,0,0,1778
28049002300,2436,65,55,2245,3,0,1,1,2371
28049002400,3788,55,36,3618,3,0,0,10,3733
28049002500,1712,46,28,1589,0,4,1,3,1666
28049002700,1142,295,51,741,5,16,5,6,847
28049003000,1595,158,54,1332,6,0,0,0,1437
28049003200,859,138,22,653,2,27,1,0,721
28049003300,5373,291,79,4850,17,0,3,8,5082
28049003400,2786,258,40,2387,0,17,0,11,2528
28049003500,3064,164,135,2703,0,0,0,19,2900
28049003600,3341,254,16,3005,4,2,1,2,3087
28049003700,2444,250,64,2047,11,2,0,15,2194
28049003800,2416,353,162,1828,8,4,0,7,2063
28049010102,5344,815,166,4215,7,33,0,18,4529
28049010103,4085,882,131,2947,8,31,0,7,3203
28049010104,2151,925,81,1070,5,25,2,5,1226
28049010201,2903,104,18,2703,0,7,0,6,2799
28049010202,5662,131,31,5419,6,11,0,8,5531
28049010203,2454,66,13,2327,2,6,0,0,2388
28049010301,2954,39,19,2822,11,0,0,9,2915
28049010304,6305,3164,147,2617,9,212,4,22,3141
28049010305,3349,1238,107,1830,1,61,0,8,2111
28049010400,5387,3563,195,1292,24,149,3,28,1824
28049010501,4847,2260,98,2218,8,145,1,23,2587
28049010502,3817,1532,67,2092,5,7,0,15,2285
28049010600,4370,1125,50,3102,4,4,0,12,3245
28049010700,6322,3500,90,2568,6,14,2,12,2822
28049010801,1469,48,56,1331,2,0,0,5,1421
28049010804,1677,525,30,915,0,154,0,6,1152
28049010805,3870,1897,104,1546,2,163,0,8,1973
28049010806,4229,2384,113,1183,6,413,0,11,1845
28049010807,3373,1842,26,1397,3,10,0,14,1531
28049010808,4103,225,44,3786,3,2,0,0,3878
28049010809,2688,414,17,2192,1,14,0,4,2274
28049010901,2471,167,136,2089,0,5,0,11,2304
28049010902,1531,102,79,1328,2,1,1,0,1429
28049011001,4906,425,98,4254,11,6,0,8,4481
28049011002,3903,216,46,3563,4,17,0,5,3687
28049011101,2827,273,20,2486,7,3,2,4,2554
28049011103,6095,1320,63,4565,2,36,0,7,4775
28049011104,5641,1162,60,4245,9,52,0,17,4479
28049011105,4641,658,40,3848,6,9,2,7,3983
28049011201,2829,1513,31,1199,8,7,0,1,1316
28049011203,4248,2298,72,1750,8,9,0,16,1950
28049011204,4902,1963,51,2786,7,10,0,2,2939
28049011300,3631,1333,89,2138,12,3,3,4,2298
28049011400,1114,32,14,1036,3,0,0,2,1082
28049011500,2554,391,127,1977,1,0,2,24,2163
28049011600,2326,19,21,2229,2,0,4,6,2307
28051950100,3715,639,20,2995,1,2,0,0,3076
28051950200,3972,611,15,3259,4,11,0,10,3361
28051950300,2337,185,24,2097,6,0,0,0,2152
28051950400,2069,430,12,1586,11,1,0,1,1639
28051950501,2712,382,27,2253,7,3,0,3,2330
28051950502,2195,112,14,2004,7,3,0,0,2083
28053950100,2114,483,23,1562,5,0,0,5,1631
28053950200,2017,566,36,1348,4,0,0,3,1451
28053950300,3654,374,32,3162,4,10,0,0,3280
28055950100,1338,440,128,748,1,5,0,1,898
28057950100,4711,4351,63,101,11,5,0,6,360
28057950201,2764,2654,30,20,2,4,0,2,110
28057950202,3493,3259,74,75,4,7,0,1,234
28057950300,3949,2921,120,762,8,15,0,20,1028
28057950400,5134,4832,58,115,11,9,0,5,302
28057950500,3812,3112,39,550,15,10,0,3,700
28059040103,4042,3506,37,328,10,12,0,7,536
28059040104,3044,2775,55,84,4,6,0,8,269
28059040105,4645,4301,83,81,15,19,5,5,344
28059040106,2884,2688,53,33,4,2,3,2,196
28059040203,5153,4098,277,277,25,141,7,17,1055
28059040205,3644,3226,94,67,30,14,1,11,418
28059040206,4994,4304,139,224,41,22,0,11,690
28059040207,4691,3478,258,462,19,145,11,8,1213
28059040208,2563,2081,132,103,11,82,3,16,482
28059040301,4841,3079,276,730,31,421,4,14,1762
28059040302,2970,1856,198,434,15,314,8,14,1114
28059040401,4322,2482,246,909,7,369,5,15,1840
28059040402,4444,3269,257,425,15,239,1,12,1175
28059040500,3685,3149,154,195,10,39,0,4,536
28059040600,5585,4508,301,336,18,108,5,15,1077
28059040701,3857,2879,296,252,17,167,3,13,978
28059040702,6209,4627,341,588,23,285,0,21,1582
28059040801,2643,1784,214,447,22,40,5,19,859
28059040802,4181,2597,333,935,29,64,1,15,1584
28059040901,6160,4147,541,944,29,113,7,34,2013
28059040902,4398,3248,330,421,21,141,1,11,1150
28059040903,3190,2380,250,295,14,48,0,13,810
28059041001,1886,1158,225,398,9,33,0,8,728
28059041002,3424,1533,311,1376,7,45,6,3,1891
28059041101,2634,1066,270,1164,6,20,5,8,1568
28059041102,3921,2037,481,1139,35,55,4,6,1884
28059041301,4210,2678,136,1131,26,26,2,13,1532
28059041302,1447,1178,70,109,5,10,0,5,269
28059041400,2796,1183,110,1413,5,12,0,13,1613
28059041500,1161,205,21,902,0,0,1,3,956
28059041600,2194,203,131,1792,9,3,0,1,1991
28059041700,1960,72,63,1754,5,9,0,2,1888
28059041800,2473,132,59,2218,0,10,0,0,2341
28059041900,2272,1196,148,844,3,9,0,4,1076
28059042000,4810,1111,1119,2372,21,44,0,9,3699
28059042100,3242,1062,690,1338,6,14,0,10,2180
28059042201,2401,844,419,1027,6,27,0,3,1557
28059042202,2212,1024,239,880,4,12,0,7,1188
28059042500,2325,1739,171,312,10,11,0,17,586
28059042600,2684,2036,278,274,0,18,0,0,648
28059042700,865,693,49,84,4,7,0,0,172
28059042900,2190,1269,195,616,1,17,3,2,921
28059990000,0,0,0,0,0,0,0,0,0
28061950101,2580,1263,11,1256,0,1,0,4,1317
28061950102,1467,905,8,521,4,0,0,0,562
28061950200,2029,721,21,1241,3,3,0,1,1308
28061950301,2078,1348,54,645,0,1,0,0,730
28061950302,3042,2150,43,760,9,3,0,5,892
28061950401,2446,507,14,1872,4,0,0,2,1939
28061950402,2725,647,18,2029,8,0,0,7,2078
28063950101,1787,105,12,1618,2,7,0,5,1682
28063950102,2441,303,23,2053,7,3,0,0,2138
28063950103,1476,384,6,1060,1,3,2,0,1092
28063950200,1556,99,33,1407,0,1,3,0,1457
28065950101,1898,450,21,1409,0,0,0,1,1448
28065950102,3200,1204,20,1922,0,3,0,0,1996
28065950201,3043,1217,35,1697,3,12,0,8,1826
28065950202,3180,1459,25,1594,5,6,0,7,1721
28067950101,4432,2639,245,1425,7,4,0,7,1793
28067950102,2135,1588,40,186,234,2,0,3,547
28067950201,2741,2271,158,240,1,2,0,4,470
28067950202,2788,1585,84,1083,2,0,1,3,1203
28067950301,4768,3776,76,822,15,21,2,3,992
28067950302,3475,3019,183,158,10,5,2,1,456
28067950401,3758,2168,452,975,8,79,4,14,1590
28067950402,5354,1574,428,3162,14,36,0,6,3780
28067950500,3839,1196,523,1983,16,18,1,14,2643
28067950601,4760,463,355,3802,5,0,1,50,4297
28067950602,2241,905,564,640,14,30,1,5,1336
28067950700,3037,1180,60,1717,6,7,2,3,1857
28067950801,2868,2462,93,249,2,6,2,4,406
28067950802,2462,2312,39,21,3,8,1,10,150
28067950901,3497,2922,89,385,3,14,1,3,575
28067950902,4258,3776,145,221,8,1,3,0,482
28067951000,3975,2105,253,1511,8,21,1,3,1870
28067951101,2986,2547,136,218,4,7,1,3,439
28067951102,3859,3188,211,333,4,11,0,12,671
28067980000,13,0,5,4,0,0,1,0,13
28069030100,4875,1277,37,3474,19,4,1,7,3598
28069030200,4113,1535,30,2012,441,2,0,6,2578
28071950100,4636,2766,242,1468,3,17,0,15,1870
28071950201,3363,2579,111,439,1,131,0,7,784
28071950203,3218,1981,286,709,0,122,3,9,1237
28071950204,2048,1658,48,277,0,22,1,1,390
28071950301,6353,4408,233,1116,9,404,0,14,1945
28071950303,2040,1088,50,790,1,44,0,2,952
28071950304,2039,1361,63,326,1,216,1,9,678
28071950402,3714,2328,73,1169,16,11,8,14,1386
28071950403,4192,2780,259,919,4,90,2,6,1412
28071950404,5134,3577,145,1074,2,173,2,20,1557
28071950502,2694,2076,48,479,8,7,1,6,618
28071950504,3490,1920,129,1085,7,188,2,10,1570
28071950505,3694,2598,143,676,2,164,0,5,1096
28071950506,3817,3134,145,351,0,68,0,2,683
28071950507,5381,4512,167,422,14,28,4,10,869
28073020101,3385,2927,47,275,6,12,0,9,458
28073020102,6752,5624,154,669,3,113,0,12,1128
28073020203,3076,1915,94,843,11,67,6,20,1161
28073020204,4595,3167,112,1079,11,49,0,9,1428
28073020205,4575,3516,108,624,3,155,2,8,1059
28073020206,4524,3559,128,581,3,93,0,2,965
28073020303,3849,2588,179,795,4,110,5,11,1261
28073020304,4661,2217,172,1888,11,132,22,19,2444
28073020305,3653,1019,587,1784,4,119,4,15,2634
28073020306,3512,1481,136,1645,9,96,0,14,2031
28073020307,1678,501,37,1001,1,43,2,23,1177
28073020308,2963,1570,162,1021,6,64,0,25,1393
28073020401,2209,1604,105,420,6,1,2,6,605
28073020402,4636,4090,95,276,9,17,1,11,546
28073020501,3896,3641,73,54,11,4,0,2,255
28073020502,3322,2728,129,329,3,5,6,12,594
28073020600,2936,1718,44,1012,7,11,0,8,1218
28075000200,2318,140,21,2071,18,4,2,2,2178
28075000300,2037,454,28,1482,2,17,0,9,1583
28075000401,1123,38,13,1036,2,0,0,6,1085
28075000402,3106,126,47,2869,1,1,2,7,2980
28075000600,1492,86,8,1334,0,1,0,10,1406
28075000700,3562,309,109,3049,5,4,0,10,3253
28075000800,1671,322,39,1250,7,6,2,6,1349
28075000900,4497,759,85,3518,3,15,0,10,3738
28075001000,3811,1425,97,2136,2,36,4,8,2386
28075001101,3436,2069,85,1153,0,64,2,7,1367
28075001102,3731,1898,82,1584,4,82,0,9,1833
28075010203,2145,1427,43,623,8,3,0,4,718
28075010204,3555,1917,106,1402,0,10,0,9,1638
28075010205,5454,3237,148,1767,5,150,6,21,2217
28075010206,1719,1143,153,312,7,28,1,2,576
28075010301,5587,4315,124,975,12,17,2,15,1272
28075010303,3803,2912,69,680,2,23,0,12,891
28075010304,2902,2489,68,261,2,14,2,4,413
28075010400,2754,1560,44,1101,5,0,1,6,1194
28075010501,2785,2448,69,180,3,5,2,11,337
28075010502,3158,2261,166,597,3,28,1,12,897
28075010601,3537,2431,99,837,3,42,0,20,1106
28075010602,3604,2384,59,1027,4,9,1,16,1220
28075010700,1149,356,11,734,3,12,0,1,793
28075980000,48,28,16,2,0,0,0,0,20
28077960100,3830,2065,40,1638,0,6,0,7,1765
28077960200,4284,2483,71,1620,7,16,2,4,1801
28077960300,3902,3259,96,432,10,11,2,0,643
28079040100,3023,2262,89,590,23,4,1,9,761
28079040401,3307,2482,45,655,52,10,3,5,825
28079040402,2756,899,71,1105,616,4,0,3,1857
28079040500,3055,1734,100,1155,13,14,0,4,1321
28079040600,5844,1637,881,2569,582,44,1,19,4207
28079040700,3290,1055,44,2115,11,2,0,2,2235
28081950101,5340,4214,104,797,7,19,5,1,1126
28081950102,3435,2576,45,709,5,14,2,0,859
28081950202,5897,5048,131,472,5,37,2,1,849
28081950203,2140,1803,18,253,2,23,0,4,337
28081950204,5619,4228,129,860,7,174,1,17,1391
28081950301,4694,4088,174,280,0,13,2,7,606
28081950302,3586,2809,87,577,2,7,1,6,777
28081950401,4001,1739,100,2033,2,26,0,7,2262
28081950403,2615,1866,52,504,4,101,2,12,749
28081950404,5282,4164,81,777,6,115,0,28,1118
28081950501,1920,976,54,805,4,45,0,4,944
28081950502,3562,2273,114,961,6,85,1,9,1289
28081950601,3991,2326,211,1240,4,57,0,10,1665
28081950602,3781,1919,228,1516,11,14,0,19,1862
28081950700,3596,1438,255,1776,2,14,0,11,2158
28081950800,3334,1290,189,1681,7,43,1,10,2044
28081950901,3170,1579,299,1138,6,56,0,14,1591
28081950902,4060,1609,291,1988,5,57,2,3,2451
28081951001,3642,2008,84,1454,0,4,0,5,1634
28081951002,3681,804,81,2672,5,5,3,12,2877
28081951101,2514,1363,43,1019,0,5,2,0,1151
28081951102,3483,2734,58,619,4,6,1,1,749
28081980000,0,0,0,0,0,0,0,0,0
28083950100,735,303,13,390,0,0,0,0,432
28083950200,3102,651,155,2238,2,8,0,0,2451
28083950300,4362,494,197,3586,4,10,0,11,3868
28083950400,4797,688,227,3808,2,14,0,3,4109
28083950600,5659,3544,143,1720,5,146,0,6,2115
28083950700,1777,200,46,1490,0,4,0,2,1577
28083950800,3749,47,13,3591,2,15,0,4,3702
28083950900,4158,36,46,3986,0,8,0,0,4122
28085950100,4015,2363,47,1521,12,6,2,11,1652
28085950201,3382,2562,59,669,5,5,1,12,820
28085950202,2958,2497,27,371,3,6,0,4,461
28085950301,3859,3004,52,694,16,12,3,10,855
28085950302,3332,3131,31,83,3,15,0,9,201
28085950401,2596,1985,31,486,10,0,0,3,611
28085950402,4383,3469,48,737,4,6,1,1,914
28085950500,4742,1311,45,3228,7,24,0,10,3431
28085950601,3144,2517,48,439,2,79,1,6,627
28085950602,2496,157,18,2256,1,10,0,11,2339
28087000102,2531,1723,50,636,3,28,0,7,808
28087000103,5224,4367,124,487,21,17,0,9,857
28087000104,1473,1090,38,265,1,0,0,6,383
28087000301,3953,2703,106,904,7,106,5,6,1250
28087000302,3733,2162,145,1187,2,86,3,7,1571
28087000403,4205,1672,43,2361,8,10,0,7,2533
28087000404,4008,3145,88,620,9,12,0,4,863
28087000405,5969,3098,89,2632,17,17,0,10,2871
28087000406,1958,1559,48,289,3,9,0,2,399
28087000500,3943,1062,58,2743,8,16,0,2,2881
28087000600,3658,678,33,2872,3,12,0,5,2980
28087000700,4489,1205,95,3045,7,43,3,9,3284
28087000800,2801,107,43,2587,0,1,0,0,2694
28087000901,2528,962,111,1313,7,50,1,12,1566
28087000902,2879,1055,40,1697,3,16,0,9,1824
28087001000,2218,1326,56,785,5,6,0,6,892
28087001100,1696,318,6,1336,0,1,0,0,1378
28087980000,1613,1131,150,126,6,84,4,9,482
28089030104,2617,1390,63,803,0,277,0,14,1227
28089030105,3595,1242,509,1595,26,116,0,19,2353
28089030107,2588,1675,110,632,3,76,1,15,913
28089030108,4495,1072,412,2679,0,139,1,12,3423
28089030109,3985,2794,171,868,5,64,4,12,1191
28089030110,3654,3119,59,272,3,117,1,6,535
28089030111,1874,571,257,893,7,77,0,8,1303
28089030112,2983,873,106,1792,3,102,0,17,2110
28089030202,5173,4061,68,605,7,274,3,19,1112
28089030203,3097,2092,82,587,8,233,0,13,1005
28089030204,4667,3371,76,682,4,398,0,13,1296
28089030205,2905,2100,53,536,2,145,0,14,805
28089030206,2173,1608,44,353,5,108,0,2,565
28089030207,3945,3332,87,339,4,93,0,6,613
28089030208,6440,4368,127,1586,6,171,0,9,2072
28089030301,6409,5065,172,745,0,234,0,22,1344
28089030302,6636,3734,39,2684,11,12,0,20,2902
28089030401,9936,5673,258,3459,29,266,2,40,4263
28089030402,10178,8173,228,1238,15,237,0,15,2005
28089030403,1362,504,7,819,0,3,0,1,858
28089030501,2396,22,490,1811,0,2,0,0,2374
28089030502,3886,28,53,3737,2,1,0,5,3858
28089030600,3447,419,304,2647,8,3,1,0,3028
28089030900,5851,1860,45,3833,5,6,0,11,3991
28089031000,1918,404,8,1469,3,4,0,3,1514
28089031100,2935,723,289,1862,4,9,0,4,2212
28091950100,5611,4195,48,1197,5,8,0,12,1416
28091950200,3362,2433,62,750,5,4,0,10,929
28091950300,3120,1104,92,1825,5,10,0,6,2016
28091950400,3747,2544,68,1013,10,21,0,2,1203
28091950500,4178,2038,70,1956,6,16,0,13,2140
28091950600,4423,3407,66,842,11,6,0,3,1016
28093950101,2466,1494,43,880,3,0,3,5,972
28093950102,3676,2172,291,1094,5,9,3,5,1504
28093950201,3883,1773,224,1734,7,6,5,3,2110
28093950202,3658,2701,275,559,9,24,1,0,957
28093950301,3756,1926,356,1337,4,16,0,10,1830
28093950302,3142,1609,184,1247,8,6,0,7,1533
28093950401,2482,353,24,2047,0,5,1,8,2129
28093950402,4654,875,47,3609,4,2,6,17,3779
28093950501,2118,815,37,1193,8,4,0,4,1303
28093950502,3917,2566,59,1180,7,2,1,8,1351
28095950101,2635,2388,16,159,1,4,0,3,247
28095950102,2647,2510,21,49,6,6,0,0,137
28095950201,2836,1696,32,1064,0,6,0,3,1140
28095950202,4298,2923,93,1155,10,8,0,2,1375
28095950300,3410,2856,84,336,5,10,0,7,554
28095950400,3116,1539,75,1413,11,7,1,8,1577
28095950501,3030,2535,42,402,0,5,0,0,495
28095950502,3985,3484,41,365,6,3,0,9,501
28095950600,3158,1318,14,1757,2,1,0,4,1840
28095950700,2239,579,22,1576,4,15,0,4,1660
28095950800,2826,659,33,2035,5,2,2,4,2167
28097950100,2624,1527,25,1024,4,1,0,1,1097
28097950200,2352,1606,39,645,5,2,0,1,746
28097950301,2580,1080,15,1393,0,20,0,5,1500
28097950302,2266,881,27,1302,0,1,0,1,1385
28099010101,2752,2026,56,551,29,10,0,19,726
28099010102,3048,1868,29,358,674,32,0,2,1180
28099010200,2924,2352,30,465,22,2,0,2,572
28099010400,3589,1189,65,2180,66,16,0,10,2400
28099010500,2876,1377,62,1202,92,34,0,10,1499
28099010600,4945,3736,71,354,690,10,0,2,1209
28099010700,4891,3304,63,1148,183,17,0,18,1587
28099940100,4062,574,58,122,3157,1,0,5,3488
28101050100,3349,3025,57,194,7,10,0,2,324
28101050200,3559,2755,40,671,14,20,0,2,804
28101050301,3588,1975,63,1420,32,15,0,2,1613
28101050302,2799,1257,23,327,1106,12,0,3,1542
28101050400,4499,2921,106,1353,5,10,0,9,1578
28101050500,3497,863,40,2482,5,10,0,11,2634
28103950100,4805,1211,68,3424,0,0,0,0,3594
28103950200,3086,1096,57,1807,9,10,0,1,1990
28103950300,2394,332,47,1959,4,4,0,3,2062
28105950101,5875,3114,179,2316,11,100,2,25,2761
28105950102,3476,1751,107,1439,8,94,0,6,1725
28105950201,3600,2159,131,956,15,199,0,10,1441
28105950202,3415,2000,48,1272,1,12,0,4,1415
28105950300,3579,838,51,2520,0,75,0,1,2741
28105950401,5577,4163,176,955,20,114,3,79,1414
28105950402,2353,1199,54,910,6,101,3,1,1154
28105950500,3894,2508,118,1086,8,66,0,0,1386
28105950601,5469,3803,156,888,13,407,0,72,1666
28105950603,2800,1638,49,925,2,120,0,3,1162
28105950604,3212,1434,107,1402,1,158,0,10,1778
28105950701,4298,2070,35,2056,0,44,1,12,2228
28105950702,4240,2547,57,1503,8,16,1,8,1693
28107950101,3040,715,24,2242,3,8,0,0,2325
28107950102,3589,1386,33,2091,11,2,0,8,2203
28107950201,1719,307,13,1362,0,0,2,3,1412
28107950202,953,333,14,576,2,0,0,5,620
28107950301,2923,2055,153,609,10,2,0,0,868
28107950302,2235,1136,72,983,3,2,0,0,1099
28107950400,5385,3621,85,1530,15,4,2,9,1764
28107950501,2707,1358,40,1237,2,2,0,3,1349
28107950502,3802,1788,66,1855,3,4,0,2,2014
28107950601,4140,2619,152,1242,2,38,0,5,1521
28107950602,2715,324,26,2308,1,0,0,0,2391
28109950101,3098,2806,89,36,24,8,0,4,292
28109950102,2552,2281,83,63,8,0,0,3,271
28109950201,2683,2400,95,84,16,7,0,7,283
28109950202,2771,2117,70,452,19,4,0,0,654
28109950300,3339,2299,79,809,8,29,0,7,1040
28109950403,3716,3012,94,414,11,8,0,19,704
28109950404,3636,3222,150,90,19,9,0,17,414
28109950405,3957,3282,185,283,14,13,0,9,675
28109950406,2416,2149,74,45,14,24,0,9,267
28109950503,4150,3661,187,87,18,21,0,12,489
28109950504,3410,2967,165,110,30,20,0,13,443
28109950505,3803,3322,141,110,22,13,0,4,481
28109950506,4705,3957,202,276,18,55,0,9,748
28109950600,4500,2982,203,1029,13,19,0,21,1518
28109950701,4823,2650,348,1481,12,18,0,22,2173
28109950702,2586,994,119,1297,10,27,0,9,1592
28111950101,4511,3825,50,508,6,17,0,2,686
28111950102,3629,2853,45,602,5,9,0,11,776
28111950200,3371,2190,59,987,34,3,3,0,1181
28113950102,4470,3487,42,783,15,11,0,18,983
28113950103,1962,1029,30,811,13,11,0,8,933
28113950104,3504,2079,41,1303,4,13,0,4,1425
28113950200,5270,2444,80,2542,26,43,0,9,2826
28113950300,4524,308,54,4023,1,9,0,10,4216
28113950400,3122,1358,93,1498,2,73,1,10,1764
28113950501,4886,1151,120,3423,14,60,6,10,3735
28113950502,2140,854,20,1198,2,14,0,2,1286
28113950601,2772,893,33,1741,2,6,0,9,1879
28113950602,3665,1243,70,2223,19,8,0,13,2422
28113950700,4009,1923,44,1912,15,6,0,16,2086
28115950101,4220,2801,90,1199,5,10,3,15,1419
28115950102,5920,4618,636,480,11,6,0,8,1302
28115950200,5053,4355,234,284,7,3,1,7,698
28115950300,5662,3626,673,1141,16,13,0,25,2036
28115950400,4954,3964,163,667,3,14,1,4,990
28115950500,5375,4495,252,437,14,9,0,8,880
28117950101,3391,3126,38,122,6,7,0,10,265
28117950102,2370,2246,11,56,8,0,0,2,124
28117950201,3254,2782,51,275,15,17,0,2,472
28117950202,2996,2627,31,211,4,16,0,5,369
28117950301,3044,1453,143,1340,13,12,5,8,1591
28117950302,3584,2954,81,358,4,25,0,12,630
28117950400,4515,4106,31,287,5,0,0,7,409
28117950500,1854,872,19,898,7,8,0,1,982
28119950100,1582,254,2,1295,0,5,1,0,1328
28119950200,1574,289,5,1254,0,4,0,1,1285
28119950300,3020,941,14,1997,1,3,2,3,2079
28121020101,5668,4311,81,1105,8,22,0,9,1357
28121020103,4934,3970,55,724,7,47,0,5,964
28121020104,4701,3467,77,966,9,45,0,7,1234
28121020105,2249,1570,52,548,4,11,0,8,679
28121020208,6606,5481,173,702,10,31,0,14,1125
28121020209,4505,3746,116,406,9,53,0,14,759
28121020210,5061,4362,66,415,9,53,0,8,699
28121020212,3606,2836,84,368,12,178,0,12,770
28121020213,1383,915,39,376,0,19,1,7,468
28121020214,4143,2896,226,795,10,96,0,11,1247
28121020215,4804,3004,175,1102,11,325,0,53,1800
28121020216,3867,2823,79,670,10,185,0,27,1044
28121020217,4018,2510,127,1126,4,74,11,21,1508
28121020218,5535,4040,129,1023,13,124,1,17,1495
28121020219,4958,3638,91,950,12,132,0,13,1320
28121020301,3146,2269,130,583,1,31,2,7,877
28121020303,5015,3687,242,740,8,146,1,13,1328
28121020304,2719,1662,105,769,4,86,0,10,1057
28121020401,4720,3083,529,940,6,67,1,3,1637
28121020402,5877,4199,156,1206,5,101,2,10,1678
28121020500,4349,1936,42,2339,8,6,0,0,2413
28121020601,3732,1960,248,1343,0,38,0,12,1772
28121020602,5100,2208,267,2359,13,66,12,30,2892
28121020703,1935,1569,82,185,0,42,0,0,366
28121020705,6994,4687,572,1334,15,52,61,31,2307
28121020801,2622,2132,44,377,6,21,0,0,490
28121020803,2223,1920,80,101,3,5,0,5,303
28121020804,7248,4429,225,2265,12,46,0,24,2819
28121020805,2806,1174,59,1471,9,26,0,5,1632
28121020806,6030,4674,140,930,9,78,1,5,1356
28121020901,3115,2277,26,736,2,7,0,1,838
28121020902,4352,3668,93,486,4,11,0,1,684
28121021001,6221,5267,235,480,2,16,0,25,954
28121021003,5361,4213,56,950,8,4,0,4,1148
28121021004,5047,3792,113,937,8,11,0,7,1255
28121021005,2309,1570,48,605,2,5,1,28,739
28121980000,72,45,5,18,2,0,0,0,27
28123020101,3314,1827,393,1008,11,21,0,4,1487
28123020102,3286,1635,108,1457,13,3,0,5,1651
28123020200,4753,2195,107,2314,0,31,0,10,2558
28123020301,2994,2330,182,398,7,8,0,5,664
28123020302,2258,1601,128,486,1,5,0,0,657
28123020400,3189,818,1252,993,46,2,0,10,2371
28123020500,4690,938,1767,1860,17,33,0,6,3752
28123020600,3506,1801,211,1407,0,0,0,12,1705
28125950100,2000,545,40,1351,0,11,0,1,1455
28125950200,1800,417,21,1320,0,3,3,0,1383
28127950101,1800,1330,12,398,1,5,0,2,470
28127950102,3030,1724,33,1185,2,8,0,4,1306
28127950200,3167,1986,28,1061,4,3,0,18,1181
28127950301,2654,1649,12,907,7,5,0,7,1005
28127950302,3247,2639,25,468,6,7,0,4,608
28127950401,2311,1306,20,924,2,5,0,4,1005
28127950402,1860,983,30,797,1,3,0,6,877
28127950403,3362,2222,82,961,5,7,1,3,1140
28127950500,4518,2089,144,2102,8,41,1,14,2429
28129950100,4607,3322,39,1166,4,3,0,0,1285
28129950201,2736,2294,53,314,6,4,0,5,442
28129950202,2537,2088,36,356,4,8,0,8,449
28129950301,2472,1371,48,999,3,2,0,1,1101
28129950302,1857,1507,22,276,3,2,0,8,350
28131020100,3703,2362,70,1106,11,21,0,7,1341
28131020203,3750,3324,90,160,23,21,0,29,426
28131020204,3903,3112,57,540,13,22,9,21,791
28131020205,3686,3059,144,329,15,16,0,9,627
28131020206,3291,1965,83,1104,17,9,0,6,1326
28133950100,6504,2165,320,3912,9,4,0,9,4339
28133950200,4144,1115,55,2905,0,0,0,7,3029
28133950300,2255,725,49,1433,2,3,0,0,1530
28133950401,3220,1302,77,1714,5,63,0,15,1918
28133950402,5222,125,46,4973,0,1,0,6,5097
28133950500,2389,574,72,1709,1,4,0,0,1815
28133950600,2237,723,42,1431,2,9,0,0,1514
28135950100,3881,2347,23,1448,1,6,2,0,1534
28135950200,2434,463,18,1908,0,4,0,0,1971
28135950300,4001,979,373,2616,3,0,1,0,3022
28135950400,2399,938,11,1418,0,0,0,0,1461
28137950100,5342,3665,137,1352,13,7,0,16,1677
28137950201,2945,2098,30,734,8,2,1,2,847
28137950202,3639,2813,149,539,7,6,0,12,826
28137950301,4081,2089,93,1727,6,10,0,8,1992
28137950302,6335,4660,205,1265,12,11,0,12,1675
28137950400,5722,2694,191,2614,6,27,0,31,3028
28139950100,4748,4023,98,492,2,5,0,8,725
28139950201,4377,3357,181,726,2,2,0,9,1020
28139950202,2016,1600,158,204,4,3,0,2,416
28139950300,2867,1569,279,895,4,11,0,8,1298
28139950401,5020,4322,245,335,6,0,0,9,698
28139950402,2787,1738,157,795,2,3,0,14,1049
28141950101,2050,1926,35,10,9,5,0,0,124
28141950102,1382,1323,10,0,3,1,0,0,59
28141950200,2519,2202,49,129,12,7,0,1,317
28141950301,2938,2742,53,50,5,5,0,0,196
28141950302,3101,2903,53,44,9,8,0,4,198
28141950401,3314,2914,72,184,6,11,0,0,400
28141950402,3546,3159,265,16,4,4,0,3,387
28143950101,2190,358,53,1754,5,1,0,0,1832
28143950102,3504,505,62,2846,4,21,0,37,2999
28143950200,4082,988,74,2916,4,5,0,19,3094
28143980000,6,2,2,0,0,0,0,0,4
28145950100,4443,3977,92,243,6,6,0,7,466
28145950200,5292,4468,160,503,4,12,0,13,824
28145950300,4335,2540,364,1229,6,56,0,15,1795
28145950400,3795,2145,442,1052,5,15,0,16,1650
28145950500,5927,4951,164,607,6,17,0,18,976
28145950600,3985,3479,79,316,0,3,0,7,506
28147950101,3286,1888,45,1258,4,11,1,7,1398
28147950102,3079,1414,54,1511,13,10,1,29,1665
28147950200,1544,836,23,623,5,24,0,2,708
28147950301,3366,1771,40,1462,6,2,3,6,1595
28147950302,2609,1638,41,852,14,1,3,6,971
28149950101,1763,622,18,1052,2,1,0,5,1141
28149950102,3144,2552,55,450,2,10,0,11,592
28149950200,3724,686,34,2877,10,36,0,11,3038
28149950300,2522,355,29,2075,2,7,0,10,2167
28149950400,2441,717,47,1620,0,6,0,4,1724
28149950500,2362,846,66,1386,0,16,0,10,1516
28149950600,5377,2701,135,2300,6,93,0,13,2676
28149950700,2107,533,30,1480,5,7,0,1,1574
28149950800,3811,1379,77,2170,8,65,0,11,2432
28149950901,4686,3453,73,950,2,42,0,4,1233
28149950902,3586,2200,60,1193,5,21,0,7,1386
28149951101,5043,2867,101,1911,16,24,0,5,2176
28149951102,4156,1998,151,1826,9,36,0,7,2158
28151000100,1438,752,25,632,0,1,1,0,686
28151000200,1588,427,21,1092,3,0,1,6,1161
28151000300,2742,208,6,2477,0,1,0,2,2534
28151000400,2183,24,17,2109,0,0,2,2,2159
28151000600,2485,174,37,2212,10,8,0,0,2311
28151000701,3519,751,38,2610,0,50,1,23,2768
28151000702,3587,1625,53,1714,5,105,0,7,1962
28151000800,3272,1304,41,1807,11,67,0,0,1968
28151000900,2701,583,18,2040,4,13,0,2,2118
28151001000,1021,51,11,944,0,4,0,3,970
28151001100,1231,8,10,1186,0,3,0,1,1223
28151001200,2048,74,20,1917,0,0,0,1,1974
28151001300,2170,156,41,1931,2,4,0,9,2014
28151001400,4066,493,50,3450,5,14,0,2,3573
28151001500,4305,3230,142,777,6,15,0,8,1075
28151001600,1759,549,11,1137,2,15,0,2,1210
28151001700,2435,557,28,1792,0,2,0,0,1878
28151002000,1135,178,5,936,0,0,0,0,957
28151002100,1237,36,10,1156,0,0,0,1,1201
28153950101,2353,1051,20,1241,0,4,0,1,1302
28153950102,2750,1186,32,1485,5,2,2,3,1564
28153950200,4455,1346,209,2812,1,18,0,4,3109
28153950301,2132,1325,14,754,10,3,0,0,807
28153950302,3149,2778,33,268,9,3,0,3,371
28153950401,2866,2683,15,94,6,5,0,0,183
28153950402,2074,944,20,1054,0,0,0,0,1130
28155950100,4731,3985,68,545,0,7,0,9,746
28155950200,3494,2852,48,474,12,5,1,7,642
28155950300,1701,854,39,763,2,1,0,5,847
28157950100,3350,1276,28,1949,4,2,0,8,2074
28157950201,2056,468,18,1520,8,1,0,1,1588
28157950202,3181,781,24,2295,4,5,0,4,2400
28159950100,3049,1992,23,975,7,3,0,1,1057
28159950200,3448,1682,22,1683,4,0,0,1,1766
28159950300,3785,932,70,2686,4,12,1,3,2853
28159950400,3346,1617,34,1611,4,18,0,8,1729
28159950500,4086,2633,77,1123,143,6,0,6,1453
28161950100,3457,2015,30,1313,9,3,0,0,1442
28161950200,4253,2406,54,1656,1,15,2,16,1847
28161950301,2645,1256,19,1291,7,0,0,0,1389
28161950302,2126,1654,60,355,7,3,0,0,472
28163950100,7987,2861,923,4060,41,24,1,0,5126
28163950200,3056,812,27,2108,0,33,1,1,2244
28163950300,4700,332,21,4231,4,25,2,14,4368
28163950400,1621,1223,29,336,0,1,0,3,398
28163950500,3653,263,35,3286,3,4,2,0,3390
28163950601,2746,1851,25,776,2,7,0,6,895
28163950602,2980,1842,16,1015,0,21,0,12,1138
29001950100,3706,3512,45,4,4,13,2,0,194
29001950200,2811,2684,36,1,5,16,1,10,127
29001950300,2925,2278,116,286,9,59,1,3,647
29001950400,4193,3448,110,331,1,104,1,4,745
29001950501,3923,3314,105,128,13,184,2,14,609
29001950502,3263,2746,100,166,5,94,0,8,517
29001950900,2149,1699,61,213,0,85,2,6,450
29001951000,2344,1909,88,136,4,130,4,5,435
29003010100,6212,5648,169,94,19,53,0,11,564
29003010201,3962,3675,97,20,8,6,0,7,287
29003010202,2939,2714,44,17,5,6,0,15,225
29003010300,1975,1860,33,5,0,5,0,5,115
29003010400,3047,2859,48,2,8,19,0,6,188
29005950100,3058,2878,49,12,7,5,0,7,180
29005950200,2247,2105,24,10,18,2,0,7,142
29007950100,3796,3191,91,306,12,13,0,22,605
29007950200,4791,4498,66,20,2,14,0,5,293
29007950300,3634,3417,100,10,11,2,0,15,217
29007950400,2720,2171,86,247,6,40,0,3,549
29007950500,3724,3027,200,229,13,16,1,11,697
29007950600,2648,2204,82,174,4,13,0,15,444
29007950700,3649,2942,106,318,15,16,1,10,707
29009960101,2938,2706,79,0,18,12,1,2,232
29009960102,2660,2387,77,5,22,8,4,8,273
29009960201,2655,2154,182,1,22,160,9,6,501
29009960202,3234,2433,604,6,27,39,1,9,801
29009960301,3740,2296,1187,5,40,25,20,3,1444
29009960302,3026,2031,509,8,10,328,20,5,995
29009960401,3962,3485,116,8,55,25,2,23,477
29009960402,3603,2895,242,37,36,160,0,13,708
29009960500,6150,5327,294,24,60,42,13,5,823
29009960600,2566,2344,43,8,26,9,0,7,222
29011960100,2865,2468,70,8,48,5,0,4,397
29011960200,3804,3490,42,2,49,9,2,0,314
29011960300,4968,4409,154,17,48,23,0,11,559
29013070100,4985,4712,70,15,24,7,1,9,273
29013070200,4055,3734,67,20,27,19,4,7,321
29013070300,4470,3966,161,103,30,20,2,2,504
29013070400,2532,2387,37,17,11,2,2,3,145
29015460100,3230,3037,29,9,17,6,0,2,193
29015460200,2383,2228,41,5,9,7,0,2,155
29015460300,4603,4165,115,22,21,17,0,16,438
29015460400,2204,2069,35,5,13,6,0,2,135
29015460701,1260,1170,22,0,8,3,0,7,90
29015460702,1611,1499,14,9,9,0,0,3,112
29015460801,1633,1498,29,8,9,5,0,6,135
29015460802,2470,2268,25,17,14,7,0,6,202
29017950100,4115,3813,74,16,16,5,0,16,302
29017950200,3858,3613,55,12,1,13,3,2,245
29017950300,2594,2436,24,7,13,2,0,4,158
29019000200,1698,1250,111,188,7,23,1,9,448
29019000300,2622,2073,113,88,9,204,6,22,549
29019000500,5226,4119,245,239,2,392,3,23,1107
29019000600,4558,4017,124,107,3,83,2,14,541
29019000700,3345,2420,170,461,12,37,0,17,925
29019000900,1389,760,68,423,9,15,2,16,629
29019001001,5042,3680,205,449,12,370,3,58,1362
29019001003,4108,2895,238,489,7,114,0,38,1213
29019001004,4170,2950,420,405,8,92,0,19,1220
29019001105,3350,2206,205,369,2,383,1,14,1144
29019001106,6434,4352,432,779,20,426,5,29,2082
29019001107,3912,3161,146,204,5,201,0,22,751
29019001108,2901,2348,121,140,2,154,0,11,553
29019001109,5811,4227,272,542,9,368,0,30,1584
29019001110,7723,5994,279,415,5,654,3,29,1729
29019001201,6064,4839,205,335,3,350,3,32,1225
29019001202,5315,4292,169,271,5,253,3,22,1023
29019001300,4074,2465,234,682,13,397,5,21,1609
29019001401,6421,4404,289,920,30,280,1,28,2017
29019001402,5964,4187,300,699,12,332,8,28,1777
29019001503,4339,2624,236,993,10,106,14,32,1715
29019001505,3504,1883,258,1001,10,67,12,25,1621
29019001506,3167,1840,180,772,15,86,1,28,1327
29019001507,3277,1639,493,669,16,133,16,37,1638
29019001508,5723,3490,347,1156,18,265,3,27,2233
29019001602,4626,3924,115,196,18,121,1,32,702
29019001603,3694,2671,146,520,10,44,4,8,1023
29019001604,4506,2843,198,921,13,164,5,35,1663
29019001702,5745,4822,130,256,29,162,4,26,923
29019001703,3658,3345,52,28,14,11,2,11,313
29019001704,4711,4296,115,40,19,14,0,28,415
29019001803,4414,3709,131,172,7,106,0,13,705
29019001806,5526,4393,175,346,10,265,0,29,1133
29019001807,5570,4106,224,452,2,368,2,31,1464
29019001901,4530,4070,125,58,23,23,0,19,460
29019001903,4870,4303,107,67,13,85,1,17,567
29019001904,4225,3868,55,36,9,6,1,22,357
29019002000,5458,5008,127,62,8,13,4,16,450
29019002100,4023,2167,169,1172,15,225,2,41,1856
29019002200,7917,6131,323,760,18,380,2,31,1786
29021000100,6343,5009,349,334,9,348,24,20,1334
29021000200,4336,3750,214,126,13,56,3,10,586
29021000300,2701,2273,152,93,9,6,2,6,428
29021000400,1563,1226,147,40,14,3,19,8,337
29021000500,2852,2407,157,78,13,28,3,12,445
29021000600,4814,3840,241,479,24,89,11,8,974
29021000701,4576,3658,207,389,15,82,0,14,918
29021000702,4334,3181,246,400,9,139,140,12,1153
29021000900,4521,3408,368,262,18,77,27,24,1113
29021001000,2279,1373,294,387,8,14,27,5,906
29021001100,2259,1722,155,151,11,16,38,15,537
29021001200,1890,1367,164,199,4,15,16,4,523
29021001500,4912,3807,409,224,21,25,21,13,1105
29021001600,2556,2066,176,135,8,8,0,5,490
29021001700,4308,3570,261,163,23,43,2,18,738
29021001800,3338,2858,191,81,12,9,2,4,480
29021002100,2188,1726,211,114,6,15,7,7,462
29021002200,1956,1755,78,22,2,6,0,2,201
29021002300,2229,1891,186,39,9,6,1,0,338
29021002400,1907,1408,295,44,8,4,53,11,499
29021002500,1973,1624,175,42,17,8,1,2,349
29021002700,3514,3116,87,103,14,0,2,1,398
29021002800,4842,4481,122,20,6,18,0,8,361
29021002900,3059,2843,72,10,12,7,0,8,216
29021003001,2961,2261,343,122,30,16,6,13,700
29021003002,2582,1771,300,246,8,10,21,7,811
29023950101,3675,3397,66,26,8,16,0,8,278
29023950102,1872,1721,30,3,14,1,2,0,151
29023950201,5476,4907,92,137,13,100,0,8,569
29023950202,6018,5427,112,121,25,33,0,14,591
29023950301,3745,3125,94,223,11,60,1,7,620
29023950302,3289,2613,108,298,15,43,5,15,676
29023950400,3171,2113,80,655,25,12,0,15,1058
29023950500,2285,1803,42,226,10,7,2,14,482
29023950600,3834,3526,60,57,25,1,0,1,308
29023950700,2587,1933,72,284,9,15,2,6,654
29023950800,2808,2246,88,253,15,7,0,7,562
29023950900,3370,2934,57,180,28,9,0,5,436
29025950100,2614,2452,20,12,8,5,0,8,162
29025950201,2979,2711,61,52,11,11,1,11,268
29025950202,3222,3009,70,1,15,10,6,4,213
29027070100,4798,4393,95,58,4,19,0,10,405
29027070200,3298,2955,38,30,10,12,0,13,343
29027070301,4021,3352,83,369,9,33,1,8,669
29027070302,3308,2599,68,421,10,18,3,9,709
29027070400,5720,4455,179,626,43,41,8,41,1265
29027070500,4900,4430,94,78,23,27,0,17,470
29027070601,3495,3193,66,28,4,12,0,15,302
29027070602,3255,3018,27,7,5,8,5,4,237
29027070701,2296,2087,48,18,8,2,2,9,209
29027070702,3821,3369,95,97,14,14,9,9,452
29027070800,5371,4602,172,211,11,36,2,27,769
29029950101,2561,2332,40,35,8,24,0,33,229
29029950102,2403,2210,74,5,4,13,4,3,193
29029950201,3635,3016,308,85,13,56,1,6,619
29029950202,2755,2466,90,17,7,31,3,3,289
29029950301,1487,1365,29,6,11,2,2,20,122
29029950302,931,882,11,0,2,5,0,0,49
29029950401,2087,1807,90,16,16,9,0,2,280
29029950402,1878,1741,40,2,6,11,4,0,137
29029950500,3707,3177,213,37,17,20,5,12,530
29029950600,3885,3559,125,15,20,13,4,6,326
29029950701,2099,1978,50,0,4,2,2,0,121
29029950702,1005,938,16,3,7,1,0,7,67
29029950801,2626,2424,58,5,15,7,0,7,202
29029950802,3781,3412,107,10,16,7,0,4,369
29029950900,3027,2849,47,1,14,8,1,8,178
29029951101,1580,1492,19,5,4,7,0,3,88
29029951102,1231,1143,12,4,6,0,2,9,88
29029951201,1060,993,9,1,5,3,0,2,67
29029951202,1007,930,17,0,2,2,0,3,77
29031880100,6095,5687,82,24,14,15,0,15,408
29031880200,4133,3829,56,43,6,32,0,8,304
29031880300,5273,4860,72,58,12,19,3,23,413
29031880401,5778,5258,92,82,21,31,0,18,520
29031880402,2500,2167,46,128,4,19,1,7,333
29031880501,5536,4974,115,98,4,61,0,8,562
29031880502,4283,3827,93,111,4,44,0,4,456
29031880600,7583,6704,154,270,11,113,0,6,879
29031880700,5025,4198,93,340,4,150,0,26,827
29031880800,4347,3363,204,502,6,82,2,4,984
29031880900,2561,1484,73,634,10,186,0,16,1077
29031881000,1749,1178,63,325,7,77,0,1,571
29031881100,3229,2486,165,332,11,22,0,8,743
29031881200,6794,5543,173,517,7,186,2,19,1251
29031881301,3804,2885,154,452,10,133,0,8,919
29031881302,2511,1508,159,643,6,39,1,16,1003
29031881400,2429,1096,197,972,8,3,3,5,1333
29031881500,5066,4512,136,134,9,50,0,4,554
29031881600,3014,1834,107,794,16,38,2,6,1180
29033960100,2225,2085,36,17,4,2,0,0,140
29033960200,2419,2299,19,20,7,0,0,1,120
29033960300,3851,3522,77,60,4,13,0,5,329
29035960100,3256,3009,62,1,13,9,1,0,247
29035960200,1946,1785,35,10,4,9,0,3,161
29037060001,4796,3839,360,266,20,40,5,10,957
29037060003,3615,2620,361,266,25,79,0,10,995
29037060004,5345,3996,585,289,27,54,3,19,1349
29037060100,1413,943,144,122,4,20,24,13,470
29037060202,4854,3950,327,179,29,33,0,22,904
29037060305,4789,3821,246,421,13,35,4,23,968
29037060306,6714,5009,380,785,37,94,1,32,1705
29037060307,4891,3676,210,617,15,90,2,38,1215
29037060308,4474,3666,193,253,24,42,0,21,808
29037060309,4475,3604,229,273,21,36,0,27,871
29037060401,2238,1933,85,65,2,21,0,4,305
29037060402,3326,2993,107,24,9,16,0,9,333
29037060500,2916,2640,78,30,5,17,3,5,276
29037060601,4916,4446,142,28,21,22,1,12,470
29037060602,4028,3488,225,32,22,12,2,15,540
29037060700,3581,3239,98,16,21,6,2,14,342
29037060800,6203,5615,165,38,32,27,0,16,588
29037060904,3229,2812,137,43,18,21,0,20,417
29037061001,4545,4031,151,65,22,35,0,19,514
29037061002,7414,6378,297,144,38,41,3,18,1036
29037061100,4179,3871,85,16,27,11,0,8,308
29037061200,4032,3640,127,17,15,4,4,12,392
29037061300,6581,4620,649,815,21,54,19,40,1961
29037061400,5270,4576,202,100,34,31,5,23,694
29039870101,2647,2408,54,13,18,5,2,4,239
29039870102,3419,3095,53,29,41,9,0,10,324
29039870200,4857,4390,101,13,26,22,2,15,467
29039870300,3265,3006,53,2,15,6,3,5,259
29041470100,2220,2125,19,1,2,0,0,0,95
29041470200,2372,2136,47,103,8,1,2,0,236
29041470300,2816,2664,35,40,5,2,1,1,152
29043020101,3106,2839,62,2,16,18,0,14,267
29043020102,6333,5724,179,28,32,18,0,12,609
29043020201,4508,3976,147,25,30,33,1,8,532
29043020202,6771,5825,353,73,31,86,7,27,946
29043020204,4714,4191,145,44,24,32,3,11,523
29043020205,6682,5716,304,71,44,69,11,19,966
29043020206,4566,4012,150,50,21,40,9,8,554
29043020207,5045,4441,153,54,28,106,6,8,604
29043020302,6449,5682,285,37,36,34,2,12,767
29043020303,5764,5132,198,38,26,24,4,23,632
29043020304,3675,3204,161,15,29,26,0,34,471
29043020307,4571,4097,141,24,27,20,0,8,474
29043020308,2946,2526,129,34,8,29,4,8,420
29043020309,1930,1696,72,30,11,6,0,10,234
29043020310,6528,5895,206,41,18,36,8,6,633
29043020401,3869,3565,59,7,24,13,0,6,304
29043020402,4032,3613,92,8,22,17,7,14,419
29043020501,4252,3856,107,13,30,12,6,12,396
29043020502,3101,2900,69,3,11,5,0,0,201
29045950100,1927,1844,5,5,0,0,0,0,83
29045950200,1936,1856,13,6,7,10,0,3,80
29045950300,2771,2637,32,10,2,2,0,7,134
29047020201,5423,3029,689,828,48,417,84,22,2394
29047020202,4867,3639,396,335,9,222,0,10,1228
29047020300,6688,4293,724,758,50,415,44,17,2395
29047020400,2561,1358,330,495,3,144,64,16,1203
29047020500,6252,3902,651,938,39,272,11,28,2350
29047020602,4417,2367,491,1052,16,129,23,22,2050
29047020603,4196,2985,432,343,13,50,20,30,1211
29047020604,5484,3299,714,861,29,148,30,14,2185
29047020802,2656,2233,138,96,11,28,1,5,423
29047020803,2906,2280,213,158,18,20,22,13,626
29047020901,6107,4564,569,383,15,190,22,13,1543
29047020902,2562,1899,288,131,22,45,5,9,663
29047021001,3716,2577,417,368,22,41,34,21,1139
29047021003,4115,3060,287,391,13,112,12,29,1055
29047021004,3068,2313,295,166,11,55,13,6,755
29047021101,5123,3851,435,325,30,83,59,23,1272
29047021103,3772,2786,313,244,20,48,71,27,986
29047021104,3187,2344,221,258,6,85,98,17,843
29047021105,3736,2638,318,362,14,61,21,20,1098
29047021204,5679,3558,701,686,23,233,48,27,2121
29047021208,6058,3860,602,987,30,155,59,29,2198
29047021209,4461,3457,359,291,15,121,12,15,1004
29047021210,4368,3144,343,370,10,269,8,19,1224
29047021211,2804,2145,210,197,10,63,5,12,659
29047021212,6754,4877,499,629,19,256,21,23,1877
29047021213,3193,1877,321,667,13,91,11,21,1316
29047021214,1417,1069,94,129,0,63,0,4,348
29047021303,5065,4242,225,170,16,133,3,8,823
29047021307,7622,5508,626,642,28,311,35,33,2114
29047021309,5911,4955,214,209,7,287,0,6,956
29047021311,2866,2218,211,177,13,85,0,14,648
29047021312,7620,6222,437,325,18,202,3,16,1398
29047021313,8275,6285,675,473,28,185,23,39,1990
29047021314,7251,5722,570,376,26,132,13,25,1529
29047021401,4628,3859,219,239,7,42,5,20,769
29047021403,2995,2420,170,125,17,15,6,8,575
29047021404,4816,3974,225,251,16,41,9,27,842
29047021601,4767,3786,310,267,19,63,17,14,981
29047021602,3505,3112,98,38,21,35,1,10,393
29047021701,5379,4777,191,69,21,27,0,14,602
29047021703,2543,2280,73,35,22,6,0,11,263
29047021704,3322,2816,142,68,19,8,1,19,506
29047021806,4066,3625,157,36,13,16,4,20,441
29047021807,4233,3260,330,267,18,75,3,32,973
29047021808,4648,3775,268,267,16,108,8,18,873
29047021809,4566,4183,152,21,12,14,2,11,383
29047021810,3033,2723,120,15,12,18,0,12,310
29047021811,3537,3212,111,12,14,23,3,28,325
29047021812,5577,5023,172,27,18,49,0,7,554
29047021900,6768,6041,274,85,32,51,9,18,727
29047022000,6540,5872,209,50,26,40,3,22,668
29047022100,5343,3724,508,656,15,126,46,28,1619
29047022200,4110,2928,561,212,21,54,5,42,1182
29047022301,3180,2586,188,171,10,32,6,3,594
29047022302,5599,4750,364,122,15,65,1,15,849
29049960100,5430,4874,144,28,21,44,0,10,556
29049960201,3045,2790,68,6,9,8,0,4,255
29049960202,4012,3709,89,10,19,9,0,8,303
29049960300,4228,3746,120,130,13,16,1,13,482
29049960400,4469,4145,81,28,9,8,4,14,324
29051010300,4815,3632,163,684,14,24,2,21,1183
29051010401,3714,2985,71,385,9,45,2,20,729
29051010402,2987,2457,95,225,13,18,3,15,530
29051010500,4313,2601,190,1164,6,36,13,16,1712
29051010600,3661,2219,181,738,12,261,2,29,1442
29051010701,6009,4770,251,493,6,223,0,16,1239
29051010702,5083,4048,175,487,12,75,7,25,1035
29051010801,5920,4553,300,658,15,64,3,27,1367
29051010802,3670,3086,201,146,3,56,4,1,584
29051010901,3568,3143,74,155,1,18,0,14,425
29051010902,2698,2139,91,281,8,23,3,8,559
29051020198,7347,5832,178,1139,16,13,2,9,1515
29051020200,4632,4372,54,30,8,15,5,8,260
29051020300,3494,3326,39,11,0,5,3,5,168
29051020400,6531,4933,416,648,25,59,2,51,1598
29051020500,2761,2555,36,6,12,6,0,13,206
29051020600,4167,3833,93,55,10,11,5,14,334
29051020700,1909,990,53,736,5,13,0,13,919
29053950100,3341,3097,48,31,8,10,4,10,244
29053950200,2640,1893,45,521,14,9,1,6,747
29053950300,4078,3420,117,196,10,29,1,25,658
29053950400,2434,2031,60,142,8,13,0,5,403
29053950500,4610,4289,52,30,13,6,0,16,321
29055450101,1794,1680,31,12,1,6,0,6,114
29055450103,3209,2960,60,12,10,13,2,4,249
29055450104,2883,2667,46,11,9,17,5,7,216
29055450200,3771,3469,44,15,26,10,6,11,302
29055450301,2227,2027,43,7,14,10,0,0,200
29055450302,4326,3856,176,31,27,17,0,4,470
29055450401,1979,1803,53,11,6,3,0,2,176
29055450402,2867,2518,29,49,14,5,1,5,349
29057480100,4621,4291,78,24,28,9,0,0,330
29057480200,2948,2704,57,10,22,15,0,0,244
29059480100,4760,4415,87,12,11,1,3,13,345
29059480200,5337,4824,130,11,49,13,5,4,513
29059480301,2799,2597,38,3,11,3,4,8,202
29059480302,4175,3860,65,18,21,8,3,18,315
29061470100,3217,3058,32,13,14,9,8,0,159
29061470200,5213,4866,81,18,13,7,2,7,347
29063080101,2157,2065,25,0,2,3,1,4,92
29063080102,5065,4066,130,663,17,33,1,0,999
29063080200,3807,3522,72,9,11,6,0,20,285
29065960100,4448,4126,52,4,25,5,0,14,322
29065960200,4945,4510,108,27,16,15,2,13,435
29065960300,2188,1980,44,9,12,25,1,6,208
29065960400,2840,2587,67,12,8,9,4,14,253
29067950100,2764,2563,62,2,14,10,0,2,201
29067950200,4605,4261,86,11,31,0,0,11,344
29067950500,4209,3778,91,22,29,14,0,15,431
29069360100,2131,1170,47,741,14,0,0,6,961
29069360200,2568,2103,71,265,7,4,3,4,465
29069360300,3658,3415,71,25,7,0,0,2,243
29069360400,3751,3159,306,105,7,2,0,3,592
29069360500,2936,1898,224,665,3,7,0,6,1038
29069360600,4290,3017,274,768,10,37,1,12,1273
29069360700,3576,2600,216,530,6,25,0,13,976
29069360800,2082,1456,530,35,6,0,0,5,626
29069360900,1666,1460,100,32,2,0,0,12,206
29069361000,1625,1351,203,10,8,3,0,2,274
29071800101,2534,2317,36,35,7,9,2,13,217
29071800102,2065,1869,62,13,5,19,1,7,196
29071800103,2224,2002,53,20,6,3,0,5,222
29071800104,1857,1738,33,4,2,7,0,8,119
29071800201,5231,4726,176,38,12,25,16,4,505
29071800202,6435,6003,123,21,9,67,1,21,432
29071800301,2969,2750,43,21,2,31,1,9,219
29071800302,4714,4291,134,35,9,33,0,12,423
29071800401,5406,4943,128,28,12,12,1,11,463
29071800403,4052,3863,42,11,3,17,0,6,189
29071800404,2941,2806,33,5,4,10,0,5,135
29071800501,4116,3874,72,13,5,18,0,8,242
29071800502,2902,2721,23,4,4,6,0,1,181
29071800603,4211,3783,123,57,9,12,2,14,428
29071800604,3665,3231,125,46,16,12,2,17,434
29071800605,4377,3993,93,27,18,20,0,10,384
29071800606,5021,4484,109,75,18,39,1,13,537
29071800702,3326,2974,92,27,9,20,0,5,352
29071800703,4458,3978,101,74,15,34,0,7,480
29071800704,2992,2536,122,61,19,24,1,14,456
29071800801,5385,4965,83,33,30,25,0,25,420
29071800802,1962,1763,27,70,0,13,1,3,199
29071800901,2793,2589,36,16,13,4,0,8,204
29071800903,3314,3008,69,46,12,2,0,9,306
29071800904,3893,3508,76,50,21,18,0,16,385
29071801000,3650,3435,29,19,5,12,2,7,215
29071801101,4088,3710,106,22,17,13,0,7,378
29071801102,4101,3820,56,9,9,27,0,18,281
29073960100,2453,2297,32,6,2,11,2,10,156
29073960200,1690,1608,18,2,1,4,2,1,82
29073960300,2889,2693,31,0,1,7,0,2,196
29073960400,3239,2944,60,8,12,15,5,9,295
29073960500,4523,4163,48,2,9,14,0,2,360
29075960100,2848,2690,46,5,3,2,1,6,158
29075960200,3314,3161,44,10,3,7,0,3,153
29077000101,949,783,48,50,6,9,0,6,166
29077000102,1595,1178,121,83,5,90,9,13,417
29077000200,4629,3292,324,409,30,230,29,12,1337
29077000300,3126,2650,152,78,21,38,2,8,476
29077000400,4349,3580,265,139,28,80,6,20,769
29077000501,2228,1636,174,172,25,20,5,12,592
29077000502,3371,2548,201,254,26,62,10,17,823
29077000600,2612,1967,106,256,31,22,4,11,645
29077000700,4607,3418,262,446,58,52,10,21,1189
29077000800,3414,2534,198,311,24,15,7,57,880
29077000900,5097,3968,292,221,30,240,6,42,1129
29077001000,2202,1944,68,25,7,18,0,9,258
29077001100,3461,2802,222,110,18,49,3,9,659
29077001200,3821,3097,232,160,20,57,10,15,724
29077001301,2234,1702,188,90,2,82,0,6,532
29077001302,2540,1998,159,107,16,105,4,13,542
29077001401,2861,2136,297,102,17,130,1,2,725
29077001402,1950,1531,104,60,9,109,9,2,419
29077001500,5201,4033,390,165,24,146,13,21,1168
29077001700,3217,2580,182,149,12,20,5,12,637
29077001800,3340,2545,211,182,33,11,0,5,795
29077001900,3000,2291,174,196,26,12,8,14,709
29077002200,4595,3410,414,279,32,38,0,9,1185
29077002300,5433,4313,347,230,28,48,5,40,1120
29077002402,4115,3372,242,133,21,47,12,15,743
29077002502,5630,4505,255,214,27,261,13,24,1125
29077002600,4997,4403,157,108,26,93,0,8,594
29077002700,2539,2057,115,72,16,141,0,8,482
29077002800,1849,1523,107,51,9,61,7,5,326
29077002900,4038,3423,166,94,18,94,1,16,615
29077003003,178,123,11,14,2,0,0,0,55
29077003004,5327,4054,421,292,25,164,8,31,1273
29077003100,3041,2315,304,125,16,28,0,10,726
29077003200,4152,3083,321,263,33,20,10,11,1069
29077003300,3728,2822,238,224,40,19,29,33,906
29077003600,2791,2110,169,198,26,18,3,10,681
29077003701,5631,5019,150,51,37,81,1,19,612
29077003702,2916,2592,77,27,5,88,5,9,324
29077003801,3798,3327,90,31,26,170,1,6,471
29077003802,3959,3484,79,26,2,194,3,3,475
29077003900,3409,2833,145,57,20,185,2,8,576
29077004002,4069,3538,139,60,25,112,2,10,531
29077004003,5179,4468,149,81,16,155,1,22,711
29077004004,2705,2153,169,49,11,210,0,13,552
29077004005,3165,2769,105,55,7,85,1,13,396
29077004104,3699,3169,148,56,24,59,9,8,530
29077004105,4858,4050,166,74,17,239,6,8,808
29077004106,4523,3870,118,71,22,213,2,9,653
29077004107,4015,3264,198,115,17,118,5,33,751
29077004108,2421,2042,86,56,9,130,6,4,379
29077004109,5383,4346,221,122,25,276,2,16,1037
29077004201,4881,4063,257,141,20,98,5,1,818
29077004202,6703,5178,376,363,29,220,12,30,1525
29077004303,2011,1727,62,51,12,53,0,9,284
29077004304,2134,1632,220,59,20,9,2,17,502
29077004305,5231,4359,238,155,38,65,15,13,872
29077004306,3905,3238,221,96,18,47,1,18,667
29077004401,3449,2824,123,181,29,43,6,11,625
29077004402,3632,3024,131,152,17,37,9,24,608
29077004500,2807,2384,113,66,16,41,2,9,423
29077004601,4282,3874,120,24,18,12,0,8,408
29077004602,3486,3199,61,6,18,21,1,14,287
29077004700,6014,5509,121,38,34,41,4,16,505
29077004802,8041,7031,264,74,39,48,5,24,1010
29077004803,6099,5327,196,77,34,38,0,14,772
29077004804,5632,4815,264,87,34,61,1,14,817
29077004805,3308,2783,186,65,20,52,0,7,525
29077004900,6396,5820,151,19,29,13,0,13,576
29077005001,3655,3320,90,8,30,7,3,17,335
29077005002,7178,6427,199,47,44,35,7,15,751
29077005100,4000,3553,115,29,23,19,0,31,447
29077005201,3063,2721,102,17,16,14,0,4,342
29077005202,3791,3441,87,14,26,19,0,4,350
29077005500,4267,3172,222,444,26,48,1,10,1095
29077005600,3502,2961,151,119,21,22,12,7,541
29077005700,3791,3143,211,106,23,70,2,20,648
29077005801,2689,1847,257,384,37,49,4,14,842
29077005802,3021,2346,177,172,14,56,8,9,675
29079960100,2084,2017,25,1,3,5,0,0,67
29079960200,2069,1948,37,5,9,5,1,10,121
29079960300,2244,2030,82,20,9,17,3,4,214
29079960400,3411,3126,97,24,12,27,4,1,285
29081950100,3169,2973,39,15,5,3,3,3,196
29081950200,2239,2126,36,7,11,4,0,0,113
29081950300,2749,2519,93,10,14,16,0,7,230
29083950100,2891,2618,88,5,21,5,0,13,273
29083950200,3606,3361,58,5,19,12,2,7,245
29083950300,3182,2887,81,10,10,9,0,10,295
29083950400,2917,2732,49,12,4,9,1,5,185
29083950500,3994,3519,118,62,10,13,3,12,475
29083950600,5356,4683,179,83,25,43,0,20,673
29085470100,2652,2453,46,2,14,6,0,6,199
29085470300,2234,2054,39,4,6,1,0,12,180
29085470501,1549,1412,22,4,9,3,0,8,137
29085470502,1844,1729,25,1,13,5,0,2,115
29087960100,1164,1102,23,1,5,0,0,2,62
29087960200,1379,1290,31,1,19,0,0,11,89
29087960300,1680,1600,13,2,6,2,0,5,80
29089960100,2987,2715,32,100,5,3,2,6,272
29089960200,3272,3042,28,37,8,5,0,13,230
29089960300,3892,3069,148,405,21,19,1,27,823
29091090101,2542,2272,68,2,19,8,4,16,270
29091090102,2786,2474,64,16,7,20,0,2,312
29091090200,3974,3598,100,9,22,19,2,4,376
29091090300,4545,4132,74,7,43,9,0,14,413
29091090400,4585,4266,64,13,25,8,1,14,319
29091090500,4833,4463,72,13,12,38,5,8,370
29091090600,4886,4452,104,5,33,17,1,9,434
29091090700,5079,4529,160,45,61,17,0,23,550
29091090801,3264,2903,86,28,13,48,2,6,361
29091090802,3256,2883,104,42,30,33,2,13,373
29093950100,2509,2319,43,19,20,5,0,0,190
29093950200,2481,2195,72,23,13,9,0,3,286
29093950300,2686,2424,37,46,17,12,1,1,262
29093950400,1861,1664,25,48,10,8,1,0,197
29095000300,2087,1120,171,510,0,186,6,3,967
29095000600,4653,877,2809,448,18,334,14,16,3776
29095000700,4056,966,1830,473,12,572,11,11,3090
29095000800,4334,1131,1713,722,18,532,7,20,3203
29095000900,3005,976,1026,535,10,346,1,22,2029
29095001000,2910,778,472,1194,12,281,11,19,2132
29095001100,2378,1589,254,296,10,112,6,11,789
29095001800,3161,648,1046,973,13,325,7,23,2513
29095001900,3380,550,1859,573,2,256,14,9,2830
29095002000,2315,403,1611,145,5,94,2,11,1912
29095002100,4470,705,2273,1100,6,204,21,21,3765
29095002200,3224,541,1682,754,12,89,6,24,2683
29095002300,2149,286,1021,723,15,21,11,9,1863
29095003400,3288,448,1699,994,19,9,7,5,2840
29095003700,1049,112,211,675,6,2,0,3,937
29095003800,1538,153,91,1175,15,15,0,7,1385
29095004300,2794,1585,199,704,10,149,4,13,1209
29095004400,1495,1140,131,79,4,83,0,4,355
29095004600,2689,1798,327,312,10,60,2,22,891
29095005100,1620,1077,131,207,0,89,0,7,543
29095005200,1038,201,52,718,2,3,5,2,837
29095005300,1437,383,136,791,9,12,0,9,1054
29095005400,826,72,93,613,0,5,2,6,754
29095005500,927,75,112,672,0,6,2,2,852
29095005601,1726,164,226,1222,13,0,0,8,1562
29095005602,1420,95,192,1034,3,3,7,20,1325
29095005700,2285,93,252,1780,9,0,4,27,2192
29095005801,2172,160,204,1649,10,8,4,13,2012
29095006000,1478,84,179,1118,12,6,0,7,1394
29095006100,2695,195,246,2097,16,3,8,11,2500
29095006300,1737,348,172,1074,4,23,0,14,1389
29095006500,1632,1157,147,192,6,31,1,4,475
29095006600,1833,1396,110,125,2,98,4,14,437
29095006700,1807,1282,157,235,2,41,0,3,525
29095006900,1338,1025,88,106,7,66,3,5,313
29095007100,2993,2383,235,128,13,103,0,9,610
29095007200,2044,1790,97,29,1,34,0,19,254
29095007301,1818,1364,119,62,4,191,0,2,454
29095007302,1377,1092,93,43,2,81,0,13,285
29095007400,4397,3508,273,91,5,303,1,20,889
29095007500,2727,1380,202,879,13,90,3,26,1347
29095007600,2294,286,205,1628,15,6,1,16,2008
29095007700,1665,217,78,1270,9,8,4,5,1448
29095007802,2258,162,128,1834,6,8,0,14,2096
29095007900,3498,207,220,2878,15,4,0,12,3291
29095008000,3022,188,190,2479,0,12,0,13,2834
29095008100,2113,590,139,1216,15,23,5,18,1523
29095008200,2913,2350,175,123,5,74,0,7,563
29095008300,2337,2035,107,34,1,40,0,1,302
29095008400,2800,2492,96,42,4,46,0,7,308
29095008500,3573,3213,111,28,10,58,0,0,360
29095008600,5385,4570,251,274,6,56,2,11,815
29095008700,2558,404,131,1840,12,6,2,27,2154
29095008800,3430,290,241,2733,10,9,4,12,3140
29095008900,1950,79,99,1673,4,4,1,3,1871
29095009000,4219,583,217,3134,23,17,8,22,3636
29095009100,3735,2976,170,328,10,65,2,7,759
29095009200,2890,2487,133,71,4,30,1,7,403
29095009300,2394,1940,207,101,5,23,0,6,454
29095009400,4391,2517,343,1087,25,81,7,41,1874
29095009500,3160,681,193,2023,26,16,4,20,2479
29095009600,1555,329,144,980,8,3,0,5,1226
29095009700,1592,357,90,988,6,39,2,15,1235
29095009800,3484,2199,289,670,9,47,2,7,1285
29095009900,2130,1609,142,174,2,66,0,14,521
29095010001,1801,1338,88,251,11,35,0,6,463
29095010002,3575,1523,380,1330,19,104,3,19,2052
29095010103,2417,914,186,1124,10,25,0,18,1503
29095010105,3510,2756,145,373,4,82,0,12,754
29095010201,1836,702,177,776,1,44,3,14,1134
29095010203,4042,2340,282,1040,16,99,3,14,1702
29095010204,4379,2230,325,1254,33,196,19,13,2149
29095010500,4803,1432,677,2364,18,26,1,15,3371
29095010600,3044,1585,321,843,29,39,26,16,1459
29095010702,3811,1401,356,1782,6,48,6,33,2410
29095011001,2451,1683,424,152,13,10,18,6,768
29095011002,2479,1588,420,227,10,43,15,3,891
29095011100,3168,2432,319,120,20,23,17,14,736
29095011200,3366,2444,365,206,14,30,37,13,922
29095011300,4810,3397,512,392,37,25,62,25,1413
29095011405,2886,1349,480,659,16,3,31,20,1537
29095011406,6000,4423,605,345,21,30,75,11,1577
29095011407,3333,2311,364,304,20,52,30,14,1022
29095011408,1546,1084,113,249,8,11,4,3,462
29095011409,1581,1191,129,113,6,23,7,3,390
29095011410,2553,1967,207,93,18,25,12,4,586
29095011501,4271,2789,625,359,30,38,43,24,1482
29095011502,1752,1038,193,274,22,11,22,1,714
29095011601,2759,1955,283,269,32,13,12,31,804
29095011602,2333,1808,171,174,7,18,12,13,525
29095011701,2113,1263,436,230,4,20,8,17,850
29095011702,2257,1536,323,163,13,16,19,14,721
29095011800,5477,3439,1037,477,35,41,8,24,2038
29095011900,3771,2379,778,301,15,31,15,9,1392
29095012000,3647,2195,729,412,21,45,6,16,1452
29095012100,5871,3736,979,554,24,60,19,30,2135
29095012200,6548,4743,732,487,29,60,49,26,1805
29095012300,3505,2718,326,149,15,39,7,22,787
29095012400,4216,2726,522,591,20,65,35,14,1490
29095012501,3727,1832,347,1245,12,28,11,24,1895
29095012502,3056,1794,224,748,13,31,3,27,1262
29095012600,4803,2577,489,1294,24,61,14,14,2226
29095012702,4214,2249,209,1409,14,29,2,26,1965
29095012703,2307,1405,162,571,6,28,1,12,902
29095012802,3772,1895,192,1395,1,59,7,8,1877
29095012803,2142,1253,140,546,17,18,9,12,889
29095012804,6120,2649,536,2465,30,61,13,26,3471
29095012903,3577,993,349,1962,22,42,2,18,2584
29095012904,2645,814,233,1333,10,112,0,9,1831
29095012906,4562,1357,373,2361,15,206,4,27,3205
29095013003,4842,1373,513,2561,13,71,10,25,3469
29095013100,2983,977,322,1509,7,32,0,6,2006
29095013203,4102,946,572,2278,11,22,5,43,3156
29095013208,3022,552,207,2083,13,16,2,20,2470
29095013210,2564,534,212,1660,15,9,7,11,2030
29095013301,4165,2314,749,711,15,40,7,15,1851
29095013307,2659,675,238,1510,5,70,12,7,1984
29095013309,5040,1525,386,2663,25,75,5,27,3515
29095013313,5162,2241,775,1689,19,83,2,24,2921
29095013401,2802,936,610,987,6,64,10,22,1866
29095013405,1981,1136,117,523,3,34,7,8,845
29095013407,2574,2100,89,210,7,61,2,22,474
29095013410,4037,2097,452,1088,37,43,4,7,1940
29095013416,2344,689,247,1254,5,36,0,17,1655
29095013417,2918,1692,263,703,12,116,3,11,1226
29095013418,2742,1968,149,353,10,93,3,12,774
29095013502,6065,5103,283,285,14,28,5,6,962
29095013504,3488,2626,192,369,7,106,3,19,862
29095013606,1445,1277,46,56,0,8,3,2,168
29095013612,7107,5478,271,707,9,276,18,24,1629
29095013613,2588,2308,89,63,1,23,6,6,280
29095013614,1456,1158,50,107,5,55,0,7,298
29095013615,2052,1617,98,170,2,50,0,7,435
29095013705,1408,1112,91,79,7,11,5,7,296
29095013706,4211,2838,447,551,8,31,11,14,1373
29095013707,2975,2235,172,251,14,57,21,31,740
29095013708,3279,2723,163,167,5,47,1,12,556
29095013801,5724,4179,435,558,15,88,13,19,1545
29095013803,5267,4109,300,417,14,69,7,18,1158
29095013804,3122,2382,153,274,10,84,0,17,740
29095013902,1776,1556,58,21,9,20,1,6,220
29095013904,7294,5686,398,552,10,177,9,16,1608
29095013916,6323,5074,320,427,18,140,3,15,1249
29095013917,3837,3461,114,39,14,29,1,23,376
29095013918,3264,2977,61,33,5,34,7,11,287
29095014002,1797,1593,39,7,9,4,2,0,204
29095014004,3141,2648,155,77,18,31,0,6,493
29095014005,5284,4593,213,67,16,25,7,13,691
29095014006,6614,5535,417,134,28,64,3,21,1079
29095014008,3931,3200,272,114,12,39,9,5,731
29095014009,3097,2501,239,123,11,25,2,5,596
29095014111,4054,3033,216,437,8,69,6,9,1021
29095014112,1801,1466,79,103,1,64,1,5,335
29095014120,3079,2518,157,172,18,38,3,5,561
29095014121,7003,5437,508,399,42,83,10,16,1566
29095014122,2455,1934,154,179,11,34,3,2,521
29095014123,3140,2282,259,302,7,29,5,24,858
29095014124,3550,2685,229,263,16,37,6,12,865
29095014125,2074,1732,83,99,10,14,0,4,342
29095014126,5497,4107,412,414,20,102,11,12,1390
29095014127,1884,1481,115,108,10,20,3,12,403
29095014128,5238,3802,380,552,25,92,17,10,1436
29095014203,4155,3247,194,309,5,169,0,10,908
29095014205,3725,2359,172,866,9,79,0,17,1366
29095014206,5093,4344,197,208,9,100,9,19,749
29095014300,5483,3152,333,1502,17,102,13,52,2331
29095014400,2951,1491,133,1007,9,100,2,17,1460
29095014501,4106,2933,358,434,20,70,35,14,1173
29095014503,1287,1073,50,88,5,22,2,3,214
29095014504,3538,2830,245,194,5,52,11,32,708
29095014601,5469,3990,762,221,47,81,44,13,1479
29095014603,3685,2721,378,151,11,85,27,21,964
29095014604,4984,3295,572,655,15,78,29,7,1689
29095014701,3903,2535,447,590,11,86,8,11,1368
29095014702,5143,4152,319,235,17,75,22,20,991
29095014804,3328,2792,89,108,11,79,8,15,536
29095014806,4576,3542,296,335,10,94,2,14,1034
29095014902,1950,1702,75,12,5,0,0,3,248
29095014903,5636,5039,194,51,20,30,9,13,597
29095014904,6713,5218,486,441,30,72,28,19,1495
29095014905,5184,4355,259,191,19,64,4,13,829
29095015000,3653,3218,140,38,22,14,5,10,435
29095015100,5935,4592,470,213,39,52,102,21,1343
29095015200,2646,1945,160,229,15,115,2,19,701
29095015300,3010,868,1494,497,5,15,1,26,2142
29095015401,2138,315,477,1172,21,61,2,9,1823
29095015402,1341,243,85,820,4,142,4,4,1098
29095015500,1328,584,586,86,14,17,5,3,744
29095015600,2483,1221,844,226,22,11,1,7,1262
29095015701,2219,1678,169,168,6,90,2,6,541
29095015702,3191,2038,306,464,7,161,5,16,1153
29095015800,1932,1552,118,104,7,53,6,6,380
29095015900,1955,961,287,428,2,193,1,16,994
29095016000,1756,222,424,1008,1,18,0,4,1534
29095016100,1906,182,129,1489,4,6,0,16,1724
29095016200,2052,682,147,1019,7,62,3,11,1370
29095016300,2082,647,385,884,4,11,0,25,1435
29095016400,1741,324,523,799,5,5,1,11,1417
29095016500,1868,116,416,1252,4,5,0,7,1752
29095016600,1619,137,203,1189,13,0,0,7,1482
29095016700,3366,2162,379,453,17,128,0,19,1204
29095016801,2178,1424,216,331,11,62,2,14,754
29095016802,1338,981,237,30,3,14,0,2,357
29095016900,2361,319,223,1686,8,5,0,12,2042
29095017000,2510,1234,454,632,23,29,8,10,1276
29095017100,3814,199,369,3047,8,35,3,7,3615
29095017200,4573,1412,417,2391,13,56,9,22,3161
29095017300,3354,2385,182,495,12,81,1,13,969
29095017400,2807,785,142,1575,6,175,4,10,2022
29095017500,2012,842,201,830,12,17,1,7,1170
29095017600,5118,2456,332,1928,21,79,4,29,2662
29095017700,5365,4168,406,217,23,67,57,22,1197
29095017800,3809,2092,417,842,8,164,5,26,1717
29095017900,5099,3601,288,610,18,273,4,21,1498
29095018000,3599,2799,280,231,18,28,15,15,800
29095018101,5159,4170,216,398,10,100,2,13,989
29095018102,3148,2237,178,404,7,97,3,24,911
29095018200,4166,3034,207,549,13,90,1,15,1132
29095018500,4559,3584,195,343,14,162,7,17,975
29095018600,3000,2406,174,152,10,55,1,13,594
29095019301,4070,2983,327,376,10,57,16,17,1087
29095019302,3168,2538,145,255,17,57,1,16,630
29095980101,3,0,1,1,0,1,0,0,3
29095980802,1,0,0,0,0,0,0,0,1
29095988300,97,92,4,1,0,0,0,0,5
29095989100,18,16,0,0,1,0,0,0,2
29095989200,7,3,1,0,0,0,0,0,4
29097010100,3730,2746,283,236,66,78,18,14,984
29097010200,4673,3723,257,84,89,106,25,8,950
29097010301,4072,3208,361,127,45,47,14,10,864
29097010302,4620,3681,321,118,65,93,11,11,939
29097010400,5609,4387,268,172,96,154,100,27,1222
29097010500,5144,3886,336,174,116,118,24,23,1258
29097010601,3070,2268,247,125,72,43,9,18,802
29097010602,2893,2181,230,121,38,64,8,2,712
29097010700,2703,2200,100,51,53,31,31,5,503
29097010800,4235,3159,349,201,74,48,9,25,1076
29097010901,2882,2375,165,46,50,37,11,3,507
29097010902,4082,3359,189,61,59,80,0,20,723
29097011000,3733,2817,297,117,104,25,17,12,916
29097011100,1762,1465,66,21,25,10,20,1,297
29097011201,3060,2644,112,28,38,35,0,14,416
29097011202,3682,3130,167,32,109,20,7,5,552
29097011301,5127,4464,133,32,100,44,0,7,663
29097011302,4068,3449,167,45,52,34,1,7,619
29097011400,5898,4861,337,78,84,50,9,19,1037
29097011501,5442,4579,253,55,59,34,12,27,863
29097011502,4648,3967,231,22,70,14,0,15,681
29097011600,5203,2432,2473,58,47,10,15,18,2771
29097011700,7195,4997,1568,74,48,145,8,13,2198
29097011800,5054,3206,1404,69,57,28,39,5,1848
29097011900,3991,3199,218,40,65,55,25,19,792
29097012000,5255,4496,368,15,90,18,5,7,759
29097012100,3909,3317,274,16,31,48,17,21,592
29097012201,3680,3253,104,17,39,20,0,7,427
29097012202,3341,2939,99,25,53,2,5,25,402
29099700107,3731,3385,62,31,11,21,2,3,346
29099700111,3671,3295,98,14,5,23,6,4,376
29099700113,4495,4054,121,28,7,69,1,15,441
29099700114,4304,3855,72,57,15,54,2,11,449
29099700115,4016,3566,122,20,10,68,0,20,450
29099700116,3084,2749,100,38,11,30,0,10,335
29099700117,6963,6207,191,55,16,61,2,16,756
29099700118,6219,5422,214,90,12,62,2,17,797
29099700119,2116,1851,63,8,6,16,1,12,265
29099700120,6096,5427,154,156,4,47,0,19,669
29099700121,3887,3457,112,23,7,60,3,4,430
29099700122,4087,3661,119,40,2,55,0,10,426
29099700123,2893,2632,89,15,0,13,0,10,261
29099700124,4831,4388,105,13,9,45,0,22,443
29099700206,5692,5041,157,53,15,35,5,9,651
29099700207,3559,3248,63,9,16,23,0,7,311
29099700208,6784,5695,278,138,30,147,0,37,1089
29099700209,3760,3314,123,32,15,75,0,2,446
29099700210,3853,3188,266,60,14,38,4,17,665
29099700211,5161,4555,172,79,22,30,0,15,606
29099700212,2927,2459,144,57,11,62,4,8,468
29099700213,3122,2788,80,35,11,71,1,11,334
29099700302,5581,5033,136,27,15,35,2,16,548
29099700303,4652,4162,140,32,18,36,2,12,490
29099700305,3814,3386,113,19,5,76,0,22,428
29099700306,3572,3227,99,19,5,43,0,6,345
29099700401,4769,4415,93,9,27,22,0,2,354
29099700402,6552,5999,157,34,11,65,4,2,553
29099700502,6120,5601,102,58,10,30,0,17,519
29099700503,3234,2926,53,10,4,17,1,4,308
29099700504,4278,3949,72,9,12,6,0,9,329
29099700603,6420,5851,162,24,13,24,5,15,569
29099700604,6331,5808,108,24,23,24,3,17,523
29099700605,6429,5722,142,90,13,46,0,16,707
29099700606,2946,2597,76,48,11,6,4,13,349
29099700607,2779,2528,54,29,9,6,0,2,251
29099700700,4605,4063,55,157,17,32,2,9,542
29099700801,5795,5164,146,109,10,35,5,8,631
29099700802,5577,4933,122,119,17,53,3,32,644
29099700900,5810,5020,126,209,20,38,2,13,790
29099701001,4753,4292,98,21,16,23,1,25,461
29099701002,4072,3732,78,10,6,11,2,9,340
29099701101,4506,4165,75,5,14,8,0,7,341
29099701102,5285,4854,64,15,24,16,1,15,431
29099701200,5941,5427,81,47,18,12,0,20,514
29099701300,3400,3082,46,34,14,3,1,14,318
29099701401,4093,3831,55,24,11,6,0,5,262
29099701403,3871,3627,63,8,10,9,0,8,244
29099701404,6303,5656,131,54,15,52,0,25,647
29101960101,5957,5316,147,27,25,24,7,19,641
29101960102,3185,2863,82,28,10,14,0,10,322
29101960200,5259,4704,112,75,36,14,5,11,555
29101960301,6057,5019,249,169,26,165,38,27,1038
29101960302,3841,3315,160,78,21,19,3,22,526
29101960401,3310,2410,189,451,24,92,15,10,900
29101960402,2821,2188,158,241,6,54,22,6,633
29101960501,3477,2711,184,220,14,106,5,11,766
29101960502,4136,3223,247,246,17,87,44,10,913
29101960600,3299,2581,177,225,13,51,11,8,718
29101960701,2096,1556,175,133,15,41,16,18,540
29101960702,2918,2230,223,168,12,59,30,8,688
29101960900,4761,4370,74,16,19,21,3,35,391
29101980000,2896,1929,418,232,21,74,11,8,967
29103960100,1808,1728,10,8,2,13,0,6,80
29103960200,1936,1845,13,12,3,5,0,0,91
29105960101,4596,4200,111,8,48,12,1,13,396
29105960102,3600,3254,91,16,21,9,3,5,346
29105960201,3074,2890,32,7,7,8,3,6,184
29105960202,2855,2571,80,4,22,14,1,2,284
29105960301,3319,3043,49,10,12,16,1,12,276
29105960302,4067,3703,85,21,12,20,0,6,364
29105960400,3934,3509,107,81,20,31,0,4,425
29105960500,5627,4984,206,53,17,47,7,2,643
29105960600,4967,4328,194,62,38,33,1,21,639
29107090100,5130,4617,160,79,14,8,0,3,513
29107090200,5837,4871,253,280,31,44,4,15,966
29107090300,1327,1195,77,9,7,1,0,0,132
29107090401,3532,3178,71,60,10,7,0,14,354
29107090402,3115,2655,122,146,11,14,3,7,460
29107090500,3716,3411,95,16,7,8,1,7,305
29107090601,6467,5784,199,67,49,24,4,7,683
29107090602,3860,3545,70,14,9,9,0,5,315
29109470100,3916,3630,67,15,22,10,2,18,286
29109470201,3537,3246,85,1,39,14,3,0,291
29109470202,4335,3876,118,25,37,17,0,11,459
29109470300,5221,4337,547,14,49,21,20,13,884
29109470401,4014,2742,953,17,30,66,4,4,1272
29109470402,2890,2430,204,9,35,14,2,19,460
29109470501,2980,2675,122,9,17,8,3,4,305
29109470502,3542,3201,126,8,34,9,2,5,341
29109470601,4872,3981,541,27,50,10,0,6,891
29109470602,2694,2283,224,9,20,2,4,11,411
29111970100,3745,3442,73,76,12,18,0,1,303
29111970200,2164,2007,20,50,8,3,0,5,157
29111970300,2346,2219,61,5,7,0,0,4,127
29111970400,1777,1647,11,54,3,1,0,0,130
29113810100,4178,3786,82,75,19,11,4,0,392
29113810203,5660,5060,148,70,16,24,1,24,600
29113810204,1794,1594,47,20,4,10,3,6,200
29113810205,3964,3637,34,29,8,16,1,16,327
29113810206,2067,1931,24,18,4,1,0,8,136
29113810305,6752,5566,381,285,16,37,1,22,1186
29113810306,2789,2444,64,79,8,10,3,9,345
29113810307,4626,4041,188,119,17,19,1,11,585
29113810308,7826,7045,195,131,22,31,3,20,781
29113810309,5519,4948,110,58,20,26,6,5,571
29113810310,5693,5054,110,99,30,23,0,28,639
29113810401,5092,4586,96,75,17,24,2,11,506
29113810402,3614,3359,62,14,12,3,2,17,255
29115490100,1568,1499,17,2,4,3,0,1,69
29115490200,2215,2091,52,6,4,0,0,2,124
29115490300,2757,2567,59,16,3,2,0,3,190
29115490400,2709,2453,90,30,15,8,1,10,256
29115490500,2625,2417,71,13,5,9,5,9,208
29117480100,3800,3432,50,205,9,17,0,3,368
29117480200,2975,2845,30,2,10,9,3,1,130
29117480300,3440,3228,57,26,9,23,1,2,212
29117480400,2743,2489,54,27,10,24,0,8,254
29117480500,1599,1374,48,55,9,14,1,5,225
29119070101,3697,3167,127,10,59,22,1,21,530
29119070102,2621,2169,48,11,51,104,3,8,452
29119070200,4491,3732,148,23,111,53,105,14,759
29119070300,6276,2625,2074,355,104,166,619,17,3651
29119070401,3285,2482,292,14,103,21,121,8,803
29119070402,2933,2492,129,8,65,10,19,14,441
29121960100,2244,2069,21,13,0,13,0,10,175
29121960200,2553,2411,28,10,9,3,0,4,142
29121960300,3775,3515,58,19,0,13,0,8,260
29121960400,4036,3655,105,75,8,41,3,8,381
29121960500,2601,2128,64,182,8,14,1,7,473
29123960100,3377,3100,81,0,15,8,0,8,277
29123960201,3024,2739,130,19,17,17,0,0,285
29123960202,2704,2419,69,22,14,8,0,9,285
29123960300,3521,3297,62,13,3,8,0,5,224
29125880100,2628,2431,46,6,9,0,0,6,197
29125880298,2491,2289,46,11,15,4,0,7,202
29125880300,3313,3076,42,6,18,3,0,3,237
29127960100,4542,4227,25,95,7,25,6,12,315
29127960200,3276,3054,20,21,7,3,0,29,222
29127960300,3672,3356,69,69,12,16,1,6,316
29127960400,4868,4117,152,306,6,42,7,16,751
29127960500,2580,2041,81,259,4,9,2,6,539
29127960600,3482,3040,51,182,13,18,0,5,442
29127960800,2813,2384,67,152,8,16,0,7,429
29127960900,3292,2711,51,279,10,36,0,15,581
29129470100,1274,1219,15,0,1,0,0,0,55
29129470200,2264,2072,140,0,7,0,0,7,192
29131962501,3364,3206,36,5,9,6,3,2,158
29131962502,2294,2215,15,5,0,2,0,2,79
29131962600,3386,3173,49,13,20,2,0,0,213
29131962701,2161,2010,33,9,8,6,0,0,151
29131962702,2961,2709,72,7,15,0,15,6,252
29131962801,2490,2215,96,36,17,15,0,5,275
29131962802,3813,3549,67,18,18,8,0,6,264
29131962901,2842,2561,46,19,23,15,6,21,281
29131962902,1411,1270,52,5,3,10,0,3,141
29133950100,3097,2024,44,940,8,1,0,11,1073
29133950200,4007,1789,78,1975,4,14,0,23,2218
29133950300,1647,1527,41,22,2,2,0,3,120
29133950400,3826,3474,60,123,19,3,0,15,352
29135385100,4015,3720,85,26,14,7,0,8,295
29135385200,4486,3605,628,34,11,14,4,13,881
29135385300,3442,3302,51,7,5,5,0,1,140
29135385400,3530,3061,100,215,10,16,12,5,469
29137960100,3539,3066,99,120,17,14,1,7,473
29137960200,2550,2377,22,54,10,3,0,1,173
29137960300,2577,2459,38,3,5,14,0,9,118
29139970100,2300,2172,37,22,7,1,1,1,128
29139970200,3666,3297,82,60,5,27,3,4,369
29139970300,2952,2766,41,8,3,11,0,9,186
29139970400,2404,2209,69,11,7,11,1,8,195
29141470100,6272,5915,100,24,15,8,0,5,357
29141470200,3809,3463,90,11,20,18,3,12,346
29141470300,2847,2520,91,69,12,6,2,11,327
29141470401,1032,955,32,3,4,1,0,4,77
29141470402,1741,1588,29,5,19,4,3,8,153
29141470501,1662,1562,38,3,6,4,0,6,100
29141470502,1245,1133,20,3,12,7,0,2,112
29141470503,2398,2162,46,8,17,13,0,9,236
29143960100,4459,3596,86,499,12,45,0,11,863
29143960200,1740,1219,18,437,4,3,1,0,521
29143960300,3169,2123,32,900,1,3,0,4,1046
29143960400,2090,1526,56,390,2,4,0,6,564
29143960500,1944,1806,27,7,6,1,0,0,138
29143960600,3032,2340,34,498,0,6,0,6,692
29145020100,4132,2758,683,29,80,14,277,8,1374
29145020200,5206,3940,591,39,86,38,152,5,1266
29145020300,3382,2459,479,41,52,17,71,15,923
29145020401,3375,2951,70,6,56,108,3,7,424
29145020402,3637,3118,91,25,80,18,31,9,519
29145020501,4186,3429,250,66,52,89,29,21,757
29145020502,5446,4472,238,88,122,106,42,19,974
29145020601,5608,4704,204,63,183,77,4,13,904
29145020602,5089,4425,163,77,106,29,29,6,664
29145020700,4452,3629,154,16,231,26,4,15,823
29145020800,6608,5341,434,56,152,51,136,11,1267
29145020900,4228,3620,105,13,89,47,7,4,608
29145021000,3299,2705,145,4,62,178,5,5,594
29147470100,2181,2068,18,6,5,2,0,3,113
29147470200,2723,2577,40,3,0,6,0,7,146
29147470301,1871,1478,46,45,6,216,0,8,393
29147470302,5095,4485,168,155,2,106,0,13,610
29147470400,4203,3848,96,57,6,44,1,10,355
29147470500,5168,4834,59,97,12,16,1,5,334
29149480100,2896,2697,31,10,26,1,0,0,199
29149480200,3760,3442,60,11,22,4,0,12,318
29149480300,1979,1851,26,4,17,3,0,2,128
29151490100,3363,3265,16,1,10,0,7,0,98
29151490200,4198,3950,56,20,9,1,2,6,248
29151490300,3320,3182,25,3,5,1,1,4,138
29151490400,2393,2291,28,0,4,1,0,0,102
29153470101,2607,2447,29,7,8,4,5,4,160
29153470102,1528,1433,17,5,6,1,0,13,95
29153470200,4418,4120,63,7,24,9,0,24,298
29155470100,1671,1450,19,121,3,1,0,3,221
29155470200,3022,1098,62,1748,7,1,0,4,1924
29155470300,2909,1769,77,886,6,8,1,6,1140
29155470400,2758,1486,74,1047,2,9,0,12,1272
29155470500,2680,2370,107,112,6,2,0,6,310
29155470600,2621,2003,76,383,5,14,3,4,618
29157470100,2458,2367,15,0,0,2,0,0,91
29157470200,4772,4502,86,15,4,20,0,3,270
29157470300,4220,3752,180,46,15,40,0,9,468
29157470400,3785,3453,72,27,7,50,0,1,332
29157470500,3721,3583,30,14,3,11,0,7,138
29159480100,4008,3711,109,14,10,7,0,15,297
29159480200,6418,5284,736,40,12,61,25,8,1134
29159480300,4432,4008,119,50,16,11,4,22,424
29159480400,4345,3861,162,54,21,17,13,3,484
29159480500,2961,2342,288,92,22,3,15,8,619
29159480600,2193,1252,419,355,7,9,4,2,941
29159480700,3705,3010,279,140,8,66,5,12,695
29159480800,3349,2469,498,123,22,15,8,19,880
29159480900,2958,1983,523,209,14,33,22,9,975
29159481000,4615,3779,362,143,16,49,15,10,836
29159481100,3996,3052,521,133,11,23,9,11,944
29161890100,4597,4159,88,37,19,35,4,8,438
29161890200,4792,4251,137,43,23,41,0,7,541
29161890301,3600,3021,108,87,16,161,0,9,579
29161890302,3612,2763,146,172,16,238,0,28,849
29161890401,3745,2826,122,174,12,373,6,41,919
29161890402,1666,1311,41,85,2,145,0,9,355
29161890500,3550,3210,82,23,20,15,0,7,340
29161890600,2742,2509,46,14,25,13,0,22,233
29161890700,2932,2537,71,28,19,72,0,6,395
29161890800,3256,2679,102,187,23,95,0,7,577
29161890900,4385,3610,158,119,21,178,0,37,775
29161891000,5761,5065,158,59,35,140,10,49,696
29163460100,3037,2515,163,155,13,7,0,0,522
29163460200,3291,3056,60,44,10,0,0,10,235
29163460300,5428,4676,100,505,8,4,3,8,752
29163460400,3763,3276,89,174,3,9,1,13,487
29163460500,2068,1860,22,64,6,3,3,1,208
29165030002,3392,1933,329,694,15,110,91,18,1459
29165030003,2554,1654,187,360,5,163,4,15,900
29165030004,5920,4236,450,673,16,139,51,27,1684
29165030101,3831,3077,256,117,21,127,5,21,754
29165030102,4775,3321,399,566,23,138,82,17,1454
29165030103,5850,4443,377,484,18,144,30,40,1407
29165030201,5492,4094,325,487,12,241,20,23,1398
29165030207,6102,4608,442,518,33,201,20,14,1494
29165030208,3165,2744,117,49,9,49,10,3,421
29165030210,2067,1471,194,206,8,53,1,13,596
29165030211,3011,1758,308,535,4,159,46,7,1253
29165030212,4849,3366,368,724,11,99,11,37,1483
29165030213,2722,1892,269,303,13,99,8,12,830
29165030214,2477,1632,252,239,17,58,117,4,845
29165030215,1552,1150,107,141,2,37,18,7,402
29165030216,4194,2996,331,334,10,184,70,0,1198
29165030306,5074,4368,261,78,24,60,3,24,706
29165030308,5728,4002,509,572,18,269,23,19,1726
29165030309,5276,3867,405,485,21,79,25,22,1409
29165030310,3755,3191,213,85,22,56,9,3,564
29165030401,7497,6467,328,126,21,109,6,60,1030
29165030501,2921,2382,164,122,8,44,12,6,539
29165030502,3182,2620,196,136,11,40,23,17,562
29165030601,1909,1530,121,67,9,28,7,23,379
29165030602,5886,5348,169,22,29,29,3,23,538
29165030700,3525,3270,79,12,11,6,0,4,255
29165980000,12,6,5,0,0,0,0,0,6
29167960101,2315,2100,44,8,10,10,0,2,215
29167960102,3964,3625,101,18,34,0,0,8,339
29167960201,2439,2259,33,6,22,3,0,5,180
29167960202,4726,4331,128,24,29,22,0,10,395
29167960301,2924,2720,53,0,16,10,0,6,204
29167960302,5632,5063,172,55,35,27,2,8,569
29167960401,4173,3681,135,100,22,16,2,9,492
29167960402,5346,4903,125,31,22,43,0,13,443
29169470101,4023,3608,135,17,16,20,21,20,415
29169470102,3176,2869,89,21,9,17,4,4,307
29169470286,5608,3650,629,616,51,206,30,39,1958
29169470288,4389,2426,523,696,28,254,48,26,1963
29169470289,3827,2253,375,545,28,214,54,13,1574
29169470389,7816,4255,1481,1431,46,379,49,9,3561
29169470390,1978,960,459,307,3,83,39,11,1018
29169470401,5173,3532,491,531,31,129,44,30,1641
29169470402,7515,4944,777,895,48,173,66,28,2571
29169470501,3416,2897,135,87,21,39,8,10,519
29169470502,1931,1735,54,11,8,12,3,10,196
29169470601,3129,1673,570,585,23,147,19,10,1456
29169470602,1974,1063,361,297,22,103,17,10,911
29171960100,2617,2540,29,4,0,0,0,0,77
29171960200,2064,1906,83,7,5,0,0,0,158
29173470100,3288,3037,27,40,12,1,3,6,251
29173470200,3893,3653,42,59,10,13,0,21,240
29173470300,3174,3023,27,15,4,3,1,14,151
29175490100,3741,3497,51,18,11,8,0,11,244
29175490200,3290,2986,66,63,10,6,0,13,304
29175490300,4604,3724,136,376,24,15,4,23,880
29175490400,3240,2733,67,173,15,14,2,13,507
29175490500,4514,3817,157,196,26,38,1,10,697
29175490600,5327,4514,95,525,16,14,2,5,813
29177080001,2524,2281,59,9,20,11,0,2,243
29177080002,4895,4425,122,12,28,14,0,21,470
29177080100,3180,3022,34,10,14,5,1,1,158
29177080201,3358,2896,87,90,14,24,2,6,462
29177080202,3283,2881,108,63,20,14,4,8,402
29177080300,5918,5388,170,43,37,8,1,15,530
29179380100,2659,2434,49,26,10,16,2,0,225
29179380200,3437,3235,50,7,13,2,0,0,202
29181870100,3354,3069,47,4,16,11,0,0,285
29181870200,2003,1870,27,5,12,2,0,0,133
29181870300,3455,3225,38,16,11,13,0,1,230
29181870400,1867,1721,15,6,5,2,1,0,146
29183310100,2064,1919,24,16,7,5,1,7,145
29183310201,6187,5068,225,445,13,135,1,19,1119
29183310202,3602,2962,78,359,12,33,0,6,640
29183310301,4068,3599,109,124,11,31,3,9,469
29183310302,3980,3263,141,256,4,82,1,27,717
29183310400,2035,1740,67,69,5,23,0,12,295
29183310501,3872,2779,548,258,10,30,4,24,1093
29183310502,2467,1901,80,289,12,41,0,7,566
29183310601,3757,2882,337,228,3,69,14,66,875
29183310602,5680,5002,162,194,3,60,0,21,678
29183310700,5232,3890,492,462,6,90,3,16,1342
29183310801,2487,2018,85,199,0,61,0,0,469
29183310802,5946,4832,271,389,3,116,2,17,1114
29183310901,2375,1640,91,403,7,86,3,15,735
29183310902,5318,4011,548,330,3,138,0,30,1307
29183310903,4051,3201,137,388,2,108,0,7,850
29183311001,4271,3246,228,293,3,335,0,12,1025
29183311003,3149,2204,194,439,1,171,0,15,945
29183311004,5736,4058,237,625,11,481,3,26,1678
29183311103,6533,5880,131,132,3,150,0,21,653
29183311114,5253,4565,151,193,1,97,5,17,688
29183311122,7301,5734,282,641,12,286,0,36,1567
29183311124,6907,5427,220,249,16,705,1,30,1480
29183311132,3499,3153,78,72,1,77,2,5,346
29183311145,4388,3736,153,143,6,132,0,18,652
29183311146,4488,3587,158,249,1,262,1,16,901
29183311147,4031,3380,131,207,9,112,0,14,651
29183311148,4317,3784,160,121,3,76,0,9,533
29183311149,3835,3207,179,146,7,64,0,13,628
29183311150,4720,3990,177,153,1,149,0,32,730
29183311151,6413,5093,196,303,14,487,6,23,1320
29183311152,4590,4071,84,112,5,125,0,15,519
29183311153,6886,5483,214,283,13,584,3,23,1403
29183311154,5387,4582,159,157,2,218,1,8,805
29183311203,6154,5054,216,358,10,150,5,24,1100
29183311211,5470,4291,163,440,5,270,0,20,1179
29183311212,4243,3312,185,253,14,253,2,16,931
29183311221,3613,3051,103,158,6,67,7,5,562
29183311294,3826,3269,117,143,12,73,3,19,557
29183311296,4110,3595,106,134,2,50,3,8,515
29183311311,5880,4652,240,386,10,189,1,42,1228
29183311312,7417,6255,302,333,12,183,6,30,1162
29183311322,6787,5669,190,336,10,228,0,15,1118
29183311331,4631,3998,172,171,3,53,0,19,633
29183311391,4831,4072,198,207,7,58,1,8,759
29183311422,6035,5084,220,283,4,145,10,30,951
29183311500,2205,1714,318,46,0,0,0,4,491
29183311602,5980,4994,233,305,6,74,13,24,986
29183311603,2780,2298,114,158,4,36,0,8,482
29183311604,3164,2769,78,94,3,44,0,13,395
29183311712,4889,3844,336,238,8,180,11,9,1045
29183311721,3765,3092,134,192,2,101,0,11,673
29183311732,7074,5921,308,261,3,193,9,22,1153
29183311733,2272,1884,104,118,8,37,0,9,388
29183311734,4233,3335,197,353,9,123,8,8,898
29183311735,5970,5015,222,284,6,175,3,11,955
29183311737,3461,2828,101,164,7,162,0,0,633
29183311738,4465,3325,463,257,14,71,1,15,1140
29183311739,4551,3775,137,138,8,276,0,3,776
29183311740,2096,1899,40,38,4,45,0,6,197
29183311801,6250,5388,178,284,4,81,2,22,862
29183311802,6220,5291,246,224,9,99,26,23,929
29183311903,6030,5066,215,312,26,90,1,22,964
29183311904,6462,5342,218,342,11,261,0,20,1120
29183311907,6223,4997,217,490,14,98,0,18,1226
29183311908,4475,3783,172,182,19,97,0,9,692
29183311909,5174,4614,124,113,21,66,7,10,560
29183312001,3228,2995,74,34,0,12,0,10,233
29183312002,4221,3682,103,160,5,53,1,20,539
29183312003,6938,6117,239,189,11,82,0,20,821
29183312094,5765,4447,236,632,16,76,6,38,1318
29183312095,6470,5263,229,498,6,103,12,19,1207
29183312096,9026,7599,247,508,15,158,0,18,1427
29183312192,6266,5395,225,217,10,81,3,9,871
29183312193,8915,7717,252,367,8,140,0,31,1198
29183312194,3488,3168,54,103,12,43,0,0,320
29183312195,3318,2723,186,191,16,27,0,4,595
29183312204,5155,4834,89,27,6,32,1,7,321
29183312206,4721,4306,92,67,8,26,1,9,415
29183312207,4286,3242,407,197,6,168,0,13,1044
29183312208,5118,4260,192,195,2,184,0,11,858
29183312209,4489,3794,149,206,2,118,2,15,695
29183312300,2730,2425,74,39,5,47,0,15,305
29183312400,5555,4544,266,320,4,71,0,19,1011
29183980000,12,5,3,0,0,0,0,0,7
29185480100,3529,3286,59,7,26,0,2,1,243
29185480200,2712,2521,46,3,11,7,1,14,191
29185480300,3043,2760,73,16,26,12,4,8,283
29186960101,3714,3475,54,6,7,2,2,8,239
29186960102,2527,2376,24,9,7,0,0,6,151
29186960200,5539,4893,119,278,19,18,0,5,646
29186960300,4083,3929,35,17,8,8,0,0,154
29186960400,2616,2454,37,10,13,1,0,0,162
29187950103,2875,2673,45,7,9,12,1,8,202
29187950104,2096,1887,38,12,6,13,0,19,209
29187950105,1763,1647,19,6,5,13,4,8,116
29187950106,2850,2646,27,15,7,4,1,7,204
29187950300,7835,6066,121,1275,25,18,7,21,1769
29187950401,3190,2987,28,11,4,0,0,5,203
29187950402,3908,3445,123,78,7,38,0,36,463
29187950600,2822,2615,34,3,8,0,2,7,207
29187950701,2557,2409,29,36,6,8,0,8,148
29187950702,3118,2961,32,12,17,12,0,10,157
29187950703,3375,3101,58,34,6,26,0,0,274
29187950801,2536,2303,54,26,14,29,2,2,233
29187950802,4065,3646,64,62,0,70,0,17,419
29187950901,2398,2163,47,21,4,62,0,0,235
29187950902,7399,5991,189,877,26,61,0,12,1408
29187951001,2455,2221,27,57,10,10,1,5,234
29187951002,4238,3921,57,60,23,7,3,4,317
29187951101,2308,2036,37,27,8,3,0,12,272
29187951102,5134,4756,60,26,7,17,0,7,378
29189210101,1400,449,25,853,9,5,1,7,951
29189210102,3961,651,71,3035,26,6,0,39,3310
29189210200,5585,505,51,4832,14,3,2,6,5080
29189210300,2985,474,52,2315,12,9,3,15,2511
29189210400,4142,190,30,3786,14,10,0,28,3952
29189210501,3164,90,65,2925,1,5,0,6,3074
29189210502,3305,122,37,3044,8,4,0,19,3183
29189210600,6645,1051,86,5336,11,13,1,26,5594
29189210702,5984,570,118,5026,7,26,0,51,5414
29189210703,3550,494,77,2804,20,6,0,34,3056
29189210704,3950,172,47,3591,5,14,1,30,3778
29189210803,4898,1030,52,3578,14,43,1,25,3868
29189210805,6080,587,107,5181,10,30,6,28,5493
29189210806,6151,360,85,5460,14,15,1,48,5791
29189210807,5760,476,73,4962,6,25,0,24,5284
29189210808,3620,302,40,3108,5,57,2,12,3318
29189210912,7155,1977,130,4638,5,95,0,53,5178
29189210921,4072,1214,126,2412,0,67,0,45,2858
29189210923,5399,2234,175,2569,8,65,3,34,3165
29189210924,4456,1121,131,2943,5,43,5,27,3335
29189210925,5419,1704,178,3197,6,31,0,38,3715
29189210926,2578,1161,80,1168,0,36,0,16,1417
29189210927,4681,1430,70,2903,8,61,1,28,3251
29189210928,4477,978,78,3153,7,100,2,40,3499
29189211001,4302,1425,123,2477,6,45,1,33,2877
29189211002,3368,1397,74,1691,3,32,0,9,1971
29189211101,7056,3071,203,3390,18,46,0,41,3985
29189211102,5002,1200,87,3513,7,16,0,17,3802
29189211201,5337,2158,195,2679,4,27,2,34,3179
29189211202,3298,2249,84,777,11,8,0,11,1049
29189211301,6432,3671,239,1953,7,79,0,52,2761
29189211331,6067,3370,168,1999,13,120,5,58,2697
29189211332,6293,3487,382,1832,17,121,3,50,2806
29189211333,4918,2372,127,2011,8,105,0,51,2546
29189211334,4258,2355,129,1456,11,45,3,22,1903
29189211401,5325,2753,294,1882,7,85,1,33,2572
29189211402,2274,758,63,1286,5,31,0,27,1516
29189211500,2989,162,94,2576,11,6,6,24,2827
29189211600,5855,1501,187,3755,16,52,7,59,4354
29189211700,3828,1046,74,2480,3,29,0,11,2782
29189211801,3553,315,70,2993,9,17,0,36,3238
29189211802,3483,319,47,2989,7,34,1,13,3164
29189211900,4495,220,72,4020,11,4,4,24,4275
29189212002,2866,111,43,2606,10,16,0,10,2755
29189212003,3441,217,34,3102,0,0,0,1,3224
29189212004,3506,145,13,3258,6,14,0,12,3361
29189212101,3467,180,47,3084,8,4,0,28,3287
29189212102,2675,142,30,2411,1,3,1,5,2533
29189212201,3792,118,37,3516,3,6,2,17,3674
29189212202,2079,35,6,1955,0,1,2,16,2044
29189212300,4623,667,70,3661,15,37,1,27,3956
29189212400,2173,219,49,1818,5,16,0,7,1954
29189212500,4599,757,68,3542,6,26,4,28,3842
29189212600,4374,1314,105,2738,3,23,0,21,3060
29189212701,3069,524,86,2309,7,13,1,23,2545
29189212702,1881,428,42,1326,0,4,0,16,1453
29189213102,377,245,25,50,4,12,0,6,132
29189213103,3278,1865,226,919,1,95,1,13,1413
29189213104,1029,465,78,415,0,28,0,9,564
29189213202,7012,4359,305,821,19,1115,2,52,2653
29189213203,5014,3680,211,665,6,180,0,23,1334
29189213204,3905,1873,450,987,8,347,5,23,2032
29189213301,3429,1535,255,1303,9,89,2,24,1894
29189213302,3726,1362,503,1532,18,47,2,32,2364
29189213401,4644,1585,716,1917,14,95,0,43,3059
29189213402,1878,826,351,543,3,22,2,12,1052
29189213500,5222,2592,526,1654,13,106,0,26,2630
29189213600,3431,448,240,2592,4,3,0,8,2983
29189213701,836,208,55,492,2,43,0,1,628
29189213702,3986,1119,121,2312,16,242,0,23,2867
29189213800,4720,95,58,4397,12,7,0,32,4625
29189213900,1437,19,21,1356,4,1,0,10,1418
29189214100,1080,21,38,992,0,1,0,2,1059
29189214200,2882,212,63,2479,4,4,0,17,2670
29189214300,3714,951,339,2183,6,28,0,29,2763
29189214400,4789,2544,672,1202,13,81,0,32,2245
29189214500,3173,1715,399,682,2,215,1,17,1458
29189214601,3891,2072,417,1011,7,87,0,35,1819
29189214602,4052,2191,577,870,15,120,0,33,1861
29189214700,6721,3259,1194,1712,19,118,2,38,3462
29189214800,5481,3277,390,1325,17,107,0,42,2204
29189214901,3196,1767,203,864,4,150,2,28,1429
29189214902,3241,1392,525,996,7,115,0,12,1849
29189215001,2840,1314,125,347,7,890,4,35,1526
29189215003,4412,3318,132,434,11,307,3,16,1094
29189215004,3427,1925,159,789,3,400,0,10,1502
29189215005,5941,3506,182,981,8,978,5,29,2435
29189215102,4979,3251,250,634,10,578,0,36,1728
29189215103,2577,1714,108,319,1,254,0,54,863
29189215105,2434,1782,122,167,2,241,2,11,652
29189215141,4229,3312,95,286,4,357,2,16,917
29189215143,2901,2161,165,250,5,105,2,8,740
29189215144,5672,3837,203,757,13,572,3,48,1835
29189215145,4914,2625,299,823,15,887,0,48,2289
29189215146,2632,968,123,639,6,771,3,42,1664
29189215201,6657,4664,266,688,7,708,5,75,1993
29189215231,4751,3706,207,214,10,384,4,19,1045
29189215233,5234,3619,205,485,2,694,0,35,1615
29189215234,2071,1650,92,140,0,108,2,2,421
29189215235,4612,3377,144,111,5,799,4,11,1235
29189215236,3250,2792,72,65,1,229,0,16,458
29189215301,4689,3391,142,285,10,648,0,21,1298
29189215302,3386,2643,89,108,2,419,1,24,743
29189215400,5507,4741,140,51,7,307,0,19,766
29189215500,5260,3565,174,444,5,755,0,15,1695
29189215600,5042,1379,287,2250,12,840,0,26,3663
29189215700,5681,1007,264,3933,12,182,2,48,4674
29189215801,3943,2909,137,587,0,115,0,39,1034
29189215802,1602,1066,58,375,0,50,0,8,536
29189215803,2430,1600,112,358,3,262,0,13,830
29189215901,3337,1061,103,1933,2,54,3,51,2276
29189215902,3161,484,61,2421,6,28,2,28,2677
29189216000,1542,218,52,1187,1,16,0,4,1324
29189216101,3337,1725,176,439,1,801,1,14,1612
29189216102,2262,972,117,611,0,431,6,7,1290
29189216201,3827,2900,145,461,6,125,2,22,927
29189216202,3950,2933,156,476,4,192,0,31,1017
29189216300,7068,4593,387,561,6,1077,2,43,2475
29189216401,2762,2175,80,65,0,325,0,7,587
29189216402,3071,2182,138,86,7,481,0,21,889
29189216500,5279,3668,165,744,1,506,1,8,1611
29189216600,2492,1962,78,112,1,251,0,2,530
29189216700,3539,2628,174,483,6,88,0,10,911
29189216800,3189,2533,120,206,3,172,0,14,656
29189216900,2333,1663,81,390,1,38,4,6,670
29189217000,4002,3047,178,402,7,99,2,28,955
29189217200,1899,1273,84,284,5,132,0,8,626
29189217300,3064,2363,126,201,5,225,0,3,701
29189217400,4915,4094,153,128,10,289,0,18,821
29189217500,5587,4991,111,58,3,220,0,12,596
29189217600,7577,6661,215,86,4,286,6,19,916
29189217701,5425,4386,163,119,3,529,2,29,1039
29189217702,7813,5984,599,170,10,767,0,31,1829
29189217802,7426,5901,224,187,3,770,0,46,1525
29189217806,5595,4465,225,159,2,495,1,24,1130
29189217807,6462,5321,201,255,3,413,1,3,1141
29189217841,5280,3954,148,208,0,758,3,17,1326
29189217851,3168,2687,75,59,4,226,0,0,481
29189217852,6729,5648,161,145,14,498,0,16,1081
29189217853,5015,3453,129,158,8,1091,0,12,1562
29189217854,2290,1880,61,48,2,209,4,6,410
29189217921,4833,3929,157,109,1,427,0,14,904
29189217923,7103,5771,280,210,11,468,6,34,1332
29189217931,6366,5220,257,189,25,304,6,15,1146
29189217932,5144,3793,152,94,5,841,4,16,1351
29189217941,6016,5019,192,159,4,281,1,13,997
29189217942,5402,4445,170,144,3,412,0,10,957
29189217943,3505,2649,104,126,2,429,0,19,856
29189217944,5818,4537,153,133,13,686,0,43,1281
29189218012,4955,4351,109,72,0,223,0,15,604
29189218013,5814,4753,284,174,5,314,0,7,1061
29189218014,1573,1420,39,23,0,23,0,3,153
29189218015,2914,2532,72,22,2,199,0,23,382
29189218016,3991,2515,268,316,7,597,0,56,1476
29189218102,3122,2533,88,174,0,134,0,6,589
29189218104,1793,1334,193,122,1,40,0,12,459
29189218105,3616,2963,118,153,2,226,3,9,653
29189218201,3274,2911,66,95,0,50,0,7,363
29189218300,4313,3729,120,208,1,61,2,14,584
29189218401,4151,3770,112,68,6,43,0,6,381
29189218402,5054,4542,120,55,2,71,5,23,512
29189218500,5064,4587,146,71,2,84,2,1,477
29189218600,2801,2139,108,383,1,37,0,10,662
29189218800,6176,5706,178,41,3,57,0,12,470
29189218901,3425,1962,106,1005,7,81,1,19,1463
29189218902,2928,2074,135,470,3,59,0,27,854
29189219100,3950,3497,138,65,2,71,0,34,453
29189219200,2679,2391,96,57,2,36,0,8,288
29189219300,2170,1831,69,115,0,32,1,3,339
29189219400,6335,5791,149,67,3,107,1,13,544
29189219501,4764,4098,176,158,8,79,0,11,666
29189219502,2553,2380,53,21,0,29,1,6,173
29189219601,4176,3540,141,214,5,130,0,19,636
29189219602,2579,2188,89,92,4,91,0,3,391
29189219700,5887,4798,253,297,25,192,1,14,1089
29189219801,3782,3203,158,78,2,137,2,19,579
29189219802,3757,3086,113,243,0,107,3,6,671
29189219900,6101,4804,182,121,23,678,3,18,1297
29189220001,5090,4463,130,97,9,171,0,24,627
29189220002,3199,2689,119,129,0,89,4,13,510
29189220101,3231,2691,156,91,5,98,0,20,540
29189220102,4503,3593,131,142,5,430,1,4,910
29189220200,5704,4355,370,417,20,66,1,24,1349
29189220300,1763,1243,86,271,5,26,0,5,520
29189220441,6024,5292,201,146,8,119,2,23,732
29189220442,4473,4024,116,70,5,61,3,19,449
29189220443,4132,3605,99,138,16,100,1,17,527
29189220445,4940,4494,95,37,8,112,3,24,446
29189220446,4414,4054,94,38,7,41,0,6,360
29189220447,3292,2840,108,127,5,59,1,1,452
29189220448,5197,4402,193,201,14,166,0,20,795
29189220449,5189,4627,153,97,7,111,0,6,562
29189220450,2832,2566,53,24,0,50,0,7,266
29189220451,4075,3708,101,29,7,84,1,10,367
29189220452,3881,3496,91,47,0,74,0,2,385
29189220501,6421,5386,291,174,24,225,4,17,1035
29189220503,2670,2292,80,67,2,94,0,7,378
29189220504,3873,2970,176,317,0,195,0,15,903
29189220601,6746,5781,211,148,8,325,0,21,965
29189220602,5760,4960,159,134,0,224,0,21,800
29189220701,3329,2916,89,57,12,77,1,21,413
29189220702,3867,3453,118,24,2,117,2,11,414
29189220703,2832,2517,110,31,0,63,1,6,315
29189220801,5657,4837,187,243,1,137,0,27,820
29189220802,5073,4408,145,145,9,126,3,15,665
29189220803,4897,4429,132,30,0,129,0,13,468
29189221000,3323,2129,113,752,9,62,2,35,1194
29189221100,1847,1676,47,24,0,34,0,3,171
29189221201,3875,3513,71,4,1,165,0,6,362
29189221202,6219,5559,160,53,5,174,0,12,660
29189221332,4642,4153,97,62,2,154,0,9,489
29189221335,5855,5193,127,148,3,160,0,7,662
29189221336,3781,3353,95,49,1,93,1,6,428
29189221337,3823,3351,101,46,2,134,0,16,472
29189221338,3051,2308,103,357,4,88,0,6,743
29189221339,3739,3362,94,43,6,99,1,2,377
29189221421,7476,6626,170,61,9,277,2,8,850
29189221423,3989,3625,102,24,0,94,1,3,364
29189221424,4912,4436,83,29,6,136,0,4,476
29189221425,5688,5003,123,81,0,170,0,15,685
29189221426,2944,2629,87,13,4,104,0,7,315
29189221502,7476,6802,186,57,4,108,5,14,674
29189221503,7682,6313,275,673,5,98,0,9,1369
29189221506,5003,4260,153,78,3,290,0,19,743
29189221621,4512,4061,133,48,7,77,0,20,451
29189221624,3369,2755,126,45,1,294,0,21,614
29189221625,7131,5831,286,137,8,522,2,23,1300
29189221626,5953,5057,178,98,11,414,0,4,896
29189221627,6677,5340,223,124,12,683,6,21,1337
29189221629,5600,4217,169,65,5,904,0,32,1383
29189221630,2227,1678,75,96,6,315,0,1,549
29189221631,5721,3530,437,168,6,1391,0,8,2191
29189221800,3098,298,160,2476,5,17,0,17,2800
29189221900,3871,3423,113,88,10,60,0,35,448
29189222000,3687,3411,67,38,4,70,0,9,276
29189222100,5298,4597,164,79,7,236,0,16,701
29195090100,2409,2050,74,117,9,8,2,14,359
29195090200,2207,2020,78,48,2,1,0,4,187
29195090300,2960,2010,502,127,10,22,118,11,950
29195090400,2826,1890,485,217,6,21,44,16,936
29195090500,5124,3196,916,454,21,76,115,158,1928
29195090600,2954,1741,709,146,4,32,117,19,1213
29195090700,2520,2355,27,27,15,12,0,9,165
29195090800,2333,2211,39,13,1,3,1,2,122
29197470100,1882,1793,29,0,1,7,1,6,89
29197470200,2150,2071,18,0,0,8,0,3,79
29199480100,2833,2756,18,3,1,3,0,0,77
29199480200,1883,1781,17,3,4,2,1,0,102
29201780100,3160,2922,75,29,5,4,0,5,238
29201780200,4165,3828,64,30,7,12,0,5,337
29201780300,2575,2375,58,20,3,0,0,8,200
29201780400,4986,4387,88,210,14,9,0,12,599
29201780600,4206,3331,146,466,14,44,0,9,875
29201780700,2892,1125,49,1552,6,10,0,24,1767
29201781000,4019,3692,111,47,7,5,0,3,327
29201781100,3230,3052,49,15,7,4,0,0,178
29201781201,2546,1084,124,1177,8,2,0,5,1462
29201781202,3180,2331,98,565,5,28,0,18,849
29201781300,3100,2468,73,365,8,31,2,8,632
29203470100,2880,2688,46,2,9,2,0,0,192
29203470200,4151,3763,95,1,28,11,0,3,388
29205450100,1802,1668,44,12,4,1,0,7,134
29205450200,2542,2409,40,3,9,0,0,2,133
29205450300,1759,1672,33,5,7,0,0,0,87
29207470100,3634,3397,40,29,13,4,0,8,237
29207470200,4066,3807,58,11,10,24,2,5,259
29207470300,4090,3853,58,16,4,24,0,4,237
29207470400,2550,2351,43,59,14,2,0,5,199
29207470500,3501,3135,151,49,8,9,0,3,366
29207470600,5118,4736,119,50,11,22,0,2,382
29207470700,2549,2306,67,77,6,2,0,1,243
29207470800,3164,3025,30,7,1,3,0,5,139
29209090101,3517,3237,66,11,20,11,2,11,280
29209090102,4107,3779,60,6,35,8,0,9,328
29209090201,2170,1948,58,10,23,4,1,13,222
29209090202,2606,2383,55,4,23,3,1,0,223
29209090401,2773,2557,54,7,15,3,4,14,216
29209090402,2241,2076,46,6,12,14,0,5,165
29209090501,1645,1455,39,9,15,13,2,4,190
29209090502,3555,3263,93,2,30,14,3,5,292
29209090603,1431,1300,36,2,5,6,0,8,131
29209090604,1742,1615,46,8,4,7,0,3,127
29209090605,2491,2181,125,9,11,23,5,3,310
29209090606,2798,2502,104,5,22,9,2,9,296
29211480100,1879,1723,86,6,11,1,0,3,156
29211480200,1281,1202,28,4,9,4,1,5,79
29211480300,2839,1582,940,198,6,24,0,6,1257
29213480106,2234,1644,242,70,30,100,4,19,590
29213480107,1733,1435,129,31,20,25,0,3,298
29213480108,3190,2384,435,74,26,45,1,16,806
29213480109,2399,1873,231,66,13,63,1,8,526
29213480203,3954,3403,248,16,45,20,0,16,551
29213480204,3360,2932,140,20,21,30,0,6,428
29213480205,1202,1025,80,19,9,9,0,7,177
29213480206,3160,2538,320,52,22,59,3,5,622
29213480207,3519,2969,246,35,21,31,2,15,550
29213480208,3078,2483,310,47,8,69,0,2,595
29213480301,5149,4412,249,63,37,47,1,20,737
29213480302,4393,3787,231,61,20,22,2,11,606
29213480402,2326,2179,34,7,5,10,0,2,147
29213480403,3330,3025,80,17,22,14,2,6,305
29213480404,2332,2138,47,4,23,8,0,10,194
29213480501,2250,2019,81,7,16,12,0,11,231
29213480503,4313,2953,807,182,42,9,164,10,1360
29213480504,4144,3269,419,66,27,35,7,15,875
29215480101,3225,2963,82,26,8,10,5,10,262
29215480102,4251,3295,93,693,39,4,0,2,956
29215480201,2696,2511,28,13,12,6,0,12,185
29215480202,2298,2115,51,11,21,2,1,4,183
29215480301,3064,2829,77,5,17,7,0,8,235
29215480302,3071,2823,80,10,16,21,0,3,248
29215480401,3816,3535,75,21,15,10,0,3,281
29215480402,2066,1921,29,1,14,5,0,4,145
29217950100,3277,3067,20,2,22,8,1,15,210
29217950200,1758,1661,12,1,10,0,4,7,97
29217950300,5887,5261,152,68,47,47,5,16,626
29217950400,3339,2919,137,32,31,19,3,9,420
29217950500,2833,2634,45,7,15,29,5,1,199
29217950600,2613,2424,60,0,6,0,0,4,189
29219820104,4104,3752,95,20,20,16,0,11,352
29219820105,3483,2878,205,88,20,18,0,9,605
29219820106,4951,4403,147,78,17,16,0,10,548
29219820107,3670,3143,91,128,14,36,0,9,527
29219820108,5450,4434,383,248,7,23,0,23,1016
29219820109,3828,3222,246,97,19,9,0,15,606
29219820201,2342,2133,80,16,5,5,0,6,209
29219820203,3763,3473,68,22,8,11,0,17,290
29219820204,3941,3665,85,21,6,9,0,11,276
29221460101,2848,2632,22,7,10,7,0,10,216
29221460102,3570,3281,45,26,14,3,1,9,289
29221460200,4302,4001,42,5,16,5,0,9,301
29221460300,4361,3529,58,532,12,7,0,14,832
29221460400,4508,4236,32,34,10,5,0,5,272
29221460500,3925,3699,28,6,16,13,0,6,226
29223690100,2740,2541,40,7,14,8,2,0,199
29223690200,2663,2467,37,10,17,6,2,0,196
29223690300,3604,3293,58,23,23,7,0,0,311
29223690400,1967,1792,20,10,13,2,1,2,175
29225470101,5305,4824,119,22,48,14,4,18,481
29225470102,5703,5279,72,3,33,26,0,16,424
29225470201,5544,5044,130,22,40,29,0,10,500
29225470202,4519,4124,104,23,40,12,5,3,395
29225470301,5815,5244,161,18,33,23,0,21,571
29225470302,5323,5054,61,5,23,16,0,6,269
29225470401,3841,3571,99,11,14,14,0,10,270
29225470402,3035,2753,44,90,12,7,0,2,282
29227960100,1973,1887,25,0,4,4,5,0,86
29229490100,3641,3411,47,26,12,7,0,18,230
29229490200,4103,3781,93,39,16,8,1,12,322
29229490300,5209,4741,81,29,14,16,0,16,468
29229490400,5235,4721,149,17,31,17,4,13,514
29510101100,2569,1859,175,164,6,205,0,12,710
29510101200,3197,2310,136,189,2,382,2,13,887
29510101300,4150,3006,272,515,12,98,0,23,1144
29510101400,2704,1357,169,901,6,43,2,21,1347
29510101500,2849,1418,234,961,18,29,0,13,1431
29510101800,2829,1270,284,995,14,40,0,18,1559
29510102100,2737,2168,94,277,6,60,0,16,569
29510102200,5967,5229,228,178,3,98,0,20,738
29510102300,1814,1328,109,100,3,159,4,4,486
29510102400,2240,1534,159,307,15,44,2,18,706
29510102500,1842,1407,85,192,1,48,3,9,435
29510103100,3331,2575,148,341,10,94,0,11,756
29510103400,1778,1511,70,72,4,13,4,4,267
29510103600,1250,1011,46,65,3,35,2,12,239
29510103700,2507,2086,93,127,3,73,0,19,421
29510103800,3823,3235,165,179,0,70,0,8,588
29510104200,3406,2795,128,160,4,147,1,18,611
29510104500,2520,1772,130,235,2,242,0,9,748
29510105198,3960,2184,170,394,4,1009,3,27,1776
29510105200,2647,1067,91,1113,5,234,2,20,1580
29510105300,2211,259,48,1762,8,29,1,21,1952
29510105400,2413,117,428,1756,6,13,0,26,2296
29510105500,2546,129,34,2276,7,11,0,8,2417
29510106100,1744,34,24,1621,2,3,1,8,1710
29510106200,1260,6,3,1219,0,2,0,0,1254
29510106300,1480,26,26,1390,0,0,0,4,1454
29510106400,1650,26,17,1550,1,0,0,17,1624
29510106500,2687,177,13,2391,6,0,0,12,2510
29510106600,1250,36,12,1139,0,2,0,2,1214
29510106700,2502,45,28,2311,5,3,0,12,2457
29510107200,974,22,18,910,0,3,0,0,952
29510107300,3968,42,30,3757,8,1,0,12,3926
29510107400,1783,16,27,1662,4,5,2,0,1767
29510107500,2040,56,28,1902,6,11,0,5,1984
29510107600,1905,25,13,1823,2,0,0,2,1880
29510108100,2535,71,20,2351,3,0,0,12,2464
29510108200,2260,70,17,2107,4,2,0,10,2190
29510108300,1830,53,13,1702,6,2,0,0,1777
29510109600,2496,33,18,2360,6,0,3,17,2463
29510109700,1644,87,12,1477,0,28,0,13,1557
29510110100,2264,25,34,2118,5,0,0,22,2239
29510110200,1922,21,17,1814,8,5,0,12,1901
29510110300,1904,22,13,1815,1,0,0,7,1882
29510110400,1960,42,30,1824,7,1,0,9,1918
29510110500,1002,31,9,942,5,0,0,2,971
29510111100,1874,58,32,1706,5,4,0,22,1816
29510111200,1014,133,16,839,2,2,3,10,881
29510111300,1199,21,3,1149,2,0,0,4,1178
29510112100,4455,2601,242,952,5,371,2,36,1854
29510112200,1434,165,47,1128,6,26,0,4,1269
29510112300,1787,68,30,1611,15,0,0,16,1719
29510112400,4492,2815,250,548,7,677,0,11,1677
29510113500,2352,2139,70,36,2,25,4,8,213
29510114101,4201,2884,200,747,14,142,0,30,1317
29510114102,4211,3720,105,132,2,74,2,17,491
29510114200,4557,3511,211,433,11,169,0,27,1046
29510114300,5242,4389,229,304,8,69,0,19,853
29510115100,3940,2201,511,833,5,126,0,21,1739
29510115200,2960,1192,417,1028,13,190,1,22,1768
29510115300,5047,1808,628,1687,13,596,1,28,3239
29510115400,3054,1622,373,700,12,136,2,16,1432
29510115500,5460,1531,719,2749,15,100,0,23,3929
29510115600,5091,1775,535,2295,19,107,3,51,3316
29510115700,3460,775,412,1797,9,239,1,23,2685
29510116100,3057,1437,362,751,7,362,0,11,1620
29510116200,4175,2948,183,614,9,147,2,30,1227
29510116301,2902,1999,167,405,4,138,0,16,903
29510116302,3007,577,391,1283,4,590,0,11,2430
29510116400,4536,930,552,2559,7,211,0,32,3606
29510116500,3813,1884,236,1261,2,192,1,8,1929
29510117100,1546,1103,61,237,1,51,1,12,443
29510117200,5460,3432,264,1330,4,113,0,25,2028
29510117400,4188,2683,162,976,2,120,0,18,1505
29510118100,1591,651,98,698,2,47,0,16,940
29510118600,4561,2493,214,951,4,525,2,154,2068
29510119101,2649,1273,94,820,0,332,5,10,1376
29510119102,3418,2053,158,454,5,578,0,28,1365
29510119200,1946,784,78,886,4,94,0,16,1162
29510119300,6100,3047,304,1419,9,952,7,80,3053
29510120200,1092,45,9,994,4,5,0,4,1047
29510121200,1787,42,31,1647,3,2,0,16,1745
29510123100,3235,1180,145,1739,3,33,1,18,2055
29510123200,2464,1460,80,740,5,48,0,12,1004
29510123300,2928,1834,85,791,4,44,3,6,1094
29510124100,4191,853,478,2556,12,39,0,23,3338
29510124200,3070,979,373,1474,6,44,1,17,2091
29510124300,3059,1979,175,683,6,33,0,19,1080
29510124600,1712,475,171,922,6,15,3,18,1237
29510125500,3810,1837,212,1372,9,177,6,25,1973
29510125600,5832,2326,290,2696,10,239,0,44,3506
29510125700,2852,95,32,2641,0,10,0,22,2757
29510126600,2779,405,57,2203,4,9,0,6,2374
29510126700,1074,156,23,832,4,0,0,13,918
29510126800,3371,2622,157,256,3,86,2,28,749
29510126900,3958,49,32,3774,16,2,0,7,3909
29510127000,1221,197,30,952,11,1,0,7,1024
29510127100,1683,81,15,1540,9,0,0,0,1602
29510127200,4163,2836,205,695,3,229,1,11,1327
29510127300,3729,1337,127,1907,10,148,0,23,2392
29510127400,4705,1328,89,3043,7,45,0,14,3377
29510127500,2461,546,42,1727,7,35,1,13,1915
29510127600,3444,2349,145,753,2,30,1,22,1095
29510127700,1868,41,7,1749,9,4,0,13,1827
29510127800,3961,1021,123,2545,11,178,0,9,2940
30001000100,1239,1115,69,0,0,1,0,9,124
30001000200,3940,3500,172,9,48,25,0,17,440
30001000300,4192,3715,190,15,72,11,3,14,477
30003000100,4664,2109,347,2,1931,33,5,2,2555
30003940400,1780,161,66,5,1461,2,0,0,1619
30003940500,1431,485,29,0,864,2,1,1,946
30003940600,3078,316,44,4,2633,4,1,0,2762
30003940700,2171,336,29,0,1738,3,2,0,1835
30005000100,1493,855,55,0,482,5,0,12,638
30005000200,2306,1992,36,2,137,4,0,20,314
30005940100,1656,42,44,3,1544,0,0,1,1614
30005940200,1589,53,23,5,1458,4,0,2,1536
30007000100,2083,1866,79,2,18,0,0,2,217
30007000200,4691,4283,121,15,26,5,0,22,408
30009000100,2687,2449,62,6,27,1,0,8,238
30009000200,1763,1619,35,0,10,1,0,19,144
30009000300,2506,2267,71,7,29,16,0,13,239
30009000400,2209,2044,61,0,14,3,0,5,165
30009000500,1308,1224,32,0,17,0,0,0,84
30011000300,1415,1341,11,0,7,1,0,4,74
30013000100,2585,2066,126,57,69,31,2,31,519
30013000200,3558,2972,170,43,112,38,10,13,586
30013000300,3417,2639,176,40,270,24,9,25,778
30013000400,1717,1303,87,18,155,18,1,7,414
30013000700,2064,1407,115,41,285,26,7,14,657
30013000800,1735,1242,101,25,159,22,0,3,493
30013000900,3383,2509,159,36,340,30,4,16,874
30013001000,3371,2892,156,26,72,27,0,11,479
30013001100,4297,3526,177,55,168,58,12,35,771
30013001201,1794,1162,253,121,13,81,0,26,632
30013001202,2364,1319,525,213,15,72,16,21,1045
30013001600,4268,3327,186,33,332,23,4,31,941
30013001700,2051,1744,78,1,79,26,0,0,307
30013001800,3642,3139,142,25,84,35,6,15,503
30013001900,6669,5716,225,74,147,69,4,23,953
30013002100,5866,4619,276,86,329,105,11,43,1247
30013002201,3207,2698,114,16,150,22,3,12,509
30013002202,3459,2852,147,25,174,38,1,14,607
30013002301,5262,4594,183,37,72,73,3,17,668
30013002302,2420,2191,53,7,19,19,3,7,229
30013010100,3937,3276,132,12,190,14,3,25,661
30013010400,1801,1658,64,3,21,2,1,4,143
30013010600,3932,3617,76,9,36,10,0,27,315
30013010700,4836,4234,120,38,201,14,0,13,602
30013010800,2779,2092,171,44,233,31,5,8,687
30015010200,2110,1944,55,5,13,6,0,6,166
30015010300,3785,2228,104,5,1334,12,0,4,1557
30017961300,2059,1949,36,9,17,3,0,0,110
30017961500,1727,1525,62,13,40,4,1,0,202
30017961600,2344,2053,94,28,51,12,2,10,291
30017961800,1536,1400,42,5,20,10,3,1,136
30017961900,2029,1831,46,4,33,18,0,2,198
30017962000,2172,1943,82,12,31,5,1,0,229
30019020300,1661,1467,49,0,34,13,0,0,194
30021000100,1392,1305,15,1,3,2,0,13,87
30021000200,2753,2469,79,3,45,12,0,6,284
30021000300,4795,4195,194,34,118,43,1,11,600
30023000300,3022,2718,80,4,73,14,0,6,304
30023000400,3405,3124,99,13,38,13,0,4,281
30023000500,2994,2672,81,6,111,6,2,5,322
30025000100,3049,2858,63,5,27,5,2,1,191
30027030100,5080,4804,61,6,37,1,0,17,276
30027030201,3300,2967,82,8,62,19,0,8,333
30027030202,3066,2795,82,7,25,18,0,8,271
30029000101,954,871,27,0,12,2,0,1,83
30029000102,2519,2225,91,0,53,7,3,19,294
30029000201,5127,4598,137,3,39,15,10,16,529
30029000202,3007,2699,103,14,18,17,1,0,308
30029000203,4762,4195,159,18,53,17,11,33,567
30029000301,3096,2757,100,7,15,31,0,25,339
30029000302,1829,1678,50,8,6,16,0,3,151
30029000402,3226,2910,99,7,20,19,1,22,316
30029000403,2564,2372,63,1,14,12,0,21,192
30029000404,3483,3194,79,15,26,12,2,3,289
30029000601,5482,4957,161,14,34,55,1,15,525
30029000602,4198,3817,118,10,24,18,1,29,381
30029000700,6239,5477,215,15,94,48,13,11,762
30029000801,3155,2835,66,8,20,44,0,18,320
30029000802,6195,5520,214,19,51,53,3,27,675
30029000901,2167,1860,100,17,28,25,4,0,307
30029000902,2148,1905,81,11,16,22,1,13,243
30029000903,3588,3214,114,12,36,24,4,5,374
30029001000,2040,1752,93,9,53,29,4,11,288
30029001101,2677,2269,146,16,33,30,1,21,408
30029001102,3337,2948,101,17,33,38,0,7,389
30029001201,3149,2698,154,17,42,23,2,19,451
30029001202,4702,4124,140,8,62,27,2,25,578
30029001303,2044,1842,60,4,15,18,0,14,202
30029001304,1880,1708,73,4,17,1,0,9,172
30029001305,1533,1398,56,0,5,3,2,10,135
30029001306,4057,3718,123,6,14,18,4,6,339
30029001401,3051,2841,81,2,12,13,2,9,210
30029001402,3134,2866,97,0,19,19,1,21,268
30029001701,4622,4193,129,0,26,23,3,23,429
30029001702,2180,1994,52,6,19,11,0,11,186
30029001703,2212,1981,47,1,22,13,1,12,231
30031000101,6362,5723,254,15,22,34,3,31,639
30031000104,4057,3398,293,17,35,21,7,23,659
30031000105,4925,4179,371,18,58,42,2,31,746
30031000201,6119,5324,381,18,39,22,3,6,795
30031000202,5898,5205,300,10,47,51,5,29,693
30031000300,3583,3188,130,15,30,26,1,10,395
30031000400,5866,5242,205,6,17,22,5,23,624
30031000502,8247,7506,233,11,27,102,2,47,741
30031000504,2690,2464,74,4,13,14,2,21,226
30031000505,6750,5852,375,23,39,90,10,32,898
30031000506,6713,5836,307,39,42,144,7,35,877
30031000507,4551,3960,216,27,36,74,0,10,591
30031000600,2860,2397,186,21,52,21,3,14,463
30031000701,3399,2967,147,25,13,36,2,23,432
30031000703,2126,1803,144,3,42,15,2,13,323
30031000704,4338,3811,184,21,34,34,5,21,527
30031000800,2328,2074,60,17,27,37,3,11,254
30031000900,4176,3381,424,30,54,78,1,20,795
30031001001,3608,3301,86,11,5,29,2,0,307
30031001002,5113,4605,180,12,24,47,2,20,508
30031001101,5535,4395,315,69,199,258,10,20,1140
30031001102,5049,4398,228,28,32,111,6,26,651
30031001200,4972,4518,194,13,12,15,1,27,454
30031001500,1956,1530,288,17,4,20,2,9,426
30031001600,3396,2997,224,11,7,22,5,17,399
30031001700,4343,3949,96,12,12,24,0,30,394
30033000100,1173,1125,14,0,9,2,1,0,48
30035940200,5670,120,140,1,5262,3,0,0,5550
30035940400,4270,1007,49,10,2912,7,8,0,3263
30035976000,3782,2333,102,8,910,29,8,10,1449
30035980000,56,36,10,0,1,0,0,0,20
30037000100,823,724,35,7,1,0,1,11,99
30039961701,1354,1246,34,0,4,0,0,11,108
30039961702,1955,1820,51,0,20,3,0,2,135
30041040100,1342,1256,29,2,11,0,1,5,86
30041040200,1858,1708,24,1,35,3,1,2,150
30041040300,3692,2528,164,19,677,18,6,3,1164
30041040400,4461,3408,177,16,490,41,0,4,1053
30041040500,2485,2033,56,6,170,17,0,8,452
30041940300,2471,87,50,0,2288,0,0,2,2384
30043962201,4307,3927,109,6,19,23,0,6,380
30043962202,4315,3825,110,2,102,22,0,22,490
30043962300,3463,3174,72,7,40,4,0,15,289
30045000100,2023,1883,49,8,1,4,2,13,140
30047000100,1565,1452,36,0,7,11,0,7,113
30047000200,1750,1612,55,0,11,9,1,5,138
30047940304,1932,1426,84,7,248,9,0,6,506
30047940305,3730,2488,130,7,656,15,4,18,1242
30047940306,3010,2047,99,9,608,12,0,3,963
30047940307,3449,2553,133,13,424,12,0,5,896
30047940400,3993,1998,207,2,1396,15,6,18,1995
30047940500,5326,3002,222,14,1494,32,9,17,2324
30047940600,4321,2701,149,6,1089,10,1,23,1620
30047940700,2058,1094,53,6,699,13,0,6,964
30049000100,2165,1967,61,3,31,9,0,5,198
30049000200,5916,5099,250,15,90,42,0,52,817
30049000300,3026,2737,119,6,20,9,0,3,289
30049000400,6349,5567,227,22,112,29,12,19,782
30049000501,4415,3907,161,13,51,13,1,22,508
30049000503,4784,4250,177,15,59,75,3,15,534
30049000504,2862,2530,90,9,41,23,5,3,332
30049000600,2880,2613,59,8,38,19,0,14,267
30049000701,2151,1872,91,4,30,13,0,10,279
30049000702,5043,4394,177,36,80,45,1,31,649
30049000800,4089,3481,186,38,84,57,3,14,608
30049000900,3814,3129,233,40,149,28,1,12,685
30049001000,3988,3559,88,10,47,32,2,18,429
30049001101,3071,2637,146,9,64,48,1,12,434
30049001102,3887,3457,115,20,63,36,3,7,430
30049001201,7030,6040,229,10,179,47,10,29,990
30049001202,5503,4824,190,8,95,26,2,21,679
30051050100,1959,1856,13,2,10,6,0,6,103
30053000100,3389,3093,62,0,32,14,2,11,296
30053000200,2484,2211,78,2,33,29,5,7,273
30053000300,3899,3537,92,12,38,12,5,8,362
30053000401,3842,3486,98,9,46,15,0,33,356
30053000402,2628,2334,131,8,17,10,1,10,294
30053000500,3435,3064,100,1,38,20,0,17,371
30055954000,1729,1592,32,1,23,8,2,10,137
30057000101,2006,1849,39,5,6,6,0,6,157
30057000102,1949,1804,62,6,7,14,1,12,145
30057000200,2489,2294,74,0,8,4,3,9,195
30057000300,2179,2008,64,0,13,6,2,13,171
30059000100,1927,1781,46,12,4,2,0,8,146
30061964500,2306,2037,87,4,36,17,5,5,269
30061964600,2229,2007,60,6,27,4,0,13,222
30063000100,6262,5531,245,24,105,43,2,23,731
30063000203,4439,3684,196,37,153,37,15,19,755
30063000204,3970,3193,205,44,215,37,6,12,777
30063000205,6806,5889,246,21,121,132,7,20,917
30063000206,6924,5980,269,35,104,124,9,37,944
30063000300,2288,1930,120,22,51,31,7,3,358
30063000400,3131,2700,126,6,72,25,4,20,431
30063000501,3262,2330,478,16,162,74,9,15,932
30063000502,2896,1490,1269,18,20,25,2,0,1406
30063000700,2970,2487,131,43,85,28,3,20,483
30063000801,4148,3314,247,76,155,35,3,16,834
30063000802,2929,2476,118,19,78,30,1,27,453
30063000901,6103,5310,198,24,144,127,2,31,793
30063000902,2444,2188,57,4,57,18,0,14,256
30063001001,3905,3205,214,33,116,38,0,23,700
30063001002,1748,1458,61,39,43,32,4,14,290
30063001100,3105,2615,138,20,108,23,4,25,490
30063001200,4778,4121,167,64,94,61,1,17,657
30063001302,6593,5774,256,38,98,89,10,19,819
30063001303,5165,4385,197,36,184,62,7,20,780
30063001304,7202,6321,224,28,107,143,7,30,881
30063001401,3070,2704,97,9,53,16,6,4,366
30063001402,3786,3360,130,7,61,29,1,15,426
30063001501,2249,2048,54,8,30,15,0,3,201
30063001502,4791,4265,178,3,76,21,4,14,526
30063001601,4754,4114,174,15,75,89,3,27,640
30063001602,3336,3054,81,3,30,15,3,16,282
30063001801,1749,1221,40,7,375,6,2,1,528
30063001802,3119,2806,88,7,37,18,0,24,313
30065000100,2787,2550,76,4,37,10,3,11,237
30065000200,1943,1724,70,0,50,12,2,1,219
30067000100,1858,1734,39,5,5,3,0,9,124
30067000200,4844,4464,98,13,56,24,0,9,380
30067000300,3358,2986,125,13,34,18,0,8,372
30067000400,5668,5158,179,16,32,24,0,18,510
30067000500,1450,1285,68,14,15,6,0,7,165
30067980600,13,9,1,1,0,0,0,0,4
30069000100,496,466,5,0,0,0,0,0,30
30071060200,4217,3492,112,5,329,15,0,26,725
30073977000,3434,3139,65,4,53,14,5,7,295
30073977200,2464,1505,32,0,838,11,6,3,959
30075000100,1694,1529,35,5,31,0,0,10,165
30077000100,1382,1295,31,0,7,3,0,9,87
30077000200,5564,4721,130,64,395,20,3,8,843
30079000100,1088,982,33,2,13,7,0,0,106
30081000100,4260,3795,140,4,41,22,1,23,465
30081000201,3926,3573,138,5,33,13,0,10,353
30081000203,2355,2111,71,2,32,12,1,28,244
30081000204,5541,5000,195,6,41,25,4,38,541
30081000300,3077,2778,99,3,21,22,2,1,299
30081000401,2714,2512,111,4,7,6,4,7,202
30081000402,6233,5596,270,5,31,27,5,33,637
30081000501,1378,1269,37,1,7,9,1,11,109
30081000502,4736,4267,170,22,25,57,6,19,469
30081000601,1821,1640,59,4,2,11,1,28,181
30081000602,4947,4302,223,24,46,31,3,59,645
30081000700,2026,1793,50,2,27,3,0,55,233
30081000800,1160,1059,21,6,10,3,1,23,101
30083070100,1772,1572,70,6,22,11,1,6,200
30083070200,1820,1663,50,4,14,11,0,10,157
30083070301,3427,2819,244,27,69,54,4,15,608
30083070302,1557,1342,63,16,14,26,0,3,215
30083070400,2915,2496,178,8,46,19,0,12,419
30085080100,1938,1627,48,12,110,1,0,13,311
30085940001,4517,1394,108,17,2569,37,0,6,3123
30085940002,4339,566,83,3,3471,9,0,3,3773
30087000100,2183,2003,40,14,37,9,0,8,180
30087000200,1272,1053,40,4,118,4,0,8,219
30087000300,2096,1560,105,2,249,17,1,12,536
30087940400,2778,152,49,0,2504,2,1,0,2626
30089000100,3951,3531,123,2,42,14,3,20,420
30089000201,1988,1813,50,11,8,6,0,13,175
30089000202,4486,3999,117,6,49,16,0,27,487
30089940300,1975,1389,56,4,342,20,0,16,586
30091090200,2407,2181,68,7,31,10,0,2,226
30091090400,1132,989,39,7,30,3,0,1,143
30093000101,1861,1536,128,14,53,11,1,4,325
30093000102,2977,2407,221,25,122,20,8,9,570
30093000200,4781,4124,274,45,65,55,0,8,657
30093000300,2337,2055,122,5,31,14,2,32,282
30093000400,3997,3566,214,5,44,6,0,3,431
30093000500,4734,4330,161,7,37,42,2,10,404
30093000600,4727,4145,247,10,68,15,0,29,582
30093000700,3647,3325,112,8,25,32,0,17,322
30093000800,6072,5593,159,7,35,19,7,22,479
30095966400,3957,3558,130,4,36,14,0,2,399
30095966500,1925,1764,54,3,10,4,0,8,161
30095966600,3081,2788,85,6,39,4,0,23,293
30097967000,3678,3332,98,8,24,15,3,8,346
30099000100,1941,1800,30,4,28,2,0,11,141
30099000200,1934,1752,26,8,9,7,3,16,182
30099000300,2351,2103,29,7,64,6,3,11,248
30101000100,1135,1043,23,1,21,0,0,2,92
30101000200,3135,2725,110,14,89,36,0,18,410
30101980000,701,411,45,17,228,0,0,0,290
30103963500,762,688,31,1,15,3,1,0,74
30105100100,1599,1481,41,0,31,0,0,7,118
30105100500,2790,2456,62,7,123,9,0,12,334
30105940600,3189,2416,71,8,520,10,0,10,773
30107000100,2069,1850,68,3,11,3,0,7,219
30109000100,937,859,27,2,5,2,2,5,78
30111000200,3511,2513,299,67,361,22,1,19,998
30111000300,3832,2385,592,77,525,21,4,18,1447
30111000401,2762,2197,235,22,111,18,8,13,565
30111000402,3196,2450,230,51,261,17,8,29,746
30111000500,4333,3620,249,33,106,41,3,4,713
30111000600,3057,2630,130,34,57,30,3,33,427
30111000701,5459,4686,280,29,164,49,2,22,773
30111000704,3871,3299,208,38,103,22,0,4,572
30111000705,3860,3130,248,46,175,21,2,22,730
30111000706,5073,3894,380,53,337,53,13,21,1179
30111000707,5917,4956,373,40,139,40,4,19,961
30111000708,2487,1792,265,11,238,8,1,6,695
30111000800,4418,3599,282,28,198,15,2,22,819
30111000901,4756,3801,417,21,210,34,1,12,955
30111000902,5415,3584,730,122,598,15,4,21,1831
30111001000,4551,3423,488,46,272,33,4,9,1128
30111001100,5437,4444,362,36,220,43,9,7,993
30111001200,2946,2466,120,17,86,48,16,15,480
30111001300,6482,5650,285,47,148,36,5,22,832
30111001402,6891,6045,300,32,102,53,6,25,846
30111001403,7509,6623,307,27,130,42,4,22,886
30111001404,8681,7576,352,62,192,103,3,34,1105
30111001501,4725,4232,128,10,90,16,0,19,493
30111001502,4341,3808,219,8,65,13,3,15,533
30111001702,4352,3508,315,30,169,46,31,6,844
30111001703,5371,4294,319,39,350,73,19,15,1077
30111001704,4719,3833,374,42,194,55,0,23,886
30111001801,7313,6572,258,14,62,122,5,23,741
30111001803,2067,1783,96,26,46,19,9,9,284
30111001804,3159,2662,183,18,57,32,28,17,497
30111001805,3534,3226,104,7,36,32,5,14,308
30111001806,2654,2283,142,12,76,24,4,0,371
30111001901,4920,4370,204,19,65,33,0,17,550
30111001902,4385,3848,215,8,75,22,0,5,537
30111940001,5125,4127,293,7,427,15,2,10,998
30111940002,3622,3205,133,8,101,13,2,4,417
31001965400,4534,4193,172,6,11,22,0,10,341
31001965500,4338,3680,369,21,20,90,3,11,658
31001965600,5499,4427,750,83,17,54,2,10,1072
31001965700,1284,919,272,27,8,21,0,5,365
31001965800,2368,1787,401,11,20,54,0,5,581
31001965900,4441,3890,298,20,7,87,4,12,551
31001966000,4642,3430,892,54,29,66,0,12,1212
31001966100,1854,1282,470,23,2,18,0,0,572
31001966200,2245,2171,35,2,5,3,0,2,74
31003979600,2023,1934,47,3,1,2,0,0,89
31003979700,1683,1543,94,4,8,9,0,0,140
31003979800,2589,2422,80,15,7,11,0,3,167
31005958300,434,400,12,3,0,0,0,0,34
31007954000,674,600,51,0,5,2,0,0,74
31009972400,431,397,11,1,0,1,0,0,34
31011960100,3448,3216,135,8,7,3,0,6,232
31011960200,1931,1841,48,13,8,4,0,0,90
31013951100,2217,2027,80,4,13,5,0,5,190
31013951200,4736,3787,544,31,138,52,0,3,949
31013951300,3889,2867,622,31,142,14,0,9,1022
31015975800,1810,1723,33,0,11,0,0,4,87
31017975000,2903,2629,176,2,7,6,0,2,274
31019968900,3762,3540,115,20,3,11,1,7,222
31019969000,4722,4432,152,8,12,7,0,10,290
31019969100,4785,3656,986,17,6,5,2,6,1129
31019969202,3408,3020,184,43,4,51,0,6,388
31019969203,6707,6022,355,38,8,87,1,12,685
31019969204,6052,5268,405,97,16,94,5,16,784
31019969300,2348,1696,523,21,8,23,0,4,652
31019969400,3993,3344,408,54,18,37,8,9,649
31019969500,2222,1789,295,31,6,20,1,2,433
31019969600,5460,3995,807,159,38,264,14,13,1465
31019969700,6625,5346,832,112,30,61,1,9,1279
31021963200,2222,1993,79,11,30,15,8,4,229
31021963300,2552,2439,28,2,8,10,0,3,113
31021963400,1948,1765,65,6,34,10,9,2,183
31023967600,3210,2957,168,4,10,1,1,10,253
31023967700,3166,2785,265,13,12,6,0,10,381
31023967800,1993,1884,49,11,0,2,0,3,109
31025965600,3770,3325,232,21,18,15,2,15,445
31025965700,5557,5157,160,21,8,26,0,9,400
31025965800,3196,2986,66,5,21,11,0,10,210
31025965900,5002,4625,148,23,15,12,2,18,377
31025966000,4518,4133,142,17,15,19,2,15,385
31025966100,4555,4035,240,15,10,20,2,24,520
31027977100,4458,4299,84,10,1,2,1,3,159
31027977200,3922,3711,102,15,12,7,1,0,211
31029961900,3893,3209,562,20,2,11,0,2,684
31031955800,4113,3493,105,10,263,7,0,5,620
31031955900,1342,1279,43,1,8,0,0,2,63
31033954800,3008,2795,106,7,7,0,0,10,213
31033954900,3714,3133,397,29,17,7,0,18,581
31033955000,2746,2311,248,15,5,68,0,11,435
31035962100,3464,2906,441,6,8,9,0,11,558
31035962200,2640,2466,82,2,5,1,0,3,174
31037964600,2212,2060,103,5,7,5,1,1,152
31037964700,1529,1338,101,55,0,5,0,3,191
31037964800,6841,1620,4789,315,19,40,1,12,5221
31039972700,2551,2341,142,1,0,0,2,5,210
31039972800,4349,3365,892,12,7,8,1,12,984
31039972900,2113,1932,78,8,19,10,6,6,181
31041971700,2517,2382,59,14,1,2,0,3,135
31041971800,2767,2617,78,6,2,3,0,1,150
31041971900,3874,3476,229,25,18,11,2,10,398
31041972000,1387,1329,22,3,11,3,0,0,58
31043010101,4101,832,2398,563,118,58,51,3,3269
31043010102,2947,878,1152,621,75,100,17,7,2069
31043010200,6870,2435,3511,376,129,211,67,5,4435
31043010300,4508,2412,1566,35,135,202,15,12,2096
31043010400,3156,2790,184,8,69,31,4,6,366
31045950600,2634,2436,81,3,30,8,0,3,198
31045950700,5565,4507,247,161,292,45,6,18,1058
31047968000,2514,2026,408,8,8,5,0,14,488
31047968100,1376,1160,168,6,1,9,0,1,216
31047968200,3703,3350,204,11,11,9,0,15,353
31047968300,4084,3241,622,20,9,48,23,11,843
31047968400,5436,1107,3756,454,8,62,6,6,4329
31047968500,5549,1383,3337,681,6,58,12,13,4166
31047968600,1449,1262,148,7,1,1,0,0,187
31049955400,1838,1686,100,1,7,6,0,7,152
31051977600,2390,2279,40,14,7,3,0,0,111
31051977800,3216,2364,756,3,12,14,0,8,852
31053963600,4738,4313,263,15,15,13,3,6,425
31053963700,2599,2407,118,5,3,6,0,8,192
31053963800,5298,4365,737,20,16,28,0,3,933
31053963900,3844,2856,814,22,16,17,0,7,988
31053964000,3425,2680,548,44,16,21,6,16,745
31053964100,4939,4404,362,15,6,36,0,6,535
31053964200,4154,2991,880,53,34,20,0,15,1163
31053964300,4960,3894,825,41,15,32,3,20,1066
31053964400,3210,1591,1536,0,12,10,0,12,1619
31055000200,3627,1946,353,978,40,47,6,38,1681
31055000300,2518,621,461,1178,23,28,1,13,1897
31055000400,1849,926,697,106,21,26,0,1,923
31055000500,3411,2077,461,630,53,77,7,10,1334
31055000600,1461,266,249,799,25,10,0,7,1195
31055000700,1214,151,218,718,12,31,1,20,1063
31055000800,2175,246,328,1205,23,263,6,13,1929
31055001100,2724,316,384,1776,26,61,1,19,2408
31055001200,3917,773,489,2121,39,248,0,59,3144
31055001600,3800,2605,300,273,10,360,14,23,1195
31055001800,5209,3438,518,788,48,188,6,23,1771
31055001900,1888,849,400,325,28,140,4,7,1039
31055002000,3647,706,2729,81,25,16,3,8,2941
31055002100,2387,880,1181,201,20,10,3,7,1507
31055002200,1197,808,242,33,10,19,0,11,389
31055002300,2335,1426,654,82,8,31,0,8,909
31055002400,3928,986,2656,147,14,18,0,7,2942
31055002500,2684,1032,1496,43,17,11,0,14,1652
31055002600,2433,454,1830,61,6,9,0,12,1979
31055002700,2667,453,1972,124,19,2,3,15,2214
31055002800,3730,701,2826,101,27,12,0,8,3029
31055002900,5582,836,3326,1137,52,24,0,53,4746
31055003000,7656,2238,4921,195,44,45,1,14,5418
31055003100,4128,1390,2324,236,27,16,1,3,2738
31055003200,2567,401,1933,151,24,9,1,1,2166
31055003300,2356,540,1531,177,22,9,0,13,1816
31055003401,3810,1945,1459,182,21,52,0,14,1865
31055003402,2487,1676,585,88,5,22,1,14,811
31055003500,4490,3024,984,197,28,69,2,11,1466
31055003600,4060,3339,344,94,11,73,3,0,721
31055003700,2361,1966,206,39,2,28,0,0,395
31055003800,3891,2209,1112,350,21,28,3,16,1682
31055003900,2378,819,1186,221,33,34,1,10,1559
31055004000,3299,1962,554,424,43,153,5,21,1337
31055004200,1412,800,359,110,12,57,1,2,612
31055004300,3086,2002,301,206,14,431,1,12,1084
31055004400,1323,1005,174,52,7,26,0,5,318
31055004500,3175,2649,220,78,16,70,2,11,526
31055004600,2373,1855,93,84,10,223,1,7,518
31055004700,3047,2602,152,58,10,101,1,8,445
31055004800,4315,2944,304,445,21,363,0,11,1371
31055004900,4665,2433,569,884,60,432,11,26,2232
31055005000,3675,2330,523,430,28,185,6,15,1345
31055005100,2406,1001,435,727,23,86,2,16,1405
31055005200,1770,209,350,823,6,312,2,14,1561
31055005300,2445,415,487,1246,19,143,2,8,2030
31055005400,3349,996,576,1213,38,261,2,41,2353
31055005500,5323,4003,333,373,7,257,5,35,1320
31055005600,3972,2845,305,412,22,105,0,27,1127
31055005700,4422,2419,414,862,38,314,6,47,2003
31055005800,4817,1849,476,1369,24,759,8,32,2968
31055005901,2375,530,416,1188,28,66,0,24,1845
31055005902,2431,254,483,1382,17,145,1,17,2177
31055006000,4076,773,638,2159,33,198,5,20,3303
31055006101,2632,474,220,1493,19,269,0,11,2158
31055006102,4267,992,511,2143,35,298,0,23,3275
31055006202,4854,2171,496,1666,57,77,3,34,2683
31055006301,2741,899,142,1307,25,221,1,17,1842
31055006302,4752,840,262,2053,25,1369,2,17,3912
31055006303,3206,1104,280,1035,23,534,0,15,2102
31055006400,4869,3510,522,444,36,118,1,18,1359
31055006503,2707,1979,197,303,11,80,0,1,728
31055006504,3293,2467,187,347,18,79,2,8,826
31055006505,1932,1100,102,386,14,223,4,19,832
31055006506,4035,1369,181,1390,31,853,5,11,2666
31055006603,2612,1439,274,631,24,69,0,16,1173
31055006604,4033,2864,338,486,17,82,4,17,1169
31055006605,3201,2452,174,224,11,186,0,15,749
31055006606,2901,1965,243,344,14,180,0,10,936
31055006701,3901,3197,211,136,10,200,1,6,704
31055006703,3046,2332,265,181,26,87,3,26,714
31055006704,1872,1610,65,41,1,118,0,2,262
31055006803,2031,1691,145,73,1,33,7,9,340
31055006804,1636,1448,41,12,1,45,2,15,188
31055006805,3270,2981,79,34,1,66,0,8,289
31055006806,2400,1689,156,201,5,248,6,15,711
31055006903,2532,2054,237,121,5,25,1,7,478
31055006904,4049,3488,230,94,11,71,0,5,561
31055006905,1867,1506,155,70,15,23,6,6,361
31055006906,3228,2555,291,127,4,59,3,23,673
31055007001,5425,3445,811,470,20,412,9,45,1980
31055007002,3491,2407,703,177,18,50,2,10,1084
31055007003,2477,1318,977,66,9,11,0,16,1159
31055007101,3386,1748,1411,69,23,31,10,16,1638
31055007102,3680,2030,1395,60,30,29,4,9,1650
31055007303,3037,2713,96,68,5,22,1,15,324
31055007304,1396,1100,59,130,5,22,0,4,296
31055007309,4472,2898,496,561,13,162,3,9,1574
31055007310,2809,1863,185,449,12,82,2,5,946
31055007311,3391,1636,285,1110,20,136,14,9,1755
31055007312,2378,1329,158,689,11,61,0,19,1049
31055007314,4932,3931,265,283,25,198,0,29,1001
31055007315,5587,4343,229,331,12,412,1,15,1244
31055007316,4085,3216,186,268,1,212,5,6,869
31055007317,5227,4081,313,434,19,131,2,6,1146
31055007318,9594,8402,313,253,13,243,1,38,1192
31055007319,5348,2233,502,1349,22,945,0,22,3115
31055007320,3693,1783,330,799,10,550,1,20,1910
31055007406,5228,4336,352,110,23,152,0,7,892
31055007407,3323,2585,354,172,13,79,4,16,738
31055007408,4398,3234,491,248,35,141,3,13,1164
31055007409,2383,1903,165,87,11,97,0,6,480
31055007424,3128,2123,236,351,4,217,3,15,1005
31055007429,3331,2972,137,43,5,63,0,4,359
31055007431,4505,3703,192,252,9,126,0,14,802
31055007432,3267,2077,631,275,17,77,1,11,1190
31055007433,4273,2884,364,675,12,124,7,18,1389
31055007434,3291,1987,285,683,23,74,3,18,1304
31055007435,3577,2381,308,458,27,175,2,27,1196
31055007436,4548,2813,289,864,27,273,7,12,1735
31055007438,2034,1678,95,57,3,51,0,11,356
31055007439,4675,3605,263,345,24,192,2,10,1070
31055007440,2409,1422,178,404,6,257,2,4,987
31055007441,2690,2264,106,57,0,167,0,8,426
31055007442,4877,4175,241,99,5,129,6,18,702
31055007443,3420,2886,131,154,3,139,0,6,534
31055007444,4810,2962,376,610,18,563,1,18,1848
31055007445,2491,1673,119,509,5,60,0,6,818
31055007446,4067,3592,136,48,4,159,0,8,475
31055007447,2828,2346,191,50,7,99,0,5,482
31055007448,2889,2630,103,30,9,34,1,11,259
31055007449,3243,2885,79,23,10,126,4,9,358
31055007450,3470,2914,214,90,6,63,2,15,556
31055007451,5770,4597,446,104,21,356,0,6,1173
31055007452,5089,4463,211,45,5,158,4,14,626
31055007453,3254,2788,161,34,8,85,1,30,466
31055007454,4746,4066,257,95,9,106,2,11,680
31055007455,1975,1437,291,66,13,67,1,15,538
31055007456,2424,1840,297,87,7,56,2,8,584
31055007457,2829,2003,422,157,11,100,1,17,826
31055007458,3146,1825,811,209,11,143,8,8,1321
31055007459,3397,2589,443,116,27,61,1,12,808
31055007460,4334,3724,185,32,5,231,0,13,610
31055007461,6232,5065,360,105,16,433,6,27,1167
31055007462,4789,3843,444,136,11,70,25,19,946
31055007463,4452,3400,497,215,16,69,3,21,1052
31055007464,3182,2614,206,145,11,60,25,10,568
31055007465,4506,3117,544,176,12,483,2,5,1389
31055007466,5826,4259,748,372,20,189,7,9,1567
31055007467,5032,3311,947,402,12,147,6,18,1721
31055007468,2392,1786,406,91,9,29,0,6,606
31055007469,4565,3632,205,209,15,274,0,10,933
31055007470,6242,4465,402,452,10,524,2,24,1777
31055007471,3865,3017,153,244,4,270,0,13,848
31055007472,4345,3676,186,149,1,140,1,20,669
31055007473,410,232,51,99,14,5,2,0,178
31055007474,1547,1234,43,21,0,168,3,0,313
31055007504,3575,3235,119,34,19,19,1,11,340
31055007505,4842,4314,174,49,13,101,0,9,528
31055007506,3407,2886,209,41,11,99,1,4,521
31055007508,2735,2503,91,21,8,28,2,6,232
31055007509,7388,6712,170,48,7,200,2,18,676
31055007514,4448,3955,131,33,2,187,2,10,493
31055007515,5331,4417,197,65,3,413,3,27,914
31055007516,4727,4052,177,68,5,238,1,11,675
31055007517,7409,6162,369,161,8,347,5,9,1247
31055007518,4560,3949,204,45,9,150,2,15,611
31055007519,6043,5019,227,81,5,446,1,17,1024
31055007520,4742,3771,172,118,3,504,0,7,971
31055007521,4078,3116,248,121,11,405,2,8,962
31055007522,1798,1476,69,10,1,141,0,13,322
31055007523,2839,2549,76,27,0,103,3,6,290
31055007524,4502,3727,200,59,6,326,0,15,775
31057962300,1654,1491,103,7,9,1,3,4,163
31059091600,2147,2034,62,7,6,6,0,0,113
31059091700,3404,3147,115,13,13,7,1,0,257
31061964600,1235,1171,33,3,1,4,0,2,64
31061964700,1654,1570,49,3,2,10,0,2,84
31063961100,2519,2337,81,17,6,0,3,4,182
31065963900,4636,4235,220,9,19,6,0,4,401
31067964600,2862,2759,47,1,0,3,0,6,103
31067964700,3461,3287,43,2,17,5,0,12,174
31067964800,3679,3363,147,26,18,23,0,8,316
31067964900,3771,3436,129,32,7,31,1,1,335
31067965000,3474,3138,126,33,12,25,0,2,336
31067965100,1943,1699,103,20,11,12,0,13,244
31067965200,2514,2371,40,8,13,0,0,1,143
31069952100,1874,1722,88,3,3,2,1,10,152
31071973200,1813,1752,24,3,0,0,0,1,61
31073967600,1893,1746,95,2,4,11,0,0,147
31075956300,611,576,12,5,12,1,0,1,35
31077970900,2188,2098,52,1,3,6,1,10,90
31079000100,2467,2288,114,8,4,6,0,5,179
31079000200,5033,1559,3300,70,8,34,2,5,3474
31079000300,6371,2460,3616,97,21,37,4,24,3911
31079000400,5286,3355,1566,106,13,99,0,18,1931
31079000500,6398,5334,731,63,15,107,0,6,1064
31079000600,6454,4814,1241,130,19,102,0,12,1640
31079000700,4697,2777,1379,320,24,62,7,31,1920
31079000800,3164,2283,675,41,18,33,0,10,881
31079000900,5296,2506,2247,315,38,41,4,14,2790
31079001000,4818,2446,1725,445,14,48,6,21,2372
31079001100,4484,2411,1705,138,23,79,0,14,2073
31079001200,3608,3000,398,71,7,34,0,14,608
31079001300,2904,2630,194,6,8,2,0,6,274
31079001400,1915,1557,290,5,3,4,2,7,358
31081969100,1944,1848,38,6,4,0,0,7,96
31081969200,2559,2402,83,0,9,3,0,6,157
31081969300,4926,4546,199,21,17,11,0,6,380
31083964200,3073,2907,90,1,5,11,0,0,166
31085961500,856,760,63,0,4,2,0,0,96
31087962700,2616,2462,87,0,0,2,4,1,154
31089974000,1510,1443,46,1,6,2,0,0,67
31089974100,2435,2368,34,7,7,2,0,0,67
31089974200,1982,1851,62,8,8,11,0,7,131
31089974300,4200,3663,379,25,17,35,1,5,537
31091956700,711,663,11,4,1,1,0,0,48
31093970500,1813,1723,44,5,5,1,0,0,90
31093970600,4662,4431,102,8,9,11,1,8,231
31095963600,2951,2799,61,3,2,4,0,5,152
31095963700,2959,2653,189,9,11,4,0,9,306
31095963800,1330,1106,111,8,27,7,0,6,224
31097967500,1944,1850,59,0,0,4,0,2,94
31097967600,3346,2251,570,311,52,72,0,6,1095
31099966600,3453,3221,120,0,8,6,0,5,232
31099966700,3235,2843,265,3,6,6,2,6,392
31101000100,1619,1306,207,10,1,15,2,1,313
31101000200,3306,2831,367,5,11,10,3,11,475
31101000300,3410,3095,176,0,7,13,2,4,315
31103975400,769,734,20,0,1,0,0,0,35
31105954500,3434,3026,262,1,24,15,0,9,408
31107976200,2886,2655,44,8,70,12,1,3,231
31107976300,2311,2115,83,3,44,5,2,4,196
31107976400,3194,2197,58,5,829,11,0,6,997
31109000100,3410,2737,314,89,12,28,0,16,673
31109000201,4670,3899,312,110,17,64,0,16,771
31109000202,4250,3094,437,288,37,152,5,12,1156
31109000300,3491,2470,360,226,35,116,1,18,1021
31109000400,4991,2916,677,622,67,310,3,18,2075
31109000500,2292,1625,194,218,29,98,0,15,667
31109000600,6828,5384,574,234,21,360,0,240,1444
31109000700,2498,1148,258,256,23,693,2,10,1350
31109000800,3597,1977,766,335,81,152,0,23,1620
31109000900,3735,2780,314,196,17,256,5,29,955
31109001001,3313,2600,269,150,7,79,3,9,713
31109001002,1658,1200,156,84,6,139,5,1,458
31109001003,3590,2612,427,124,24,183,3,19,978
31109001101,4674,3980,252,100,16,94,6,12,694
31109001102,3417,2916,173,69,12,77,3,17,501
31109001200,6546,5339,419,188,17,221,0,23,1207
31109001301,3665,3237,157,51,18,76,3,5,428
31109001302,3060,2681,138,60,12,62,1,6,379
31109001400,4833,3928,357,133,22,126,9,19,905
31109001500,4458,3621,302,139,18,153,0,42,837
31109001600,5603,4454,444,201,47,87,13,18,1149
31109001700,5207,2756,880,507,59,684,0,19,2451
31109001800,2136,1139,382,198,28,241,2,13,997
31109001900,1841,1518,86,45,10,102,2,22,323
31109002001,2473,1420,381,338,27,149,0,16,1053
31109002002,2405,1264,510,328,31,131,3,13,1141
31109002100,2578,1438,719,118,18,148,0,5,1140
31109002200,5550,3557,843,477,55,265,0,23,1993
31109002300,6053,4510,488,343,63,259,6,30,1543
31109002400,3541,3066,178,133,31,36,0,8,475
31109002500,5417,4589,294,134,22,85,10,17,828
31109002701,3017,2311,352,93,23,41,14,36,706
31109002702,5714,4804,304,176,25,135,4,21,910
31109002800,5226,4301,326,184,14,132,0,30,925
31109002900,5603,4000,596,309,43,333,0,27,1603
31109003002,3264,2282,399,232,21,142,1,6,982
31109003003,5185,3227,845,508,31,302,0,11,1958
31109003004,2958,2187,114,84,8,425,0,10,771
31109003005,4809,3242,272,311,6,751,0,4,1567
31109003102,6051,4992,367,170,17,242,0,11,1059
31109003103,2730,1568,608,221,27,138,1,14,1162
31109003104,6093,3696,1392,282,52,294,6,27,2397
31109003202,3054,2069,414,207,52,17,4,13,985
31109003301,4237,3103,434,243,24,214,5,30,1134
31109003302,5056,3561,617,393,63,147,4,24,1495
31109003401,6499,4585,719,450,119,347,0,15,1914
31109003402,6698,4492,810,508,14,480,8,22,2206
31109003500,204,152,6,38,0,5,1,2,52
31109003601,1361,658,177,459,51,13,1,0,703
31109003604,3702,3306,159,17,2,101,0,2,396
31109003605,3644,2973,239,160,18,65,1,7,671
31109003607,4585,3604,249,140,7,388,3,13,981
31109003608,1389,1179,83,33,1,30,0,12,210
31109003609,2529,2210,85,31,0,115,0,11,319
31109003704,5233,4205,378,193,25,112,2,21,1028
31109003708,4248,3693,161,52,15,142,1,14,555
31109003709,4910,4295,240,91,15,95,0,17,615
31109003713,2929,2528,86,51,1,150,0,32,401
31109003714,5111,4506,175,41,5,164,0,8,605
31109003715,2368,2082,56,53,1,83,2,5,286
31109003716,5011,4170,227,119,8,274,1,8,841
31109003718,3142,2830,61,25,9,135,0,0,312
31109003719,6135,5307,255,122,7,254,2,9,828
31109003721,4245,3658,207,45,9,184,0,2,587
31109003722,1864,1621,108,19,3,24,0,10,243
31109003723,3545,3091,136,39,9,96,6,16,454
31109003724,4275,3740,126,34,9,226,0,1,535
31109003725,3392,2955,111,33,0,153,0,10,437
31109003726,2819,2386,105,47,4,183,1,0,433
31109003727,2651,2250,116,45,7,145,0,5,401
31109003728,4397,3709,166,142,9,164,3,24,688
31109003801,4797,4220,177,87,6,104,0,14,577
31109003802,3210,2794,173,67,7,31,0,0,416
31109010100,7176,6705,168,30,13,51,0,18,471
31109010202,4821,4450,128,33,12,52,2,14,371
31109010203,1716,1518,43,19,0,77,1,5,198
31109010204,4567,3280,380,174,6,527,7,11,1287
31109010300,4581,4256,120,17,15,21,0,16,325
31109010401,4830,4546,115,23,4,12,2,1,284
31109010402,5239,4805,196,25,8,33,2,8,434
31109983200,8,5,2,0,0,0,0,0,3
31111959700,3483,3226,120,6,2,9,1,3,257
31111959800,3155,2856,208,4,7,3,0,4,299
31111959900,5150,4076,721,61,50,32,1,28,1074
31111960200,4119,3224,593,73,34,37,4,8,895
31111960300,4292,3570,430,40,10,38,0,24,722
31111960400,5471,4789,447,34,14,39,0,3,682
31111960500,5043,4344,279,144,21,127,0,8,699
31111960600,3963,3558,213,20,9,40,0,33,405
31113957500,716,665,23,0,0,4,0,0,51
31115972800,607,565,18,0,0,1,0,0,42
31117957900,399,378,3,0,4,2,0,1,21
31119960600,6155,5030,677,95,61,71,0,32,1125
31119960700,3132,2214,590,89,77,31,0,14,918
31119960801,4987,4251,454,32,36,78,0,14,736
31119960802,3562,3267,150,13,21,38,1,1,295
31119960900,4473,3138,1005,62,75,46,1,14,1335
31119961000,3013,1997,766,66,42,20,0,15,1016
31119961100,1850,1257,485,20,12,24,0,2,593
31119961200,3637,3447,76,8,25,8,2,13,190
31119961300,4776,3222,1311,19,17,129,3,13,1554
31121966600,1779,1632,66,10,3,7,1,0,147
31121966700,2468,2217,167,8,5,0,2,0,251
31121966800,3421,3092,139,23,17,22,0,0,329
31123952500,4555,3722,648,19,38,20,0,11,833
31125966100,3380,3202,60,4,8,5,0,1,178
31127968100,3412,3114,105,54,15,8,0,9,298
31127968200,3662,3424,103,2,12,23,0,4,238
31129960000,2130,2009,61,0,0,2,0,12,121
31129960100,1965,1826,57,4,4,1,0,2,139
31131966600,2068,1901,75,3,7,7,0,1,167
31131966700,3213,3010,71,13,6,4,0,7,203
31131966800,3097,2882,70,7,2,15,0,2,215
31131966900,4596,3735,601,35,13,46,0,15,861
31131967000,2938,2339,445,24,8,14,0,10,599
31133967800,2544,2446,39,4,7,0,1,3,98
31135959300,2858,2620,146,10,3,3,3,2,238
31137967000,2677,2401,202,11,7,8,0,6,276
31137967100,3303,3015,176,15,7,11,0,6,288
31137967200,2988,2724,173,8,6,9,1,12,264
31139979100,3930,3745,69,11,11,3,1,3,185
31139979200,3387,3205,73,19,6,9,1,11,182
31141965100,3651,3529,51,1,3,4,0,4,122
31141965298,3335,3128,94,6,6,10,5,7,207
31141965301,3100,2499,453,38,8,11,0,11,601
31141965302,5493,4248,1001,60,13,67,1,12,1245
31141965400,5029,2964,1899,33,7,29,0,12,2065
31141965500,5701,4014,1343,108,20,41,0,29,1687
31141965600,4531,2841,1486,52,29,16,3,16,1690
31141965700,3456,2360,925,48,12,20,0,10,1096
31143960000,2069,1963,37,2,6,1,1,7,106
31143960100,3145,2788,222,6,8,1,0,3,357
31145963100,2478,2342,75,5,7,4,0,0,136
31145963200,5003,4399,334,88,24,18,6,5,604
31145963300,3221,2795,278,19,6,17,6,9,426
31147964500,1703,1541,46,2,58,1,0,2,162
31147968500,1754,1652,24,0,22,2,0,3,102
31147968600,4414,3903,85,13,143,32,0,6,511
31149974600,1262,1219,20,3,1,0,0,2,43
31151960601,4242,2127,1727,79,15,136,44,12,2115
31151960602,3463,1442,1822,11,7,107,1,8,2021
31151960700,2045,1781,191,17,0,10,0,5,264
31151960800,1416,1316,52,0,5,3,1,0,100
31151960900,3126,2697,275,23,14,21,0,0,429
31153010103,4709,3725,418,170,4,69,11,19,984
31153010104,2175,1309,599,110,14,24,4,1,866
31153010105,3058,2185,408,213,16,71,0,13,873
31153010106,4394,3019,483,300,34,225,17,27,1375
31153010107,3995,2378,1032,218,13,121,6,17,1617
31153010108,4073,2428,795,440,28,106,14,3,1645
31153010203,5626,4415,459,229,19,132,3,16,1211
31153010204,3495,2390,446,318,14,66,6,16,1105
31153010205,3436,2536,337,186,7,86,12,28,900
31153010206,4067,2928,374,301,1,117,5,27,1139
31153010207,2408,1733,233,140,11,93,4,7,675
31153010208,4374,3421,309,232,20,116,8,25,953
31153010209,3426,2643,258,181,12,62,3,12,783
31153010302,841,502,114,105,2,36,1,12,339
31153010305,1792,1089,293,166,4,27,17,7,703
31153010306,2737,1756,385,213,18,68,12,7,981
31153010401,2991,1855,640,190,10,53,3,17,1136
31153010402,3669,2701,475,124,22,73,2,26,968
31153010502,4479,2822,1232,130,13,46,2,27,1657
31153010503,3519,2214,1005,94,12,48,0,13,1305
31153010504,3160,1975,547,223,9,164,9,18,1185
31153010505,3846,2082,1348,151,13,47,0,8,1764
31153010614,5131,3599,708,304,17,184,4,24,1532
31153010615,1944,1458,233,57,8,81,3,8,486
31153010616,4474,3794,252,91,2,142,2,12,680
31153010617,5347,4482,358,136,18,62,0,29,865
31153010619,4239,3287,293,278,14,63,6,16,952
31153010620,6314,5120,508,188,16,150,0,41,1194
31153010621,5862,4425,706,310,15,124,6,29,1437
31153010622,3773,3073,246,94,8,150,1,21,700
31153010623,5822,4792,504,74,16,139,7,19,1030
31153010624,6552,5254,454,252,14,144,7,16,1298
31153010625,5183,4239,346,162,9,121,27,26,944
31153010626,5591,4711,363,96,11,176,0,17,880
31153010627,3219,2754,228,48,3,87,0,0,465
31153010629,3765,3156,262,71,4,115,3,7,609
31153010630,6442,5572,250,77,3,230,1,11,870
31153010631,5160,4831,130,9,12,30,2,9,329
31153010632,6663,5991,286,42,4,37,4,4,672
31153010633,3258,2614,302,67,16,64,3,14,644
31153010634,2756,2327,197,68,6,32,0,4,429
31153010635,2856,2357,131,50,8,170,0,8,499
31153010636,5347,4808,192,39,8,93,0,15,539
31153010637,3956,2924,379,144,2,323,0,11,1032
31153010638,4400,3549,375,108,6,134,6,7,851
31153010701,2559,2384,61,7,13,13,2,13,175
31153010702,3721,3457,101,26,24,12,1,9,264
31155968100,3329,3132,71,11,4,12,0,17,197
31155968200,5282,5030,76,11,11,15,0,21,252
31155968300,5230,4814,207,19,22,16,1,13,416
31155968400,4883,4548,117,16,16,22,0,8,335
31155968500,3554,3179,114,15,24,21,4,12,375
31157952900,2731,2215,409,5,13,4,2,4,516
31157953000,3017,2372,493,0,9,22,0,9,645
31157953100,2232,1805,322,2,15,19,1,3,427
31157953200,1566,1413,119,2,0,7,0,2,153
31157953300,3407,2610,562,48,29,84,0,5,797
31157953400,3166,2618,354,54,15,25,5,11,548
31157953500,2959,1897,846,23,57,27,0,6,1062
31157953600,2972,2018,777,10,39,20,4,5,954
31157953700,3812,1290,2260,16,136,10,6,12,2522
31157953800,4890,3390,1159,52,72,32,5,19,1500
31157953900,5332,4083,902,22,81,27,2,24,1249
31159960100,4470,4265,71,4,7,12,1,8,205
31159960200,2540,2288,110,25,3,10,3,11,252
31159960300,5492,5090,183,47,15,22,0,5,402
31159960400,5107,4739,132,26,19,13,2,20,368
31161951600,2081,1579,115,6,248,14,2,3,502
31161951700,3046,2516,107,9,274,15,0,7,530
31163970100,2959,2774,82,0,16,5,2,1,185
31165950100,1135,1055,43,0,2,4,2,4,80
31167962100,1445,1357,48,0,0,5,4,2,88
31167962200,4397,3858,304,22,27,13,3,9,539
31169963100,2657,2519,71,5,2,1,2,0,138
31169963200,2377,2250,65,5,7,9,3,3,127
31171957100,669,623,29,0,3,0,0,0,46
31173940100,4181,1824,166,6,2113,8,3,9,2357
31173940200,2592,620,94,18,1784,0,1,7,1972
31175971300,1728,1653,30,0,0,1,0,5,75
31175971400,2331,2165,86,15,4,4,5,6,166
31177050101,3134,2895,99,6,6,18,0,4,239
31177050102,5322,4789,262,26,2,41,1,10,533
31177050201,4557,4326,89,13,5,19,0,7,231
31177050202,3419,3180,85,19,8,13,0,14,239
31177050300,4433,4169,84,6,4,9,0,7,264
31179978600,3482,3165,215,9,12,4,0,1,317
31179978700,6215,4663,776,341,16,118,8,60,1552
31181965000,1701,1588,49,6,2,4,0,0,113
31181965100,1694,1523,99,8,12,5,0,2,171
31183973600,774,736,20,0,2,0,0,1,38
31185969600,2695,2543,67,3,3,8,0,11,152
31185969700,4286,3727,269,82,12,27,2,11,559
31185969800,4617,3865,463,81,49,46,0,8,752
31185969900,2527,2424,40,1,7,9,0,0,103
32001950100,2464,1828,331,47,39,40,9,12,636
32001950301,4150,2718,623,131,190,126,26,18,1432
32001950302,5526,3683,844,166,131,268,25,17,1843
32001950400,291,185,33,24,1,16,4,6,106
32001950500,1527,786,134,3,495,3,2,1,741
32001950600,5736,4124,920,27,77,112,4,53,1612
32001950700,5822,4546,701,30,73,75,17,36,1276
32003000101,6669,1233,4447,532,10,194,40,18,5436
32003000103,5917,1101,3752,549,23,199,51,22,4816
32003000105,3962,997,2377,244,13,198,13,14,2965
32003000106,4527,1350,2139,550,13,275,29,20,3177
32003000107,4009,1003,1980,474,26,309,48,11,3006
32003000108,3748,520,2838,221,14,80,9,8,3228
32003000109,3591,859,1969,440,22,119,21,5,2732
32003000201,4787,554,2134,1633,11,198,19,55,4233
32003000203,3987,1194,1251,927,20,289,35,12,2793
32003000204,954,534,221,74,5,67,6,7,420
32003000301,2996,191,1226,1407,6,70,10,5,2805
32003000302,5188,265,1583,2980,22,83,27,24,4923
32003000401,2463,761,606,687,64,61,40,138,1702
32003000402,3265,374,1806,826,10,102,8,23,2891
32003000403,2316,525,1170,365,14,120,19,11,1791
32003000510,5274,346,4450,264,10,104,21,14,4928
32003000513,3666,679,2471,321,9,69,6,21,2987
32003000514,5850,798,3709,828,15,194,28,44,5052
32003000515,5075,481,3803,404,21,214,1,20,4594
32003000516,5795,592,4133,732,9,154,18,36,5203
32003000517,5257,612,3554,682,8,186,24,10,4645
32003000518,5668,706,3899,683,22,167,16,22,4962
32003000519,5155,572,3842,457,10,157,5,16,4583
32003000520,1978,149,1719,40,1,59,0,1,1829
32003000521,3958,701,2382,607,14,82,25,19,3257
32003000522,3206,200,2321,492,13,84,11,17,3006
32003000523,2848,413,1431,666,9,171,16,29,2435
32003000524,2477,317,1469,477,12,115,4,8,2160
32003000525,2862,226,2292,270,2,22,5,14,2636
32003000526,2861,305,2241,183,1,46,10,27,2556
32003000527,3551,271,2846,266,5,72,16,12,3280
32003000528,3117,298,2189,437,3,79,10,8,2819
32003000600,2644,836,996,470,15,155,17,16,1808
32003000700,2870,1175,552,904,5,118,10,14,1695
32003001003,4211,1337,1690,469,7,429,43,36,2874
32003001004,6820,2195,2771,882,36,563,43,35,4625
32003001005,1528,991,238,73,8,122,0,11,537
32003001006,3932,2133,899,317,10,271,30,40,1799
32003001100,2954,790,1166,472,26,298,11,24,2164
32003001200,4055,1329,1854,351,12,297,25,18,2726
32003001300,4624,1368,2582,177,16,270,7,34,3256
32003001401,3424,736,2059,333,14,160,6,16,2688
32003001402,4092,516,3139,115,18,219,1,15,3576
32003001501,3395,876,1215,981,23,95,20,36,2519
32003001502,4150,1460,1994,326,27,193,10,22,2690
32003001607,6549,2303,2165,1233,31,177,196,27,4246
32003001608,1990,586,941,257,11,97,10,4,1404
32003001609,4263,592,2864,258,19,401,7,26,3671
32003001610,2952,604,1997,104,11,151,2,11,2348
32003001611,4791,887,3091,434,10,211,20,18,3904
32003001613,4209,733,2533,549,28,169,28,16,3476
32003001614,2338,470,1036,582,7,128,6,7,1868
32003001615,4763,1111,1773,1286,22,258,46,31,3652
32003001706,3356,1720,709,378,8,308,31,30,1636
32003001707,1792,829,477,230,6,144,21,12,963
32003001708,3433,1351,1469,202,14,192,20,15,2082
32003001709,1715,701,667,137,12,87,7,15,1014
32003001710,4794,1408,2218,547,42,235,90,20,3386
32003001711,3440,1210,1247,499,34,240,27,18,2230
32003001712,4256,1850,1415,416,30,291,23,24,2406
32003001713,3314,1218,1577,170,21,150,18,11,2096
32003001714,3502,1145,1789,211,7,181,22,11,2357
32003001715,2685,550,1668,216,10,103,31,8,2135
32003001716,1689,456,1000,93,2,76,1,7,1233
32003001717,1542,876,410,35,3,125,18,9,666
32003001718,3180,640,1572,522,30,129,70,38,2540
32003001801,6761,1958,3578,557,49,290,35,64,4803
32003001803,2889,802,1432,232,12,248,17,21,2087
32003001804,3760,760,2181,414,13,211,10,32,3000
32003001901,5249,797,2700,1076,23,416,23,44,4452
32003001902,4231,961,2474,397,7,199,16,30,3270
32003002000,4884,2272,959,783,26,492,26,41,2612
32003002201,4766,1510,1294,938,40,530,121,44,3256
32003002203,4585,652,2691,588,14,428,30,23,3933
32003002204,4288,527,2808,559,5,232,26,17,3761
32003002206,3344,574,1503,528,18,522,40,16,2770
32003002207,3866,351,2640,501,6,214,23,25,3515
32003002302,757,447,86,72,5,114,2,2,310
32003002303,1025,694,65,46,0,169,0,11,331
32003002403,4613,1399,1330,1241,26,280,47,45,3214
32003002404,5826,915,2048,2065,55,339,64,62,4911
32003002405,4233,864,1882,1014,25,253,26,18,3369
32003002406,3923,1108,651,1438,22,432,48,19,2815
32003002501,6110,1688,1836,1084,26,1028,50,53,4422
32003002504,3820,1274,1330,581,20,309,38,38,2546
32003002505,2126,430,1044,252,8,259,23,16,1696
32003002506,3544,807,1348,683,18,440,51,24,2737
32003002603,3597,1581,679,492,26,543,13,25,2016
32003002604,2520,934,906,387,19,142,5,19,1586
32003002605,1380,499,193,510,7,26,6,16,881
32003002706,3868,923,1745,625,28,294,26,38,2945
32003002707,3995,1140,2126,250,16,252,14,57,2855
32003002708,2754,494,1178,735,11,192,17,40,2260
32003002808,2155,1231,347,138,10,255,27,2,924
32003002810,3546,1266,1015,530,22,345,90,29,2280
32003002811,4138,2095,834,204,12,621,74,30,2043
32003002814,5217,2420,1100,350,16,830,90,26,2797
32003002821,4944,2130,1251,725,25,347,65,55,2814
32003002822,4038,982,2443,260,12,148,36,22,3056
32003002823,3858,1409,1254,574,19,363,29,21,2449
32003002824,1700,1016,423,54,13,101,6,3,684
32003002825,3324,1410,1362,179,20,169,19,15,1914
32003002826,3027,1276,1183,154,25,200,9,17,1751
32003002827,2922,1251,998,206,10,230,23,32,1671
32003002828,3583,1808,651,384,19,433,33,30,1775
32003002829,3590,1916,852,156,10,332,50,35,1674
32003002830,5193,2574,1154,419,17,627,50,43,2619
32003002831,4246,1641,891,620,15,610,135,35,2605
32003002833,5186,2397,1096,327,17,908,76,31,2789
32003002834,5233,2312,1335,323,15,718,122,34,2921
32003002835,2787,1173,625,140,16,461,117,16,1614
32003002836,2816,956,740,320,23,457,101,12,1860
32003002837,5923,3431,1157,206,6,669,71,26,2492
32003002838,5492,2779,1198,383,21,618,68,41,2713
32003002841,5511,2631,926,290,18,1124,70,43,2880
32003002842,6749,2285,1545,612,25,1413,208,32,4464
32003002844,5925,2213,1505,533,13,1048,163,23,3712
32003002845,6424,2360,1698,782,27,741,215,39,4064
32003002846,5725,2229,1547,464,23,923,123,23,3496
32003002847,4041,1523,1207,476,27,407,74,38,2518
32003002848,3739,1692,1132,315,10,347,36,31,2047
32003002849,3156,1446,661,341,5,421,47,18,1710
32003002850,3850,1562,879,378,8,651,87,22,2288
32003002851,6359,2371,1425,610,18,1240,133,29,3988
32003002852,1392,557,249,119,1,318,28,0,835
32003002853,2883,1121,594,195,10,644,52,7,1762
32003002901,5673,1434,899,632,12,2232,45,30,4239
32003002902,4719,1201,715,450,21,1948,80,22,3518
32003002905,5378,1966,1420,1069,35,515,34,47,3412
32003002915,5176,2668,1014,664,21,469,39,37,2508
32003002916,2839,1638,432,255,12,315,11,54,1201
32003002919,4528,1506,1344,305,7,1076,36,12,3022
32003002935,1638,583,444,127,0,386,16,9,1055
32003002936,3274,1193,885,306,12,686,34,9,2081
32003002937,5084,1336,1991,616,20,815,33,30,3748
32003002938,1687,646,330,136,2,471,4,12,1041
32003002939,1848,1201,231,80,3,249,1,13,647
32003002940,3784,969,888,529,4,1157,33,19,2815
32003002941,5154,1769,2204,286,13,528,54,22,3385
32003002942,4548,1887,1304,425,9,657,27,24,2661
32003002944,4700,1557,686,439,18,1675,52,16,3143
32003002946,2013,818,497,172,1,394,15,16,1195
32003002947,2528,1480,450,70,3,352,10,9,1048
32003002948,3435,1023,1730,178,13,274,61,8,2412
32003002949,2703,998,985,147,1,379,30,17,1705
32003002950,4894,1568,1078,831,15,1118,50,19,3326
32003002952,2431,1044,365,225,5,668,10,10,1387
32003002953,4254,1629,1175,337,21,851,25,20,2625
32003002954,4399,1030,2175,360,7,601,38,25,3369
32003002956,2958,1110,607,537,12,454,33,25,1848
32003002957,1933,1400,103,66,7,262,1,19,533
32003002958,5885,2007,1621,942,21,874,55,42,3878
32003002961,2000,1019,282,140,12,393,22,15,981
32003002962,2544,1269,433,478,29,149,20,5,1275
32003002964,4187,950,1199,1214,4,531,67,28,3237
32003002965,3507,1336,1295,460,17,285,14,10,2171
32003002966,4971,1177,1512,1215,16,770,26,22,3794
32003002967,3962,1123,805,1155,15,579,43,37,2839
32003002968,2638,739,490,511,3,737,21,11,1899
32003002969,1743,522,311,542,2,255,11,12,1221
32003002970,3714,950,790,1204,7,529,27,36,2764
32003002974,7295,2626,1364,839,12,1855,87,59,4669
32003002975,6821,2131,1375,905,32,1887,65,35,4690
32003002976,6630,2354,1182,631,17,1936,90,23,4276
32003002977,4154,1588,613,206,5,1459,28,12,2566
32003002978,6907,2959,1190,454,11,1759,61,20,3948
32003002979,4599,1869,657,349,15,1382,43,18,2730
32003002980,6724,1845,1264,905,19,2129,104,41,4879
32003002981,4306,1225,929,745,17,1021,51,23,3081
32003002982,7804,2098,1423,1216,19,2384,101,34,5706
32003002983,3348,867,634,613,9,949,42,13,2481
32003002985,5151,1774,998,613,14,1336,87,24,3377
32003002995,2564,497,1038,397,5,445,39,29,2067
32003002996,4420,791,1587,866,12,908,48,27,3629
32003002997,3811,1627,701,513,13,656,43,25,2184
32003002998,4391,1477,664,360,8,1578,49,25,2914
32003003001,3895,1288,1890,322,10,148,50,17,2607
32003003003,5676,2188,1866,701,28,486,69,33,3488
32003003004,2372,927,595,445,4,161,20,45,1445
32003003005,3779,1591,1540,177,28,168,66,17,2188
32003003006,3491,1309,1507,239,19,180,30,13,2182
32003003102,5414,1474,2753,600,15,197,39,44,3940
32003003103,3418,895,1674,451,8,209,24,10,2523
32003003104,4329,1087,1604,985,27,265,57,39,3242
32003003204,5756,3938,804,359,16,259,23,38,1818
32003003208,3037,2158,369,117,2,174,16,11,879
32003003210,2424,2084,85,74,0,132,6,4,340
32003003211,3012,2535,153,93,5,157,4,5,477
32003003213,1928,1649,66,39,4,122,1,7,279
32003003214,1748,1394,86,124,7,79,2,3,354
32003003215,4237,2307,788,466,9,397,25,42,1930
32003003218,5370,3370,680,264,9,659,31,29,2000
32003003219,6251,3446,1117,518,25,745,34,19,2805
32003003220,6808,2680,2006,953,33,592,65,43,4128
32003003222,4926,2816,716,350,16,619,25,21,2110
32003003223,3269,2207,275,145,6,440,1,29,1062
32003003226,2606,1681,210,146,3,450,0,26,925
32003003227,4006,2504,480,268,20,496,17,21,1502
32003003228,7043,3034,1572,1063,17,645,66,30,4009
32003003229,7241,3515,1461,883,29,633,49,44,3726
32003003233,6702,3526,1097,704,18,706,59,47,3176
32003003234,4915,1942,1070,950,20,366,70,37,2973
32003003235,2184,1151,387,295,14,146,9,11,1033
32003003236,2382,1534,419,170,17,95,16,4,848
32003003237,4619,2445,907,496,8,364,39,22,2174
32003003239,3738,2091,707,413,7,306,12,20,1647
32003003240,3894,2270,767,290,16,264,25,17,1624
32003003241,3967,2012,823,494,7,297,42,14,1955
32003003242,1964,1412,209,114,6,112,1,4,552
32003003243,4797,2281,1041,550,12,524,32,35,2516
32003003244,3532,1701,863,408,28,212,13,25,1831
32003003245,4743,2161,1267,523,21,424,40,17,2582
32003003246,3947,1956,921,364,17,377,68,20,1991
32003003247,3611,2217,545,256,10,348,12,42,1394
32003003248,3178,1726,483,415,5,290,6,21,1452
32003003249,3302,2054,460,137,5,374,20,20,1248
32003003250,5182,3021,807,236,13,780,29,20,2161
32003003251,2517,1600,357,99,7,290,1,23,917
32003003252,4334,2645,639,263,12,452,24,36,1689
32003003253,3628,1601,1105,306,10,401,9,16,2027
32003003254,3825,1881,1038,346,9,297,36,21,1944
32003003260,3585,1671,871,439,14,336,19,20,1914
32003003261,2769,1399,654,284,18,237,14,14,1370
32003003262,2691,2218,106,90,5,200,3,15,473
32003003263,4605,2385,967,468,11,398,14,22,2220
32003003264,6685,3593,1394,502,13,631,25,17,3092
32003003265,7474,3983,1417,695,9,688,51,38,3491
32003003266,4919,2497,885,583,22,421,47,54,2422
32003003267,4157,2895,534,248,7,194,14,18,1262
32003003268,3655,2398,628,180,14,148,10,27,1257
32003003269,2946,1556,653,286,12,193,28,14,1390
32003003270,3559,1666,856,433,17,329,28,29,1893
32003003303,5351,2321,1501,692,39,306,42,32,3030
32003003305,5743,3184,1319,483,13,299,42,27,2559
32003003306,4074,2745,647,270,18,152,10,15,1329
32003003307,5935,3079,1299,628,24,366,60,49,2856
32003003308,2917,1692,553,291,12,179,5,0,1225
32003003309,4540,2932,732,320,14,182,36,32,1608
32003003311,3551,2027,634,440,12,179,32,15,1524
32003003312,4406,2782,699,297,9,219,27,25,1624
32003003313,3343,1861,715,293,17,190,46,5,1482
32003003314,8198,5348,1189,551,30,443,43,57,2850
32003003315,4062,2206,827,363,18,283,17,40,1856
32003003316,5569,3373,870,551,20,321,39,11,2196
32003003317,2961,1481,710,329,21,142,27,30,1480
32003003318,6347,3511,1241,609,33,381,49,43,2836
32003003319,5833,3179,1315,452,26,334,51,27,2654
32003003320,5689,3239,983,597,17,343,60,27,2450
32003003321,2677,1624,367,254,19,184,16,14,1053
32003003322,4260,2948,589,243,4,177,28,32,1312
32003003323,1798,1163,303,121,1,109,14,1,635
32003003408,5246,2494,1263,684,19,429,28,19,2752
32003003409,5198,2037,1836,669,38,252,48,28,3161
32003003410,4937,2555,1151,526,26,291,30,24,2382
32003003411,3874,1782,893,682,17,182,33,42,2092
32003003412,4794,2012,1740,542,23,212,38,31,2782
32003003413,5275,1836,1915,939,26,198,56,41,3439
32003003414,2765,1457,717,282,10,155,11,16,1308
32003003415,7702,2084,2916,1541,50,492,77,64,5618
32003003416,2926,1164,1131,295,6,170,11,21,1762
32003003418,4082,1146,1242,1014,27,325,28,23,2936
32003003419,6810,1460,2897,1659,31,263,75,46,5350
32003003420,4330,1126,2269,569,13,105,31,25,3204
32003003421,3512,1119,1240,504,20,332,42,20,2393
32003003422,5670,1517,2751,778,15,240,42,25,4153
32003003423,6786,1534,3723,899,8,270,43,41,5252
32003003426,3235,1129,1188,634,12,94,14,12,2106
32003003427,4073,862,1552,1141,10,227,29,30,3211
32003003428,2061,528,883,438,5,69,21,12,1533
32003003429,5445,1145,2804,935,17,215,65,37,4300
32003003430,3499,416,1475,1204,13,182,26,24,3083
32003003431,3210,306,1822,834,10,82,47,24,2904
32003003500,3016,225,1105,1482,5,90,21,10,2791
32003003609,4968,2098,1666,593,18,188,36,45,2870
32003003610,6630,1820,2742,1155,36,425,57,51,4810
32003003613,7551,1353,3319,1996,12,418,111,35,6198
32003003615,3048,707,1250,719,13,181,23,11,2341
32003003616,5484,490,3043,1540,18,172,37,29,4994
32003003617,2102,138,1089,702,6,79,27,4,1964
32003003619,3829,1562,641,730,9,549,37,22,2267
32003003620,5717,2209,1250,1059,16,682,44,29,3508
32003003621,3241,2448,160,243,8,271,25,11,793
32003003626,4267,1206,1407,846,20,392,82,25,3061
32003003627,5443,1365,1622,1599,17,384,56,32,4078
32003003630,6618,2350,2303,1056,26,350,77,39,4268
32003003631,4300,1521,1143,865,13,383,58,40,2779
32003003632,3047,1057,1025,449,22,224,51,7,1990
32003003633,4006,1236,1615,650,16,252,47,13,2770
32003003634,4399,1250,1634,902,19,249,52,24,3149
32003003635,6115,1893,2354,961,12,398,63,40,4222
32003003636,2697,1246,747,370,7,131,16,8,1451
32003003637,4902,1270,1563,1292,32,347,36,24,3632
32003003638,4070,1045,1453,947,12,268,81,20,3025
32003003639,4450,1161,1924,753,10,263,47,33,3289
32003003640,6351,1283,2226,2028,8,356,101,18,5068
32003003641,6738,1334,2327,2045,10,547,58,51,5404
32003003642,4194,442,1907,1274,1,328,33,23,3752
32003003643,5406,955,2212,1548,10,323,64,22,4451
32003003644,5416,851,2189,1593,21,337,112,46,4565
32003003645,4205,1147,1452,884,10,406,37,15,3058
32003003646,4695,1391,1735,1071,11,224,28,23,3304
32003003647,7022,2009,2163,1491,14,745,122,67,5013
32003003648,4297,1102,1493,1017,15,329,35,34,3195
32003003649,1867,377,691,479,9,155,15,9,1490
32003003650,4260,869,1616,1109,12,372,40,32,3391
32003003651,5341,1101,1961,1321,25,467,50,33,4240
32003003652,4773,910,1580,1531,14,353,51,20,3863
32003003653,2499,603,985,484,6,253,27,15,1896
32003003654,3389,719,1174,717,9,436,37,22,2670
32003003655,4978,1459,1930,935,21,280,46,24,3519
32003003656,3529,1099,1011,912,4,231,28,18,2430
32003003657,2595,591,667,974,13,123,19,11,2004
32003003658,1289,396,307,225,11,251,13,10,893
32003003659,1741,569,403,361,1,240,12,18,1172
32003003660,4632,1510,1068,849,16,728,70,20,3122
32003003661,3925,1038,1142,1060,3,277,48,39,2887
32003003662,4708,2331,865,492,14,498,58,50,2377
32003003663,1613,707,322,276,7,177,7,4,906
32003003664,3549,1311,836,699,22,311,31,34,2238
32003003665,4684,1417,1172,1232,9,417,59,25,3267
32003003666,4564,1792,1208,703,10,439,65,21,2772
32003003700,4126,245,1605,1907,15,94,49,21,3881
32003003800,4943,559,2723,1404,22,48,28,26,4384
32003004000,3304,230,2888,98,5,39,5,6,3074
32003004100,5609,478,4798,161,25,45,12,35,5131
32003004200,5207,442,4354,245,13,62,8,16,4765
32003004301,1904,83,1672,101,6,14,4,4,1821
32003004302,7031,1236,4234,1434,12,50,23,2,5795
32003004401,2850,207,2371,191,13,15,7,5,2643
32003004402,3772,229,2519,851,6,22,22,12,3543
32003004500,4875,311,3900,447,14,77,24,12,4564
32003004601,5018,486,2987,1245,6,89,19,36,4532
32003004602,2996,255,1934,699,2,36,4,6,2741
32003004703,6209,776,3177,1660,20,233,48,22,5433
32003004707,3110,290,2271,346,19,83,9,8,2820
32003004709,5853,435,4085,975,23,143,9,23,5418
32003004710,7849,943,4625,1678,24,215,24,115,6906
32003004712,5891,1291,2330,1758,40,88,35,25,4600
32003004713,4714,684,2206,1507,29,74,23,21,4030
32003004714,5865,647,4053,865,15,101,12,32,5218
32003004715,6285,794,3742,1181,8,248,40,23,5491
32003004716,3351,382,2241,530,3,59,19,12,2969
32003004717,3251,415,2494,164,1,74,22,7,2836
32003004907,3573,1117,1633,254,8,415,15,16,2456
32003004910,2937,421,1969,142,12,251,30,27,2516
32003004911,4353,882,2234,742,19,277,34,26,3471
32003004912,6227,895,4057,694,10,270,54,39,5332
32003004914,2773,538,1911,125,2,126,11,5,2235
32003004915,3493,694,2397,184,9,90,19,20,2799
32003004916,2669,549,1785,182,11,59,5,8,2120
32003004917,3417,862,1842,311,12,165,27,29,2555
32003004918,4250,1123,2278,302,16,322,42,8,3127
32003004919,4425,1081,2334,316,7,451,49,19,3344
32003004920,5401,760,3506,631,23,271,33,21,4641
32003004921,6309,1259,3884,649,30,197,24,27,5050
32003004923,4135,797,2097,520,11,456,26,15,3338
32003004924,4174,882,2520,349,17,231,29,18,3292
32003004925,6245,1041,3599,555,30,737,15,24,5204
32003004926,4167,734,2355,310,22,528,43,22,3433
32003005005,4160,1951,1120,611,27,235,44,16,2209
32003005006,4814,1600,1466,1221,37,171,38,25,3214
32003005007,2506,1018,586,348,7,407,13,7,1488
32003005010,6173,1861,2285,1205,23,328,110,24,4312
32003005011,3618,857,2082,269,10,208,23,15,2761
32003005012,2998,1056,1236,186,9,308,25,30,1942
32003005013,4499,819,2333,441,8,669,45,8,3680
32003005014,5438,1350,2115,874,21,653,69,34,4088
32003005015,4895,1656,1318,530,12,1091,45,11,3239
32003005016,5767,1889,2347,539,9,659,43,24,3878
32003005017,7956,1964,2705,997,33,1646,98,43,5992
32003005102,4853,2540,1182,432,21,282,70,19,2313
32003005103,5165,2513,1227,612,23,317,69,57,2652
32003005104,3254,1897,697,239,8,199,23,12,1357
32003005106,2989,1584,698,260,14,169,39,31,1405
32003005107,4250,2480,912,209,17,298,15,14,1770
32003005108,4111,2129,866,315,8,456,24,32,1982
32003005110,2324,972,590,302,5,273,17,7,1352
32003005111,6549,2834,1838,742,25,571,67,38,3715
32003005112,3048,1266,832,345,6,340,9,17,1782
32003005113,3337,1261,908,314,37,521,34,24,2076
32003005114,5149,1801,1484,879,23,511,68,33,3348
32003005115,2914,1531,595,164,9,309,55,32,1383
32003005116,5691,2803,1245,391,12,762,71,44,2888
32003005200,4016,2251,1042,259,31,144,24,19,1765
32003005311,2669,1279,628,241,0,322,11,3,1390
32003005312,2639,1407,569,177,7,238,36,3,1232
32003005313,6280,3498,1244,373,47,567,42,42,2782
32003005314,2601,1681,486,131,13,139,6,11,920
32003005316,4057,2264,881,291,10,265,53,28,1793
32003005317,5425,3245,848,379,13,544,31,29,2180
32003005318,3032,1964,350,215,7,286,32,14,1068
32003005319,2714,1507,560,127,10,290,31,12,1207
32003005320,2804,1616,600,183,15,164,20,13,1188
32003005321,3583,2254,627,158,11,291,16,23,1329
32003005322,1580,1023,175,69,6,183,10,11,557
32003005333,3150,2036,460,89,10,306,13,21,1114
32003005335,4600,3305,756,94,35,133,23,20,1295
32003005336,4050,2399,842,340,42,111,54,27,1651
32003005337,3142,2239,386,81,7,260,13,11,903
32003005338,1911,1676,95,39,8,56,1,4,235
32003005341,2323,1513,485,90,19,59,15,3,810
32003005342,3060,2139,554,92,18,70,9,7,921
32003005343,6083,3766,1034,338,26,374,55,30,2317
32003005346,5661,2705,951,508,12,979,61,44,2956
32003005347,7250,3963,1032,490,27,1084,52,43,3287
32003005348,5631,3422,666,227,10,826,24,28,2209
32003005349,4697,2831,679,214,17,576,23,25,1866
32003005350,3806,2430,469,132,10,471,30,18,1376
32003005351,5589,3114,1022,330,5,630,55,38,2475
32003005352,4071,2626,515,156,13,453,17,45,1445
32003005353,5340,2838,973,496,25,537,55,28,2502
32003005354,6369,3474,1273,425,39,647,51,39,2895
32003005355,5770,3843,704,268,13,599,16,21,1927
32003005356,2858,1877,289,110,4,384,19,17,981
32003005358,3576,2447,592,91,12,185,2,25,1129
32003005360,4925,3174,881,293,26,163,31,28,1751
32003005361,4446,3208,595,143,9,181,21,25,1238
32003005362,3909,2697,653,102,0,206,8,22,1212
32003005363,2317,1045,508,344,4,204,19,7,1272
32003005364,6571,3690,1201,437,21,688,49,54,2881
32003005365,3720,2300,469,141,4,488,8,28,1420
32003005366,3961,2741,526,170,11,223,24,20,1220
32003005421,3642,1898,810,508,57,110,12,22,1744
32003005422,4344,2240,1332,333,37,118,18,28,2104
32003005423,4581,2146,1167,694,24,154,50,18,2435
32003005432,5574,3773,955,215,26,228,24,22,1801
32003005433,5623,3871,996,187,44,179,23,20,1752
32003005434,5165,3309,966,210,23,226,44,20,1856
32003005435,3952,2701,593,120,20,191,59,27,1251
32003005437,5060,3531,585,264,11,407,15,19,1529
32003005438,3008,1370,821,456,10,102,18,24,1638
32003005439,4013,1723,1396,392,40,159,26,27,2290
32003005440,6744,2785,1709,1085,28,506,95,36,3959
32003005441,7148,4005,1190,509,25,855,24,35,3143
32003005442,4561,2268,937,339,12,656,50,22,2293
32003005501,4441,3786,317,68,18,68,9,12,655
32003005502,4245,3605,346,17,22,50,2,32,640
32003005503,2874,2300,339,27,19,49,3,5,574
32003005504,3325,2689,354,42,18,53,1,3,636
32003005607,4007,2085,1641,38,33,56,6,34,1922
32003005612,1410,1141,173,13,10,14,0,2,269
32003005613,4100,3487,378,4,22,28,2,17,613
32003005614,2542,1270,1064,28,37,68,2,4,1272
32003005615,1752,1302,367,20,1,19,8,1,450
32003005702,3398,2362,511,187,45,95,16,24,1036
32003005703,1615,982,231,212,11,100,9,4,633
32003005704,1922,1286,336,117,13,35,5,9,636
32003005705,3607,2598,615,89,22,95,14,22,1009
32003005711,4549,2928,649,110,11,519,27,34,1621
32003005713,6765,4580,783,266,21,705,18,30,2185
32003005715,4422,3226,321,75,10,591,6,12,1196
32003005716,3626,2656,129,132,8,597,6,15,970
32003005717,7006,4313,958,323,11,878,16,32,2693
32003005718,2170,1351,261,108,12,282,15,7,819
32003005719,5364,2932,933,274,11,742,40,28,2432
32003005720,3779,1971,603,245,8,648,11,15,1808
32003005721,2878,2228,114,81,5,375,4,14,650
32003005722,3105,2502,108,89,5,316,10,9,603
32003005803,4606,2622,831,286,11,517,32,35,1984
32003005804,4690,2601,800,372,11,519,40,40,2089
32003005805,3369,1968,606,253,6,337,13,17,1401
32003005806,4250,2400,761,387,9,412,23,21,1850
32003005807,4402,2386,751,467,11,436,37,36,2016
32003005808,3452,2039,602,297,15,275,11,17,1413
32003005809,4308,2129,964,429,7,443,24,45,2179
32003005813,4474,1656,948,701,16,809,49,35,2818
32003005818,6118,2358,1424,2017,42,170,6,3,3760
32003005822,5506,3078,790,165,12,1034,25,38,2428
32003005824,3693,2313,467,111,11,525,14,11,1380
32003005825,5475,2383,1084,756,12,816,46,38,3092
32003005826,3996,1717,653,439,10,923,34,20,2279
32003005828,9551,3961,1868,638,20,2161,100,46,5590
32003005829,6867,2617,1459,674,30,1428,105,38,4250
32003005830,4588,1866,913,397,22,1020,62,24,2722
32003005831,6166,2677,1120,387,13,1385,47,33,3489
32003005834,3291,1377,542,360,6,766,37,17,1914
32003005835,4213,1947,724,327,12,793,56,26,2266
32003005836,3787,1841,771,288,12,530,34,18,1946
32003005837,4747,2378,827,408,16,723,27,31,2369
32003005839,8128,3926,1277,489,22,1627,93,46,4202
32003005841,6075,3910,598,191,14,986,13,39,2165
32003005842,3418,2312,340,79,6,485,1,11,1106
32003005843,3261,1952,383,189,6,512,21,20,1309
32003005844,6310,3891,881,358,18,712,30,37,2419
32003005845,4170,2628,534,217,8,548,14,15,1542
32003005846,6284,4288,509,208,8,977,19,32,1996
32003005847,4267,1955,786,474,12,727,25,30,2312
32003005848,4010,1568,860,667,14,544,29,43,2442
32003005849,4027,1541,788,645,20,785,18,22,2486
32003005850,4929,1780,881,463,9,1435,44,17,3149
32003005852,5785,2674,939,445,15,1206,50,33,3111
32003005855,7620,3065,1200,527,17,2087,111,41,4555
32003005856,5248,1808,684,524,10,1800,47,39,3440
32003005857,6553,2239,1525,696,25,1415,127,44,4314
32003005858,11099,4840,2183,688,33,2310,107,68,6259
32003005859,4068,1429,901,652,20,669,89,15,2639
32003005860,10707,4184,1877,1118,17,2641,84,55,6523
32003005861,1621,724,388,122,5,223,45,5,897
32003005862,5982,2321,1149,603,27,1246,59,32,3661
32003005863,2746,931,537,330,7,718,30,16,1815
32003005864,6774,2519,1158,704,15,1844,48,35,4255
32003005865,6060,1723,1107,574,7,2040,90,37,4337
32003005866,6863,2359,1503,557,31,1732,99,41,4504
32003005867,5811,2547,1201,399,13,1107,70,30,3264
32003005868,5248,2023,1000,305,18,1450,73,25,3225
32003005869,3721,1284,768,468,22,880,18,15,2437
32003005870,3270,1100,673,444,2,689,48,23,2170
32003005871,2297,1033,504,262,9,324,18,6,1264
32003005872,7482,4511,710,239,6,1515,6,42,2971
32003005873,4984,3173,529,129,8,793,7,40,1811
32003005874,5063,2175,843,532,20,1174,57,26,2888
32003005875,3328,1474,534,453,10,600,32,5,1854
32003005876,1828,1260,409,25,13,33,10,8,568
32003005877,7499,2933,1411,571,12,1842,96,40,4566
32003005902,1359,701,387,8,193,18,0,7,658
32003005903,3631,3019,373,27,15,76,2,10,612
32003005904,4149,3722,213,28,14,60,2,11,427
32003005905,2541,2059,294,45,14,48,5,6,482
32003006001,9453,3227,1700,3202,58,439,90,68,6226
32003006103,3242,980,1245,630,25,115,15,22,2262
32003006104,5142,1381,2059,320,16,1057,54,21,3761
32003006201,4577,870,2625,760,8,119,11,23,3707
32003006202,4269,1160,2444,304,25,134,39,10,3109
32003006203,3084,847,1771,217,12,90,27,13,2237
32003006204,4985,944,3051,525,17,208,24,22,4041
32003006700,1698,1044,178,110,0,264,1,22,654
32003006800,4778,885,2506,691,29,404,33,40,3893
32003006900,1670,951,376,90,13,117,16,10,719
32003007100,3191,401,2436,202,20,47,5,9,2790
32003007200,4924,1164,2241,1043,19,149,20,46,3760
32003007500,1194,905,116,47,44,31,1,10,289
32003007600,4067,2883,873,42,14,44,12,12,1184
32003007801,1626,672,273,482,18,44,9,6,954
32003007802,632,285,114,137,6,33,6,6,347
32003007900,3487,1597,693,660,20,280,18,44,1890
32005001000,2906,2279,374,5,29,27,9,7,627
32005001100,5238,3907,867,30,52,76,11,20,1331
32005001200,3138,2552,357,12,19,38,6,23,586
32005001300,1762,1560,117,0,18,16,2,3,202
32005001400,3439,2859,322,19,19,56,2,9,580
32005001500,6211,4696,940,25,78,160,11,32,1515
32005001600,1799,1552,94,5,3,59,1,10,247
32005001700,1493,1036,276,10,2,61,8,16,457
32005001800,2301,1898,220,11,7,50,2,8,403
32005001900,1843,1631,114,1,11,22,0,10,212
32005002000,3515,2310,838,21,56,75,15,18,1205
32005002100,2051,1456,356,7,6,93,6,18,595
32005002200,6572,5524,530,14,57,89,5,33,1048
32005002300,3642,3125,254,15,42,38,2,29,517
32005002400,1717,930,311,0,381,18,0,1,787
32005002500,1861,1541,171,8,27,20,1,3,320
32005990000,0,0,0,0,0,0,0,0,0
32007950200,2023,1377,425,40,76,3,5,11,646
32007950701,6886,4364,1848,121,96,157,2,47,2522
32007950702,5944,3769,1098,62,676,71,9,30,2175
32007950800,1530,1058,318,12,25,43,4,7,472
32007950900,2111,1474,439,10,49,11,5,12,637
32007951000,1625,1054,434,22,39,29,3,3,571
32007951201,5517,4661,439,10,58,24,3,13,856
32007951202,4470,2478,1530,45,152,28,17,21,1992
32007951300,2847,1216,1370,54,53,37,2,13,1631
32007951401,4377,2958,1104,13,69,16,1,17,1419
32007951403,3510,2868,414,7,44,14,4,14,642
32007951404,3551,2972,348,6,30,27,7,23,579
32007951500,4892,1505,3094,18,51,68,6,15,3387
32007951600,2095,1626,233,65,33,15,3,11,469
32007951700,2324,797,498,9,927,12,14,10,1527
32009950100,729,521,139,4,20,4,0,0,208
32011000100,1855,1545,178,2,21,4,3,11,310
32013010501,2361,1474,440,41,300,14,6,15,887
32013010502,3665,2350,1020,26,44,41,4,41,1315
32013010600,2133,1490,440,9,41,9,0,59,643
32013010701,4916,2815,1589,49,137,46,6,64,2101
32013010702,4210,2903,1022,12,49,42,10,20,1307
32015000301,2460,1632,572,6,116,12,4,5,828
32015000302,3274,2343,684,1,90,15,6,14,931
32017950100,2440,2064,158,127,9,10,5,0,376
32017950200,2059,1774,136,41,17,11,8,9,285
32019960103,1722,1137,393,12,24,22,9,12,585
32019960104,3967,2628,800,77,86,70,22,22,1339
32019960105,3998,2867,691,23,61,92,21,12,1131
32019960106,5062,3673,772,56,61,143,18,25,1389
32019960107,3588,2434,695,32,50,66,10,23,1154
32019960108,4709,3341,766,90,56,92,15,13,1368
32019960203,2459,1968,227,5,40,35,7,5,491
32019960204,2001,1594,200,7,29,21,1,21,407
32019960205,2191,1694,221,22,27,12,5,10,497
32019960206,1496,1220,122,5,17,13,6,9,276
32019960301,1875,1204,531,12,22,17,0,5,671
32019960303,5001,3841,630,22,41,148,11,19,1160
32019960304,6139,4623,896,23,66,93,15,32,1516
32019960305,4965,3295,1208,32,65,39,18,25,1670
32019960801,2505,1898,453,10,13,15,4,10,607
32019960802,2140,1522,482,14,32,12,0,4,618
32019960901,2558,1520,679,16,180,23,2,5,1038
32019960902,2859,1891,573,30,213,11,4,0,968
32021970700,3237,2376,377,152,81,59,8,11,861
32021970800,1317,482,131,9,630,5,0,5,835
32023960100,2338,1754,220,19,199,15,11,6,584
32023960200,2334,1835,262,57,23,32,5,10,499
32023960300,2078,1212,659,55,28,14,6,19,866
32023960405,4552,3391,717,70,39,87,23,21,1161
32023960407,3529,2453,459,198,25,90,27,25,1076
32023960408,5493,4082,761,97,42,118,26,45,1411
32023960409,6013,4443,747,197,40,226,21,42,1570
32023960410,5656,4055,866,188,46,130,22,33,1601
32023960411,3396,2447,533,96,28,66,9,19,949
32023960412,4109,2804,686,255,51,79,19,13,1305
32023960413,3273,2337,625,41,35,33,7,14,936
32023960414,2749,2134,311,81,16,46,16,12,615
32023960415,2041,1529,278,51,18,24,8,14,512
32023960416,4030,2837,803,91,30,68,17,18,1193
32023980500,0,0,0,0,0,0,0,0,0
32027960100,6650,4197,1499,322,198,109,8,21,2453
32029970200,4104,3338,340,24,38,67,8,34,766
32031000103,1161,766,138,94,16,69,4,7,395
32031000104,2551,1806,250,126,49,149,4,18,745
32031000105,2903,1687,563,237,54,110,32,32,1216
32031000106,696,439,91,47,7,45,13,0,257
32031000201,3329,1193,1707,65,15,172,34,17,2136
32031000202,2687,1630,541,148,32,129,17,37,1057
32031000301,1622,1229,203,23,8,36,1,11,393
32031000302,2138,1602,273,40,18,77,4,12,536
32031000401,2960,2163,403,45,22,125,12,13,797
32031000402,2324,1933,216,11,5,41,3,8,391
32031000701,2593,1434,740,64,24,163,24,35,1159
32031000702,3429,1659,1089,187,57,206,48,27,1770
32031000900,5087,1137,3315,219,36,184,53,13,3950
32031001005,3206,2023,652,72,22,245,13,5,1183
32031001010,4392,3285,437,55,17,325,6,27,1107
32031001011,4148,3356,337,15,8,191,0,32,792
32031001012,3375,2706,331,31,18,112,1,37,669
32031001013,6604,5483,372,28,20,367,8,29,1121
32031001014,3433,2556,379,37,11,263,6,19,877
32031001015,4677,3819,346,28,16,225,7,30,858
32031001016,2343,1017,718,101,24,291,51,30,1326
32031001017,1057,670,193,42,13,59,0,11,387
32031001018,2703,915,1104,263,30,165,67,11,1788
32031001019,2049,845,804,121,10,113,29,25,1204
32031001101,2956,2470,252,20,13,65,5,13,486
32031001103,5500,4512,337,17,8,291,5,27,988
32031001104,4505,3719,331,20,9,165,7,18,786
32031001105,3928,3166,349,15,8,174,2,13,762
32031001201,3009,2086,550,52,21,110,10,16,923
32031001203,3199,1867,756,124,28,154,9,17,1332
32031001204,1763,1053,461,73,14,59,5,9,710
32031001300,3658,2385,705,69,23,170,58,18,1273
32031001400,3006,1893,503,109,20,251,10,11,1113
32031001501,5194,2720,1464,171,30,493,36,21,2474
32031001503,5157,2210,1657,353,37,431,54,83,2947
32031001504,3636,2129,592,189,19,394,15,20,1507
32031001701,3320,1059,1543,271,37,138,78,13,2261
32031001703,3730,1304,1528,228,53,337,93,15,2426
32031001704,2984,1319,947,132,36,374,5,11,1665
32031001801,3549,730,2126,239,20,210,106,11,2819
32031001802,3280,731,2073,112,28,212,28,10,2549
32031001901,4749,1528,2487,173,38,233,109,19,3221
32031001903,3873,1534,1752,159,40,172,51,28,2339
32031001904,2399,1263,611,163,28,149,23,12,1136
32031002103,2774,1973,400,49,30,156,18,11,801
32031002104,3477,2425,590,48,21,176,21,8,1052
32031002105,4029,2076,1269,105,25,289,34,20,1953
32031002106,3462,1712,1220,35,25,309,16,16,1750
32031002107,1828,506,746,78,349,61,12,19,1322
32031002204,5314,1639,2685,188,46,495,37,30,3675
32031002207,5280,3586,676,59,19,632,29,26,1694
32031002208,3296,2399,388,54,17,241,10,8,897
32031002210,4500,3422,418,30,17,308,5,22,1078
32031002211,3862,1003,2304,139,34,219,31,10,2859
32031002212,4293,1069,2658,224,43,139,12,18,3224
32031002213,6004,3790,874,74,28,787,26,31,2214
32031002214,2693,1312,689,160,21,324,16,16,1381
32031002215,2682,1528,738,81,16,141,7,19,1154
32031002216,2655,1478,626,80,31,236,15,12,1177
32031002217,3567,2577,354,27,15,400,3,9,990
32031002218,3857,2699,483,51,4,307,11,15,1158
32031002219,4523,3115,578,46,36,411,10,2,1408
32031002302,2850,2329,230,15,13,96,0,21,521
32031002303,3104,2645,168,14,6,148,0,33,459
32031002304,4432,3585,312,24,12,268,9,16,847
32031002401,4095,2687,639,71,32,396,26,24,1408
32031002406,5132,3149,1134,179,39,220,57,25,1983
32031002407,4064,2374,746,66,25,607,4,15,1690
32031002408,3071,2095,411,46,24,241,0,17,976
32031002409,4618,3300,548,51,29,388,16,16,1318
32031002411,4348,2579,862,129,38,423,36,21,1769
32031002412,2534,1706,302,23,2,305,26,13,828
32031002413,3100,1993,582,64,18,226,21,9,1107
32031002414,1633,1058,314,40,11,91,5,6,575
32031002500,5090,3521,753,98,43,328,18,27,1569
32031002603,1555,1212,171,16,34,11,2,13,343
32031002610,5753,2787,2161,82,35,306,37,18,2966
32031002611,6130,2789,2254,137,70,402,113,17,3341
32031002612,4057,2900,728,41,46,51,7,29,1157
32031002613,6546,4574,1195,80,59,131,34,34,1972
32031002614,4357,1906,1580,171,40,291,97,38,2451
32031002615,4606,2079,1683,132,41,355,30,29,2527
32031002616,5247,2478,2036,101,43,214,95,15,2769
32031002618,6302,4341,1280,47,52,174,27,51,1961
32031002620,3993,2377,938,111,35,228,29,27,1616
32031002621,2037,931,921,28,8,26,4,12,1106
32031002622,3900,1746,1406,285,53,204,43,8,2154
32031002623,3498,2067,944,78,25,158,27,28,1431
32031002703,2723,1054,1432,55,19,31,11,11,1669
32031002704,4835,1792,2414,109,65,104,91,26,3043
32031002705,5238,2326,2401,69,70,110,27,19,2912
32031002706,5120,2083,2523,81,50,86,49,19,3037
32031002707,5192,1929,2863,45,53,78,25,21,3263
32031002801,4912,1835,2020,202,38,491,103,10,3077
32031002802,5509,1697,3128,86,43,301,31,27,3812
32031002901,3696,1878,1291,90,30,150,25,9,1818
32031002902,4267,1725,2051,73,36,177,34,15,2542
32031003001,3859,1693,1703,65,40,169,23,13,2166
32031003002,3278,1392,1270,134,38,179,48,16,1886
32031003105,2278,1448,491,36,12,138,5,10,830
32031003106,7595,3790,2558,204,59,410,115,36,3805
32031003108,3297,2078,767,53,21,170,15,12,1219
32031003109,3374,2336,456,44,23,342,4,1,1038
32031003110,5186,3189,1160,124,36,371,56,13,1997
32031003111,2357,1305,526,114,21,217,46,6,1052
32031003112,3064,1541,967,109,29,222,39,6,1523
32031003203,5172,4345,317,13,13,181,0,39,827
32031003205,4077,3032,623,37,26,77,13,30,1045
32031003206,1562,1339,92,7,13,27,1,11,223
32031003207,3586,2965,246,24,22,36,2,24,621
32031003305,1160,787,270,3,4,31,0,5,373
32031003306,1826,1041,656,4,8,35,2,12,785
32031003307,1268,1056,133,6,1,22,6,12,212
32031003308,2423,2098,109,4,8,70,1,22,325
32031003310,1447,1154,170,4,4,35,5,10,293
32031003311,1693,1376,201,8,3,41,0,4,317
32031003501,4228,2962,416,35,542,41,6,32,1266
32031003503,4348,3134,726,48,28,120,5,34,1214
32031003507,4225,2889,691,72,26,280,3,23,1336
32031003508,4279,2643,822,78,40,416,35,21,1636
32031003510,3692,2106,1005,80,29,222,23,22,1586
32031003511,5588,4196,773,76,30,179,7,38,1392
32031003512,4746,3280,756,99,40,295,16,10,1466
32031003513,4280,2617,822,136,45,367,30,33,1663
32031003514,3052,2449,320,28,28,42,8,6,603
32031003516,3702,2722,541,54,19,120,9,16,980
32031003517,5839,3871,1050,125,36,418,18,24,1968
32031003518,3735,2920,497,23,32,51,10,9,815
32031003519,5011,3856,580,53,60,133,16,11,1155
32031003520,2559,1467,577,81,28,254,12,10,1092
32031003521,2511,1524,534,98,18,160,9,18,987
32031003522,3588,1959,842,170,14,290,39,13,1629
32031940200,1926,327,164,7,1335,6,5,0,1599
32031980000,167,99,29,16,3,5,0,1,68
32031980100,0,0,0,0,0,0,0,0,0
32031980200,0,0,0,0,0,0,0,0,0
32031980300,12,9,1,0,0,0,0,0,3
32031990000,0,0,0,0,0,0,0,0,0
32031990100,0,0,0,0,0,0,0,0,0
32033970100,1438,1083,193,24,52,9,4,2,355
32033970200,5507,3701,860,400,245,78,12,16,1806
32033970300,2135,1570,404,14,61,18,3,4,565
32510000100,3260,2669,301,13,34,54,1,33,591
32510000200,4062,2996,619,34,58,90,14,33,1066
32510000300,3825,3086,201,15,215,105,6,25,739
32510000400,3964,2792,716,43,47,112,10,20,1172
32510000501,6158,3181,2307,56,70,205,19,29,2977
32510000502,3581,2366,869,43,50,41,7,15,1215
32510000601,3973,2515,835,246,62,148,5,29,1458
32510000602,2755,1509,883,46,35,65,8,25,1246
32510000701,4080,2647,1009,44,38,101,4,22,1433
32510000702,3439,2276,823,17,42,79,8,9,1163
32510000800,5538,3678,868,409,246,107,10,15,1860
32510000900,5648,3204,1977,43,75,73,12,12,2444
32510001001,4480,1535,2602,44,51,74,0,12,2945
32510001002,3876,2610,860,26,49,104,6,13,1266
32510990000,0,0,0,0,0,0,0,0,0
33001965100,3417,3181,42,15,1,15,0,24,236
33001965200,2982,2761,64,9,1,27,0,2,221
33001965300,3680,3443,74,15,7,29,0,8,237
33001965400,3026,2825,55,13,3,18,0,10,201
33001965598,3962,3620,76,9,11,60,1,13,342
33001965600,3945,3667,45,12,5,15,0,16,278
33001965700,4915,4568,82,13,6,18,2,17,347
33001965801,3239,2977,59,15,2,51,0,4,262
33001965802,4075,3770,87,9,6,10,3,12,305
33001965900,4092,3651,132,40,19,54,0,8,441
33001966000,5052,4467,143,76,14,88,2,8,585
33001966100,4493,4099,112,37,16,46,0,6,394
33001966200,3234,2963,70,26,6,47,1,0,271
33001966401,1460,1388,25,0,2,7,2,0,72
33001966403,3957,3647,89,17,7,48,0,13,310
33001966404,2282,2149,39,4,3,6,0,19,133
33001966501,3082,2904,25,9,4,21,0,22,178
33001966502,2812,2634,42,5,9,22,0,6,178
33003955101,2062,1956,21,4,5,13,0,10,106
33003955102,2366,2264,31,8,0,4,0,3,102
33003955301,2779,2609,42,9,5,35,0,7,170
33003955302,2970,2733,63,11,6,37,0,6,237
33003955401,2311,2120,33,0,19,25,0,6,191
33003955402,2103,1959,41,4,2,37,1,9,144
33003955500,2970,2800,60,10,4,4,4,22,170
33003955601,2749,2594,34,2,5,8,0,11,155
33003955602,2288,2136,33,6,6,20,0,17,152
33003955801,1691,1578,28,4,9,11,0,7,113
33003955802,1689,1607,12,0,0,7,0,4,82
33003955901,2191,2001,39,8,7,21,0,8,190
33003955902,2181,2016,17,15,3,12,0,6,165
33003956000,5956,5604,72,19,12,27,1,21,352
33003956101,3472,3267,71,4,7,16,0,12,205
33003956102,2944,2772,33,14,2,28,0,14,172
33003956301,2239,2091,51,7,5,22,0,6,148
33003956302,2679,2484,54,6,3,20,0,25,195
33003956400,2467,2356,34,0,0,11,0,12,111
33005970100,4185,3865,84,6,6,14,0,13,320
33005970200,3633,3343,84,19,5,16,1,7,290
33005970401,2516,2294,65,6,4,31,3,22,222
33005970402,2881,2670,46,13,4,18,0,11,211
33005970500,5320,4800,125,22,11,95,0,29,520
33005970600,6476,5811,199,160,17,71,5,16,665
33005970700,3548,3208,96,9,11,15,1,26,340
33005970800,4226,3913,59,28,10,40,1,21,313
33005970901,4355,4006,90,12,7,44,2,23,349
33005970902,2915,2572,65,23,3,87,1,11,343
33005971000,5900,5330,116,44,16,178,1,17,570
33005971100,5120,4514,169,67,7,78,1,17,606
33005971300,3606,3098,153,60,3,75,2,18,508
33005971402,3962,3581,80,44,1,119,0,9,381
33005971403,4459,4011,155,62,3,75,3,23,448
33005971500,5258,4929,62,14,10,32,0,23,329
33005971600,3948,3537,59,28,9,47,24,13,411
33005971700,4150,3782,95,31,19,32,1,6,368
33007950100,1907,1818,21,8,4,2,0,4,89
33007950200,2743,2571,52,10,3,22,2,4,172
33007950300,2040,1951,37,1,3,7,0,3,89
33007950400,3267,3048,41,17,11,8,0,8,219
33007950500,3218,3009,47,17,6,19,0,13,209
33007950600,4135,3317,233,388,25,20,0,4,818
33007950700,3089,2871,70,14,2,22,1,6,218
33007950800,2201,2006,43,3,9,21,0,4,195
33007950900,3053,2869,46,14,8,28,0,5,184
33007951000,2192,2049,36,2,0,21,0,2,143
33007951100,3423,3120,46,20,13,23,0,18,303
33009960101,2912,2609,106,14,6,38,0,18,303
33009960102,3093,2837,107,9,7,24,1,7,256
33009960200,4214,3882,91,11,8,44,1,28,332
33009960300,4885,4576,78,25,11,13,1,10,309
33009960401,2708,2512,56,8,5,21,3,5,196
33009960402,2141,1939,53,9,1,66,0,9,202
33009960500,2633,2436,38,6,4,20,0,20,197
33009960600,4585,4304,75,19,5,29,1,3,281
33009960700,2851,2677,24,6,0,12,0,8,174
33009960801,3343,3045,79,20,4,19,0,15,298
33009960802,1591,1473,13,0,5,8,0,6,118
33009960900,3285,3043,43,15,0,39,2,7,242
33009961001,3338,2877,143,35,10,105,1,9,461
33009961002,3344,2943,102,34,11,70,2,24,401
33009961101,1938,1796,36,1,0,15,3,12,142
33009961102,2004,1871,28,9,3,19,1,5,133
33009961201,2939,2691,59,13,13,34,0,9,248
33009961202,1465,1382,18,6,0,5,0,0,83
33009961300,3438,3168,47,7,12,22,1,23,270
33009961400,3794,3443,54,16,7,41,0,6,351
33009961500,4465,4101,96,27,6,41,3,26,364
33009961601,2792,2266,93,20,3,222,0,12,526
33009961603,5896,4664,374,125,33,416,0,8,1232
33009961604,3182,2383,196,64,4,356,0,23,799
33009961701,4672,3433,210,138,7,638,2,29,1239
33009961702,3596,2903,139,51,6,280,0,22,693
33009961801,2102,1839,78,6,3,76,0,13,263
33009961802,3912,3277,143,89,6,182,2,11,635
33011000103,5418,4553,304,135,9,200,0,22,865
33011000104,3019,2614,131,54,4,65,4,17,405
33011000202,2451,1842,333,99,4,52,2,17,609
33011000203,3057,2496,207,112,5,104,0,14,561
33011000204,5684,4379,441,272,13,360,0,5,1305
33011000300,3081,2208,425,189,6,93,2,26,873
33011000600,2344,1667,305,177,3,49,2,22,677
33011000700,3119,2686,167,57,3,52,0,22,433
33011000800,2442,1873,246,104,12,44,0,10,569
33011000901,3563,2849,213,179,6,126,0,34,714
33011000902,5636,4207,419,401,8,375,1,21,1429
33011001000,6318,5420,306,136,0,202,4,22,898
33011001100,5418,4575,248,128,9,266,1,15,843
33011001200,2013,1685,163,55,3,54,0,0,328
33011001300,3277,2025,675,282,6,94,1,11,1252
33011001400,2528,1402,633,315,9,48,0,7,1126
33011001500,3235,1364,1165,445,4,113,0,4,1871
33011001600,4185,2237,1088,384,25,264,2,36,1948
33011001700,2234,1465,392,158,3,115,2,3,769
33011001800,6117,4286,1000,267,12,264,0,32,1831
33011001900,3402,1982,803,238,17,162,1,32,1420
33011002000,2300,1385,438,188,5,151,0,16,915
33011002100,5293,3683,712,330,18,189,0,48,1610
33011002200,3297,2766,232,84,8,66,1,6,531
33011002300,3747,2787,340,183,11,223,0,5,960
33011002400,7564,5461,1002,450,8,276,2,36,2103
33011002500,5510,4378,492,107,10,317,0,23,1132
33011002600,5862,4828,351,120,4,298,0,18,1034
33011002701,3968,3713,76,13,7,22,1,9,255
33011002702,6298,5757,161,62,11,62,0,17,541
33011002801,1436,1315,39,5,5,13,2,1,121
33011002802,6875,6018,352,133,7,142,3,23,857
33011002901,8202,6937,249,68,10,598,4,26,1265
33011002902,6771,5910,220,62,12,289,0,31,861
33011002903,8349,7240,279,51,4,426,1,25,1109
33011010100,5310,4329,394,98,4,218,6,34,981
33011010201,4410,3005,379,138,5,551,5,57,1405
33011010202,2516,1676,418,75,11,158,0,58,840
33011010301,4788,3916,225,92,4,320,1,31,872
33011010302,4322,3426,362,109,4,214,3,33,896
33011010400,5042,4105,507,95,4,89,0,43,937
33011010500,4717,2870,1280,168,13,96,0,49,1847
33011010600,6716,4022,1875,262,11,179,2,53,2694
33011010700,1671,1105,377,53,4,58,0,5,566
33011010801,2429,1210,926,97,5,45,1,24,1219
33011010802,5820,2903,2191,235,15,138,0,41,2917
33011010900,6275,4319,1268,180,8,159,1,55,1956
33011011000,4874,4032,383,88,12,168,2,20,842
33011011101,3771,2291,351,173,7,695,0,59,1480
33011011102,3466,2063,376,109,2,631,2,77,1403
33011011200,7432,5239,257,95,6,1555,1,48,2193
33011011300,4399,3751,269,51,0,121,1,25,648
33011011401,5682,4209,275,90,2,875,0,31,1473
33011011402,5165,3578,475,158,6,746,2,42,1587
33011011500,2517,2176,99,17,7,96,2,32,341
33011012101,5157,4501,185,94,1,185,2,24,656
33011012102,3285,2965,97,33,4,54,4,16,320
33011012201,1899,1623,120,35,4,36,0,8,276
33011012202,5635,4755,361,81,10,138,2,23,880
33011012301,5392,4741,194,42,1,221,1,25,651
33011012302,4026,3540,194,28,7,79,1,17,486
33011013101,3807,3467,130,27,7,29,0,25,340
33011013102,4671,4293,134,26,7,45,0,10,378
33011014101,3825,3276,193,80,4,92,5,21,549
33011014102,2530,2145,91,44,7,113,0,19,385
33011014201,5957,5357,209,37,6,96,0,38,600
33011014202,6391,5760,198,27,13,125,0,44,631
33011014301,2052,1808,48,21,0,67,0,13,244
33011014302,5877,5201,252,36,5,102,3,33,676
33011015100,5451,4932,164,34,1,84,1,37,519
33011015200,6302,5677,209,37,6,120,1,34,625
33011016100,3013,2705,128,19,2,32,0,13,308
33011016202,5471,4901,145,51,8,67,2,25,570
33011016203,3723,3184,171,92,8,75,2,28,539
33011016204,3924,3432,149,63,0,65,0,17,492
33011017101,3643,3182,91,21,8,160,2,14,461
33011017102,4699,4150,149,24,0,193,0,13,549
33011018001,2419,2172,50,13,5,63,1,11,247
33011018002,3220,2841,100,19,0,53,3,24,379
33011018501,1974,1781,70,5,6,16,0,0,193
33011018502,1448,1330,47,0,0,6,0,10,118
33011019000,3896,3565,102,9,0,16,3,20,331
33011019501,1702,1551,44,2,5,8,0,15,151
33011019502,2584,2302,91,18,3,31,0,18,282
33011020000,6108,5611,128,45,13,28,1,36,497
33011021001,5152,4791,98,8,14,18,0,22,361
33011021002,3940,3655,75,19,4,14,1,19,285
33011021500,5015,4643,89,21,13,24,0,27,372
33011022000,1716,1578,38,15,0,11,1,5,138
33011022501,2623,2387,95,16,4,15,0,16,236
33011022502,4322,4018,82,17,2,29,3,28,304
33011023001,3716,3411,94,16,5,42,1,9,305
33011023002,2702,2379,158,16,1,17,3,20,323
33011024000,1731,1610,25,5,1,11,0,16,121
33011025000,2651,2420,51,6,3,15,0,13,231
33011025501,3060,2762,92,24,6,10,2,13,298
33011025502,3141,2871,70,11,8,19,0,9,270
33011200101,3167,2854,77,27,0,96,0,24,313
33011200201,2670,2369,130,27,5,34,0,3,301
33011200300,4852,4308,214,36,8,118,0,20,544
33011200400,3530,2505,426,267,4,175,2,21,1025
33011200500,3533,3125,146,24,0,80,0,14,408
33011980101,0,0,0,0,0,0,0,0,0
33013003001,4350,3895,177,53,4,50,1,9,455
33013003006,3907,3410,119,70,10,99,7,19,497
33013003100,4707,4271,94,37,11,38,0,13,436
33013003201,5064,4613,120,50,2,39,2,20,451
33013003202,2143,1946,63,12,7,29,0,14,197
33013030000,3005,2786,53,19,3,18,0,10,219
33013031001,4249,3904,96,7,3,41,0,24,345
33013031002,3980,3676,95,10,2,79,1,12,304
33013032100,3766,3383,104,24,5,110,3,11,383
33013032200,2728,2253,88,111,9,78,1,25,475
33013032300,1763,1572,63,22,2,18,0,2,191
33013032400,3237,2813,107,68,18,69,1,16,424
33013032500,3802,3382,76,67,9,113,0,18,420
33013032600,4917,4211,270,289,7,45,0,11,706
33013032701,1548,1406,41,11,4,12,0,7,142
33013032706,3889,3346,119,97,7,144,0,21,543
33013032800,5182,4616,109,55,4,188,3,18,566
33013032900,4345,2820,134,562,10,601,0,38,1525
33013033000,2665,2496,37,7,7,4,0,10,169
33013034000,4834,4511,80,18,0,21,0,15,323
33013035000,4075,3647,100,30,18,20,0,5,428
33013036000,5576,5154,78,54,11,28,0,12,422
33013037000,2389,2184,68,14,3,9,0,9,205
33013038000,3998,3717,76,44,0,19,3,14,281
33013038500,4850,4479,114,32,19,27,3,21,371
33013039000,5914,5503,133,21,7,34,0,32,411
33013040000,6185,5333,217,226,25,84,17,6,852
33013040501,1662,1573,35,1,4,4,0,5,89
33013040502,4150,3887,52,7,9,36,9,16,263
33013041001,1813,1682,35,8,0,14,0,8,131
33013041002,2587,2368,46,37,8,36,2,5,219
33013041500,3674,3405,53,14,5,20,0,18,269
33013042500,3828,3583,45,2,7,14,1,11,245
33013043001,4242,3786,119,42,9,27,1,20,456
33013043002,4499,4130,97,13,8,25,0,11,369
33013044000,4872,4444,91,39,5,56,0,23,428
33013044100,3694,2993,86,191,17,231,1,22,701
33013044200,6614,5714,211,44,7,358,0,14,900
33013044300,5105,4360,179,128,24,175,3,10,745
33015003301,4590,4132,194,47,7,39,0,18,458
33015003302,4856,4226,236,56,8,82,1,22,630
33015003400,5735,4979,311,83,10,108,0,27,756
33015003500,5974,5152,345,68,5,90,1,35,822
33015003601,7152,6325,305,78,11,113,1,28,827
33015003602,6010,5415,189,50,6,93,2,41,595
33015003701,4099,3629,207,40,1,54,1,25,470
33015003703,5892,5273,172,57,2,181,0,39,619
33015003801,4047,3632,119,30,5,75,1,11,415
33015003802,4236,3801,132,35,3,82,5,5,435
33015003901,4205,3780,171,23,4,52,4,9,425
33015003902,3341,2985,170,21,1,49,0,2,356
33015004000,5946,5498,128,13,8,72,1,25,448
33015050000,4013,3702,82,21,0,53,0,24,311
33015051000,5232,4866,133,0,2,45,2,23,366
33015052000,6548,6060,185,20,4,34,4,35,488
33015053000,4408,4076,106,28,10,28,1,7,332
33015054000,4739,4411,108,17,7,18,3,25,328
33015055001,6263,5721,127,39,10,55,0,17,542
33015055002,4421,4090,116,17,14,16,0,9,331
33015056000,4855,4552,86,9,1,13,0,14,303
33015057000,4641,4302,86,16,10,39,3,9,339
33015058000,5229,4810,103,20,1,47,1,33,419
33015059000,7125,6539,131,25,13,82,0,35,586
33015060000,4490,4148,79,27,6,68,0,25,342
33015061001,6903,6137,201,50,11,176,1,15,766
33015062000,2441,2286,52,5,1,7,0,18,155
33015062500,2989,2772,54,11,1,29,0,15,217
33015063001,3466,3104,92,29,10,42,3,25,362
33015063003,4017,3703,89,35,7,27,0,4,314
33015063004,918,878,14,1,0,3,0,0,40
33015064000,2403,2214,36,13,2,43,2,8,189
33015065005,2621,2473,55,5,3,24,0,0,148
33015065006,1762,1653,29,3,4,9,1,7,109
33015065007,1613,1503,44,2,0,27,0,4,110
33015065008,1887,1719,59,16,1,18,1,7,168
33015065009,3775,3499,78,8,2,66,1,17,276
33015065010,4556,4165,127,19,5,68,2,16,391
33015066000,4538,4207,75,20,7,81,0,18,331
33015067000,7669,6961,169,16,4,237,0,32,708
33015067502,3601,3194,118,39,5,94,9,14,407
33015067503,2877,2439,109,30,3,159,4,1,438
33015067504,2952,2676,74,15,0,86,0,6,276
33015067505,1769,1651,28,1,1,23,0,7,118
33015069100,4240,3920,119,24,8,53,1,9,320
33015069200,2931,2696,63,13,10,45,3,16,235
33015069300,2202,1990,61,18,2,37,0,6,212
33015069700,3475,3096,104,24,2,147,0,3,379
33015071001,3226,3043,73,7,0,29,0,15,183
33015071002,2317,2162,37,3,1,10,0,29,155
33015100100,6944,6271,237,48,14,167,0,17,673
33015100200,5509,4784,341,39,8,157,0,8,725
33015100301,4927,4231,283,44,6,209,0,19,696
33015100302,4519,3391,560,93,3,286,5,41,1128
33015100401,4659,3949,370,44,4,145,0,13,710
33015100402,3531,3095,163,29,2,104,0,13,436
33015101101,4882,4496,171,30,4,36,0,29,386
33015101102,2948,2624,156,24,3,36,0,1,324
33015102100,4820,4408,148,28,6,33,0,26,412
33015103100,7087,6617,199,25,0,96,0,17,470
33015104101,4932,4524,158,26,6,31,0,15,408
33015104102,4066,3785,102,10,2,38,1,18,281
33015105100,6202,5757,146,32,12,22,2,27,445
33015106101,8159,7040,295,59,7,432,0,33,1119
33015106102,7658,6836,208,35,7,255,1,37,822
33015106200,4464,4039,111,44,5,89,4,12,425
33015106400,4682,4230,97,24,0,149,0,14,452
33015107100,2590,1997,141,47,5,230,0,9,593
33015107200,6262,5236,251,86,3,440,3,24,1026
33015107400,1256,1092,37,16,6,58,0,11,164
33015107500,4878,4447,101,46,0,106,4,17,431
33015980011,6,5,1,0,0,0,0,0,1
33015990000,0,0,0,0,0,0,0,0,0
33017080100,2911,2614,56,13,4,91,2,6,297
33017080202,2766,2374,71,30,1,186,2,1,392
33017080203,5600,4645,287,105,28,286,6,4,955
33017080204,4213,3413,239,59,18,262,0,3,800
33017080500,6438,5726,149,31,6,231,3,30,712
33017081101,4813,3834,196,97,10,429,1,21,979
33017081102,2100,1880,47,26,1,56,0,4,220
33017081200,5188,4581,112,55,0,198,2,23,607
33017081300,4963,4327,174,68,5,164,0,13,636
33017081400,2309,1945,79,49,0,153,0,9,364
33017081500,5701,4700,154,67,12,489,0,18,1001
33017081600,7667,6516,285,158,11,304,2,46,1151
33017082000,2597,2392,74,19,6,13,1,3,205
33017083001,6750,5597,292,138,20,305,3,30,1153
33017083002,5105,4034,217,60,6,561,3,29,1071
33017084100,5754,5132,123,60,5,137,4,10,622
33017084201,4471,4035,120,30,8,62,0,5,436
33017084202,3684,3396,79,21,8,41,0,2,288
33017084301,2866,2523,124,43,6,36,0,14,343
33017084302,3946,3422,156,48,7,83,1,9,524
33017084400,4360,3809,197,75,6,58,5,0,551
33017084500,4380,3949,123,31,6,60,0,18,431
33017084600,3031,2738,94,19,11,41,0,12,293
33017085001,3895,3570,71,23,5,40,0,7,325
33017085002,5431,4997,104,16,3,66,0,17,434
33017086000,4230,3952,65,13,3,20,2,18,278
33017087001,3840,3431,92,36,23,38,3,11,409
33017087002,2882,2682,26,10,10,10,1,14,200
33017088000,4482,4138,62,18,13,35,1,17,344
33017088500,4516,4247,46,16,9,18,0,9,269
33019975100,4075,3714,71,21,3,54,0,21,361
33019975200,5464,4984,99,18,17,67,1,34,480
33019975300,3342,3057,66,8,6,37,0,30,285
33019975401,3030,2716,72,13,6,19,0,5,314
33019975402,3269,3037,49,4,10,17,1,9,232
33019975500,3106,2882,56,7,7,6,0,14,224
33019975600,3022,2791,52,18,12,12,1,13,231
33019975700,4806,4414,73,22,16,21,0,11,392
33019975800,4705,4236,95,27,12,71,1,5,469
33019975901,4438,3970,85,15,24,51,2,21,468
33019975902,3806,3322,104,32,21,48,0,18,484
34001000100,2334,529,919,286,5,540,0,16,1805
34001000200,2897,1153,765,120,1,750,2,28,1744
34001000300,4027,463,1895,315,6,1276,5,25,3564
34001000400,3243,1236,906,365,3,638,0,12,2007
34001000500,3012,275,1331,105,0,1220,0,7,2737
34001001100,2021,72,267,1516,5,58,1,21,1949
34001001200,2834,127,538,1975,7,32,0,29,2707
34001001300,1901,145,339,1291,9,16,2,12,1756
34001001400,3887,229,1218,2275,10,54,3,8,3658
34001001500,1912,122,433,1171,7,87,1,15,1790
34001001900,1324,278,295,633,3,50,0,10,1046
34001002300,2758,222,1468,182,0,822,0,21,2536
34001002400,2420,551,402,1036,7,288,3,34,1869
34001002500,3927,817,737,1809,9,377,0,25,3110
34001010101,2977,2687,102,29,3,70,1,16,290
34001010102,1341,1211,51,13,0,15,0,11,130
34001010104,1198,1020,85,29,0,36,1,4,178
34001010105,2200,1530,250,84,0,264,0,8,670
34001010200,6606,4966,641,463,10,242,3,33,1640
34001010300,2531,965,445,572,3,449,0,20,1566
34001010401,5779,4473,549,334,9,149,2,22,1306
34001010403,7313,3206,1175,843,2,1783,1,49,4107
34001010501,7540,6146,496,323,2,274,1,27,1394
34001010503,7549,2928,1485,2111,6,671,3,49,4621
34001010505,2986,2133,322,176,2,210,1,17,853
34001010506,5253,3348,647,322,12,645,0,20,1905
34001010600,4396,1979,1223,840,3,117,1,32,2417
34001010700,5816,4319,1005,224,2,38,4,28,1497
34001010800,3091,2298,631,65,1,23,2,5,793
34001010900,5868,4026,1329,237,3,103,3,11,1842
34001011000,2645,1986,546,33,0,10,0,12,659
34001011100,3107,1954,1011,62,6,21,0,5,1153
34001011201,1811,1505,174,47,5,6,2,13,306
34001011202,7033,4996,909,737,6,59,1,29,2037
34001011300,4501,2507,1449,319,7,79,4,3,1994
34001011401,4729,3638,522,242,21,70,5,28,1091
34001011403,6325,2226,1238,1897,6,660,0,56,4099
34001011404,9976,5476,1483,1761,13,776,2,30,4500
34001011500,6454,4041,817,990,8,153,0,41,2413
34001011600,4753,4157,255,118,5,25,0,21,596
34001011702,3660,1266,1305,657,12,258,3,36,2394
34001011703,5392,2060,1057,638,8,1396,0,20,3332
34001011704,4737,1720,1318,511,13,988,3,32,3017
34001011803,5691,3154,1213,631,13,429,1,42,2537
34001011804,7289,5531,750,348,17,266,2,31,1758
34001011805,2268,1836,208,66,0,37,0,16,432
34001011806,7947,5521,808,474,8,764,4,42,2426
34001011807,5787,3275,842,463,6,954,0,24,2512
34001011808,4135,2188,655,418,4,684,0,14,1947
34001011901,3393,137,1946,1155,5,36,0,28,3256
34001011902,4807,723,1838,1910,15,143,0,32,4084
34001012000,4444,695,2119,1215,5,282,0,16,3749
34001012100,3044,406,1753,709,1,109,3,10,2638
34001012200,5729,394,2838,2276,3,89,1,16,5335
34001012302,3322,2493,397,71,0,251,0,10,829
34001012401,2989,2253,394,97,3,123,3,7,736
34001012402,2123,1721,183,29,0,91,3,8,402
34001012501,2290,1892,130,40,0,134,1,1,398
34001012502,1675,1413,84,25,0,85,0,3,262
34001012602,1474,1262,75,13,2,61,0,4,212
34001012701,3326,2388,422,213,1,156,0,14,938
34001012702,1719,1215,226,178,5,22,0,4,504
34001012801,3706,2491,601,375,6,93,2,14,1215
34001012802,1718,1491,125,29,1,19,0,8,227
34001013000,3152,2940,88,7,4,32,0,11,212
34001013101,993,936,24,0,0,13,0,2,57
34001013102,1172,1070,71,4,0,8,0,3,102
34001013201,2224,1253,499,71,0,313,0,15,971
34001013202,2287,1599,338,63,4,179,1,13,688
34001013301,2185,1686,294,65,0,76,0,7,499
34001013302,2514,1940,303,43,2,144,1,6,574
34001013500,2573,2322,88,14,4,67,0,1,251
34001983400,2494,1647,368,264,8,105,0,0,847
34001990000,0,0,0,0,0,0,0,0,0
34003001001,3363,2529,242,17,0,441,2,18,834
34003001002,3485,2732,214,25,1,396,0,4,753
34003002100,1762,949,121,54,0,593,0,5,813
34003002200,5168,3041,602,65,0,1305,0,14,2127
34003002300,5641,3196,418,74,4,1809,0,8,2445
34003003100,5337,1604,1802,353,0,1434,0,49,3733
34003003200,4829,1169,1652,301,4,1566,0,48,3660
34003003300,7045,1865,2536,428,7,2018,0,35,5180
34003003401,2983,1781,564,115,3,414,0,50,1202
34003003402,3897,2108,714,250,0,734,0,33,1789
34003003500,4170,744,1833,447,16,1028,0,26,3426
34003004001,3528,1062,1817,236,6,290,2,42,2466
34003004002,5250,1552,2689,349,9,458,0,51,3698
34003005000,6372,3855,1582,132,10,608,0,41,2517
34003006101,4153,1903,1126,128,0,792,2,91,2250
34003006102,3278,1509,1191,64,2,349,0,50,1769
34003006201,4769,2064,1639,117,1,752,1,43,2705
34003006202,4710,2674,704,122,4,1086,0,35,2036
34003006301,4597,1229,2692,124,16,311,0,93,3368
34003006302,4186,1806,1602,101,0,494,2,42,2380
34003007001,3920,2047,434,40,2,1257,0,7,1873
34003007002,4674,2449,291,43,0,1752,0,23,2225
34003008001,4770,2780,331,53,3,1468,1,23,1990
34003008002,4385,2525,299,37,0,1397,0,14,1860
34003009100,4981,2941,270,41,1,1562,1,24,2040
34003009200,3343,2416,191,51,0,545,0,12,927
34003010100,6335,3528,1320,171,7,1106,0,51,2807
34003010200,4131,2172,1040,126,3,675,2,21,1959
34003010300,7457,4154,1543,206,2,1328,0,24,3303
34003011100,4832,1969,1490,460,15,737,0,60,2863
34003011200,5023,2370,1347,498,6,570,0,112,2653
34003011300,4979,2664,1370,241,0,547,0,30,2315
34003011400,6588,3925,1691,295,4,513,0,36,2663
34003012001,6326,3007,1879,347,6,849,2,58,3319
34003012002,3696,2021,677,109,22,763,0,41,1675
34003013002,6554,3021,1030,372,8,1833,0,37,3533
34003013003,4231,1653,394,186,5,1837,1,24,2578
34003013004,3551,1260,535,214,0,1401,0,26,2291
34003014000,7290,5328,948,108,4,709,0,15,1962
34003015100,2506,1896,210,131,0,192,0,31,610
34003015200,6255,1123,2627,1771,6,424,7,78,5132
34003015300,6257,214,2630,2927,20,216,0,77,6043
34003015401,4819,802,2448,1078,8,336,0,30,4017
34003015402,3282,854,708,580,5,1041,0,31,2428
34003015500,6189,3608,1016,693,7,654,1,68,2581
34003016000,5342,2201,341,107,0,2534,0,21,3141
34003017101,5375,4200,460,50,3,513,1,24,1175
34003017102,2190,1666,223,55,0,193,0,20,524
34003017200,6701,4083,1318,199,2,902,0,34,2618
34003017301,3280,2036,635,120,0,402,0,20,1244
34003017302,3059,2117,476,51,0,320,3,30,942
34003017400,5861,4062,716,122,4,825,0,19,1799
34003017501,4575,2848,769,107,8,701,5,26,1727
34003017502,3886,2293,772,80,7,612,1,17,1593
34003018101,5023,987,3688,67,7,109,0,82,4036
34003018102,2959,627,2087,42,2,105,0,51,2332
34003018200,7043,1899,4243,131,18,480,0,105,5144
34003019102,3022,1032,482,93,2,1291,4,33,1990
34003019103,4121,1168,673,271,0,1879,0,20,2953
34003019104,4099,1170,633,132,0,2057,0,16,2929
34003019202,3959,1248,544,170,2,1870,0,14,2711
34003019203,3269,1371,434,62,1,1328,5,8,1898
34003019204,3847,1407,490,86,3,1732,0,34,2440
34003019303,5764,1868,757,150,7,2812,0,46,3896
34003019304,2783,1125,536,43,0,1005,0,12,1658
34003019305,6995,3915,577,129,5,2194,0,41,3080
34003019306,2332,1184,250,56,1,781,0,12,1148
34003020100,4329,3421,353,72,2,366,1,19,908
34003020200,6750,5334,433,100,0,685,2,29,1416
34003021101,4437,2753,1355,117,0,105,0,29,1684
34003021102,2664,1632,767,101,2,92,0,15,1032
34003021200,5935,3497,1812,258,4,231,2,40,2438
34003021300,4841,2557,1809,225,12,130,1,39,2284
34003021400,4883,2513,1783,292,5,143,0,34,2370
34003021500,5253,1915,2721,342,16,157,0,32,3338
34003021600,4642,1531,2534,349,9,127,0,36,3111
34003022100,4220,3275,301,105,0,381,0,8,945
34003022200,7913,5762,547,58,0,1236,1,17,2151
34003023100,4026,719,1776,892,5,503,1,32,3307
34003023201,3927,1161,1298,915,9,406,0,32,2766
34003023202,3257,896,1199,672,9,361,0,36,2361
34003023301,2932,1237,792,529,5,269,0,26,1695
34003023303,2817,1110,590,606,6,335,0,41,1707
34003023304,2207,894,560,399,3,289,0,15,1313
34003023401,3635,924,974,838,2,794,2,36,2711
34003023402,6099,1117,2792,1312,14,686,0,54,4982
34003023501,3739,383,1656,1358,1,233,0,46,3356
34003023502,4649,1234,1946,947,4,413,2,28,3415
34003023601,3405,735,1825,441,2,318,0,32,2670
34003023602,5337,643,3812,649,2,127,2,57,4694
34003024100,5888,3673,380,59,3,1600,0,15,2215
34003024200,4741,3235,299,35,0,1049,0,14,1506
34003025100,6227,3416,1516,269,1,840,1,30,2811
34003025200,5898,4050,1035,64,6,581,0,43,1848
34003026100,4562,3594,430,63,0,375,1,21,968
34003026200,5581,4267,708,52,3,367,0,26,1314
34003027000,4258,3475,302,26,1,321,0,19,783
34003028001,5350,1638,1069,146,1,2350,0,19,3712
34003028002,3954,1618,600,56,1,1526,0,13,2336
34003029100,4233,1258,1012,228,3,1606,3,26,2975
34003029200,6754,2754,2456,241,3,1111,0,65,4000
34003030100,5640,2248,2333,408,1,497,0,41,3392
34003030201,4679,1696,2221,390,6,247,0,46,2983
34003030202,3447,1445,1389,226,2,264,0,36,2002
34003030300,4658,1805,2022,326,1,399,0,33,2853
34003030401,3495,1286,1249,433,0,423,0,24,2209
34003030402,4287,1933,1624,237,2,364,0,23,2354
34003031100,6652,3594,1780,364,4,664,0,65,3058
34003031200,4731,2846,1322,94,0,332,0,51,1885
34003031300,5415,3435,1474,106,0,236,0,47,1980
34003031400,5721,3513,1505,124,5,355,0,60,2208
34003032102,5886,4832,345,65,1,466,0,20,1054
34003032103,4724,3599,309,80,4,590,0,19,1125
34003032104,4269,2687,635,299,71,397,2,27,1582
34003032201,5537,4208,408,98,2,669,0,20,1329
34003032202,5071,3514,507,144,15,708,0,17,1557
34003033100,3851,2225,916,169,3,417,1,15,1626
34003033200,2628,1459,680,154,11,254,0,25,1169
34003033300,3601,1459,971,282,18,771,0,23,2142
34003034001,2807,2209,343,41,5,100,0,19,598
34003034002,4207,3540,391,29,1,141,0,15,667
34003035100,8436,6069,683,121,0,1324,1,17,2367
34003035200,6128,4955,407,46,2,536,1,28,1173
34003036100,2675,1053,1249,138,0,172,0,17,1622
34003036200,3133,1391,1292,20,0,351,0,27,1742
34003037100,5501,3235,1004,205,0,893,0,31,2266
34003037201,4180,2147,844,105,5,940,0,19,2033
34003037203,3928,2250,631,152,0,751,0,44,1678
34003037204,3314,1198,825,334,1,836,0,45,2116
34003038100,5837,3498,1730,54,1,364,0,47,2339
34003038200,4475,2095,1502,120,0,592,2,25,2380
34003038300,6145,3652,1877,83,6,217,0,94,2493
34003039100,4110,3177,396,36,12,308,0,13,933
34003039200,5742,4812,516,47,0,197,0,11,930
34003039300,2896,2381,298,36,0,100,1,6,515
34003040001,3575,2766,275,38,0,364,0,19,809
34003040002,4669,3123,459,35,7,913,0,20,1546
34003041100,5668,598,1471,77,0,3450,1,20,5070
34003041200,4597,552,871,40,2,3036,2,22,4045
34003041301,5380,845,1703,69,5,2668,1,18,4535
34003041302,4647,908,817,76,3,2746,2,33,3739
34003042101,3155,1889,349,47,1,763,0,25,1266
34003042102,4698,2822,454,69,0,1187,0,49,1876
34003042301,4410,2812,436,32,0,1026,0,15,1598
34003042302,5108,3045,462,150,0,1190,0,14,2063
34003042400,4561,2725,501,49,0,1164,0,16,1836
34003042500,4766,2263,608,112,2,1636,0,16,2503
34003043001,4158,3389,318,18,0,317,0,15,769
34003043002,4725,3583,618,73,2,314,0,18,1142
34003044100,6030,5037,433,26,0,344,0,21,993
34003044201,3741,3021,378,20,4,203,1,25,720
34003044202,5027,3653,563,81,0,587,0,18,1374
34003045101,4516,1847,1265,63,0,1187,0,52,2669
34003045102,3996,1548,1206,113,2,997,1,40,2448
34003045200,2989,886,872,24,8,1135,3,15,2103
34003046100,4215,1465,1883,218,0,522,1,35,2750
34003046200,4390,1597,2122,152,4,384,0,28,2793
34003046300,4619,1415,2184,279,4,554,0,30,3204
34003047100,6135,3967,507,80,1,1342,0,13,2168
34003047200,4481,3294,268,29,3,675,0,21,1187
34003047300,3287,2486,221,19,0,365,0,27,801
34003047400,5158,3381,601,173,2,763,0,24,1777
34003047500,6918,4658,472,52,1,1411,0,26,2260
34003048100,4355,1783,606,206,8,1635,0,14,2572
34003048200,7694,4866,733,77,0,1799,0,36,2828
34003049001,4624,3722,353,52,5,388,0,12,902
34003049002,5285,4034,378,65,3,605,1,18,1251
34003050000,5814,3254,1575,208,3,602,0,28,2560
34003051100,6416,3698,1135,371,13,950,0,34,2718
34003051200,2665,1818,445,27,0,258,0,11,847
34003051300,4764,2573,986,132,14,837,3,30,2191
34003051400,4989,3153,829,101,0,643,3,49,1836
34003052100,7873,5620,1421,138,0,546,2,20,2253
34003052200,6421,3934,1327,304,6,673,0,42,2487
34003053100,3372,2550,181,65,11,451,2,14,822
34003053201,4770,3492,319,92,1,708,0,16,1278
34003053202,3583,2628,260,37,0,532,1,17,955
34003054101,4247,151,1068,2559,9,283,0,44,4096
34003054102,4033,1477,796,1182,0,366,0,46,2556
34003054200,4931,1365,1355,1607,13,365,2,49,3566
34003054300,7216,6013,349,361,3,165,0,147,1203
34003054400,7217,2775,1881,1315,4,857,4,104,4442
34003054500,4879,2596,935,674,3,384,1,127,2283
34003054601,3419,834,1177,621,2,676,0,28,2585
34003054602,5304,1634,1287,861,12,1282,1,45,3670
34003055100,7275,4657,490,103,3,1710,8,54,2618
34003055201,4078,2317,333,64,5,1219,0,1,1761
34003055202,4056,1745,314,73,0,1782,4,32,2311
34003056100,4754,3669,607,58,0,289,0,14,1085
34003056200,5304,4032,708,68,6,351,0,17,1272
34003057101,4108,2543,790,217,5,468,0,31,1565
34003057102,4271,3323,655,33,2,151,0,51,948
34003057200,3489,2420,854,70,4,75,6,9,1069
34003058100,3777,3018,367,40,3,252,0,17,759
34003058200,5508,4567,433,47,5,314,0,10,941
34003059100,5222,3283,780,365,2,593,1,17,1939
34003059200,6060,4578,871,83,4,335,5,16,1482
34003060001,3889,2451,856,85,2,406,0,16,1438
34003060002,6335,3731,914,256,3,1212,1,60,2604
34003061100,4456,3710,330,17,4,224,2,4,746
34003061200,3406,2963,215,17,0,114,0,6,443
34003061300,3642,2895,451,33,0,164,1,2,747
34003061400,5081,4199,319,26,0,370,0,11,882
34005700102,2569,2093,180,127,4,30,6,2,476
34005700103,2985,2134,239,379,3,80,0,13,851
34005700104,1884,852,291,488,2,56,2,30,1032
34005700200,2764,2370,139,92,4,24,0,16,394
34005700303,4067,2455,355,754,8,134,4,54,1612
34005700304,2541,2054,162,141,0,52,0,19,487
34005700305,5017,4283,234,150,6,166,0,41,734
34005700306,2593,2265,94,66,0,58,0,7,328
34005700307,2846,2484,77,92,0,100,0,3,362
34005700401,2046,1704,147,35,2,40,1,9,342
34005700402,3352,2836,280,46,0,41,0,11,516
34005700403,4373,3568,380,128,0,104,3,14,805
34005700405,1683,1323,156,71,3,58,0,4,360
34005700407,6136,2053,1388,1736,14,528,11,43,4083
34005700408,2390,1171,207,342,3,532,0,15,1219
34005700501,5432,4133,364,400,2,287,0,13,1299
34005700502,2224,1800,147,65,1,130,0,10,424
34005700503,3835,2893,165,400,11,144,0,17,942
34005700504,3192,2547,169,147,0,150,0,41,645
34005700505,6672,4731,158,159,6,1357,0,13,1941
34005700602,6516,4681,376,555,4,392,0,151,1835
34005700603,6361,4169,513,855,14,148,5,203,2192
34005700605,5005,3789,257,236,1,118,0,138,1216
34005700701,3089,2134,422,198,2,28,0,72,955
34005700702,2458,1264,536,186,1,47,0,144,1194
34005700703,2456,1458,449,184,3,23,5,136,998
34005700800,4824,3231,382,804,6,82,4,26,1593
34005700900,2499,1193,373,653,0,43,2,46,1306
34005701001,5013,2199,816,1371,38,151,0,145,2814
34005701002,3917,1877,494,1148,5,119,0,54,2040
34005701102,5715,2844,534,1509,6,521,7,36,2871
34005701103,6434,3029,600,1787,2,702,0,46,3405
34005701104,5428,2179,456,1943,2,545,5,54,3249
34005701105,6406,2802,508,1962,12,815,4,38,3604
34005701201,2948,1464,344,839,4,84,2,18,1484
34005701203,2142,1063,218,697,7,61,1,15,1079
34005701204,2471,636,301,1365,0,50,0,10,1835
34005701205,2182,1250,235,508,13,34,0,16,932
34005701301,4704,2998,390,723,9,321,4,20,1706
34005701302,2611,2021,163,161,1,162,0,9,590
34005701303,5497,3437,344,728,7,747,0,20,2060
34005701401,6522,4446,491,679,10,615,0,27,2076
34005701402,2375,1971,78,88,1,187,0,12,404
34005701502,3999,2850,385,302,9,322,0,6,1149
34005701700,3993,3043,338,320,5,95,0,10,950
34005702101,3380,1808,678,416,9,109,24,36,1572
34005702203,3242,1432,520,910,9,110,3,21,1810
34005702204,2094,1097,305,461,11,48,0,7,997
34005702206,1745,1278,168,140,2,26,0,13,467
34005702207,3370,1923,480,546,0,121,5,17,1447
34005702208,6819,4360,843,825,10,159,5,53,2459
34005702209,2989,1841,366,396,16,72,10,25,1148
34005702210,4559,2465,639,861,12,158,6,14,2094
34005702300,1371,762,214,230,0,47,2,14,609
34005702400,3245,2708,205,102,7,72,3,11,537
34005702500,6191,3679,788,1047,8,265,1,44,2512
34005702601,4145,2470,618,615,6,106,4,37,1675
34005702603,2599,1306,503,546,1,38,0,26,1293
34005702701,2917,1045,292,1158,5,212,3,18,1872
34005702702,6204,3419,627,1301,3,457,0,35,2785
34005702801,2120,265,206,1484,7,26,6,25,1855
34005702802,3248,378,371,2252,11,44,0,25,2870
34005702803,3778,437,467,2636,3,37,10,35,3341
34005702804,2594,340,256,1824,0,31,0,16,2254
34005702805,3651,384,501,2484,6,79,0,15,3267
34005702806,3803,370,564,2570,14,77,4,45,3433
34005702807,3195,394,430,2036,22,94,1,52,2801
34005702808,3295,351,424,2241,5,74,0,25,2944
34005702809,2266,287,177,1596,10,52,3,24,1979
34005702810,1371,208,97,972,0,28,0,9,1163
34005702811,2568,264,272,1845,3,60,0,24,2304
34005702905,4810,3469,298,439,5,406,0,20,1341
34005702906,2223,1653,193,146,1,136,2,17,570
34005702907,2979,2492,125,124,4,109,0,20,487
34005702908,4398,3613,164,124,2,339,2,4,785
34005702909,6282,4023,372,665,2,931,5,23,2259
34005702910,6103,4082,390,674,12,656,3,20,2021
34005702913,4755,2512,369,842,4,758,1,24,2243
34005702914,4383,2957,290,370,9,515,0,18,1426
34005702915,4282,2298,441,862,11,412,1,32,1984
34005702917,2606,1632,202,334,3,287,0,49,974
34005702918,1812,1170,118,211,0,205,0,16,642
34005703000,6035,4654,397,433,7,264,1,24,1381
34005703102,2600,1971,155,231,0,162,0,2,629
34005703103,4979,2199,550,1554,10,317,2,27,2780
34005703104,5224,3460,409,835,7,195,3,5,1764
34005703201,3550,3026,216,84,5,51,7,12,524
34005703202,2642,2313,145,54,1,26,0,0,329
34005703203,4125,3777,105,119,1,42,2,7,348
34005703600,6776,6112,285,74,3,54,5,19,664
34005703700,6460,5816,265,79,7,48,1,12,644
34005703801,7215,6260,352,188,4,166,0,37,955
34005703802,4926,4211,281,105,7,122,2,5,715
34005703803,5062,4540,216,42,1,113,0,9,522
34005703804,7294,6495,258,94,2,181,0,18,799
34005703900,4264,3927,122,26,3,43,0,15,337
34005704004,3811,2691,299,232,0,396,2,20,1120
34005704005,3874,3082,188,221,0,245,0,12,792
34005704006,2342,1553,188,190,1,322,1,8,789
34005704007,3579,3043,151,88,0,131,3,13,536
34005704008,5100,4357,197,127,0,255,1,15,743
34005704009,4661,3413,355,385,5,294,1,15,1248
34005704011,3340,2861,124,81,1,124,2,5,479
34005704012,5865,4825,375,269,5,139,5,22,1040
34005704013,5263,4108,278,225,0,426,0,10,1155
34005704015,4068,2764,192,287,3,676,1,27,1304
34005704016,4923,3874,180,119,2,583,0,10,1049
34005704201,5303,4162,405,291,3,233,1,13,1141
34005704202,3015,1329,297,636,4,585,1,22,1686
34005704302,6298,3947,339,274,16,1502,0,33,2351
34005704500,5303,3877,667,373,5,114,2,15,1426
34005704600,3237,1336,601,964,9,113,8,15,1901
34005704700,3592,3096,216,65,7,18,1,8,496
34005704801,3455,1864,605,633,7,83,25,25,1591
34005981802,3124,531,666,1919,0,3,0,1,2593
34005982111,1142,625,233,157,4,47,9,11,517
34005982200,3855,1462,767,1449,15,68,9,7,2393
34007600200,1876,50,819,934,10,5,0,14,1826
34007600400,2910,109,1447,1263,1,13,2,13,2801
34007600700,1540,83,1022,393,1,8,1,4,1457
34007600800,4805,154,3293,1249,11,5,1,17,4651
34007600900,4059,79,3099,781,10,10,0,20,3980
34007601000,5365,135,4312,793,5,53,0,15,5230
34007601101,3027,42,2296,442,2,168,0,15,2985
34007601102,5111,123,3358,1112,1,426,1,28,4988
34007601200,5691,118,3857,1421,13,139,0,44,5573
34007601300,5330,170,3314,1634,2,80,0,29,5160
34007601400,4274,78,968,3091,10,13,0,9,4196
34007601500,5447,122,2004,3127,11,28,0,13,5325
34007601600,2134,40,662,1366,5,12,1,6,2094
34007601700,2875,59,1080,1669,4,4,0,9,2816
34007601800,1102,73,417,494,0,53,2,5,1029
34007601900,2804,36,1042,1605,11,17,0,7,2768
34007602000,6247,329,2399,3283,12,16,0,35,5918
34007602503,2621,185,1233,942,15,198,0,5,2436
34007602601,2936,896,941,557,4,439,0,21,2040
34007602602,3021,533,1308,651,1,430,0,6,2488
34007602901,4993,2600,1121,728,1,383,2,26,2393
34007602902,3224,1256,1027,650,9,117,0,30,1968
34007603001,3736,1897,989,478,9,224,0,18,1839
34007603002,5021,715,2431,1148,1,598,5,13,4306
34007603100,3820,2377,724,422,8,120,1,15,1443
34007603201,5006,2877,733,590,2,577,5,24,2129
34007603202,2693,1641,327,251,0,371,0,7,1052
34007603301,5993,3365,764,548,9,1044,0,61,2628
34007603302,6338,4251,606,424,5,767,0,35,2087
34007603303,2897,1657,320,320,3,451,0,13,1240
34007603400,7573,4652,603,714,12,1278,0,43,2921
34007603501,6669,3951,353,588,1,1525,6,28,2718
34007603503,4840,3579,229,184,0,660,0,26,1261
34007603504,2688,1898,193,168,0,336,0,4,790
34007603505,3381,2216,298,223,4,484,0,15,1165
34007603506,6560,4524,310,262,3,1197,2,35,2036
34007603507,7239,4926,485,369,1,1210,0,39,2313
34007603601,3951,2963,332,282,4,237,5,14,988
34007603602,2621,2282,95,26,1,110,0,18,339
34007603603,2465,2070,112,77,0,102,1,27,395
34007603700,3639,2266,678,246,3,319,0,17,1373
34007603800,5504,4922,208,95,2,93,0,12,582
34007603901,5044,4399,275,85,2,128,2,18,645
34007603902,3178,2603,173,115,0,177,0,13,575
34007604100,2902,351,1290,921,0,259,1,16,2551
34007604200,3183,2342,372,190,7,101,0,11,841
34007604300,3887,3254,225,143,3,83,0,16,633
34007604400,3255,2814,203,62,7,44,0,25,441
34007604600,2091,1541,238,162,0,54,0,8,550
34007604700,1839,1594,123,13,0,40,1,3,245
34007605100,2393,1945,197,48,4,62,0,9,448
34007605200,2732,1828,561,94,4,150,1,17,904
34007605300,1815,1380,209,83,0,65,0,1,435
34007605400,2666,2293,182,60,0,23,0,14,373
34007605602,2781,2457,163,48,4,12,1,9,324
34007605700,3538,3054,187,87,1,63,1,9,484
34007605800,2906,2634,90,33,3,42,1,14,272
34007605900,2608,2398,79,31,1,16,0,13,210
34007606000,1981,1767,85,22,1,29,0,18,214
34007606100,2480,2261,93,12,1,32,3,0,219
34007606200,4279,3705,169,33,1,179,0,9,574
34007606300,2359,2033,77,59,5,72,0,16,326
34007606400,3441,3025,121,30,4,82,0,22,416
34007606500,2955,189,340,2216,0,59,1,18,2766
34007606600,2280,1884,153,90,4,51,0,0,396
34007606700,4795,3817,308,354,13,111,0,18,978
34007606800,3960,2700,365,103,1,602,0,29,1260
34007607000,4745,3658,514,179,2,180,0,25,1087
34007607100,3742,3146,289,90,3,87,0,6,596
34007607200,4582,3403,463,331,12,225,0,11,1179
34007607300,4352,2787,497,722,3,123,1,29,1565
34007607401,2989,1708,372,599,4,154,1,6,1281
34007607402,2577,1403,315,538,8,195,0,11,1174
34007607502,5781,4152,326,366,0,732,4,38,1629
34007607503,7150,4343,373,717,4,1459,2,38,2807
34007607504,4086,2984,167,215,0,541,1,19,1102
34007607505,4640,3191,224,345,7,721,2,10,1449
34007607506,3185,1172,284,447,4,1154,0,9,2013
34007607507,6227,3339,446,792,7,1401,2,30,2888
34007607600,2189,1792,154,74,0,79,2,7,397
34007607701,6969,1047,3413,2198,8,139,1,39,5922
34007607702,6382,1753,2327,1895,9,115,0,32,4629
34007607801,5787,1906,861,2477,5,228,0,46,3881
34007607802,2503,1274,524,544,5,59,0,9,1229
34007607900,1978,1516,173,163,4,33,0,8,462
34007608001,3403,1894,515,561,3,253,1,17,1509
34007608202,4059,2728,330,701,5,112,2,5,1331
34007608205,3929,3332,168,255,3,88,0,1,597
34007608206,3534,2838,267,210,4,74,0,19,696
34007608209,4270,2254,441,1198,10,212,0,12,2016
34007608210,3640,1663,503,1005,8,224,0,79,1977
34007608211,6367,2666,745,1909,13,609,0,110,3701
34007608302,4746,3253,491,693,6,96,0,12,1493
34007608303,3079,2205,263,336,0,126,0,9,874
34007608304,6107,4513,461,578,10,273,1,34,1594
34007608401,3994,2889,340,443,0,114,3,11,1105
34007608402,4021,2459,230,912,10,232,0,5,1562
34007608403,7473,3659,690,2100,11,627,0,45,3814
34007608404,6402,3597,515,1706,20,235,0,37,2805
34007608503,2882,1108,451,1057,6,96,0,23,1774
34007608504,3300,1371,375,1241,5,97,0,38,1929
34007608600,5338,2779,944,1174,11,144,0,21,2559
34007608700,7489,6092,422,346,4,258,3,85,1397
34007608800,5867,4120,620,483,5,411,0,17,1747
34007608901,5794,4592,418,409,2,109,0,33,1202
34007608903,3212,2860,137,70,8,17,0,10,352
34007608904,1415,1276,61,14,0,7,0,3,139
34007609000,1536,636,228,593,0,10,0,7,900
34007609103,5663,3488,535,1220,2,136,0,29,2175
34007609201,4520,1848,552,1824,4,72,2,22,2672
34007609202,4847,860,629,2915,21,162,1,37,3987
34007609204,3966,502,516,2688,17,47,2,15,3464
34007609205,6440,3826,940,1235,6,153,1,19,2614
34007609206,5008,1783,595,2133,16,264,0,31,3225
34007609207,4714,1564,372,2238,9,318,1,30,3150
34007610300,2662,725,651,1058,6,132,0,9,1937
34007610400,4532,397,1872,2085,11,47,3,23,4135
34007610500,6775,861,3179,1802,4,749,3,28,5914
34007610600,1459,557,339,296,8,212,1,4,902
34007610800,3288,961,1296,816,17,83,2,15,2327
34007610900,3379,3054,139,47,4,29,3,15,325
34007611000,6359,4334,968,498,13,215,5,8,2025
34007611100,3002,2226,344,217,1,113,0,9,776
34007611200,4505,3529,365,288,8,122,0,34,976
34007611300,4413,3287,435,353,2,184,0,18,1126
34007611400,4582,3161,437,611,5,96,0,8,1421
34007611500,4749,3658,481,391,14,63,0,17,1091
34007611600,4592,2298,974,906,21,152,2,36,2294
34007611700,2935,2430,212,134,1,74,0,2,505
34009020101,3556,2927,269,161,3,59,0,5,629
34009020102,2124,1844,197,23,1,17,0,9,280
34009020201,1397,1328,7,13,1,14,0,0,69
34009020203,2351,2266,41,7,4,8,0,1,85
34009020205,856,818,15,5,0,2,0,6,38
34009020206,945,889,19,4,0,5,0,0,56
34009020301,4537,4161,155,35,7,34,3,25,376
34009020302,4950,4580,134,26,3,39,0,24,370
34009020400,3052,2806,86,19,2,8,3,0,246
34009020500,2128,1010,530,435,1,12,0,25,1118
34009020600,2028,1794,78,14,0,9,0,6,234
34009020700,4257,3804,161,63,3,30,0,17,453
34009020800,2104,1998,57,5,2,11,0,7,106
34009020901,796,764,17,0,0,1,0,0,32
34009020902,1243,1200,12,2,0,12,0,0,43
34009021001,2135,1864,80,94,0,27,0,10,271
34009021002,3801,3159,271,150,8,52,0,14,642
34009021100,5573,4486,370,382,3,119,0,21,1087
34009021300,3621,3365,129,34,1,7,0,7,256
34009021400,3527,2238,1013,108,1,26,0,39,1289
34009021500,2170,1175,638,247,6,27,0,1,995
34009021600,3101,2764,192,35,5,25,0,8,337
34009021701,2797,2444,155,72,1,18,0,10,353
34009021702,2660,2399,115,29,4,16,0,7,261
34009021803,3495,3109,255,38,9,12,0,2,386
34009021804,5641,4579,600,135,3,28,2,17,1062
34009021805,4146,3713,202,46,3,48,1,0,433
34009021806,2349,2086,115,61,5,17,0,2,263
34009021900,2284,2082,79,51,0,13,2,7,202
34009022000,2768,2325,237,73,1,22,0,14,443
34009022101,1586,1310,118,66,2,7,1,5,276
34009022102,7285,4753,1118,872,20,168,10,30,2532
34009990100,0,0,0,0,0,0,0,0,0
34011010101,3184,2721,216,91,0,10,0,9,463
34011010103,3034,959,441,1582,14,7,0,24,2075
34011010200,4669,3449,434,457,17,15,0,13,1220
34011010301,3087,2260,413,215,19,10,0,13,827
34011010302,1399,1219,71,22,2,1,0,1,180
34011010401,4492,1425,716,1917,205,11,0,18,3067
34011010402,1054,346,287,373,28,15,0,0,708
34011010500,2083,1784,120,67,22,18,0,7,299
34011010600,4835,3604,613,300,68,50,0,19,1231
34011010701,4211,2288,782,841,19,72,0,10,1923
34011010702,3434,2420,503,198,41,104,0,8,1014
34011010800,3136,2025,559,345,30,36,0,5,1111
34011020100,1183,52,952,156,0,7,0,5,1131
34011020200,2745,204,2038,413,16,15,1,8,2541
34011020301,2587,127,1824,570,6,3,0,15,2460
34011020302,4341,215,3598,458,7,8,0,7,4126
34011020400,3526,839,1858,652,27,50,3,11,2687
34011020502,3913,354,2698,832,20,4,0,1,3559
34011020503,4304,216,1272,2609,34,7,0,9,4088
34011020600,4664,1156,2129,1126,43,22,0,13,3508
34011030100,921,294,219,342,6,9,0,11,627
34011030200,4959,1712,1256,1603,27,24,0,24,3247
34011030300,3710,1451,766,1209,28,35,0,23,2259
34011030401,4045,2013,848,891,13,64,0,21,2032
34011030402,3811,2494,540,502,18,43,0,10,1317
34011030501,6038,4593,588,460,27,93,0,18,1445
34011030502,4007,1962,998,741,13,44,0,15,2045
34011040300,3428,1053,1706,481,20,54,0,14,2375
34011040400,6557,2062,3393,871,7,40,0,29,4495
34011040500,6000,964,3723,1017,18,112,3,30,5036
34011040601,3094,1724,924,290,7,51,0,6,1370
34011040602,4142,601,2420,901,7,72,0,33,3541
34011040701,4625,2578,1170,478,20,232,0,20,2047
34011040702,3793,1884,1248,460,7,59,1,11,1909
34011040800,5527,3495,986,477,10,328,3,18,2032
34011040901,2837,1181,1108,392,7,26,1,11,1656
34011040902,6678,3205,2548,618,15,62,0,21,3473
34011041001,4057,2815,685,300,18,48,0,44,1242
34011041002,3436,1655,1245,298,5,90,0,12,1781
34011041101,3259,259,2305,541,9,82,0,19,3000
34011041102,3347,150,2854,279,5,18,0,9,3197
34011990000,0,0,0,0,0,0,0,0,0
34013000100,6153,591,4157,1109,11,98,0,55,5562
34013000200,3293,136,2586,415,13,32,0,49,3157
34013000300,3533,208,2219,924,2,37,0,45,3325
34013000400,2514,275,1836,202,0,90,0,51,2239
34013000500,1936,133,1542,82,14,60,5,62,1803
34013000600,4295,381,3186,301,16,151,0,173,3914
34013000700,7108,152,3681,2928,13,65,0,94,6956
34013000800,4621,205,3588,587,26,46,1,97,4416
34013000900,4387,127,2427,1750,7,2,0,16,4260
34013001000,3936,215,1638,1868,16,81,10,30,3721
34013001100,4312,1129,1054,1227,0,741,0,28,3183
34013001300,2025,27,610,1309,4,8,0,19,1998
34013001400,3528,50,780,2579,13,9,1,13,3478
34013001500,2084,26,484,1516,0,6,0,10,2058
34013001600,1999,46,823,1022,0,11,1,34,1953
34013001700,2654,25,648,1894,7,2,0,18,2629
34013001800,2490,18,467,1882,1,0,1,15,2472
34013001900,2295,11,257,1905,2,0,6,17,2284
34013002000,4551,62,246,4006,18,13,0,28,4489
34013002100,3479,50,242,2940,11,41,0,40,3429
34013002202,3846,85,213,3384,12,28,0,4,3761
34013002203,5730,459,1666,2340,8,1047,0,70,5271
34013002204,1963,82,147,1628,0,15,0,25,1881
34013002300,4773,50,357,4103,13,30,0,26,4723
34013002400,3955,46,456,3268,7,5,0,17,3909
34013002500,4269,37,399,3629,6,14,0,23,4232
34013002600,2249,46,441,1639,6,16,0,29,2203
34013002800,2127,14,288,1753,0,1,0,8,2113
34013003100,2232,25,375,1770,6,9,0,5,2207
34013003500,3026,17,440,2416,1,6,0,3,3009
34013003700,2656,30,279,2276,0,1,0,9,2626
34013003800,2594,24,426,2050,9,17,0,13,2570
34013003900,1698,1,228,1433,12,0,0,6,1697
34013004100,3449,47,369,2863,11,13,1,46,3402
34013004200,3627,27,338,3134,0,4,0,15,3600
34013004300,3207,32,264,2815,3,0,0,30,3175
34013004400,2125,6,217,1857,2,4,0,5,2119
34013004500,3722,45,312,3233,2,0,0,21,3677
34013004600,3742,48,307,3231,4,8,0,52,3694
34013004700,4797,36,280,4276,8,6,0,33,4761
34013004801,2593,13,359,2097,1,2,0,18,2580
34013004802,4113,245,993,2732,10,20,1,43,3868
34013004900,4188,43,391,3613,10,15,5,17,4145
34013005000,3542,33,462,2899,7,16,3,25,3509
34013005100,2759,15,275,2358,1,3,0,20,2744
34013005200,1607,9,150,1388,5,1,0,9,1598
34013005300,3041,44,296,2569,3,3,0,9,2997
34013005400,4656,58,790,3596,7,30,1,48,4598
34013005700,2984,220,1315,1016,18,25,0,157,2764
34013006200,1875,25,453,1346,1,3,0,4,1850
34013006400,1320,115,145,857,2,127,1,15,1205
34013006600,1305,19,253,990,2,5,0,2,1286
34013006700,3593,204,1630,1567,2,25,0,54,3389
34013006800,5458,878,2596,903,5,32,0,427,4580
34013006900,4627,1220,2385,66,12,17,0,385,3407
34013007000,3878,1072,2010,83,2,24,12,302,2806
34013007100,3634,1451,1130,43,3,21,0,532,2183
34013007200,4002,1370,1752,30,0,7,1,442,2632
34013007300,5338,1696,2202,101,0,45,0,517,3642
34013007400,5474,1122,2009,1450,3,40,0,400,4352
34013007501,4200,677,2224,563,6,35,0,350,3523
34013007502,3233,405,1778,593,3,6,2,236,2828
34013007600,3304,783,1620,56,10,22,0,315,2521
34013007700,2662,762,1416,62,6,29,0,194,1900
34013007800,3714,742,2296,84,4,14,0,277,2972
34013007900,4339,902,2487,265,1,71,0,205,3437
34013008000,2921,601,903,1028,0,183,0,63,2320
34013008100,4539,253,792,3190,11,87,0,33,4286
34013008200,2338,210,326,1440,4,276,0,21,2128
34013008700,4322,135,3384,629,0,31,0,63,4187
34013008800,2009,30,1412,487,0,14,1,35,1979
34013008900,2271,82,1725,398,11,13,0,10,2189
34013009000,1769,62,544,1037,14,28,0,23,1707
34013009100,3530,131,2752,554,6,5,0,25,3399
34013009200,3494,156,1981,1175,7,7,0,72,3338
34013009300,5281,151,3861,1012,3,91,0,72,5130
34013009400,6003,480,3835,1302,14,129,2,85,5523
34013009500,6248,465,4743,766,3,85,0,81,5783
34013009600,5577,103,3686,1580,14,14,3,87,5474
34013009700,5198,128,4200,659,29,58,2,69,5070
34013009900,2340,54,253,1866,3,31,0,28,2286
34013010000,3304,115,330,2680,13,43,0,20,3189
34013010100,2917,63,464,2201,9,27,0,18,2854
34013010200,4625,172,783,3376,12,61,0,39,4453
34013010300,4360,102,692,3279,5,26,0,50,4258
34013010400,5149,100,629,4149,25,17,0,27,5049
34013010500,4758,89,637,3688,3,46,0,44,4669
34013010600,4893,82,643,3884,13,11,4,28,4811
34013010700,3710,74,598,2750,3,45,0,53,3636
34013010800,2712,21,666,1862,7,15,0,19,2691
34013010900,2584,22,383,2014,5,4,0,19,2562
34013011100,4040,66,782,2983,7,30,0,16,3974
34013011200,3469,35,350,2825,19,10,0,38,3434
34013011300,4225,75,482,3458,14,27,0,19,4150
34013011400,4859,173,442,3914,10,53,1,31,4686
34013011500,2535,52,222,2115,2,21,0,14,2483
34013011600,3133,26,229,2628,8,17,0,26,3107
34013011700,3557,54,298,2916,6,15,0,41,3503
34013011800,2442,13,149,2101,0,2,1,40,2429
34013011900,1948,66,310,1474,4,31,0,8,1882
34013012000,6940,134,872,5608,6,94,0,30,6806
34013012100,4429,62,1343,2825,0,23,0,35,4367
34013012200,6531,153,1419,4622,5,29,0,69,6378
34013012300,5189,97,448,4356,7,23,1,32,5092
34013012400,4555,75,655,3623,10,33,0,25,4480
34013012500,4038,57,350,3400,5,26,0,14,3981
34013012600,3172,53,283,2680,10,23,3,25,3119
34013012700,4260,58,420,3600,5,26,0,22,4202
34013012800,3688,41,524,2904,6,16,3,31,3647
34013012900,3652,28,615,2850,4,6,0,30,3624
34013013000,3327,65,216,2859,6,54,0,24,3262
34013013100,2270,24,357,1780,1,7,0,27,2246
34013013200,3428,29,717,2568,6,1,0,33,3399
34013013300,3749,41,456,3059,9,21,0,24,3708
34013013400,4184,3055,681,42,7,295,5,14,1129
34013013500,4603,3093,822,98,4,420,0,23,1510
34013013600,6923,3515,1401,379,2,1418,0,50,3408
34013013700,4959,2898,1212,218,3,484,3,27,2061
34013013800,4390,3236,626,54,4,310,2,20,1154
34013013900,5084,3067,1116,137,18,591,3,44,2017
34013014000,4533,1680,1436,360,4,933,0,42,2853
34013014100,3799,1389,1487,202,7,587,0,26,2410
34013014200,4070,1322,1904,223,8,466,0,61,2748
34013014300,5658,1495,3199,290,12,454,11,68,4163
34013014400,3966,901,2269,352,3,320,7,55,3065
34013014500,4064,794,2610,323,3,182,0,79,3270
34013014600,4814,963,2645,572,11,437,0,82,3851
34013014700,7318,1766,3631,770,2,822,0,104,5552
34013014800,3383,2038,539,167,1,460,0,41,1345
34013014900,4794,2843,886,283,1,555,0,37,1951
34013015000,3663,1913,757,372,9,413,0,53,1750
34013015100,4985,1921,1634,780,0,386,0,72,3064
34013015200,4988,2272,1415,749,3,358,2,33,2716
34013015300,3017,872,801,849,9,358,0,32,2145
34013015400,6065,2561,1461,1335,7,420,0,41,3504
34013015500,4104,1382,1568,720,10,269,0,42,2722
34013015600,4632,1529,1312,1236,1,308,1,50,3103
34013015700,3004,553,975,1016,1,301,0,41,2451
34013015800,4429,995,1988,900,13,342,1,47,3434
34013015900,6041,789,2861,1534,29,325,0,224,5252
34013016000,7802,5825,558,289,0,587,0,48,1977
34013016100,4728,2622,494,1102,2,211,0,26,2106
34013016200,3615,2626,273,211,0,238,2,33,989
34013016300,3654,2732,265,201,0,212,0,21,922
34013016400,3894,2838,291,258,0,223,1,47,1056
34013016500,4074,2727,374,423,5,208,0,58,1347
34013016600,2909,1446,372,765,6,116,0,44,1463
34013016700,2595,973,377,875,4,162,0,33,1622
34013016800,3986,2185,409,847,7,249,0,68,1801
34013016900,2879,1845,193,492,2,133,7,15,1034
34013017000,3182,1579,385,839,1,163,0,35,1603
34013017100,2242,269,552,1282,1,26,1,24,1973
34013017200,3163,751,319,1713,8,104,0,40,2412
34013017301,5318,3043,562,1004,1,456,0,43,2275
34013017302,7695,3823,771,1662,0,1050,3,51,3872
34013017400,5606,2741,776,1270,2,541,2,51,2865
34013017500,6470,2805,882,1898,21,532,1,36,3665
34013017600,5025,880,1730,2047,6,146,5,47,4145
34013017700,5201,529,2359,1964,5,110,4,75,4672
34013017800,3686,532,1469,1405,11,99,0,48,3154
34013017900,3622,1673,464,1109,0,131,0,27,1949
34013018000,6220,3129,634,1557,7,458,3,58,3091
34013018100,2235,47,496,1585,3,16,1,20,2188
34013018200,4675,104,1420,2920,2,15,2,38,4571
34013018300,5172,134,2217,2563,3,46,0,54,5038
34013018400,2544,18,638,1721,8,2,0,17,2526
34013018600,5165,194,2498,2288,7,25,0,60,4971
34013018700,5613,143,922,4236,12,55,2,36,5470
34013018800,4751,259,536,3679,4,58,2,36,4492
34013018900,4292,174,1256,2635,5,45,0,42,4118
34013019000,5044,3297,321,728,0,306,0,57,1747
34013019100,4202,2086,297,1278,4,197,0,46,2116
34013019200,5281,2863,628,989,1,481,0,135,2418
34013019300,3957,2264,358,808,6,244,2,44,1693
34013019400,3151,2492,215,137,0,106,0,12,659
34013019500,4163,3081,273,360,0,148,0,30,1082
34013019600,6313,2276,590,2753,9,309,0,48,4037
34013019700,6509,1345,688,3894,15,186,1,54,5164
34013019800,2821,1834,203,503,6,108,1,11,987
34013019900,2727,2142,213,93,0,94,2,11,585
34013020000,6212,3848,192,48,0,1803,0,27,2364
34013020100,5317,3009,156,77,0,1826,1,36,2308
34013020200,5125,2982,292,155,7,1487,1,30,2143
34013020300,5056,2308,333,178,8,2007,0,53,2748
34013020400,5181,3361,223,121,0,1314,0,37,1820
34013020500,8192,4785,305,206,2,2666,4,53,3407
34013020600,5230,3172,279,203,1,1395,0,37,2058
34013020700,4435,2486,298,122,2,1345,0,26,1949
34013020800,8292,5008,478,301,7,2294,0,24,3284
34013020901,2244,1889,137,24,2,104,0,2,355
34013020902,6299,4904,437,192,7,551,1,22,1395
34013021000,5497,4429,525,102,7,238,0,31,1068
34013021100,5218,4004,602,150,2,278,0,9,1214
34013021200,3857,3158,304,71,2,180,2,12,699
34013021300,6040,4444,682,159,6,555,0,33,1596
34013021400,6940,5310,783,146,12,461,2,32,1630
34013021601,7872,6562,733,38,0,355,1,24,1310
34013021602,6694,5476,405,85,3,518,0,10,1218
34013021701,3793,2805,609,78,3,193,0,16,988
34013021702,5234,3666,704,341,1,352,4,39,1568
34013021801,2647,2218,223,22,0,85,0,14,429
34013021802,3705,2915,374,61,0,234,0,13,790
34013021803,4660,3931,374,55,0,121,0,33,729
34013022700,3437,85,922,2226,0,8,0,79,3352
34013022800,2425,17,347,1983,4,3,0,12,2408
34013022900,5752,1155,1176,2785,11,392,2,45,4597
34013023000,3783,45,844,2736,6,17,1,26,3738
34013023100,2685,36,318,2247,7,6,0,23,2649
34013023200,3761,105,655,2748,3,2,0,99,3656
34013980100,5777,1334,1274,3052,17,67,0,19,4443
34013980200,10,5,4,0,0,0,0,0,5
34015500100,4264,3023,480,379,11,139,1,31,1241
34015500201,2497,2097,176,78,2,31,2,2,400
34015500202,4843,3730,397,398,13,68,2,21,1113
34015500203,4771,4039,215,230,5,121,2,11,732
34015500204,6374,4748,406,676,4,279,1,29,1626
34015500205,3712,3050,174,277,6,54,0,15,662
34015500300,3026,2574,152,118,9,18,0,7,452
34015500400,6196,2576,914,2213,16,65,7,59,3620
34015500500,4917,4194,230,200,5,45,0,11,723
34015500601,7543,6013,438,459,0,310,0,29,1530
34015500602,4163,3467,145,165,5,220,0,18,696
34015500702,5876,5279,204,109,13,73,0,17,597
34015500703,1422,1264,52,41,2,17,0,3,158
34015500704,3318,2819,162,132,2,55,0,16,499
34015500705,4619,3986,181,197,4,73,0,17,633
34015500800,2283,2075,71,15,0,32,0,10,208
34015500900,3098,2692,164,119,0,31,11,6,406
34015501001,2189,1155,338,474,1,59,2,6,1034
34015501002,3986,1700,735,1292,15,31,5,26,2286
34015501003,3788,2355,505,652,0,67,0,18,1433
34015501101,4244,2568,581,810,6,58,0,13,1676
34015501102,7076,4598,540,963,9,676,0,29,2478
34015501103,5513,4017,433,400,3,436,1,22,1496
34015501104,3217,2482,255,232,2,101,0,5,735
34015501105,3118,2038,292,506,1,82,0,22,1080
34015501106,4174,2377,367,1016,12,205,2,15,1797
34015501107,4635,3888,292,160,7,59,3,7,747
34015501201,6009,5099,227,277,7,236,0,11,910
34015501202,4713,4097,186,117,2,175,1,11,616
34015501203,3265,2869,161,53,0,67,0,14,396
34015501204,3837,3260,224,148,0,80,1,10,577
34015501205,3542,2543,260,419,0,206,0,8,999
34015501206,3794,3070,250,248,6,127,2,4,724
34015501208,4177,3643,149,133,1,137,3,9,534
34015501209,7286,5075,472,944,6,446,0,29,2211
34015501210,3518,2934,157,149,0,126,0,10,584
34015501212,3916,2505,387,623,7,207,0,15,1411
34015501213,4620,3781,238,235,0,211,0,14,839
34015501301,3406,3070,141,38,0,22,0,4,336
34015501302,2673,2357,143,28,3,29,0,7,316
34015501303,2701,2481,62,42,0,22,0,4,220
34015501402,5009,2578,729,1340,10,130,2,18,2431
34015501403,4821,3368,405,679,9,151,0,9,1453
34015501404,5222,3347,594,693,1,321,0,27,1875
34015501405,3792,2679,241,467,0,237,0,11,1113
34015501406,4305,2498,560,834,10,169,3,26,1807
34015501501,3312,1881,348,744,10,93,0,30,1431
34015501502,5495,3596,485,925,1,87,1,19,1899
34015501603,6316,4762,527,640,4,99,0,20,1554
34015501604,7438,5199,559,1157,6,186,0,11,2239
34015501605,4197,3097,278,490,1,92,7,16,1100
34015501606,7483,5164,513,1160,9,198,3,33,2319
34015501608,5639,4000,534,664,7,143,7,30,1639
34015501609,6044,3914,385,1181,10,258,2,24,2130
34015501701,5288,4265,298,437,7,68,0,20,1023
34015501702,2473,2101,146,101,9,13,0,7,372
34015501703,4534,3601,377,339,10,45,0,13,933
34015501704,4085,3424,252,140,4,33,0,16,661
34015501800,1774,1384,233,56,0,12,0,1,390
34015501900,4424,3238,393,505,6,45,0,30,1186
34015502001,6282,5053,350,340,9,336,0,0,1229
34015502002,7359,6126,295,364,0,317,0,37,1233
34015502100,3395,2896,157,162,0,62,2,14,499
34015502201,3423,2549,185,303,0,253,1,13,874
34015502202,2792,2090,132,346,1,128,0,5,702
34015502203,3510,2499,192,482,0,161,0,7,1011
34015502204,2852,2334,142,159,3,98,0,4,518
34015502300,2711,1628,478,379,7,64,0,30,1083
34015502400,6000,4496,391,665,12,180,0,17,1504
34017000101,2554,455,1059,105,0,864,0,35,2099
34017000102,3834,702,1590,218,7,1233,0,31,3132
34017000200,5391,859,2954,320,11,1043,3,86,4532
34017000300,3948,1249,1910,141,4,496,1,42,2699
34017000400,3973,666,1372,146,19,1654,0,46,3307
34017000500,4317,957,1677,197,10,1310,0,58,3360
34017000600,5790,1237,2450,286,9,1602,0,74,4553
34017000700,3609,955,1864,169,10,488,0,46,2654
34017000800,4075,1582,1562,178,0,541,0,68,2493
34017000902,6778,1341,896,278,15,4074,0,63,5437
34017001000,2118,502,519,107,13,904,0,29,1616
34017001100,5345,1359,1889,245,6,1634,0,69,3986
34017001201,2153,313,464,89,14,1191,0,21,1840
34017001202,1268,188,395,281,2,354,0,15,1080
34017001300,2624,919,962,148,4,449,2,44,1705
34017001400,3867,900,1505,214,18,1070,1,41,2967
34017001701,5237,1157,1128,624,19,2054,0,56,4080
34017001800,3965,889,850,496,15,1555,0,35,3076
34017001900,2684,588,329,176,2,1482,0,17,2096
34017002001,1627,402,300,87,6,757,0,14,1225
34017002002,2563,800,523,218,6,909,2,27,1763
34017002200,2036,1119,337,90,4,364,0,16,917
34017002300,2470,1278,383,104,1,538,0,14,1192
34017002400,2806,1718,359,90,1,448,1,17,1088
34017002700,5952,1224,1721,1146,20,1436,9,158,4728
34017002800,5643,1730,1594,814,25,1181,0,87,3913
34017002900,3990,1275,708,384,22,1434,4,41,2715
34017003000,2974,856,990,428,24,536,4,35,2118
34017003101,2846,588,381,257,4,1504,0,33,2258
34017003102,3365,1014,841,395,0,948,5,51,2351
34017003500,2257,970,709,127,2,312,0,22,1287
34017004000,5642,672,1487,1086,5,2077,9,144,4970
34017004102,3091,461,1080,1076,4,318,1,29,2630
34017004103,2285,605,620,706,3,227,6,33,1680
34017004104,4593,1235,1455,997,15,661,0,79,3358
34017004200,5100,764,1559,1759,16,670,4,125,4336
34017004300,2503,434,552,1264,6,105,10,39,2069
34017004400,2697,113,661,1763,4,74,2,16,2584
34017004500,4395,327,1316,2437,19,90,1,72,4068
34017004600,2309,260,1219,712,5,45,1,13,2049
34017004700,3304,1002,1182,712,1,253,1,30,2302
34017004800,4713,710,1122,991,10,1595,3,97,4003
34017004900,4370,461,1203,1612,11,805,1,109,3909
34017005200,4815,665,1272,2376,4,328,1,58,4150
34017005300,3201,188,912,1995,0,38,0,12,3013
34017005400,7307,1004,1085,2204,13,2507,0,207,6303
34017005500,3141,123,678,2176,13,50,0,18,3018
34017005600,3897,342,995,1457,22,749,0,168,3555
34017005801,5569,217,1535,3423,27,143,0,78,5352
34017005802,1683,845,154,79,4,449,0,36,838
34017005901,3443,485,809,477,13,1472,3,98,2958
34017005902,4857,620,1210,1161,2,1549,5,139,4237
34017006000,4709,195,1501,2572,8,206,1,62,4514
34017006101,3954,877,909,542,11,1459,3,60,3077
34017006102,3436,257,1054,1519,19,338,0,130,3179
34017006200,4047,394,1431,1450,19,425,0,152,3653
34017006300,4792,459,1855,1822,27,302,0,163,4333
34017006400,3276,1814,514,145,5,586,0,32,1462
34017006500,2270,960,657,211,0,317,1,25,1310
34017006600,1329,212,83,45,2,909,0,42,1117
34017006700,3670,374,1461,1595,7,106,0,20,3296
34017006800,4143,155,1080,2600,0,130,0,52,3988
34017006900,99,20,61,3,0,13,0,0,79
34017007001,2141,701,805,171,1,366,0,8,1440
34017007002,2373,1031,315,69,0,840,5,14,1342
34017007100,3510,1124,772,398,0,1036,0,49,2386
34017007200,3269,1544,297,184,4,1050,0,31,1725
34017007300,4946,2395,351,133,0,1878,0,30,2551
34017007400,5833,2862,400,150,7,2111,1,37,2971
34017007500,7364,3189,748,417,11,2626,0,99,4175
34017007601,10344,3807,670,254,3,5189,2,79,6537
34017007602,5234,1595,217,93,6,3151,0,33,3639
34017007701,6081,905,232,145,8,4657,0,30,5176
34017007702,1289,243,41,9,0,951,2,11,1046
34017007703,5018,1291,286,166,6,3090,1,29,3727
34017007800,4343,1895,708,485,4,1119,5,25,2448
34017010100,6695,2573,1998,818,21,1022,0,70,4122
34017010200,3477,1627,995,334,4,349,0,52,1850
34017010300,3131,1346,1070,278,1,273,1,28,1785
34017010400,5008,1954,1303,494,11,1070,6,36,3054
34017010500,5712,2999,1451,456,8,610,6,55,2713
34017010601,2916,1473,847,232,6,267,1,19,1443
34017010602,4372,2073,1440,318,2,371,0,38,2299
34017010701,2603,1164,911,191,1,227,0,14,1439
34017010702,1451,655,492,139,4,105,1,15,796
34017010800,3688,1492,1373,274,1,398,0,32,2196
34017010900,2700,1186,777,342,1,268,0,32,1514
34017011000,2543,854,848,409,0,337,0,28,1689
34017011100,4715,1752,1887,622,2,277,0,44,2963
34017011200,7398,4107,1940,532,8,579,0,63,3291
34017011300,3238,1353,1201,336,3,232,0,39,1885
34017011400,3863,1980,1164,375,1,237,0,15,1883
34017011500,3429,1911,988,217,4,186,0,23,1518
34017011600,4747,2198,1416,749,2,203,2,35,2549
34017012300,2250,860,1042,48,3,119,0,55,1390
34017012400,3230,1873,1000,35,0,171,0,43,1357
34017012500,3900,1900,1470,52,6,179,9,64,2000
34017012600,3846,1566,1729,58,0,153,2,127,2280
34017012700,6009,2299,2533,492,7,230,8,167,3710
34017012800,4829,1497,2397,123,9,329,2,178,3332
34017012900,4062,1121,2371,91,0,137,0,135,2941
34017013000,3665,765,2377,59,0,143,2,160,2900
34017013100,2178,754,1150,28,4,56,0,72,1424
34017013200,4265,1100,2537,125,0,183,0,168,3165
34017013300,3765,1154,1859,135,8,334,0,116,2611
34017013400,2594,511,1619,54,2,257,0,82,2083
34017013500,5028,1291,2531,119,6,689,0,165,3737
34017013600,2234,360,1279,32,2,394,0,83,1874
34017013700,2624,432,1507,61,1,492,0,55,2192
34017013800,4944,1206,985,322,9,2105,0,125,3738
34017013900,4620,1401,1457,188,0,1266,0,101,3219
34017014000,5209,824,4026,86,2,173,0,43,4385
34017014101,4498,1846,1208,281,7,983,8,39,2652
34017014102,5149,1394,3191,133,11,293,0,43,3755
34017014200,5932,954,4562,112,3,202,0,42,4978
34017014300,5937,710,4835,64,4,191,3,71,5227
34017014401,4518,873,3294,64,3,161,0,38,3645
34017014402,3657,586,2728,61,2,205,1,36,3071
34017014501,6312,986,4781,107,2,265,0,72,5326
34017014502,3562,512,2872,40,2,73,2,24,3050
34017014600,4228,587,3184,113,8,280,0,24,3641
34017014700,4880,609,3772,80,10,271,0,75,4271
34017014801,5234,704,3845,179,8,390,0,55,4530
34017014802,1095,266,685,26,1,80,0,13,829
34017014900,3150,384,1917,57,7,702,0,37,2766
34017015001,2611,1178,513,131,1,676,3,24,1433
34017015003,2700,281,2282,43,0,65,0,15,2419
34017015004,3462,567,2500,118,6,192,0,33,2895
34017015100,3244,400,2573,51,0,131,0,50,2844
34017015201,2880,1241,509,126,5,860,0,32,1639
34017015202,6467,1056,4553,257,12,404,1,89,5411
34017015300,4568,380,3835,109,3,138,0,58,4188
34017015500,5203,419,4465,55,8,157,2,39,4784
34017015600,4315,336,3668,111,1,131,1,24,3979
34017015700,3753,209,3400,60,1,36,0,28,3544
34017015801,3494,1402,352,122,3,1453,0,22,2092
34017015802,5710,499,4819,123,4,174,0,42,5211
34017015900,5966,368,5242,115,1,151,1,48,5598
34017016000,3794,271,3236,88,10,117,0,26,3523
34017016100,3773,226,3310,72,2,91,2,25,3547
34017016200,4813,324,4284,50,4,60,0,42,4489
34017016300,4503,385,3772,91,15,177,0,20,4118
34017016400,3784,323,3250,57,4,80,0,27,3461
34017016500,4682,860,3184,126,10,342,0,86,3822
34017016600,3822,398,3176,66,5,98,0,37,3424
34017016700,1773,131,1526,27,4,67,0,10,1642
34017016800,3348,190,2873,103,16,99,0,24,3158
34017016900,3364,219,2955,30,2,107,0,17,3145
34017017000,4920,351,4214,124,8,120,0,54,4569
34017017100,5359,470,4552,105,8,139,2,46,4889
34017017200,3229,315,2746,43,0,74,1,26,2914
34017017300,2272,671,1344,39,1,154,0,17,1601
34017017400,2597,174,2295,51,3,41,0,15,2423
34017017500,4361,238,3899,60,5,83,0,40,4123
34017017600,3219,166,2884,57,3,43,1,37,3053
34017017700,2192,261,1578,86,2,213,0,19,1931
34017017800,6578,1153,4667,168,7,406,1,58,5425
34017017900,5358,2642,755,224,9,1509,1,36,2716
34017018000,4156,1323,2152,175,5,336,1,46,2833
34017018100,2849,1142,1181,112,0,286,0,25,1707
34017018200,4834,2430,1577,174,1,463,5,25,2404
34017018301,3180,2047,200,24,0,753,0,28,1133
34017018302,5227,3934,334,101,0,584,5,43,1293
34017018401,3156,2241,507,62,0,200,2,31,915
34017018402,3484,2419,431,49,2,415,1,19,1065
34017018501,5445,3909,566,169,0,631,3,31,1536
34017018502,1863,1241,327,67,0,143,0,16,622
34017018600,2441,1865,218,35,0,196,0,11,576
34017018701,3006,1539,359,623,3,288,28,73,1467
34017018702,4382,3113,727,56,3,322,2,28,1269
34017018800,3369,2453,418,58,0,312,0,18,916
34017018900,4764,3454,610,89,8,429,1,25,1310
34017019000,4822,2189,1709,528,4,230,0,27,2633
34017019100,3949,2633,743,104,1,330,8,20,1316
34017019200,5108,3383,358,43,0,1051,0,22,1725
34017019300,3260,2207,541,32,3,364,0,19,1053
34017019400,2963,2030,494,66,5,270,0,26,933
34017019800,7080,3139,1561,232,4,1941,0,41,3941
34017019900,5542,2127,1244,224,8,1771,0,40,3415
34017020000,5303,2644,1362,216,8,955,2,15,2659
34017020100,4256,850,533,250,3,2500,1,26,3406
34017032400,6762,468,6035,68,3,124,3,39,6294
34017980100,5,0,2,0,0,0,0,0,5
34019010100,5870,5019,332,54,0,232,0,35,851
34019010201,2968,2598,183,33,4,48,0,9,370
34019010202,4232,3725,214,32,1,90,0,22,507
34019010300,3120,2584,267,93,0,52,1,24,536
34019010400,4537,3938,263,65,2,105,0,17,599
34019010500,5177,4694,220,31,2,44,0,9,483
34019010600,6041,5250,370,82,11,117,1,26,791
34019010701,6507,5026,543,481,1,258,1,23,1481
34019010702,3267,2828,214,28,1,58,0,20,439
34019010801,2773,2115,281,50,7,235,0,7,658
34019010802,1665,1328,144,70,0,70,0,3,337
34019010900,3546,2928,340,51,1,113,0,7,618
34019011001,6475,4525,648,663,5,393,0,42,1950
34019011003,5112,4231,293,80,3,314,0,11,881
34019011004,1918,1635,130,14,0,61,1,13,283
34019011100,5777,4624,534,99,7,349,0,17,1153
34019011202,3402,2820,274,55,0,148,0,15,582
34019011203,4606,4045,242,29,0,138,0,13,561
34019011204,2343,1954,167,30,1,109,0,3,389
34019011301,7405,5557,713,183,9,652,1,51,1848
34019011303,4707,3760,377,92,1,323,0,11,947
34019011304,3549,2817,249,49,4,277,1,11,732
34019011305,3173,2372,218,133,0,349,0,9,801
34019011306,4613,3483,342,131,2,503,0,17,1130
34019011400,4876,2350,1928,133,7,317,1,31,2526
34019011500,5172,4592,247,58,4,63,0,23,580
34019011600,5055,4469,274,39,4,72,0,20,586
34019011700,3917,3467,217,35,12,64,0,19,450
34019011800,3005,2596,180,62,0,61,0,6,409
34019011900,4139,3337,525,75,3,62,1,21,802
34021000100,3354,392,2142,731,2,12,0,15,2962
34021000200,4349,407,2817,942,6,41,5,36,3942
34021000300,5068,593,3497,840,4,40,2,16,4475
34021000400,6305,390,4983,811,16,23,0,22,5915
34021000500,5050,406,3990,524,2,40,0,28,4644
34021000600,5052,550,3222,1101,11,38,7,35,4502
34021000700,3907,276,2921,621,6,26,1,19,3631
34021000800,2808,259,1986,471,7,13,1,22,2549
34021000900,3942,400,1515,1866,7,34,0,31,3542
34021001000,2999,205,1436,1229,4,25,0,11,2794
34021001101,2377,146,365,1750,9,19,0,9,2231
34021001102,3237,125,557,2441,3,7,0,13,3112
34021001200,3819,497,380,2735,7,17,2,20,3322
34021001300,3963,753,383,2636,4,70,2,22,3210
34021001401,3884,68,421,3251,10,2,0,20,3816
34021001402,1754,34,192,1465,5,2,0,7,1720
34021001500,2708,82,380,2134,4,10,0,19,2626
34021001600,1225,49,238,859,9,28,0,1,1176
34021001700,3524,123,681,2622,6,13,0,8,3401
34021001800,5193,1719,1603,1682,4,74,1,16,3474
34021001900,1500,59,800,596,8,3,0,5,1441
34021002000,1595,92,408,1048,0,4,0,8,1503
34021002100,5670,282,2589,2637,2,15,0,26,5388
34021002200,6109,196,3067,2680,8,34,3,31,5913
34021002500,7579,2703,3217,1242,10,135,0,54,4876
34021002601,4785,983,2321,1194,3,127,0,26,3802
34021002602,4348,1838,1447,757,3,155,0,23,2510
34021002701,4586,1650,1639,956,3,209,0,21,2936
34021002702,6454,3786,1255,905,0,298,0,24,2668
34021002800,6725,1080,2328,2884,8,215,1,41,5645
34021002902,4869,2030,1166,1275,7,238,0,10,2839
34021002903,3561,2231,434,222,0,516,0,11,1330
34021002904,5214,4013,416,212,5,397,0,19,1201
34021003001,6287,5029,461,379,3,234,0,11,1258
34021003002,5691,4787,347,153,2,257,4,7,904
34021003003,6209,5020,551,280,5,181,2,17,1189
34021003004,5811,4516,709,221,1,191,0,23,1295
34021003006,5965,4809,574,198,8,195,2,8,1156
34021003007,3394,2872,282,78,4,59,1,11,522
34021003008,5389,3886,598,406,5,310,3,14,1503
34021003009,5430,3966,534,362,0,404,1,28,1464
34021003100,4516,2518,1026,567,2,252,0,4,1998
34021003201,7475,4214,1157,1293,14,539,6,35,3261
34021003202,5643,3479,537,613,3,773,0,15,2164
34021003301,7112,5143,462,405,0,734,2,40,1969
34021003303,6419,1653,425,794,5,3286,0,57,4766
34021003304,1912,1363,80,83,3,299,0,6,549
34021003400,2810,477,601,1546,8,74,1,35,2333
34021003500,7331,2438,1142,3043,3,377,7,40,4893
34021003601,3350,1077,486,1499,4,117,0,18,2273
34021003602,3129,1476,392,970,3,144,3,14,1653
34021003703,7108,3929,948,1697,18,386,3,13,3179
34021003704,2679,1825,170,347,4,209,0,17,854
34021003706,3737,2196,282,731,2,369,2,49,1541
34021003707,1402,817,165,318,2,45,0,7,585
34021003708,5718,3352,682,1213,8,217,0,29,2366
34021003800,6874,5485,398,256,2,422,3,35,1389
34021003902,1918,1685,84,32,4,27,1,3,233
34021003903,2802,2466,88,45,4,83,0,6,336
34021003904,6122,3971,379,234,0,1347,1,17,2151
34021003905,4495,3652,262,96,7,266,3,37,843
34021004000,5686,3264,906,440,2,777,0,43,2422
34021004203,4199,2244,238,195,4,1303,2,15,1955
34021004204,6054,3577,428,186,1,1555,3,34,2477
34021004205,4671,2600,411,342,2,1034,0,39,2071
34021004206,2443,1481,346,129,0,369,0,21,962
34021004306,5108,1626,189,133,8,2995,8,12,3482
34021004307,6218,2624,387,235,0,2664,0,37,3594
34021004309,4980,3146,243,137,14,1287,0,18,1834
34021004311,6975,3955,402,269,7,2088,0,34,3020
34021004312,3521,2235,145,63,0,932,0,21,1286
34021004313,4390,906,246,315,10,2746,0,29,3484
34021004314,5526,1861,413,375,11,2668,3,19,3665
34021004315,3485,1307,132,56,0,1879,1,12,2178
34021004316,4791,1900,140,92,4,2547,0,25,2891
34021004403,5900,2739,2166,402,6,333,4,37,3161
34021004404,7787,2762,3093,858,4,784,2,61,5025
34021004406,5771,2601,1137,479,13,1390,3,27,3170
34021004407,7733,3611,1613,723,15,1511,3,44,4122
34021004408,4637,1787,462,252,10,1995,3,29,2850
34021004409,4117,1149,1445,341,1,1100,0,14,2968
34021004501,6474,3424,614,425,6,1550,4,36,3050
34021004502,1154,856,71,25,2,144,0,7,298
34021980000,1479,407,332,714,0,2,0,0,1072
34023000101,3132,2342,425,92,4,165,0,15,790
34023000102,4559,3016,772,218,1,384,0,16,1543
34023000200,6945,2973,2554,592,9,610,0,34,3972
34023000300,7637,3390,2820,669,2,430,4,92,4247
34023000401,3839,1252,824,758,15,837,0,38,2587
34023000403,6555,1377,628,1373,7,2921,0,71,5178
34023000404,6031,1685,1104,1100,11,1922,3,48,4346
34023000501,5273,781,1637,1939,12,617,2,77,4492
34023000503,2742,588,404,588,6,1074,0,29,2154
34023000504,4690,550,763,943,22,2256,1,47,4140
34023000603,2259,699,195,274,3,992,0,27,1560
34023000608,1609,362,104,233,0,861,1,4,1247
34023000609,2942,377,207,542,6,1692,0,22,2565
34023000610,5403,766,386,1075,18,3007,0,30,4637
34023000701,3642,1111,426,590,15,1357,1,26,2531
34023000702,5863,1984,676,1445,6,1484,0,39,3879
34023000801,3762,1781,969,613,11,208,3,47,1981
34023000802,2812,1686,539,180,2,261,0,41,1126
34023000901,2380,1381,513,198,3,163,0,32,999
34023000902,4618,2615,984,456,1,396,0,25,2003
34023001001,2646,1611,378,182,4,360,0,32,1035
34023001003,5784,2001,960,567,25,1939,0,100,3783
34023001004,2336,513,212,300,5,1252,2,12,1823
34023001100,5408,2683,619,366,3,1488,4,72,2725
34023001200,5445,2726,1098,647,6,753,1,60,2719
34023001300,4219,2803,534,245,3,402,0,40,1416
34023001409,3589,857,136,75,3,2438,1,16,2732
34023001410,4429,597,145,270,11,3319,2,17,3832
34023001411,3619,775,131,190,5,2461,0,11,2844
34023001412,3864,893,94,93,12,2698,2,14,2971
34023001413,5765,770,226,742,19,3898,2,24,4995
34023001414,6173,758,167,183,11,4970,0,14,5415
34023001415,5608,1825,201,77,3,3399,0,21,3783
34023001417,2165,691,55,64,0,1294,0,16,1474
34023001418,5921,498,232,72,24,4980,0,45,5423
34023001419,2497,283,165,235,10,1731,0,41,2214
34023001502,5826,3234,692,196,14,1513,9,54,2592
34023001504,7324,975,471,680,19,5007,1,44,6349
34023001505,2282,211,106,198,5,1709,0,12,2071
34023001506,6515,533,468,746,30,4625,0,12,5982
34023001600,5123,1914,1249,399,1,1344,2,53,3209
34023001701,5237,2255,788,281,8,1725,0,22,2982
34023001702,3511,1433,576,217,0,1183,1,19,2078
34023001803,3328,1515,717,270,2,689,1,30,1813
34023001804,4112,1437,716,339,6,1469,1,35,2675
34023001805,5931,1688,763,685,10,2582,0,33,4243
34023001806,3658,722,691,668,4,1440,0,22,2936
34023001901,5071,1628,673,562,15,2053,4,30,3443
34023001902,2359,1153,561,177,2,377,0,17,1206
34023001903,3681,1659,748,345,5,783,1,27,2022
34023002000,4842,2459,536,342,7,1264,1,35,2383
34023002101,2416,1710,220,48,0,296,0,11,706
34023002102,4007,2706,362,95,5,643,1,22,1301
34023002200,3784,2384,392,160,4,622,0,15,1400
34023002301,3913,2622,475,251,3,431,0,5,1291
34023002302,3883,2344,548,93,1,781,2,19,1539
34023002401,5607,3579,805,297,19,751,0,18,2028
34023002402,1528,810,139,38,0,482,0,8,718
34023002500,7379,1555,695,253,24,4657,3,60,5824
34023002603,5453,1191,418,520,14,3169,1,45,4262
34023002604,6894,2484,903,547,10,2679,0,60,4410
34023002605,2924,1606,494,258,5,460,0,30,1318
34023002701,5705,1548,958,664,23,2293,2,55,4157
34023002703,7097,2700,1478,1035,14,1625,2,46,4397
34023002805,2777,1617,663,193,5,200,0,16,1160
34023002901,3086,1321,786,437,2,409,0,34,1765
34023002902,2720,1207,914,251,8,213,3,36,1513
34023003001,4395,2265,1230,297,1,454,0,16,2130
34023003002,6755,1261,648,720,17,3924,0,69,5494
34023003101,2806,917,520,235,1,1051,0,24,1889
34023003102,4938,1607,1114,709,8,1290,0,49,3331
34023003201,3438,1691,1055,217,0,396,0,17,1747
34023003203,4527,1904,1633,418,2,418,3,27,2623
34023003300,5991,1482,3509,519,1,323,3,53,4509
34023003401,3894,1841,1292,387,0,237,0,27,2053
34023003500,3699,1151,1170,341,3,911,0,33,2548
34023003601,8156,1413,3675,1070,24,1761,5,80,6743
34023003700,3860,1022,1013,354,9,1331,0,23,2838
34023003801,6002,1686,2041,767,6,1329,0,48,4316
34023003802,3553,314,1421,1268,1,415,0,35,3239
34023004000,4269,616,3095,433,2,49,0,19,3653
34023004100,3047,430,2387,134,7,30,1,23,2617
34023004200,3631,329,3107,87,5,52,0,24,3302
34023004300,3962,406,3333,131,0,14,5,29,3556
34023004400,4665,298,4170,84,3,28,3,39,4367
34023004501,4235,179,3857,123,2,12,0,44,4056
34023004502,3880,311,2001,1238,1,134,0,66,3569
34023004600,6347,313,5565,281,14,61,1,66,6034
34023004700,4213,264,3479,291,1,90,1,39,3949
34023004800,6300,262,5716,181,0,75,1,37,6038
34023004900,5451,388,4651,310,2,42,0,31,5063
34023005000,5436,357,4788,190,1,23,0,34,5079
34023005100,7337,3600,983,463,1,1927,5,235,3737
34023005200,5656,1549,2813,479,4,665,11,47,4107
34023005300,3973,325,3130,205,2,242,3,37,3648
34023005500,3618,137,2278,1083,0,50,0,25,3481
34023005601,2946,176,2395,284,9,32,1,25,2770
34023005602,7282,255,6344,461,2,81,0,69,7027
34023005700,5625,378,4058,886,3,179,1,50,5247
34023005800,5884,489,4629,483,1,180,0,46,5395
34023006001,2193,877,734,331,0,174,0,16,1316
34023006002,5130,1185,1737,829,12,1163,7,142,3945
34023006101,5851,1562,3028,478,1,579,0,90,4289
34023006103,5423,1410,1967,837,9,974,0,90,4013
34023006104,4277,1404,876,762,5,1062,0,29,2873
34023006204,1878,396,253,289,0,886,1,4,1482
34023006205,7332,2222,1003,1267,27,2541,0,74,5110
34023006206,1977,1035,239,147,0,467,0,8,942
34023006207,7294,2068,2131,1798,11,1042,0,68,5226
34023006208,7190,1076,783,1857,19,3222,0,56,6114
34023006209,2683,1441,396,302,3,439,0,28,1242
34023006300,7037,5555,810,178,5,246,0,29,1482
34023006403,2733,1330,253,150,2,872,0,12,1403
34023006500,7351,4252,632,249,7,1929,3,42,3099
34023006601,2395,1587,216,24,2,487,0,19,808
34023006604,7107,3553,486,277,6,2600,0,30,3554
34023006605,4089,2644,297,142,7,887,0,15,1445
34023006606,3111,1691,158,88,1,1068,0,19,1420
34023006607,2905,1924,268,124,0,494,0,18,981
34023006608,3917,2111,258,133,4,1268,0,29,1806
34023006701,4074,2509,481,177,4,746,4,23,1565
34023006703,5979,2830,740,294,8,1900,0,60,3149
34023006800,4661,2627,1274,228,2,167,0,105,2034
34023006900,3565,1588,1348,183,0,48,0,151,1977
34023007000,7892,4589,1576,589,2,611,2,183,3303
34023007101,3444,1962,638,300,2,405,0,46,1482
34023007102,5286,2749,798,380,4,1154,0,49,2537
34023007103,5639,1206,1279,2000,17,871,0,87,4433
34023007202,4640,2463,628,276,3,1077,0,30,2177
34023007203,4988,2364,833,531,14,1107,0,29,2624
34023007301,3151,2048,522,147,8,337,0,8,1103
34023007303,1922,1156,326,183,2,171,1,6,766
34023007305,3456,1563,594,485,3,691,0,28,1893
34023007306,3463,1078,537,642,4,1058,1,51,2385
34023007402,4956,3278,796,354,7,369,0,22,1678
34023007500,3274,2104,739,170,4,120,0,25,1170
34023007600,6137,3844,1354,359,4,350,1,25,2293
34023007702,6994,3890,817,483,3,1507,0,33,3104
34023007703,3121,2011,505,184,4,269,2,51,1110
34023007704,2578,1873,401,94,0,143,0,0,705
34023007801,3157,1720,579,296,9,430,0,12,1437
34023007804,5489,3496,720,303,3,775,0,40,1993
34023007805,4444,3106,724,107,3,363,2,30,1338
34023007806,4078,2803,674,215,1,256,2,31,1275
34023007905,2320,1446,410,95,0,281,0,5,874
34023007906,1431,695,349,171,3,178,0,1,736
34023007907,3153,2027,486,180,4,361,0,19,1126
34023007908,5457,1468,841,1250,10,1710,2,61,3989
34023007909,4011,2765,412,154,2,554,2,24,1246
34023007910,3163,2244,343,166,0,319,0,17,919
34023007911,3419,2050,283,163,10,786,3,18,1369
34023007913,3814,2107,305,191,6,1085,3,29,1707
34023007914,3612,2339,392,151,0,602,1,13,1273
34023008001,6635,4354,1035,468,13,500,0,39,2281
34023008101,4608,3469,541,156,1,264,0,16,1139
34023008102,3555,2675,376,116,2,259,0,10,880
34023008103,2455,1846,282,99,1,119,4,12,609
34023008204,4897,3542,257,213,6,780,0,30,1355
34023008205,3406,2946,135,119,0,169,0,6,460
34023008206,3533,2824,192,202,7,257,0,4,709
34023008207,2705,2267,82,67,0,259,2,8,438
34023008209,3719,2947,367,54,4,231,0,16,772
34023008210,4158,1924,241,128,4,1787,0,10,2234
34023008211,6157,3974,510,162,2,1294,2,59,2183
34023008212,4334,2218,320,259,0,1397,0,26,2116
34023008213,5609,4157,278,156,2,879,0,18,1452
34023008214,10076,3386,364,295,17,5839,0,37,6690
34023008300,5783,3043,1843,401,9,267,1,34,2740
34023008403,7969,2559,470,534,11,4147,2,37,5410
34023008404,4274,2190,688,211,4,998,0,6,2084
34023008405,5106,1683,244,248,12,2781,0,20,3423
34023008406,2239,1086,208,100,4,781,0,2,1153
34023008501,5106,1164,600,866,29,2305,0,31,3942
34023008502,5669,1849,279,243,5,3159,3,28,3820
34023008504,7460,3011,458,441,2,3345,2,33,4449
34023008505,5246,1359,295,385,11,3082,0,12,3887
34023008506,3974,1197,268,377,7,2006,0,25,2777
34023008601,5423,2048,160,238,1,2806,6,22,3375
34023008602,5065,1314,313,357,11,2899,0,22,3751
34023008604,6106,1684,364,288,13,3590,0,32,4422
34023008605,2806,546,203,272,8,1679,0,20,2260
34023008606,4684,1104,409,424,16,2604,1,24,3580
34023008700,3842,2612,183,108,0,803,0,20,1230
34023008801,5364,1601,497,574,7,2471,10,158,3763
34023009000,5134,1320,1232,1605,6,850,4,28,3814
34023009101,2711,1380,712,199,1,332,1,15,1331
34023009200,4400,2499,917,445,2,371,3,40,1901
34023009300,5622,1351,2275,774,0,1029,2,58,4271
34023009400,6054,2754,969,455,0,1643,0,41,3300
34023980000,56,0,20,20,0,9,1,0,56
34023980100,84,20,58,0,0,0,0,0,64
34023980200,4592,1118,425,337,2,2482,3,218,3474
34025800101,3461,2913,277,68,2,44,0,28,548
34025800102,1160,1015,66,12,1,11,0,3,145
34025800200,4414,3748,363,54,0,78,1,4,666
34025800400,3566,3051,319,54,7,35,1,3,515
34025800500,4346,3580,437,60,4,106,1,14,766
34025800601,5131,4043,568,149,5,132,1,27,1088
34025800602,3567,3005,347,30,0,65,0,19,562
34025800701,4779,4055,447,51,3,125,0,23,724
34025800702,3592,2985,291,43,2,152,0,20,607
34025800800,6328,5254,497,88,3,299,1,16,1074
34025800900,6107,5240,358,144,1,127,0,21,867
34025801000,4192,3507,362,59,4,149,0,8,685
34025801100,4645,4071,243,30,1,138,0,20,574
34025801200,3717,3281,212,9,4,86,0,13,436
34025801300,6010,5440,311,30,0,79,2,16,570
34025801400,3883,3360,295,25,0,72,0,17,523
34025801500,7060,6139,394,43,8,302,1,15,921
34025801600,5369,3611,1021,370,6,122,0,12,1758
34025801700,4563,2656,939,559,8,143,4,17,1907
34025801800,5723,4499,726,111,10,125,0,31,1224
34025801900,3548,2214,857,221,5,110,1,10,1334
34025802000,3656,2540,715,166,0,116,0,14,1116
34025802100,6213,5009,744,96,2,179,0,43,1204
34025802200,3773,3047,464,76,2,57,4,13,726
34025802300,4513,3678,497,58,11,139,1,11,835
34025802400,5626,4439,587,100,1,307,4,10,1187
34025802500,3036,1892,536,332,5,119,1,12,1144
34025802600,5394,2684,834,1132,13,451,1,43,2710
34025802700,4144,2985,606,194,4,208,1,16,1159
34025802800,4806,3723,491,152,3,249,0,24,1083
34025802900,1949,1536,175,73,0,89,0,13,413
34025803000,5896,4015,817,416,2,340,0,52,1881
34025803100,3669,2344,614,309,8,254,0,20,1325
34025803201,4047,2633,231,47,2,982,0,25,1414
34025803202,6116,4187,356,58,1,1293,0,24,1929
34025803300,7237,5174,402,84,2,1280,0,22,2063
34025803400,5344,1049,3320,737,4,88,1,27,4295
34025803500,2722,1901,603,75,0,63,0,6,821
34025803601,2127,1477,491,58,0,45,0,7,650
34025803602,2743,2031,476,96,0,35,0,10,712
34025803700,6269,5664,241,66,6,92,0,11,605
34025803800,3512,3159,140,12,0,52,0,13,353
34025803900,3831,3476,168,9,2,54,0,22,355
34025804100,3174,2908,122,9,5,36,0,20,266
34025804200,6131,5504,261,25,1,138,0,13,627
34025804600,3403,2758,194,129,0,200,0,8,645
34025804801,7330,5031,671,744,4,544,0,40,2299
34025804802,2817,2361,133,162,9,105,0,12,456
34025805001,5755,2274,1074,1192,11,641,1,125,3481
34025805100,4284,3109,464,188,5,293,0,26,1175
34025805300,5882,4965,594,39,0,65,0,53,917
34025805400,4309,2330,941,478,3,76,3,105,1979
34025805500,4471,1257,1485,759,6,76,2,322,3214
34025805600,2508,246,1268,739,7,24,0,75,2262
34025805700,3246,982,1428,175,0,29,0,246,2264
34025805800,3634,1271,1702,193,2,74,0,150,2363
34025805900,5691,1834,2306,530,0,122,1,331,3857
34025806000,4342,2523,875,201,1,139,0,195,1819
34025806100,3466,2690,327,102,4,48,0,118,776
34025806201,4039,3189,384,185,5,49,0,57,850
34025806202,4548,3629,390,90,0,94,0,89,919
34025806300,2435,2074,131,31,0,47,0,56,361
34025806400,5135,4130,474,93,5,194,0,51,1005
34025806501,4136,1777,896,887,3,401,0,52,2359
34025806502,3797,2407,426,480,8,306,0,37,1390
34025806503,3997,3351,207,56,0,264,0,21,646
34025806504,2770,1172,402,852,2,218,2,15,1598
34025806600,5402,4359,471,108,5,206,3,46,1043
34025807004,2677,1960,297,274,0,46,0,15,717
34025807005,2422,1211,700,364,0,35,0,15,1211
34025807006,1921,922,483,407,4,34,0,8,999
34025807100,2389,872,535,873,3,21,2,12,1517
34025807200,2389,153,681,1438,6,10,1,12,2236
34025807300,3390,166,1383,1703,1,16,1,17,3224
34025807401,1178,998,79,58,0,9,1,9,180
34025807402,1879,1609,124,55,0,22,3,3,270
34025807500,2988,745,1002,1069,3,47,0,8,2243
34025807600,3435,228,915,2116,1,39,0,13,3207
34025807700,3821,778,517,2246,7,95,0,17,3043
34025807800,4333,1339,590,1995,12,180,0,36,2994
34025807900,4020,1668,427,1470,3,232,0,20,2352
34025808001,4075,3643,178,43,0,58,0,15,432
34025808002,2332,1550,220,367,6,88,0,13,782
34025808100,4626,3041,644,627,8,92,0,13,1585
34025808201,2650,1780,698,57,2,35,0,9,870
34025808202,1632,1339,182,25,5,22,0,6,293
34025808300,1933,1702,141,22,1,20,0,2,231
34025808401,2158,1914,147,7,0,28,0,15,244
34025808402,3749,2691,816,93,5,43,0,19,1058
34025808501,3569,3158,226,15,0,79,0,3,411
34025808502,2939,2405,361,30,2,32,0,14,534
34025808600,6130,5124,355,333,7,91,1,37,1006
34025808701,5125,4556,252,34,1,131,4,7,569
34025808702,4258,3913,128,12,0,75,0,4,345
34025808800,4504,4086,237,37,3,35,6,8,418
34025808901,2426,2225,116,11,3,15,0,6,201
34025808902,2464,2238,105,12,1,39,0,3,226
34025809000,1697,1199,336,73,0,33,0,9,498
34025809100,2789,2591,86,11,1,36,0,11,198
34025809200,1866,1771,56,9,2,4,1,4,95
34025809301,3220,2779,337,8,0,29,0,0,441
34025809302,2718,2556,80,2,1,19,3,1,162
34025809400,4982,4500,226,69,3,34,2,20,482
34025809503,7162,3951,398,167,8,2449,1,23,3211
34025809504,2575,1588,154,65,1,699,0,5,987
34025809505,4892,3422,183,53,4,1150,0,15,1470
34025809506,3631,2126,256,109,5,1047,1,24,1505
34025809600,7071,5447,470,110,1,877,2,18,1624
34025809701,5495,3889,359,76,12,1002,0,22,1606
34025809703,4630,3850,247,57,3,400,0,11,780
34025809704,6046,4160,256,91,3,1396,0,22,1886
34025809901,5157,4436,282,42,0,265,1,20,721
34025809902,4606,3955,265,37,0,224,0,21,651
34025809903,194,78,67,26,0,6,0,1,116
34025810001,6007,4670,569,164,1,450,0,23,1337
34025810002,3873,3319,247,62,0,190,0,12,554
34025810003,5447,4481,438,100,6,264,0,21,966
34025810004,4064,3356,340,38,3,183,4,14,708
34025810101,4171,3451,350,35,0,211,0,14,720
34025810102,4197,3304,307,55,1,424,0,21,893
34025810201,6325,4730,416,227,0,753,0,54,1595
34025810202,6821,4829,521,195,2,1086,1,25,1992
34025810300,2346,1630,368,66,0,207,0,10,716
34025810401,4138,2971,409,291,3,338,0,6,1167
34025810402,7934,5785,729,269,1,883,1,32,2149
34025810501,3879,2707,551,250,4,189,3,29,1172
34025810503,4261,3456,319,135,4,226,0,19,805
34025810504,4333,2974,738,223,9,238,0,17,1359
34025810505,3733,2947,275,77,3,316,0,5,786
34025810600,7091,5559,615,261,4,395,0,35,1532
34025810700,2011,1051,679,135,1,69,1,6,960
34025810800,4018,590,2643,593,4,88,0,25,3428
34025810900,2941,1358,1328,119,0,56,0,11,1583
34025811000,3568,1061,1999,263,5,117,2,42,2507
34025811101,5724,4416,503,240,0,383,0,25,1308
34025811102,7265,5760,609,184,2,463,0,34,1505
34025811200,6000,4343,899,231,10,249,2,44,1657
34025811301,6545,4223,1094,370,5,593,0,30,2322
34025811303,4484,3443,502,188,1,162,0,30,1041
34025811304,3766,2806,523,125,1,202,3,15,960
34025811401,5639,4397,612,181,6,210,0,27,1242
34025811402,3771,2782,488,189,2,115,3,35,989
34025811501,6476,5242,668,154,7,175,2,10,1234
34025811502,3867,3133,461,96,5,69,0,14,734
34025811600,1504,1148,167,80,0,40,1,1,356
34025811900,7273,5950,454,161,5,460,1,35,1323
34025812000,1734,1477,92,64,3,28,2,8,257
34025812100,1455,1271,81,13,0,34,0,9,184
34025812200,3823,2379,482,310,3,387,2,66,1444
34025812300,5260,4257,382,209,6,185,1,31,1003
34025812400,2424,2140,166,11,1,19,0,24,284
34025812501,6172,4908,499,232,3,321,0,25,1264
34025812502,5012,3833,448,206,12,318,0,24,1179
34025812600,5634,3935,698,575,3,192,0,34,1699
34025990000,0,0,0,0,0,0,0,0,0
34027040101,4108,3043,577,83,1,259,0,24,1065
34027040102,6807,4997,892,249,6,460,2,36,1810
34027040200,7121,5772,838,60,8,241,0,28,1349
34027040301,4455,4094,145,34,0,102,3,8,361
34027040302,3995,3595,241,4,0,52,0,1,400
34027040400,4107,3269,411,88,0,219,1,9,838
34027040500,3621,2548,766,55,4,131,0,5,1073
34027040600,4426,3439,643,68,1,153,0,10,987
34027040701,5679,4783,387,52,2,276,0,22,896
34027040702,4287,3409,341,39,4,334,0,18,878
34027040801,5164,3874,405,53,10,624,0,26,1290
34027040803,7258,4288,550,185,1,2011,3,29,2970
34027040804,3846,2573,232,32,0,913,3,15,1273
34027040805,6182,4274,391,49,7,1263,0,31,1908
34027040900,4380,3626,275,47,2,275,0,11,754
34027041000,5193,3306,870,203,6,588,1,19,1887
34027041100,3622,2294,539,241,0,365,0,21,1328
34027041200,4472,3285,247,19,4,694,1,13,1187
34027041300,4999,4266,287,41,0,230,0,4,733
34027041400,5728,4647,449,65,10,356,0,12,1081
34027041500,6380,4572,544,211,17,765,0,25,1808
34027041602,2977,1917,339,70,4,524,0,34,1060
34027041603,4431,1912,441,128,5,1817,0,27,2519
34027041604,4872,2891,477,123,7,1183,0,14,1981
34027041605,4219,1962,325,240,0,1570,0,16,2257
34027041606,3913,1633,358,223,2,1558,0,24,2280
34027041701,6480,2449,738,204,9,2848,0,47,4031
34027041702,3465,1755,522,120,0,918,0,24,1710
34027041704,4837,2133,589,199,3,1724,0,25,2704
34027041705,1613,704,111,26,3,710,1,12,909
34027041706,6227,2325,684,303,16,2686,0,37,3902
34027041801,2877,921,263,71,7,1538,0,9,1956
34027041802,5159,2179,525,113,10,2197,0,33,2980
34027041803,5092,2179,259,91,11,2421,5,15,2913
34027041901,6023,4675,508,61,0,658,0,16,1348
34027041902,5082,3775,368,80,4,767,0,14,1307
34027042000,4598,3365,274,64,4,771,0,9,1233
34027042100,4173,3322,245,44,2,419,0,8,851
34027042200,5906,4193,527,217,4,758,5,23,1713
34027042301,2524,1964,307,54,0,116,0,9,560
34027042302,3629,2711,283,165,0,371,0,6,918
34027042500,3454,2961,172,26,0,179,1,10,493
34027042601,3109,2224,364,244,5,174,1,15,885
34027042602,6022,4225,393,455,0,722,6,16,1797
34027042700,4234,3175,370,67,0,426,0,27,1059
34027042800,4978,3984,305,22,0,421,0,25,994
34027042900,3862,2574,750,97,2,254,0,29,1288
34027043000,4709,3490,627,95,1,322,0,11,1219
34027043100,3740,3223,140,38,0,186,0,19,517
34027043200,4626,3195,487,233,8,500,7,25,1431
34027043301,2770,1520,616,368,2,165,0,21,1250
34027043302,3546,2923,191,51,0,290,0,2,623
34027043303,3842,3086,257,92,0,242,1,13,756
34027043401,7151,5312,843,314,6,408,7,34,1839
34027043402,5665,4412,471,194,1,263,1,47,1253
34027043500,4104,401,2684,877,2,45,3,22,3703
34027043601,3208,1903,778,178,8,242,0,20,1305
34027043602,2464,1313,573,273,2,192,2,11,1151
34027043700,3221,2390,380,137,6,172,0,24,831
34027043801,2603,1477,753,175,5,109,1,12,1126
34027043802,4580,1714,2199,321,5,201,5,39,2866
34027043900,5032,4044,229,29,4,519,0,18,988
34027044000,5951,4505,285,52,0,868,0,39,1446
34027044101,3031,2392,232,13,3,256,0,25,639
34027044102,5598,4184,680,60,3,437,4,41,1414
34027044200,3871,3305,179,41,1,180,0,10,566
34027044300,6598,4273,1355,187,7,553,1,33,2325
34027044401,5242,4219,499,132,6,220,4,17,1023
34027044403,5080,3719,643,147,3,362,5,17,1361
34027044404,4193,3106,548,89,0,279,1,17,1087
34027044502,4335,2245,1421,151,0,394,0,15,2090
34027044503,2367,1971,229,39,1,58,0,6,396
34027044504,4124,2544,655,173,0,605,0,11,1580
34027044601,4639,3939,401,46,0,85,4,34,700
34027044602,5566,4818,421,68,4,77,1,26,748
34027044701,4506,3748,476,63,8,68,0,18,758
34027044702,5827,4100,700,179,6,630,2,50,1727
34027044800,7336,917,5843,309,11,157,0,39,6419
34027044900,5842,984,4402,244,10,92,0,44,4858
34027045000,5282,825,3964,230,6,174,0,17,4457
34027045100,7241,2795,3576,225,7,394,1,51,4446
34027045200,4015,2178,1283,191,3,210,1,29,1837
34027045300,4521,2956,1000,108,5,258,1,31,1565
34027045402,5106,3518,964,201,1,217,0,25,1588
34027045403,3435,2547,406,138,1,257,0,12,888
34027045404,2474,1931,313,59,2,77,0,13,543
34027045501,5044,4147,458,72,0,211,0,29,897
34027045503,3811,3076,360,69,0,205,1,9,735
34027045504,4468,3168,558,197,2,401,0,15,1300
34027045603,5142,2376,1547,161,8,899,1,31,2766
34027045701,6177,4620,616,184,0,515,0,26,1557
34027045703,3949,2896,382,84,0,406,0,10,1053
34027045704,5443,4204,449,96,1,462,0,24,1239
34027045804,6016,4929,330,93,1,347,0,40,1087
34027045901,1681,1276,281,5,1,60,0,1,405
34027045903,3130,2611,184,46,1,168,1,8,519
34027045904,4583,3766,355,44,2,213,0,18,817
34027046000,3375,2162,817,151,12,118,0,11,1213
34027046103,6422,4473,986,340,4,397,0,17,1949
34027046104,6210,4245,887,361,0,465,0,38,1965
34027046107,3491,1880,834,303,0,321,1,18,1611
34027046108,3778,2363,681,232,2,344,2,25,1415
34027046109,3312,1930,407,142,2,648,0,23,1382
34027046110,5673,3508,665,429,4,850,0,20,2165
34027046201,5920,4697,512,151,1,387,0,17,1223
34027046202,3749,3243,227,29,1,117,1,5,506
34027046297,3500,3009,227,44,0,103,0,10,491
34027046298,5028,4260,393,62,0,153,1,48,768
34027046400,4981,4321,293,29,2,161,0,29,660
34027046500,7375,3831,1982,357,10,944,0,36,3544
34029710101,2754,2329,302,16,0,24,0,5,425
34029710102,2012,1755,173,12,1,33,1,6,257
34029711100,4591,4018,396,20,7,31,0,12,573
34029711200,4282,3786,343,11,2,30,2,4,496
34029711300,4228,3744,299,11,8,49,0,17,484
34029711400,5840,5344,289,16,3,44,9,3,496
34029713000,4139,3404,410,79,6,97,0,22,735
34029713100,6573,5457,623,138,6,118,0,28,1116
34029713201,2356,2101,115,14,1,54,1,2,255
34029713202,3740,3012,359,127,0,77,1,14,728
34029713203,5145,3447,802,624,3,87,0,20,1698
34029713300,4259,3812,213,64,1,87,0,4,447
34029713401,5076,3792,689,292,5,83,0,26,1284
34029713402,3849,2819,662,110,8,95,1,13,1030
34029713500,3006,2642,180,15,3,65,0,20,364
34029713600,3529,3067,254,18,6,46,1,7,462
34029713700,2559,2312,127,11,0,18,0,9,247
34029713800,3272,2753,287,49,2,66,0,16,519
34029713900,6381,4199,1508,187,12,198,6,32,2182
34029714000,6079,4808,878,95,4,93,0,18,1271
34029714100,3301,2915,223,47,0,38,0,7,386
34029714200,6416,5220,708,170,5,96,0,20,1196
34029714300,3292,2972,160,31,1,28,0,7,320
34029715001,10354,6973,2352,669,1,63,1,157,3381
34029715002,4562,3314,886,195,4,30,3,78,1248
34029715201,11817,10813,557,42,0,2,0,233,1004
34029715202,6784,4361,1941,229,2,16,0,160,2423
34029715301,10137,7915,1581,266,12,91,0,134,2222
34029715303,3015,2714,183,15,0,0,0,60,301
34029715304,4262,3206,864,65,2,6,1,54,1056
34029715401,6454,5764,323,139,6,12,0,109,690
34029715403,3334,3125,47,1,1,0,0,109,209
34029715404,3076,2818,182,1,0,4,0,26,258
34029715501,4939,4549,226,29,2,7,0,55,390
34029715502,6629,6287,132,13,0,5,0,110,342
34029715503,5627,5203,178,35,14,1,0,76,424
34029715600,10459,8770,1183,301,13,27,0,75,1689
34029715701,12850,10602,1638,214,15,27,2,201,2248
34029715702,4127,3729,165,68,0,62,0,51,398
34029715800,12984,11112,1013,215,11,105,0,300,1872
34029715901,4593,3346,644,364,1,114,0,47,1247
34029715902,4966,2999,1488,339,7,56,0,15,1967
34029716000,4189,3788,185,90,0,71,0,6,401
34029717001,3225,2419,460,133,0,100,1,30,806
34029717002,5520,3995,822,405,0,80,0,51,1525
34029717101,8832,6478,1120,482,8,376,1,66,2354
34029717102,4980,3753,646,248,2,167,2,12,1227
34029717200,9136,7225,904,414,10,258,5,44,1911
34029717300,5679,4410,518,325,0,187,0,39,1269
34029717400,5978,4441,910,224,6,129,1,22,1537
34029717501,7920,5906,1174,332,14,163,2,76,2014
34029717502,7206,5730,979,196,2,96,1,43,1476
34029718000,8072,6832,677,107,10,58,2,28,1240
34029720001,4140,3657,218,77,0,61,1,19,483
34029720102,3579,3191,151,110,8,52,0,7,388
34029720104,3103,2820,135,50,4,43,0,8,283
34029720105,3255,2273,485,283,1,76,0,22,982
34029720106,2537,2231,128,72,3,35,0,11,306
34029720107,2532,2321,99,35,0,36,2,1,211
34029720202,3801,3040,305,286,4,70,0,4,761
34029720203,4512,3480,496,205,0,150,0,24,1032
34029720204,5819,4114,838,338,11,262,0,15,1705
34029720205,3903,3421,176,160,4,78,1,2,482
34029720206,6289,5400,394,213,5,135,0,10,889
34029721000,2636,1680,505,236,2,76,0,11,956
34029722001,5583,4305,604,300,2,216,2,27,1278
34029722003,5782,3659,1006,611,7,317,2,31,2123
34029722004,4249,3441,410,100,1,207,0,19,808
34029722100,7553,6186,481,135,0,498,0,107,1367
34029722200,2546,2273,161,25,2,32,1,5,273
34029722300,4158,3477,283,83,5,199,0,16,681
34029722401,5194,4291,538,71,8,84,2,32,903
34029722402,4068,3463,346,50,1,64,0,16,605
34029722500,1277,1222,25,2,0,7,0,5,55
34029722600,3047,2547,304,31,0,62,0,5,500
34029722701,4562,3871,392,32,0,157,0,4,691
34029722702,4381,3657,453,70,1,59,0,11,724
34029722800,5150,2738,1548,270,5,416,0,18,2412
34029722900,5666,3571,965,475,0,408,1,26,2095
34029723000,5476,3830,796,266,8,352,0,15,1646
34029723100,3909,2969,490,191,10,103,0,16,940
34029723200,6265,5071,680,112,0,212,3,36,1194
34029723300,6679,4877,1101,173,6,210,0,18,1802
34029723400,3293,2770,311,50,7,49,0,12,523
34029723500,2714,2143,368,59,0,61,0,8,571
34029723600,2555,2087,256,45,2,65,0,16,468
34029724000,3643,1778,1040,528,8,75,0,17,1865
34029725001,2922,2405,311,48,0,46,1,6,517
34029725002,5821,4772,648,115,5,75,0,23,1049
34029725100,2116,1588,331,76,2,26,1,3,528
34029726000,1650,1487,55,8,3,14,1,12,163
34029727001,1787,1657,60,8,2,7,0,2,130
34029727002,1331,1223,75,4,0,2,0,2,108
34029728001,968,918,19,6,0,3,0,4,50
34029728002,1083,986,56,4,1,9,3,2,97
34029728003,1463,921,335,98,6,30,0,2,542
34029728004,977,652,231,38,5,6,0,2,325
34029729000,1932,1623,156,46,0,5,0,8,309
34029730000,2148,1884,133,17,0,29,0,8,264
34029731001,3515,2931,377,32,1,54,1,10,584
34029731002,4078,3246,524,54,4,59,2,24,832
34029731101,3301,2542,401,121,0,81,0,12,759
34029731102,6903,5395,905,175,7,190,3,15,1508
34029731103,4844,4012,417,119,6,80,0,17,832
34029731201,4407,4079,183,44,0,46,0,7,328
34029731202,4552,4217,174,51,7,34,0,6,335
34029731203,1867,1736,73,16,0,11,1,3,131
34029731204,3634,3401,136,32,0,27,0,8,233
34029731205,3614,2741,356,376,8,28,3,13,873
34029731206,2415,2176,114,53,1,24,1,10,239
34029732001,7025,6243,411,36,2,110,0,14,782
34029732003,3813,3278,293,36,4,54,0,19,535
34029732004,4846,4250,338,39,7,47,0,9,596
34029732101,6253,5404,475,76,1,68,4,32,849
34029732103,2564,2270,171,15,0,31,0,4,294
34029732104,4154,3646,312,21,8,24,1,17,508
34029733001,5481,4866,321,47,14,48,1,16,615
34029733002,3348,3138,84,25,0,22,1,6,210
34029734002,7243,5767,779,296,8,127,3,32,1476
34029734003,7788,5546,1133,502,7,167,0,13,2242
34029734004,5109,4378,351,131,4,105,1,17,731
34029734005,4156,3770,197,58,1,72,0,4,386
34029735001,7043,6010,613,71,3,107,0,14,1033
34029735003,3327,2792,295,83,3,64,0,6,535
34029735004,6741,5729,586,93,0,79,0,14,1012
34029735101,2769,2477,190,18,0,36,3,0,292
34029735104,4172,3348,539,50,0,96,0,10,824
34029735105,2368,2215,89,1,4,11,2,1,153
34029735106,2197,1971,156,0,2,27,0,6,226
34029736001,3403,3104,148,21,3,32,1,3,299
34029736002,1722,1519,116,8,12,10,0,1,203
34029736101,5701,4776,483,137,5,88,9,12,925
34029736105,3523,3161,181,28,4,42,1,10,362
34029736106,3288,2819,264,40,3,27,0,9,469
34029736107,4867,3999,464,141,9,36,0,21,868
34029737000,3577,3065,304,40,5,37,3,10,512
34029738001,2198,2068,64,2,0,20,0,6,130
34029738002,1292,1147,121,2,0,1,0,1,145
34029738100,1721,1626,46,0,0,11,1,6,95
34029739000,2341,2157,116,2,1,19,0,10,184
34029739100,1713,1532,88,26,10,21,2,0,181
34029739200,1909,1776,62,6,3,16,2,4,133
34029980000,6,0,2,0,0,1,0,0,6
34029980100,2,0,1,0,0,0,0,0,2
34029990000,0,0,0,0,0,0,0,0,0
34031116500,7777,5914,1186,114,9,273,0,45,1863
34031124201,3787,1875,1276,140,0,368,0,44,1912
34031124202,4334,2479,1083,129,9,528,0,25,1855
34031124311,4979,2741,1075,126,7,889,0,27,2238
34031124312,4558,2814,706,213,4,682,4,7,1744
34031124321,6296,3374,1514,326,5,895,7,37,2922
34031124322,4828,2632,1174,142,2,745,0,20,2196
34031124323,3122,1319,760,307,2,633,0,16,1803
34031124402,5917,3079,1682,199,0,744,0,102,2838
34031124403,3746,2812,515,64,6,251,0,24,934
34031124404,4014,2095,1223,122,0,409,0,13,1919
34031124500,6867,2315,3336,426,16,592,0,25,4552
34031124601,4710,1977,2068,256,8,242,0,36,2733
34031124602,5255,2427,1914,198,13,554,1,20,2828
34031124700,6956,2281,3853,372,1,292,1,58,4675
34031124800,4924,1704,2632,227,2,208,0,40,3220
34031124900,5360,991,3708,303,2,241,1,46,4369
34031125000,6628,1438,4713,232,5,114,0,47,5190
34031125100,4015,897,2927,117,7,27,0,20,3118
34031133701,5803,1201,3167,795,2,452,0,69,4602
34031133702,3249,1393,1309,268,7,179,0,24,1856
34031143201,2307,1716,395,67,0,74,0,3,591
34031143202,4332,3386,626,69,1,111,0,33,946
34031143301,1977,1278,554,47,0,46,0,16,699
34031143302,4213,2858,967,116,6,126,2,19,1355
34031143401,3203,1943,993,102,2,53,0,13,1260
34031143402,3605,1948,1243,190,3,122,0,22,1657
34031154003,3624,2722,512,68,1,214,0,18,902
34031154004,2855,1516,492,652,0,140,0,1,1339
34031154005,2553,1813,463,38,0,155,2,11,740
34031154006,4328,3065,797,76,3,214,0,38,1263
34031163501,4677,3756,519,77,8,206,1,6,921
34031163502,4250,3170,610,213,1,143,0,15,1080
34031175200,5128,153,4676,244,3,5,0,19,4975
34031175301,3617,139,3380,43,0,5,0,31,3478
34031175302,4740,162,4397,128,10,9,0,19,4578
34031175401,5737,163,5022,453,5,24,0,39,5574
34031175402,4442,98,3831,440,1,8,0,21,4344
34031175501,4230,160,3647,344,3,38,0,17,4070
34031175502,3396,126,2690,466,8,16,0,54,3270
34031175601,2573,2149,251,40,1,23,0,43,424
34031175603,3955,171,3215,255,4,223,0,43,3784
34031175604,3241,779,1912,215,3,234,4,40,2462
34031175701,5791,1828,3024,285,3,508,0,76,3963
34031175703,4520,1604,1955,240,19,528,2,70,2916
34031175704,4501,2742,1178,160,6,209,0,93,1759
34031175801,4094,126,2946,225,17,686,2,45,3968
34031175803,2901,26,2668,153,19,17,0,9,2875
34031175804,3950,73,3657,136,3,54,0,16,3877
34031175900,3721,319,3135,178,6,12,0,37,3402
34031180101,4179,454,2227,511,4,887,0,31,3725
34031180102,3843,600,2064,563,8,514,0,48,3243
34031180201,3677,307,1957,1001,5,339,1,11,3370
34031180203,3944,134,1945,208,5,1580,0,25,3810
34031180204,3799,179,1718,236,7,1599,0,35,3620
34031180301,4094,102,2414,658,7,822,0,32,3992
34031180302,3451,203,2188,805,7,177,0,17,3248
34031180600,5025,232,2978,1610,10,100,0,43,4793
34031180700,3025,69,1443,1391,3,21,2,32,2956
34031180800,3202,45,1871,1220,13,0,0,17,3157
34031180900,3762,132,2969,552,8,26,0,25,3630
34031181000,5415,233,4493,595,13,18,0,28,5182
34031181101,2299,53,1632,570,0,7,0,13,2246
34031181102,4093,100,3142,765,5,16,0,44,3993
34031181200,4734,91,2727,1808,5,17,1,30,4643
34031181300,5659,151,3263,2052,7,10,0,70,5508
34031181400,4380,65,2193,2009,5,12,0,26,4315
34031181500,3768,86,1554,2036,10,11,0,23,3682
34031181702,3780,84,2467,1130,0,20,0,42,3696
34031181800,3181,228,2142,673,0,85,0,22,2953
34031181900,5472,909,3124,451,4,861,0,38,4563
34031182000,1815,137,1535,84,6,37,0,4,1678
34031182100,3641,745,2315,405,6,64,0,24,2896
34031182200,3660,260,2650,620,4,50,0,33,3400
34031182301,1846,34,1575,205,0,5,0,10,1812
34031182302,6180,121,4775,1152,6,8,2,49,6059
34031182400,6169,96,4081,1828,6,19,6,45,6073
34031182501,5148,150,2753,2082,9,33,1,42,4998
34031182502,3014,507,1050,1345,0,51,0,3,2507
34031182600,5775,221,2731,2596,6,30,2,54,5554
34031182701,3624,162,3173,191,0,23,0,48,3462
34031182702,3010,126,2589,233,1,9,0,28,2884
34031182800,3805,120,3246,358,5,19,0,21,3685
34031182900,2370,172,1854,258,0,40,0,23,2198
34031183001,3641,1577,1677,111,1,131,1,42,2064
34031183002,4009,1743,1689,244,5,174,0,41,2266
34031183101,4139,859,2578,568,0,54,1,20,3280
34031183102,4606,715,3401,342,0,44,0,47,3891
34031183200,3567,197,1908,1328,1,67,0,15,3370
34031196401,4187,2988,868,52,4,150,0,18,1199
34031196403,3200,2000,742,78,2,235,1,30,1200
34031196404,3740,2796,564,40,3,209,0,14,944
34031203600,6372,1153,3752,1023,7,294,0,52,5219
34031216701,6282,5280,460,86,108,69,0,30,1002
34031216702,5453,4420,624,81,1,127,1,17,1033
34031223801,3092,1774,996,64,0,163,0,9,1318
34031223802,7966,5523,1410,180,0,675,1,39,2443
34031223900,7,0,2,3,0,0,0,0,7
34031236601,4493,3065,798,157,19,287,0,33,1428
34031236603,3069,2509,344,54,0,103,0,6,560
34031236604,3755,2797,517,94,8,153,0,23,958
34031246001,6263,3701,663,836,3,931,0,27,2562
34031246002,3141,2561,225,57,8,214,0,10,580
34031246003,5902,4257,689,89,0,692,0,20,1645
34031246101,6875,5000,788,145,2,734,0,27,1875
34031246102,2794,1660,367,99,2,597,0,18,1134
34031246103,6608,4982,768,86,6,596,0,13,1626
34031246104,3189,2562,307,34,1,206,0,0,627
34031246201,6327,4963,687,90,2,425,0,17,1364
34031246202,5332,4404,483,30,0,231,0,21,928
34031246203,3860,2952,451,36,0,273,0,28,908
34031246300,4547,2955,1011,137,2,268,0,37,1592
34031256801,4845,3991,457,101,24,67,0,20,854
34031256802,3883,3312,308,36,14,46,0,11,571
34031256803,4635,3930,392,65,1,105,0,19,705
34031256804,6572,5564,607,69,12,99,4,24,1008
34031256805,4927,4098,495,49,22,61,0,26,829
34031264101,5789,2817,2362,226,6,224,0,31,2972
34031264102,7695,5258,1454,299,2,463,1,22,2437
34031264200,4931,124,2772,1873,4,11,0,59,4807
34033020100,1910,1532,118,132,4,9,0,8,378
34033020200,1924,425,634,774,3,5,0,8,1499
34033020300,2913,635,1059,1086,5,6,0,22,2278
34033020400,2767,1165,659,757,4,33,0,10,1602
34033020500,3119,1802,484,703,7,40,0,11,1317
34033020600,2751,1903,374,283,8,44,0,6,848
34033020700,4183,3432,232,276,0,48,0,19,751
34033020800,3678,2808,247,385,7,57,0,4,870
34033020900,3432,3019,196,69,7,12,1,17,413
34033021000,1347,1172,64,29,4,7,1,6,175
34033021101,4567,3972,253,80,9,35,0,16,595
34033021102,4210,3082,407,391,38,62,3,15,1128
34033021201,3283,2920,64,102,21,25,5,16,363
34033021202,2580,1851,195,263,14,22,1,30,729
34033021300,1475,1056,148,184,5,5,0,18,419
34033021400,3230,2791,177,98,5,26,0,6,439
34033021500,1751,1408,122,67,11,48,0,9,343
34033021600,5765,4996,261,146,7,66,0,8,769
34033021700,1938,1567,117,84,2,59,0,10,371
34033021900,1797,492,149,1061,3,5,0,18,1305
34033022000,1908,253,318,1244,0,6,0,10,1655
34033022100,1591,545,151,793,5,18,0,5,1046
34033022201,1717,1586,53,9,6,6,0,4,131
34033022202,1001,867,53,33,7,5,2,1,134
34033990000,0,0,0,0,0,0,0,0,0
34035050100,3032,1742,811,189,7,188,0,22,1290
34035050200,2714,1041,631,386,4,532,0,15,1673
34035050300,3400,2201,512,138,2,406,0,19,1199
34035050400,3200,1089,1159,488,9,307,2,18,2111
34035050500,3538,1586,1140,123,3,574,1,10,1952
34035050600,4297,2534,532,124,3,984,0,15,1763
34035050701,4156,2758,405,76,1,721,4,30,1398
34035050703,4836,1800,313,180,8,2434,0,11,3036
34035050704,6793,2849,522,208,16,2981,0,31,3944
34035050801,4024,3155,275,65,2,393,0,10,869
34035050802,4760,3021,310,153,3,1126,1,23,1739
34035050901,4819,3665,336,66,2,585,0,23,1154
34035050902,3875,2812,290,84,2,531,1,25,1063
34035050903,5395,4009,310,77,0,818,2,14,1386
34035051000,7319,3478,1756,359,8,1491,1,53,3841
34035051100,4530,917,2899,389,0,135,0,107,3613
34035051200,5218,1409,2870,473,12,258,4,83,3809
34035051300,2240,1316,605,114,3,90,0,17,924
34035051400,4356,2627,1308,165,7,120,6,11,1729
34035051500,3418,1821,1156,196,0,125,1,26,1597
34035051600,3179,1807,1000,153,7,92,0,9,1372
34035051700,5246,536,4100,395,1,96,2,48,4710
34035051800,4433,761,2741,662,7,118,0,41,3672
34035051900,4232,1390,1298,1127,4,230,1,57,2842
34035052001,4014,1146,1486,1049,2,173,2,26,2868
34035052002,4883,1165,1923,1157,3,447,3,50,3718
34035052100,7281,4134,843,313,5,1743,0,34,3147
34035052201,5704,3805,502,124,0,1012,4,49,1899
34035052203,5271,3387,323,86,4,1249,0,16,1884
34035052204,4948,3377,331,67,2,988,0,30,1571
34035052300,6449,4302,519,309,6,1001,0,51,2147
34035052400,5417,4368,377,39,1,429,0,18,1049
34035052603,4411,3114,252,69,1,815,0,25,1297
34035052604,4133,3145,230,26,0,563,1,12,988
34035052605,5935,2122,235,52,5,3309,0,26,3813
34035052701,4276,2986,892,29,1,206,0,23,1290
34035052702,3617,2941,380,20,2,137,0,6,676
34035052800,2558,2061,319,60,0,50,0,7,497
34035052901,924,745,107,8,0,42,0,3,179
34035052904,2275,1824,242,15,0,121,0,2,451
34035052905,3493,2435,345,71,7,504,0,22,1058
34035052906,2504,1901,217,67,0,257,0,5,603
34035053000,4863,2212,1537,528,7,395,1,35,2651
34035053102,3571,972,520,1177,8,749,1,19,2599
34035053103,4995,1648,784,1720,10,611,1,40,3347
34035053105,7699,2870,917,1579,4,1981,2,52,4829
34035053200,7723,926,3009,2961,25,495,4,73,6797
34035053300,6101,550,2984,1854,11,494,1,78,5551
34035053402,7290,2425,564,1032,4,3016,0,39,4865
34035053403,4860,1325,475,1212,2,1621,4,34,3535
34035053405,4129,1500,532,1014,5,922,0,20,2629
34035053406,6678,1206,883,2177,10,2191,0,41,5472
34035053501,6058,3173,485,643,5,1538,0,44,2885
34035053602,6386,4700,454,209,2,786,0,21,1686
34035053603,4804,3792,338,100,5,398,0,18,1012
34035053604,3750,2729,324,129,0,425,0,19,1021
34035053703,3886,2578,244,97,1,835,4,29,1308
34035053704,2900,2090,250,75,1,331,0,19,810
34035053705,7135,3659,971,592,13,1601,0,47,3476
34035053706,4864,2702,351,277,0,1382,2,19,2162
34035053707,3875,2556,249,92,0,820,0,16,1319
34035053801,448,380,34,7,1,9,0,0,68
34035053804,4803,2615,828,311,2,862,0,25,2188
34035053805,6468,3683,721,399,4,1430,0,35,2785
34035053806,2467,1836,132,36,2,380,1,2,631
34035053807,6878,3906,321,161,7,2248,2,21,2972
34035053901,743,604,70,3,1,36,0,4,139
34035053904,3622,1978,186,92,0,1232,0,7,1644
34035053905,6629,2531,326,330,7,3180,3,25,4098
34035054100,7934,5291,501,261,0,1592,5,16,2643
34035054201,7173,3674,456,139,5,2631,2,22,3499
34035054202,6266,3208,346,160,3,2309,0,29,3058
34035054301,3457,2063,167,311,8,827,0,8,1394
34035054302,5803,2747,618,851,3,1390,0,35,3056
34037371000,3792,3108,370,71,6,69,0,21,684
34037371100,3763,3229,262,63,1,43,0,14,534
34037371200,2024,1576,284,47,0,26,0,7,448
34037371300,3525,2967,333,52,4,35,0,18,558
34037371400,2990,2489,260,74,10,42,0,7,501
34037371502,5100,4386,418,67,15,20,0,12,714
34037371503,2626,2249,211,40,0,18,0,16,377
34037371600,3084,2512,397,36,3,31,0,12,572
34037371700,5033,4159,544,62,5,60,0,19,874
34037371801,3818,3353,225,38,1,59,0,24,465
34037371802,3230,2692,301,51,6,25,0,19,538
34037371900,1984,1760,103,9,0,31,0,8,224
34037372000,2966,2693,139,4,3,21,0,10,273
34037372100,1927,1642,128,22,2,58,0,9,285
34037372200,1981,1764,119,8,5,16,0,1,217
34037372300,4112,3603,231,42,10,76,0,14,509
34037372400,2358,2083,164,20,1,13,0,17,275
34037372500,3262,2600,312,142,2,78,0,9,662
34037372600,4863,4105,335,102,8,137,0,27,758
34037372700,3266,2603,318,98,7,94,0,12,663
34037372800,1630,1297,218,30,2,38,0,3,333
34037372900,3282,2525,443,78,4,40,0,25,757
34037373000,2258,1835,265,20,3,28,0,9,423
34037373100,6331,5029,584,148,6,293,4,32,1302
34037373200,3625,3068,275,52,0,88,0,18,557
34037373300,3045,2430,292,56,0,131,0,10,615
34037373400,6599,5772,419,53,4,108,0,28,827
34037373500,3799,3065,342,167,8,68,1,30,734
34037373600,2792,2246,247,37,3,148,0,8,546
34037373700,3973,2900,534,213,12,133,0,11,1073
34037373800,4401,2994,829,219,10,159,0,18,1407
34037373900,4004,3609,202,23,4,38,1,16,395
34037374000,3235,2866,181,20,5,58,0,11,369
34037374100,3627,3071,306,65,2,62,0,24,556
34037374200,2256,1936,145,28,0,38,0,15,320
34037374300,3409,2884,283,51,0,55,0,24,525
34037374400,2363,1936,255,53,2,35,0,6,427
34037374500,1875,1465,262,37,7,36,0,14,410
34037374600,3526,2724,492,74,3,93,2,20,802
34037374700,4082,3075,658,110,9,77,3,22,1007
34037374800,4285,3067,760,185,6,122,0,17,1218
34037374900,4120,2880,864,91,12,118,0,29,1240
34039030200,3895,120,2761,836,3,28,0,61,3775
34039030400,6854,326,4397,1869,6,48,0,67,6528
34039030500,5942,457,4790,431,5,63,0,109,5485
34039030600,3730,448,2197,884,4,52,1,62,3282
34039030701,2190,470,1450,87,1,55,0,41,1720
34039030703,5284,618,3778,579,5,97,0,100,4666
34039030704,3055,294,2167,436,1,71,0,29,2761
34039030802,3006,392,2174,292,6,80,0,24,2614
34039030900,6485,735,5336,198,3,56,0,77,5750
34039031000,4553,196,3887,314,6,70,0,41,4357
34039031100,6260,548,5056,417,7,47,1,97,5712
34039031200,6712,328,4428,1602,9,56,6,156,6384
34039031301,3408,721,2233,117,3,71,0,102,2687
34039031302,4179,253,2435,1178,4,78,1,113,3926
34039031400,5807,301,3057,2054,2,137,0,82,5506
34039031500,5690,1153,3547,520,8,87,0,133,4537
34039031601,4397,391,2455,1216,10,113,0,71,4006
34039031602,5768,878,3434,982,8,102,0,129,4890
34039031700,6125,739,2784,1956,14,304,0,114,5386
34039031801,5616,641,3986,660,6,149,3,73,4975
34039031802,3345,297,2063,815,11,73,0,22,3048
34039031903,6516,858,4316,947,3,227,0,78,5658
34039031904,3288,299,2095,739,2,52,0,37,2989
34039032002,4090,671,2826,381,3,91,2,44,3419
34039032003,3875,560,2747,338,0,91,0,50,3315
34039032004,3092,341,2104,423,5,124,0,33,2751
34039032101,3845,1334,2023,195,2,125,0,64,2511
34039032102,3239,1467,1431,114,3,133,0,23,1772
34039032200,5984,140,831,4682,11,58,0,72,5844
34039032300,2477,163,446,1734,1,29,0,28,2314
34039032401,4340,951,1297,1382,5,140,0,201,3389
34039032402,3661,617,928,1693,4,72,0,114,3044
34039032500,5994,1916,1687,1836,4,199,0,122,4078
34039032600,5121,665,727,3132,9,391,3,48,4456
34039032701,3387,1085,721,846,2,522,0,87,2302
34039032702,4829,952,787,2299,3,511,2,54,3877
34039032800,5346,429,700,3805,12,169,0,74,4917
34039032901,4100,1352,735,1265,2,561,0,59,2748
34039032902,5101,2487,973,749,0,674,5,51,2614
34039033000,4305,1771,981,855,3,443,0,74,2534
34039033100,5957,1712,1263,1776,9,898,1,86,4245
34039033200,4341,1394,969,1267,5,481,0,43,2947
34039033300,4048,1678,949,717,9,494,0,52,2370
34039033400,3818,1902,913,475,1,370,0,35,1916
34039033501,4543,1930,1010,892,10,503,1,57,2613
34039033502,4832,1789,1171,1218,3,455,1,46,3043
34039033600,8427,5524,1933,219,8,435,2,38,2903
34039033700,4811,2038,1912,355,3,339,0,35,2773
34039033800,5834,2474,1886,545,2,715,0,71,3360
34039033900,3322,1213,1495,286,2,217,1,30,2109
34039034000,6009,594,2558,2472,14,168,0,56,5415
34039034100,3665,465,1333,1618,7,86,3,41,3200
34039034200,3747,356,1281,1848,3,97,0,36,3391
34039034300,4422,788,1275,1983,6,175,4,41,3634
34039034400,4852,271,1453,2879,7,54,0,48,4581
34039034500,4775,799,2101,1618,4,101,0,62,3976
34039034600,4438,210,999,3014,5,47,3,59,4228
34039034700,4139,1155,1472,1221,7,104,0,48,2984
34039034800,5068,2632,1373,635,1,226,0,66,2436
34039034900,6681,3165,1861,1037,0,360,1,67,3516
34039035000,2857,1224,1083,364,2,84,0,23,1633
34039035100,4177,1124,1291,1421,0,158,1,40,3053
34039035200,2649,596,1479,352,0,83,0,91,2053
34039035300,6062,1858,2333,1438,8,231,0,42,4204
34039035400,2892,981,1063,622,6,90,0,43,1911
34039035500,7256,2339,2414,1935,11,279,1,65,4917
34039035600,3727,2034,897,455,3,203,0,27,1693
34039035700,5602,2072,1795,1186,4,305,3,43,3530
34039035800,3339,605,907,1588,9,90,0,20,2734
34039035900,4188,1068,1299,1225,7,396,0,28,3120
34039036000,5444,795,1555,2503,6,349,0,45,4649
34039036100,1423,1187,139,14,2,6,1,2,236
34039036200,6436,5181,764,34,0,293,3,20,1255
34039036301,5229,3934,778,164,4,222,0,18,1295
34039036302,3879,3231,403,33,0,129,0,8,648
34039036400,7403,6219,359,58,0,464,1,25,1184
34039036500,5614,4453,369,103,3,443,0,36,1161
34039036600,4100,2687,513,363,6,314,0,26,1413
34039036700,6071,4548,513,146,6,560,0,31,1523
34039036800,7844,5912,493,120,4,954,0,32,1932
34039036900,4454,3436,670,69,1,119,0,32,1018
34039037000,6048,4926,582,145,0,198,4,20,1122
34039037100,4373,3732,294,25,1,133,0,23,641
34039037200,4274,3247,465,193,5,188,0,28,1027
34039037300,4641,3500,585,165,0,203,0,22,1141
34039037400,4511,3541,517,125,0,181,0,13,970
34039037500,5979,3692,1004,489,0,525,0,43,2287
34039037601,4718,3475,469,204,3,368,0,32,1243
34039037602,6481,3973,762,811,4,648,1,56,2508
34039037700,4851,3498,432,110,0,556,0,17,1353
34039037800,6078,3989,755,277,4,743,3,37,2089
34039037900,6111,4763,409,87,3,530,0,41,1348
34039038000,5679,2766,1717,421,1,542,2,31,2913
34039038101,5036,3681,331,53,0,782,0,29,1355
34039038103,3400,2310,326,64,0,540,0,12,1090
34039038104,5214,3438,594,124,7,849,2,19,1776
34039038201,6139,4117,489,168,5,1086,1,58,2022
34039038202,7146,5161,651,74,0,979,0,26,1985
34039038300,7020,5498,667,134,2,466,0,50,1522
34039038400,6115,3283,872,1034,12,615,0,45,2832
34039038500,6136,4275,589,506,1,468,0,40,1861
34039038601,8476,5811,813,668,0,860,0,36,2665
34039038602,4241,2928,305,157,1,667,0,24,1313
34039038701,4083,2895,398,216,0,389,1,7,1188
34039038702,3691,2709,331,170,3,324,1,4,982
34039038800,4898,220,1778,2652,12,50,1,65,4678
34039038900,5982,208,3563,1976,33,25,0,56,5774
34039039000,4609,144,3258,1073,6,20,0,48,4465
34039039100,3281,948,592,1526,6,100,4,15,2333
34039039200,5838,449,3323,1825,8,43,0,54,5389
34039039301,3697,64,2676,840,0,12,1,42,3633
34039039302,2576,78,2226,215,0,8,0,23,2498
34039039400,6137,192,4204,1508,10,50,0,95,5945
34039039501,3940,57,2619,1143,7,13,0,32,3883
34039039502,3281,68,2123,925,11,29,0,78,3213
34039039600,4515,256,1691,2291,1,75,1,65,4259
34039039700,5832,699,1739,3060,10,75,1,61,5133
34039039801,4838,525,2998,1040,5,33,0,88,4313
34039039900,1915,157,1129,570,7,13,3,17,1758
34039980000,299,35,149,71,0,31,1,8,264
34041030600,4111,2795,529,473,5,79,1,34,1316
34041030700,5059,2988,983,713,0,60,0,19,2071
34041030800,3067,2161,401,286,1,43,0,6,906
34041030900,3012,1742,639,435,0,37,0,9,1270
34041031101,5715,4992,335,67,10,75,4,40,723
34041031102,3786,3364,226,38,0,21,0,6,422
34041031200,7399,6386,492,70,10,94,0,33,1013
34041031301,5469,4543,444,143,2,122,1,25,926
34041031302,5335,4258,465,227,7,181,0,28,1077
34041031401,4922,3348,1033,131,3,276,1,17,1574
34041031402,5326,3433,1360,210,8,126,0,26,1893
34041031500,7781,5599,1153,408,7,251,0,42,2182
34041031601,4606,4122,240,94,4,41,0,13,484
34041031602,2444,2055,186,47,0,24,0,4,389
34041031700,2520,2166,198,28,7,20,0,12,354
34041031800,2503,2305,57,29,1,21,0,9,198
34041031900,6492,5327,533,238,5,153,2,26,1165
34041032000,7299,5198,1002,540,15,230,7,35,2101
34041032101,2968,2519,174,54,0,92,5,13,449
34041032102,5473,3792,546,474,1,416,0,24,1681
34041032200,8776,6496,803,714,7,440,4,65,2280
34041032300,3241,2731,215,89,2,43,2,11,510
34041032400,2328,1935,211,65,1,41,1,3,393
35001000107,2693,1785,573,36,114,53,0,16,908
35001000108,2685,1509,678,68,138,99,1,29,1176
35001000109,2401,1381,701,50,87,81,0,7,1020
35001000110,3498,1841,1148,101,125,117,0,16,1657
35001000111,2820,1629,794,64,51,141,0,21,1191
35001000112,1996,1337,429,28,40,50,4,9,659
35001000113,3006,1587,984,110,95,89,2,19,1419
35001000114,3074,1372,1308,46,130,62,0,27,1702
35001000115,3263,1509,1152,121,240,59,2,27,1754
35001000116,2925,1618,978,74,73,66,2,9,1307
35001000117,2317,1244,740,50,42,109,0,28,1073
35001000118,2694,1338,802,105,257,58,0,25,1356
35001000119,1807,1073,552,35,25,40,0,13,734
35001000120,2781,1247,965,177,182,67,4,11,1534
35001000121,5882,2818,2215,151,252,202,1,30,3064
35001000122,4284,2246,1437,80,92,274,4,10,2038
35001000123,4953,2224,2139,83,175,120,7,21,2729
35001000124,3339,1318,1405,153,252,63,6,22,2021
35001000125,4006,2480,967,62,63,239,1,34,1526
35001000126,2785,1472,908,99,119,80,2,9,1313
35001000127,2837,1236,1235,69,80,77,1,15,1601
35001000128,3115,1160,1500,77,150,73,4,12,1955
35001000129,4252,1834,1467,198,335,182,2,37,2418
35001000203,2120,1053,715,62,147,53,4,13,1067
35001000204,2973,1078,1363,97,245,57,1,18,1895
35001000205,3261,1115,1659,104,191,66,4,12,2146
35001000206,2906,1323,1277,63,67,45,0,20,1583
35001000207,3212,1310,1464,71,154,79,8,13,1902
35001000208,2690,873,1450,33,123,86,1,17,1817
35001000300,5863,3421,1627,102,192,217,5,51,2442
35001000401,4270,2162,1433,81,154,214,0,29,2108
35001000402,3548,2012,1052,81,146,81,3,31,1536
35001000501,2768,1106,1091,153,210,77,3,23,1662
35001000503,3350,2004,871,99,111,90,1,28,1346
35001000504,1287,689,348,43,72,55,3,11,598
35001000601,3854,1761,1432,156,188,138,1,23,2093
35001000603,4716,891,3059,216,344,62,0,18,3825
35001000605,4119,1011,2362,174,365,77,3,21,3108
35001000704,4015,1575,1750,142,222,104,2,51,2440
35001000711,4272,2446,1226,94,105,183,6,17,1826
35001000712,4189,1598,1717,215,316,142,3,12,2591
35001000713,5509,1971,2406,295,530,88,9,20,3538
35001000714,5042,1731,2115,158,180,709,8,14,3311
35001000715,2151,308,1688,15,92,17,0,7,1843
35001000716,4133,1087,2430,173,197,86,9,12,3046
35001000717,1848,603,807,120,201,28,2,4,1245
35001000718,4500,1634,2019,168,209,232,10,20,2866
35001000719,3045,1365,918,97,50,461,4,9,1680
35001000720,4531,2987,1126,83,24,127,4,17,1544
35001000904,4215,1277,2221,193,247,151,8,10,2938
35001000905,2079,604,993,120,234,43,3,7,1475
35001000906,3494,1037,1489,307,394,59,1,20,2457
35001000907,2461,490,1633,85,135,33,4,4,1971
35001000908,4382,722,2647,319,423,127,8,22,3660
35001001101,4523,2710,1225,83,137,67,5,54,1813
35001001102,2902,1333,1091,95,146,81,3,17,1569
35001001201,3852,1220,1844,240,219,137,3,36,2632
35001001202,4021,1019,2022,320,284,235,3,12,3002
35001001300,3989,290,3450,108,73,5,5,24,3699
35001001400,2324,483,1586,54,115,20,1,13,1841
35001001500,2852,888,1558,111,131,53,0,14,1964
35001001701,2012,1438,386,15,24,46,4,16,574
35001001702,2796,1301,871,85,174,189,0,24,1495
35001001800,2211,899,792,101,154,156,5,3,1312
35001002000,2487,629,1391,88,242,26,3,19,1858
35001002100,2126,714,815,131,303,44,0,13,1412
35001002200,3687,1810,1425,76,122,66,5,23,1877
35001002301,2024,190,1744,35,20,4,3,0,1834
35001002302,3482,478,2816,30,75,7,3,30,3004
35001002303,2709,339,2237,21,49,6,0,18,2370
35001002401,4933,684,3986,56,107,25,2,14,4249
35001002403,3998,422,3289,71,141,9,0,17,3576
35001002404,3674,299,3105,104,87,27,10,10,3375
35001002700,3671,1505,1685,99,172,49,3,40,2166
35001002900,3845,1104,2398,54,131,53,2,13,2741
35001003001,4724,1625,2519,118,230,65,5,33,3099
35001003002,3850,1593,1997,21,85,32,0,6,2257
35001003100,2793,1422,1146,29,36,27,0,21,1371
35001003201,2872,861,1758,40,80,21,1,6,2011
35001003202,5631,1385,3759,103,171,37,3,41,4246
35001003400,4368,1122,2188,197,581,93,3,17,3246
35001003501,5380,1687,3272,73,180,25,3,33,3693
35001003502,5112,2681,2063,44,62,68,0,49,2431
35001003600,6160,2206,3567,26,153,46,2,24,3954
35001003707,4883,2371,1675,160,344,139,1,20,2512
35001003712,5021,2933,1558,42,105,175,3,20,2088
35001003715,4192,2830,908,31,50,173,0,26,1362
35001003717,5240,3018,1374,187,245,183,5,27,2222
35001003718,2540,1431,739,78,72,77,2,18,1109
35001003719,5383,3095,1477,136,221,242,5,20,2288
35001003722,7223,3099,2222,139,118,1261,10,50,4124
35001003723,6743,3498,2392,147,247,215,3,41,3245
35001003724,3448,1888,1164,70,99,83,0,19,1560
35001003725,4378,1987,1638,126,248,169,4,23,2391
35001003726,2397,1544,437,42,29,252,0,13,853
35001003728,4351,2394,1288,118,222,141,7,20,1957
35001003729,2007,1347,438,15,16,117,0,12,660
35001003730,4745,3011,1053,42,25,375,0,29,1734
35001003731,3760,2403,882,26,26,244,5,14,1357
35001003733,3535,807,1544,300,544,172,3,20,2728
35001003736,2589,937,1220,60,227,67,8,7,1652
35001003737,2760,1933,523,43,25,111,0,17,827
35001003738,4859,2905,1130,94,227,245,8,34,1954
35001003739,1873,968,648,37,103,42,2,7,905
35001003740,4980,1746,1955,248,606,166,9,34,3234
35001003741,1861,1436,229,15,14,73,0,4,425
35001003742,4587,3199,837,45,27,261,4,13,1388
35001003743,6197,3396,1439,87,46,921,9,24,2801
35001003744,1376,817,331,26,5,123,4,9,559
35001003745,1361,563,681,16,42,10,0,6,798
35001003746,4912,2007,2278,74,109,245,0,21,2905
35001003803,3400,2526,638,18,29,29,1,25,874
35001003804,5497,3868,1252,43,44,40,2,46,1629
35001003805,2223,1423,651,9,28,10,0,20,800
35001003806,3421,2330,873,11,21,21,0,27,1091
35001003807,4369,2659,1383,20,79,12,2,65,1710
35001004001,5316,1182,3807,61,103,25,1,35,4134
35001004300,4924,782,3933,51,61,19,0,29,4142
35001004401,2928,245,2608,18,22,0,0,6,2683
35001004402,3950,566,3226,37,53,16,2,16,3384
35001004501,3199,305,2783,47,33,1,5,9,2894
35001004502,3290,370,2754,15,74,13,3,5,2920
35001004602,4151,959,3025,40,43,7,2,30,3192
35001004603,3455,626,2661,41,42,11,4,20,2829
35001004604,5202,890,4119,35,47,22,0,22,4312
35001004712,6754,731,5468,148,253,47,1,19,6023
35001004713,6907,730,5703,120,194,47,0,21,6177
35001004715,4526,546,3831,13,55,12,4,8,3980
35001004716,2298,1123,808,79,87,86,3,16,1175
35001004720,3823,1860,1478,95,135,75,9,24,1963
35001004722,4896,1883,2032,130,519,144,3,17,3013
35001004723,6756,2966,3082,128,133,218,6,52,3790
35001004724,2969,1241,1463,26,91,42,0,22,1728
35001004725,3458,1223,1883,60,121,53,4,17,2235
35001004726,2297,837,1250,53,51,20,1,18,1460
35001004727,2024,823,1024,28,74,8,1,4,1201
35001004728,5010,1758,2621,154,152,121,1,28,3252
35001004729,4562,1721,2328,93,165,109,6,15,2841
35001004733,6717,525,5780,111,183,42,5,20,6192
35001004734,7094,456,6328,67,123,29,1,25,6638
35001004735,2226,123,2043,17,24,2,0,3,2103
35001004736,1768,97,1565,7,89,0,0,3,1671
35001004737,8660,1325,6275,313,294,205,2,23,7335
35001004738,6932,776,5436,208,228,87,5,37,6156
35001004739,6554,551,5495,142,220,41,3,29,6003
35001004742,6119,1646,3759,159,274,102,6,19,4473
35001004743,4027,917,2463,127,182,178,4,20,3110
35001004744,7711,2520,4072,293,270,278,1,38,5191
35001004745,6425,2529,2964,219,301,128,20,38,3896
35001004747,4825,1727,2485,143,169,64,2,21,3098
35001004749,4319,1071,2472,195,342,103,0,9,3248
35001004750,6347,1572,3873,241,339,110,12,21,4775
35001004752,3850,1585,1636,127,234,120,5,14,2265
35001004753,4043,1559,1831,139,179,153,2,27,2484
35001004754,4554,1570,2353,180,158,98,16,19,2984
35001004755,3907,1377,1973,93,200,102,1,19,2530
35001004756,4303,1688,1975,116,144,183,6,27,2615
35001004757,5035,2019,2364,132,184,69,6,18,3016
35001004758,4019,1620,1957,109,108,83,2,12,2399
35001004759,4166,393,3313,88,243,52,1,15,3773
35001004760,3839,495,2669,195,294,69,3,19,3344
35001004761,2012,262,1540,71,51,32,1,1,1750
35001004762,5281,573,4217,203,143,55,3,23,4708
35001004763,4807,1883,1959,202,374,193,5,26,2924
35001004764,3529,1443,1414,130,246,153,0,8,2086
35001004800,3851,1231,2276,86,99,31,3,18,2620
35001004900,3506,1637,1126,103,221,257,6,23,1869
35001940500,2958,2320,394,17,33,77,1,3,638
35001940601,10658,3858,5227,335,343,366,18,52,6800
35001940602,2099,280,189,46,1547,6,2,1,1819
35001940700,2372,35,283,0,2012,5,0,4,2337
35001940800,16,1,7,0,6,0,1,0,15
35001980000,4578,2674,910,384,66,155,30,45,1904
35001980300,3,2,1,0,0,0,0,0,1
35001980500,1297,439,660,112,85,0,0,0,858
35001980600,7,1,3,0,0,1,0,0,6
35003976401,1612,1159,361,19,7,0,0,16,453
35003976402,1967,1579,241,16,40,8,0,21,388
35005000201,3501,1257,2040,68,21,7,2,20,2244
35005000202,3779,1237,2242,78,43,41,2,23,2542
35005000301,3587,1342,2009,45,22,76,0,20,2245
35005000302,2668,1307,1148,30,42,70,2,9,1361
35005000400,4521,1389,2941,52,39,13,2,16,3132
35005000500,1941,499,1346,23,7,11,1,8,1442
35005000600,4510,685,3645,85,14,10,2,26,3825
35005000700,4671,1373,3030,89,35,34,4,14,3298
35005000800,6063,1984,3735,141,35,31,1,25,4079
35005000900,3185,1551,1428,51,11,41,3,6,1634
35005001001,5344,2846,2153,67,23,105,4,5,2498
35005001002,4708,2739,1605,48,30,122,0,23,1969
35005001101,5390,1112,4080,73,22,22,1,22,4278
35005001102,3856,2556,1121,8,13,9,3,18,1300
35005001200,1447,719,703,3,4,5,0,3,728
35005001300,3430,1063,2169,83,40,3,1,20,2367
35005001400,2556,786,1702,3,10,11,1,0,1770
35006941500,3224,65,79,8,3020,4,0,0,3159
35006945800,2588,257,83,0,2172,17,0,3,2331
35006946100,4040,27,148,1,3677,2,5,134,4013
35006974201,5278,1148,2562,87,1264,104,0,23,4130
35006974202,2784,675,1393,32,556,44,2,11,2109
35006974401,949,219,570,7,109,6,0,3,730
35006974402,2155,563,1081,16,413,2,0,10,1592
35006974701,4395,2078,1682,71,415,16,0,9,2317
35006974702,1759,506,1046,32,141,6,0,3,1253
35007950500,4108,1613,2356,13,27,11,1,15,2495
35007950600,3023,1426,1502,0,22,19,0,3,1597
35007950700,5256,2915,2020,12,59,30,10,21,2341
35009000100,4519,630,3245,495,24,20,0,17,3889
35009000201,4214,1820,1925,206,22,44,3,30,2394
35009000202,4086,1119,2458,299,30,48,0,9,2967
35009000303,4391,2285,1533,219,27,98,4,30,2106
35009000305,2097,734,1114,123,4,35,3,10,1363
35009000306,4132,1797,1809,266,15,75,0,19,2335
35009000307,2912,1846,639,156,14,73,2,24,1066
35009000308,3680,2411,831,123,17,119,6,15,1269
35009000400,4086,1028,2661,217,16,20,2,11,3058
35009000500,2087,521,1487,32,8,2,0,2,1566
35009000601,1126,868,188,0,16,2,0,4,258
35009000602,5196,3273,1348,171,31,128,9,17,1923
35009000603,3926,1613,2072,55,19,28,3,17,2313
35009000900,1978,1107,486,151,6,41,3,6,871
35011960100,1698,983,654,3,4,4,4,0,715
35013000102,3942,1089,2610,76,16,30,2,25,2853
35013000103,4309,1078,3081,41,29,11,0,7,3231
35013000104,5359,1733,3347,67,36,32,0,33,3626
35013000203,2644,801,1665,40,17,16,6,18,1843
35013000204,4665,910,3584,52,17,22,0,14,3755
35013000205,2877,1392,1339,64,15,21,0,7,1485
35013000206,2733,572,2025,42,27,16,3,9,2161
35013000300,3535,1094,2244,65,39,13,3,14,2441
35013000401,2443,388,1929,22,41,14,1,7,2055
35013000402,5581,1035,4306,85,49,11,1,14,4546
35013000500,2510,718,1646,29,20,12,0,19,1792
35013000600,2659,507,1979,51,60,15,5,11,2152
35013000700,6060,1287,4348,172,78,30,2,22,4773
35013000800,4168,1321,2351,148,59,119,8,23,2847
35013000901,2593,661,1718,86,32,30,0,13,1932
35013000902,4312,1235,2405,165,51,287,1,29,3077
35013001000,3014,1704,902,104,66,120,0,2,1310
35013001102,2624,977,1474,32,24,11,0,11,1647
35013001103,3912,1449,2286,25,21,25,3,18,2463
35013001105,2736,484,2104,26,45,29,0,28,2252
35013001106,2701,785,1816,24,6,15,4,22,1916
35013001203,4491,1579,2512,116,45,119,2,11,2912
35013001204,4219,2719,1203,59,20,82,0,18,1500
35013001205,4368,2209,1742,67,37,145,0,29,2159
35013001206,3447,1649,1431,97,16,129,4,15,1798
35013001207,3698,1056,2439,39,40,24,4,10,2642
35013001208,6713,3233,2730,195,37,257,9,28,3480
35013001209,2709,1339,1092,77,20,87,0,10,1370
35013001210,3266,1669,1211,73,21,162,2,20,1597
35013001308,5842,1883,3559,91,37,98,7,32,3959
35013001309,2360,727,1562,11,8,3,2,2,1633
35013001310,6288,2083,3736,137,46,89,4,19,4205
35013001311,5932,1845,3654,151,36,93,6,21,4087
35013001312,1624,551,946,40,21,19,3,5,1073
35013001313,2463,596,1744,16,19,8,0,11,1867
35013001314,2191,656,1418,21,24,18,1,11,1535
35013001315,3972,798,3005,44,30,24,0,4,3174
35013001316,4500,986,3261,90,35,15,5,8,3514
35013001317,3735,1043,2572,15,15,7,3,6,2692
35013001318,3788,1763,1880,28,27,19,2,8,2025
35013001401,2562,288,2232,0,11,3,0,11,2274
35013001402,2306,218,2052,5,4,1,1,3,2088
35013001501,4013,2789,998,75,11,49,2,16,1224
35013001502,2126,950,1083,10,18,5,0,14,1176
35013001600,2615,411,2162,7,3,2,2,5,2204
35013001701,10245,1448,8495,95,25,45,8,47,8797
35013001702,1488,241,1219,0,4,1,0,5,1247
35013001703,2897,643,2173,10,17,10,0,3,2254
35013001705,2805,117,2652,2,2,7,0,12,2688
35013001706,3223,73,3140,0,1,2,0,2,3150
35013001707,5479,70,5365,9,1,2,0,22,5409
35013001805,3187,57,3116,4,5,0,0,0,3130
35013001807,2294,40,2242,5,3,0,0,1,2254
35013001808,3515,107,3372,11,1,5,0,6,3408
35013001809,2143,433,1625,12,13,8,3,18,1710
35013001810,4510,713,3656,34,14,10,0,9,3797
35013001811,1936,182,1740,3,0,0,0,0,1754
35013001812,4107,170,3871,8,13,1,1,11,3937
35013001813,2957,83,2835,8,18,0,1,5,2874
35013001814,3240,574,2595,3,15,4,3,26,2666
35013001900,930,538,193,88,2,26,1,9,392
35015000100,1661,789,733,27,26,11,0,7,872
35015000200,6520,4098,1901,81,40,153,2,43,2422
35015000300,5829,2954,2416,80,48,95,11,37,2875
35015000401,3844,1944,1656,26,30,55,7,8,1900
35015000402,4745,1727,2780,67,17,15,2,31,3018
35015000500,3573,954,2429,83,10,12,0,24,2619
35015000600,8396,2799,4943,250,93,99,10,49,5597
35015000700,6097,2954,2849,29,43,15,1,51,3143
35015000800,2223,689,1481,10,16,10,0,1,1534
35015000900,5720,2888,2586,17,49,14,0,15,2832
35015001001,3008,1260,1603,27,22,27,0,26,1748
35015001002,3338,780,2380,51,35,16,1,14,2558
35015001100,7360,3303,3550,43,89,56,9,98,4057
35017964100,2643,1813,668,17,31,14,0,26,830
35017964200,2133,1563,450,4,35,14,1,4,570
35017964300,5509,2369,2774,58,46,64,4,29,3140
35017964401,1933,740,1061,14,25,20,0,10,1193
35017964402,2807,1172,1419,81,23,17,7,20,1635
35017964500,2627,748,1777,17,28,5,0,15,1879
35017964600,2847,619,2131,14,31,6,0,18,2228
35017964701,2942,1828,926,26,16,36,0,25,1114
35017964702,3094,1632,1325,8,23,15,6,10,1462
35017964800,1650,633,935,10,7,0,0,11,1017
35019961600,4452,769,3436,64,40,49,0,21,3683
35021000100,657,352,282,2,0,0,0,1,305
35023970000,1912,1263,566,6,6,5,2,20,649
35023970200,2266,382,1824,8,8,6,3,8,1884
35025000100,3013,528,2229,129,15,55,0,12,2485
35025000200,3778,597,2932,115,34,11,0,19,3181
35025000300,4150,424,3329,322,10,2,2,19,3726
35025000400,3593,446,2721,336,13,12,1,9,3147
35025000502,8810,2834,5063,443,78,131,4,51,5976
35025000503,4384,1720,2226,184,38,81,1,17,2664
35025000504,4210,2104,1668,128,19,115,0,17,2106
35025000600,6782,2160,4114,259,34,29,9,27,4622
35025000701,1607,834,685,11,11,6,0,5,773
35025000702,4996,1714,2911,150,94,50,2,8,3282
35025000703,3159,1701,1188,95,19,32,0,8,1458
35025000704,3254,1433,1666,45,5,14,0,21,1821
35025000800,3329,1416,1746,33,17,3,0,13,1913
35025000900,2333,821,1436,11,11,0,0,0,1512
35025001003,4537,1164,3137,91,19,63,2,10,3373
35025001004,4001,913,2923,62,22,7,0,31,3088
35025001005,3723,746,2843,57,15,14,0,15,2977
35025001100,4796,2220,2376,26,23,11,0,12,2576
35027960200,1726,982,640,6,29,6,1,12,744
35027960300,3059,2261,609,8,16,12,0,34,798
35027960401,2306,950,1165,11,75,15,2,21,1356
35027960402,1161,949,173,1,2,1,0,5,212
35027960403,3535,1939,1394,7,79,13,0,16,1596
35027960601,1913,1286,507,13,26,5,0,11,627
35027960602,1898,1115,549,0,106,35,3,7,783
35027960603,2182,1537,493,9,20,18,2,17,645
35027960800,2489,1320,966,13,76,33,0,14,1169
35028000100,4256,2966,715,15,20,313,1,29,1290
35028000200,5388,3796,912,32,21,328,8,38,1592
35028000400,3907,2364,793,85,34,411,3,35,1543
35028000500,5868,4320,1015,25,41,171,3,36,1548
35029000100,5838,1787,3833,52,32,48,4,14,4051
35029000200,4261,926,3176,31,5,39,5,10,3335
35029000300,2305,626,1573,18,4,17,1,1,1679
35029000401,3589,1073,2378,19,18,13,0,14,2516
35029000402,2220,901,1208,10,18,13,0,7,1319
35029000500,4228,1550,2461,52,35,16,0,4,2678
35029000600,2986,808,2041,46,31,14,2,0,2178
35031940301,2131,7,28,2,2082,0,1,0,2124
35031940302,4002,42,81,2,3837,8,0,0,3960
35031940500,1324,58,54,3,1117,69,0,2,1266
35031943500,3762,104,87,28,3433,51,3,1,3658
35031943601,3576,18,85,2,3431,3,0,0,3558
35031943602,2883,39,46,0,2774,1,0,0,2844
35031943701,2124,5,38,3,2055,0,0,3,2119
35031943702,1818,4,15,3,1782,0,0,1,1814
35031943801,2033,10,27,12,1925,24,1,1,2023
35031943802,2207,32,44,8,2075,28,0,2,2175
35031943803,1775,7,25,1,1720,0,0,4,1768
35031943903,2508,69,166,3,2227,0,0,3,2439
35031943904,1733,126,121,0,1449,0,0,0,1607
35031943905,1231,4,26,3,1181,3,0,2,1227
35031943906,2260,66,272,6,1875,2,4,0,2194
35031943907,1902,99,101,1,1683,0,1,0,1803
35031944000,2009,52,49,1,1886,0,2,0,1957
35031945201,3264,306,978,22,1784,64,0,3,2958
35031945202,3251,363,1019,25,1712,25,4,2,2888
35031945300,3271,209,1144,27,1757,28,2,8,3062
35031945400,2979,520,847,37,1379,79,4,9,2459
35031945501,1951,641,458,39,520,188,3,2,1310
35031945502,1665,621,450,19,389,97,1,14,1044
35031945503,2251,656,585,18,718,134,2,26,1595
35031945601,2009,543,449,14,862,52,0,14,1466
35031945602,3707,157,937,23,2432,26,4,21,3550
35031945701,1027,161,58,2,777,0,0,0,866
35031945702,1411,69,27,1,1284,2,0,3,1342
35031946001,2510,157,139,10,2117,39,1,0,2353
35031946002,1350,133,97,0,1081,3,1,0,1217
35031946003,1861,64,54,0,1718,0,0,4,1797
35031973100,1110,603,100,8,339,9,0,2,507
35031980000,7,1,4,0,0,0,0,0,6
35033955201,2056,279,1722,3,7,5,0,6,1777
35033955202,2133,485,1579,7,15,9,0,4,1648
35035000100,1618,476,911,134,13,24,2,5,1142
35035000200,1748,854,655,65,33,46,0,10,894
35035000303,2281,1165,883,92,13,25,11,6,1116
35035000304,3454,2099,838,166,31,83,11,10,1355
35035000305,3640,1849,1374,166,35,29,6,22,1791
35035000306,3153,1789,907,160,30,53,10,12,1364
35035000401,4927,2626,1565,277,58,106,22,34,2301
35035000403,3141,2037,645,159,18,99,8,21,1104
35035000404,4698,2436,1433,287,42,185,24,44,2262
35035000501,2882,1388,1077,134,36,70,8,19,1494
35035000502,1853,992,697,31,14,29,1,8,861
35035000601,871,482,155,124,3,34,14,4,389
35035000602,2275,1579,434,74,27,37,0,17,696
35035000603,2435,1577,679,22,26,17,2,17,858
35035000604,2980,1674,554,269,9,98,24,21,1306
35035000701,4094,2109,1621,20,157,18,0,28,1985
35035000702,1591,836,624,13,50,1,0,7,755
35035000901,3597,2898,452,13,25,11,2,37,699
35035000903,6585,710,5651,61,93,20,0,23,5875
35035000904,5994,1273,4572,27,16,11,0,28,4721
35035940000,4022,82,425,5,3444,5,0,4,3940
35037958601,3019,1307,1509,56,11,36,0,9,1712
35037958602,2946,1032,1765,29,33,8,0,15,1914
35037958900,2781,2095,574,4,13,4,2,12,686
35039000100,3233,322,2845,8,14,1,0,7,2911
35039000200,3802,782,2795,13,101,29,1,18,3020
35039000301,3440,453,2879,14,46,8,0,15,2987
35039000302,3164,430,2631,8,40,5,0,32,2734
35039000401,1784,431,1285,3,30,7,0,3,1353
35039000402,2928,635,2205,7,24,3,0,9,2293
35039000500,3658,1195,2231,15,94,40,0,23,2463
35039940700,3570,413,2983,28,76,31,1,18,3157
35039940800,4534,702,2501,12,1192,11,0,11,3832
35039941000,3670,95,428,32,2976,60,1,24,3575
35039944100,6580,487,4376,20,1542,38,2,24,6093
35041000100,4700,2357,1850,135,40,53,12,44,2343
35041000200,3543,1018,2396,41,24,11,0,13,2525
35041000300,4311,2203,1583,206,65,94,5,17,2108
35041000401,3173,1676,1326,42,13,8,0,20,1497
35041000402,3464,2074,1242,19,21,7,1,20,1390
35043010503,3340,698,2327,24,220,21,0,8,2642
35043010601,4359,2882,1200,29,55,50,0,28,1477
35043010602,4134,2729,1027,53,104,45,2,23,1405
35043010702,7404,4236,2495,139,163,117,9,39,3168
35043010705,5840,2847,2374,106,195,74,7,19,2993
35043010712,5404,2322,2428,106,200,61,12,24,3082
35043010713,5624,2329,2704,74,182,47,6,36,3295
35043010714,4823,2451,1738,135,167,125,2,15,2372
35043010715,3828,2054,1292,121,119,84,3,18,1774
35043010719,4042,1948,1676,65,85,85,0,17,2094
35043010721,4905,2009,2302,161,170,60,5,19,2896
35043010722,6441,2530,3260,128,166,85,8,50,3911
35043010724,2360,913,1061,39,211,49,11,6,1447
35043010725,8468,3369,3932,238,399,161,23,40,5099
35043010726,5335,2641,2081,101,149,122,5,51,2694
35043010727,2940,1204,1307,114,164,35,5,16,1736
35043010728,2940,1558,1060,54,43,50,1,11,1382
35043010729,8456,4252,3323,122,203,148,8,38,4204
35043010730,2051,943,947,40,42,20,1,15,1108
35043010731,9131,4059,3638,328,207,465,12,28,5072
35043010732,6450,3466,2323,142,209,87,11,39,2984
35043010733,5355,2156,2518,155,186,67,15,14,3199
35043010734,6300,2706,2782,229,202,117,4,19,3594
35043010900,2002,504,1175,13,245,11,0,16,1498
35043011101,3217,1982,385,35,681,25,6,20,1235
35043011102,3939,2335,896,36,450,58,6,27,1604
35043011200,2675,1147,547,10,866,23,0,13,1528
35043940200,3428,60,524,0,2822,3,1,0,3368
35043940300,0,0,0,0,0,0,0,0,0
35043940500,3936,479,3180,10,181,7,0,20,3457
35043940600,1991,2,18,0,1953,1,0,0,1989
35043940700,3686,196,523,9,2922,4,1,4,3490
35043940900,2307,26,42,0,2197,0,0,0,2281
35043941000,1723,393,532,7,733,13,2,6,1330
35043980000,0,0,0,0,0,0,0,0,0
35045000100,4509,1392,1545,30,1406,9,0,7,3117
35045000201,4812,3217,902,36,343,72,0,30,1595
35045000202,5353,3188,1084,36,646,113,3,20,2165
35045000204,2153,968,592,14,467,11,0,12,1185
35045000206,4026,1409,953,16,1415,22,5,25,2617
35045000207,2385,781,653,14,815,30,5,2,1604
35045000301,5044,2284,981,41,1407,81,0,31,2760
35045000302,3306,1609,691,43,749,17,3,27,1697
35045000401,5046,2569,1063,74,1025,54,7,16,2477
35045000402,3986,1093,674,51,1932,73,3,22,2893
35045000503,3887,505,719,15,2502,12,2,7,3382
35045000504,1964,630,155,3,1075,18,3,3,1334
35045000506,3709,650,400,15,2469,17,0,7,3059
35045000507,2653,1107,331,6,1072,17,1,6,1546
35045000607,3532,1175,1072,24,1103,18,0,16,2357
35045000609,1362,770,347,6,130,8,1,9,592
35045000610,3935,2461,922,9,322,20,0,44,1474
35045000611,3227,2434,505,5,146,12,0,22,793
35045000612,2061,1091,580,2,259,13,2,10,970
35045000613,3737,2409,853,11,263,8,2,27,1328
35045000614,2871,1365,820,8,549,5,0,11,1506
35045000615,2951,1181,845,3,836,3,0,8,1770
35045000702,913,560,239,3,67,1,3,3,353
35045000705,3350,1382,1060,5,740,28,0,14,1968
35045000706,2650,1245,1151,5,115,8,4,19,1405
35045000707,4033,1524,1273,13,1067,30,2,11,2509
35045000708,3840,1502,1429,27,790,3,1,16,2338
35045000900,1990,1012,698,7,191,4,2,13,978
35045942801,2408,20,19,0,2337,0,0,0,2388
35045942802,5739,80,97,8,5409,89,3,0,5659
35045942803,2574,16,48,3,2450,18,5,0,2558
35045942900,4283,18,45,5,4130,33,1,2,4265
35045943000,4326,28,85,3,4122,6,1,0,4298
35045943100,1739,13,37,0,1678,2,1,0,1726
35045943201,5229,518,437,3,4145,10,0,7,4711
35045943300,2078,1377,325,10,241,7,7,7,701
35047957200,3851,369,3339,30,27,26,0,19,3482
35047957300,3098,773,2066,99,65,37,1,9,2325
35047957400,4067,574,3358,32,27,11,1,12,3493
35047957501,1685,492,1137,4,5,8,0,4,1193
35047957502,2350,743,1456,34,43,11,0,10,1607
35047957601,2101,620,1396,6,23,3,0,12,1481
35047957602,1265,360,850,10,7,5,0,7,905
35047957603,2538,510,1938,7,9,5,0,23,2028
35047957700,2018,498,1422,8,17,4,0,11,1520
35047957800,4228,508,3528,34,55,22,0,25,3720
35049000102,2205,1746,332,13,17,21,1,16,459
35049000103,2048,1521,395,9,14,21,0,6,527
35049000201,1748,1229,365,13,18,51,0,18,519
35049000202,2726,1615,848,10,30,72,0,34,1111
35049000300,1513,824,549,19,28,19,0,12,689
35049000400,433,319,85,4,7,5,1,2,114
35049000500,2136,1531,441,15,12,38,3,22,605
35049000600,2218,1549,525,16,15,27,0,11,669
35049000700,2015,1097,739,23,27,22,0,20,918
35049000800,2971,1457,1302,35,38,40,0,10,1514
35049000900,3608,1604,1748,32,60,51,0,16,2004
35049001001,2076,1339,583,10,26,26,0,14,737
35049001002,3448,1239,1858,53,95,56,4,28,2209
35049001102,3399,1972,1078,54,43,152,0,17,1427
35049001103,1916,777,900,35,32,101,3,9,1139
35049001105,2287,1095,995,29,42,40,0,12,1192
35049001106,3088,1154,1687,30,57,41,6,24,1934
35049001107,5326,2028,2855,43,121,65,2,45,3298
35049001202,5779,1256,4073,81,113,73,0,41,4523
35049001203,2993,646,2254,3,30,20,1,15,2347
35049001205,5713,486,5092,21,30,26,0,19,5227
35049001206,3770,613,2936,47,55,47,1,25,3157
35049001207,3006,442,2453,6,19,31,1,16,2564
35049001301,1370,549,690,21,41,16,0,5,821
35049001302,2963,447,2316,30,65,67,1,4,2516
35049001304,1029,172,834,1,12,4,0,2,857
35049001305,5038,1264,3300,73,107,159,1,27,3774
35049001306,2315,373,1796,16,44,27,0,18,1942
35049010102,4960,948,3847,13,67,15,2,24,4012
35049010204,2067,1580,312,5,29,41,2,23,487
35049010205,1246,759,391,4,10,10,2,12,487
35049010304,4432,2039,2187,19,47,49,2,20,2393
35049010308,2310,650,1543,11,25,8,4,7,1660
35049010309,1903,1385,358,21,15,18,0,11,518
35049010310,1278,885,310,6,13,10,0,10,393
35049010311,4498,3125,1053,29,38,20,0,37,1373
35049010312,4573,2953,1285,21,60,20,6,28,1620
35049010315,2632,1412,1024,17,50,38,0,11,1220
35049010316,1772,946,677,27,26,26,5,6,826
35049010317,1172,552,487,9,11,49,2,37,620
35049010318,1884,675,1029,11,20,77,1,11,1209
35049010400,3454,2584,558,36,12,90,0,29,870
35049010500,1768,1268,398,5,6,28,1,11,500
35049010601,5742,2447,2744,53,141,143,3,53,3295
35049010602,3005,2432,372,8,20,30,1,20,573
35049010603,2427,1166,1117,5,31,11,0,9,1261
35049010701,3754,2899,577,35,22,45,4,40,855
35049010702,1579,1170,319,6,6,22,0,14,409
35049010800,2867,1588,1109,12,21,31,0,12,1279
35049010900,3173,1429,1588,14,23,32,0,11,1744
35049940300,1819,288,909,2,570,11,0,1,1531
35049940400,1773,563,679,4,480,11,0,9,1210
35049940500,1840,320,1013,10,422,9,6,6,1520
35049940600,3529,806,2221,13,372,18,2,20,2723
35049940900,3218,446,2571,23,80,52,2,7,2772
35049980000,966,193,648,60,52,4,2,0,773
35049980200,45,9,22,0,2,2,0,2,36
35051962200,3294,2043,978,22,40,75,0,13,1251
35051962300,3216,2037,958,31,31,24,0,9,1179
35051962401,2357,1823,381,9,18,16,0,4,534
35051962402,2709,1604,994,8,17,4,3,5,1105
35053940000,1569,49,54,5,1436,8,0,1,1520
35053978100,3703,1336,2144,16,80,18,0,16,2367
35053978200,1615,829,634,5,89,3,0,2,786
35053978301,2648,868,1551,17,64,59,2,9,1780
35053978302,3910,1494,1873,57,143,185,2,28,2416
35053978303,3150,785,2097,21,134,22,4,19,2365
35055940000,1623,204,1190,0,185,3,0,13,1419
35055940101,3761,1363,1112,11,1116,13,0,28,2398
35055940102,4458,2028,2168,21,66,25,0,36,2430
35055952101,3539,1949,1362,3,43,27,1,39,1590
35055952102,3057,1361,1579,18,18,14,0,13,1696
35055952300,3066,1404,1458,14,48,14,1,41,1662
35055952601,2865,1251,1339,14,106,40,0,24,1614
35055952602,5783,1775,3641,33,133,23,0,48,4008
35055952701,3512,1527,1757,9,62,29,2,19,1985
35055952702,2825,844,1824,7,53,8,0,13,1981
35057963201,3811,2241,1243,28,58,21,0,36,1570
35057963202,3004,1539,1256,31,40,10,1,19,1465
35057963601,5914,2923,2632,41,111,14,1,12,2991
35057963700,2055,1026,911,18,27,4,0,23,1029
35057980000,261,32,223,3,1,2,0,0,229
35059950200,4079,2234,1596,65,57,6,4,15,1845
35061940300,896,31,102,1,718,1,2,7,865
35061941400,3477,1170,1990,43,121,25,1,19,2307
35061970101,4573,932,3413,32,91,3,2,16,3641
35061970103,2809,915,1685,16,76,13,0,22,1894
35061970104,3347,1307,1832,20,75,17,0,16,2040
35061970200,4015,2020,1698,13,105,13,0,46,1995
35061970302,2654,979,1457,49,27,27,5,27,1675
35061970304,3716,1337,2185,16,36,7,0,20,2379
35061970305,2586,903,1544,4,37,4,1,14,1683
35061970306,3730,855,2662,40,63,10,4,19,2875
35061970307,3410,604,2633,14,90,1,0,22,2806
35061970401,5184,1393,3510,33,97,17,6,20,3791
35061970404,5528,1782,3284,83,151,49,1,29,3746
35061970405,4099,1535,2142,78,132,66,0,16,2564
35061970701,5788,2009,3368,71,151,6,2,32,3779
35061970800,4746,1312,3201,27,51,24,3,32,3434
35061970901,4405,1195,3004,34,59,11,0,33,3210
35061970902,2031,635,1298,9,35,1,0,8,1396
35061971000,4923,1978,2626,84,74,22,2,18,2945
35061971100,1481,587,809,14,21,9,3,11,894
35061971301,1960,868,903,24,72,15,0,20,1092
35061980100,76,30,45,0,0,0,0,0,46
35061980200,767,274,381,42,70,0,0,0,493
35061980300,4,0,3,0,1,0,0,0,4
35061980400,0,0,0,0,0,0,0,0,0
36001000100,2073,370,258,1236,4,42,0,13,1703
36001000201,3125,566,345,1875,20,104,0,44,2559
36001000202,2598,184,413,1805,3,61,0,12,2414
36001000301,3190,497,524,1805,20,88,4,19,2693
36001000302,3496,1916,380,646,7,358,0,26,1580
36001000401,2216,1731,85,215,0,105,4,18,485
36001000403,4418,2823,320,554,3,526,0,20,1595
36001000404,5194,2897,998,266,1,870,1,18,2297
36001000501,3440,1000,501,1358,5,332,19,54,2440
36001000502,2841,1562,261,582,12,163,1,191,1279
36001000600,3500,844,528,1218,17,626,6,36,2656
36001000700,4196,494,493,2786,9,100,10,40,3702
36001000800,2216,306,343,1246,3,152,2,24,1910
36001001100,1826,875,148,586,7,107,2,12,951
36001001400,3818,2490,357,494,14,220,5,23,1328
36001001500,4528,2281,575,939,8,465,0,32,2247
36001001600,4290,2399,469,886,9,243,1,71,1891
36001001700,4016,2561,290,662,0,313,2,15,1455
36001001802,3728,2602,200,476,6,258,0,19,1126
36001001803,3232,2476,158,235,4,221,0,20,756
36001001804,3473,2575,159,307,3,315,0,3,898
36001001901,2514,1864,139,234,7,121,0,13,650
36001001902,2566,1716,141,344,0,229,0,11,850
36001002000,5960,2117,1046,1944,22,412,5,26,3843
36001002100,3937,1767,394,704,9,838,0,28,2170
36001002200,2299,1294,237,535,11,66,0,15,1005
36001002300,2147,616,282,982,12,124,0,13,1531
36001002500,3208,482,564,1880,18,95,4,16,2726
36001002600,5179,1087,933,2422,7,395,0,39,4092
36001012700,3391,2607,231,251,4,102,0,12,784
36001012800,3797,2713,257,427,15,65,0,26,1084
36001012900,3931,2749,326,385,10,130,1,31,1182
36001013000,7028,5989,279,297,6,119,1,20,1039
36001013100,2934,2102,137,211,14,195,0,13,832
36001013200,3380,1938,384,581,5,169,0,13,1442
36001013300,4397,2790,314,658,3,261,0,36,1607
36001013400,2598,1860,165,292,2,86,1,17,738
36001013503,5284,3537,207,230,12,1039,2,41,1747
36001013505,2804,2183,113,107,4,256,0,6,621
36001013507,2716,1813,118,175,2,491,0,10,903
36001013509,3692,2610,121,127,0,642,2,21,1082
36001013510,3497,2498,134,210,8,461,2,16,999
36001013511,3687,2450,167,325,5,585,0,23,1237
36001013512,3858,3046,146,130,0,378,1,10,812
36001013602,4554,2530,231,849,9,730,0,27,2024
36001013603,3151,2322,161,272,5,212,0,7,829
36001013604,7198,5301,424,431,6,816,1,22,1897
36001013703,2101,1577,107,235,5,124,0,9,524
36001013706,2087,1748,86,59,4,108,1,3,339
36001013707,6066,4941,221,192,10,458,0,21,1125
36001013708,3494,2868,112,145,3,259,0,0,626
36001013709,3313,2589,178,148,4,223,0,14,724
36001013802,4487,3562,116,170,0,409,0,33,925
36001013803,3347,2542,211,157,6,243,13,7,805
36001013804,3897,2917,198,281,4,233,1,25,980
36001013901,2396,1828,129,147,3,187,0,3,568
36001013902,5385,4006,190,344,3,551,0,24,1379
36001014001,4200,2545,283,461,6,668,0,11,1655
36001014002,4376,3154,351,368,10,245,0,19,1222
36001014100,5628,4617,200,129,3,455,1,31,1011
36001014201,5959,5026,214,131,6,321,1,33,933
36001014202,6064,5266,214,136,1,209,0,20,798
36001014203,6270,5442,229,136,10,180,0,8,828
36001014301,3005,2396,182,256,1,40,0,4,609
36001014303,4874,4014,173,81,3,398,0,12,860
36001014304,3234,2668,183,116,2,77,4,10,566
36001014401,3985,3494,174,65,9,28,0,22,491
36001014402,3271,2603,207,188,0,29,0,28,668
36001014501,2703,2428,60,20,3,47,0,19,275
36001014502,3552,3194,106,24,2,44,0,16,358
36001014503,2841,2536,105,33,3,50,0,14,305
36001014606,3825,3134,152,94,4,254,2,17,691
36001014608,4014,3103,364,171,0,201,27,11,911
36001014609,4829,3519,218,269,0,588,0,27,1310
36001014611,2260,1795,94,76,3,180,0,20,465
36001014612,1675,1507,59,14,3,13,0,2,168
36001014613,3132,2655,92,62,2,167,1,27,477
36001014614,5767,3803,275,351,6,1046,26,28,1964
36001014615,2759,1508,94,140,10,913,10,16,1251
36001014616,6214,4996,221,174,3,569,0,18,1218
36001014617,2373,1998,116,67,1,109,0,11,375
36001014700,2635,2379,59,14,6,24,0,6,256
36001014801,2689,2454,51,12,2,10,2,7,235
36001014802,1826,1685,45,15,0,11,0,11,141
36001014803,3194,2968,70,6,2,6,0,12,226
36003940200,7,2,0,0,0,0,0,1,5
36003950100,2270,2126,51,3,2,5,0,23,144
36003950300,4755,4341,93,82,13,73,0,10,414
36003950401,1647,1560,15,0,2,9,1,1,87
36003950402,1960,1850,30,6,5,2,0,4,110
36003950500,3671,3351,57,36,4,23,0,12,320
36003950600,3653,3349,61,53,9,8,0,5,304
36003950700,3575,3339,43,33,5,26,0,4,236
36003950800,6136,4721,427,526,11,154,3,98,1415
36003950900,3649,3416,44,11,8,14,2,13,233
36003951000,3116,2929,47,20,0,10,0,19,187
36003951100,3772,3558,42,16,13,17,0,10,214
36003951201,2301,2180,11,6,4,12,0,0,121
36003951202,2475,2315,16,7,7,7,0,2,160
36003951301,1350,1260,7,9,3,8,0,9,90
36003951302,2119,2030,21,1,5,5,0,7,89
36005000100,3772,260,1259,2172,6,59,0,6,3512
36005000200,4779,152,3173,1011,20,202,0,95,4627
36005000400,6272,238,3972,1592,9,230,6,76,6034
36005001600,5795,121,3479,1884,18,122,1,62,5674
36005001901,2292,250,1089,803,9,39,0,26,2042
36005001902,1613,165,854,524,3,13,2,16,1448
36005001903,2,0,2,0,0,0,0,0,2
36005001904,0,0,0,0,0,0,0,0,0
36005002001,5007,68,3023,1755,11,21,5,43,4939
36005002002,4584,66,3058,1169,16,78,0,96,4518
36005002300,4742,67,3045,1473,26,19,0,31,4675
36005002400,6,1,3,0,0,0,0,0,5
36005002500,5442,105,4135,1048,5,53,0,21,5337
36005002701,3080,35,2063,900,6,28,0,9,3045
36005002702,4995,94,3318,1398,21,55,4,13,4901
36005002800,5853,89,1647,3889,7,38,0,32,5764
36005003100,2964,35,1780,1014,7,58,0,25,2929
36005003300,3689,55,2453,1066,4,16,2,24,3634
36005003500,3726,122,2592,924,1,25,0,31,3604
36005003700,340,5,194,123,1,0,0,5,335
36005003800,1683,18,1082,475,9,49,0,18,1665
36005003900,6345,249,5107,823,5,37,2,58,6096
36005004001,1739,125,740,220,8,566,0,21,1614
36005004100,6146,94,4083,1819,1,35,0,36,6052
36005004200,7201,90,4313,2581,11,63,0,36,7111
36005004300,5883,130,4174,1409,5,43,0,28,5753
36005004400,4642,88,2809,1437,24,180,1,29,4554
36005004600,1976,53,1187,673,5,4,0,9,1923
36005004800,4184,64,3263,646,8,67,0,87,4120
36005005001,4960,81,3463,1191,13,95,5,50,4879
36005005002,6518,104,4973,1051,12,139,9,112,6414
36005005100,6459,163,3963,2131,5,55,2,41,6296
36005005200,2130,20,1483,543,4,34,0,21,2110
36005005300,4371,38,2038,2092,20,12,2,28,4333
36005005400,6804,81,4750,1282,2,370,2,178,6723
36005005600,2863,30,1958,618,24,62,1,100,2833
36005005902,2577,224,1641,592,3,37,0,20,2353
36005006000,1262,16,1013,196,5,11,0,10,1246
36005006100,3444,33,708,2580,1,24,0,17,3411
36005006200,6769,102,4455,1860,23,117,1,105,6667
36005006301,6567,323,4292,1579,5,191,3,55,6244
36005006302,19,0,15,4,0,0,0,0,19
36005006400,4186,106,2227,1225,18,312,3,164,4080
36005006500,6251,225,4045,1704,21,69,2,78,6026
36005006700,6893,117,4895,1687,7,52,3,59,6776
36005006800,3419,60,1899,814,18,397,1,130,3359
36005006900,6964,124,4179,2440,10,72,1,38,6840
36005007000,5021,105,2616,884,33,1051,1,183,4916
36005007100,2789,66,1584,1003,3,61,0,20,2723
36005007200,6291,309,2498,685,25,2535,2,119,5982
36005007300,4205,80,2804,1165,4,19,5,53,4125
36005007400,3536,57,2047,1194,1,132,0,28,3479
36005007500,6749,199,4218,2080,18,72,2,55,6550
36005007600,5682,170,3588,946,54,697,0,113,5512
36005007700,1974,61,1445,410,0,14,0,12,1913
36005007800,7037,230,3969,995,30,1481,5,166,6807
36005007900,6826,101,4889,1622,3,67,0,57,6725
36005008300,6122,72,4849,1048,9,48,4,39,6050
36005008400,2587,33,1439,830,6,206,1,48,2554
36005008500,5894,141,4288,1245,10,59,0,60,5753
36005008600,4145,35,2457,1401,1,106,2,72,4110
36005008700,5976,84,4334,1397,4,15,2,66,5892
36005008900,3118,88,2371,585,3,28,0,26,3030
36005009000,3911,60,2488,1141,16,86,0,59,3851
36005009200,6271,385,3031,830,28,1581,1,213,5886
36005009301,5551,85,4031,1281,3,33,0,42,5466
36005009302,512,32,195,263,2,14,0,1,480
36005009600,2946,191,1451,392,36,690,4,102,2755
36005009800,5903,171,3638,1185,47,507,2,177,5732
36005011000,0,0,0,0,0,0,0,0,0
36005011502,4396,44,3055,1186,1,28,4,23,4352
36005011701,1554,15,1063,437,0,5,0,4,1539
36005011702,0,0,0,0,0,0,0,0,0
36005011800,5324,3338,1511,148,8,177,5,29,1986
36005011900,5703,125,4008,1429,18,25,0,32,5578
36005012101,3319,53,2234,909,0,26,0,45,3266
36005012102,1616,20,1225,332,7,5,3,1,1596
36005012300,4766,61,3126,1413,3,37,1,51,4705
36005012500,4139,75,2608,1316,0,23,0,35,4064
36005012701,2184,34,1567,492,2,45,1,17,2150
36005012901,4923,86,3044,1637,6,24,0,42,4837
36005013000,1198,349,670,116,0,46,0,5,849
36005013100,5390,105,3404,1687,22,57,1,40,5285
36005013200,6652,1573,3764,756,8,382,1,75,5079
36005013300,6064,69,3612,2194,6,32,1,51,5995
36005013500,4001,50,2062,1781,13,13,0,21,3951
36005013800,3060,1653,1029,140,2,113,1,47,1407
36005014100,7344,149,3846,3062,17,53,4,61,7195
36005014300,1898,63,936,844,1,9,0,21,1835
36005014400,6046,221,3927,1641,9,123,1,53,5825
36005014500,7055,116,3641,3107,13,11,4,28,6939
36005014701,6361,41,3287,2884,3,6,2,36,6320
36005014702,5081,36,2931,1985,5,6,1,39,5045
36005014900,4723,104,2850,1617,14,12,2,39,4619
36005015100,5957,123,3164,2512,6,18,0,46,5834
36005015200,2593,664,1538,207,0,88,0,58,1929
36005015300,4258,72,2077,1919,10,77,1,36,4186
36005015500,2891,33,2188,579,4,25,0,17,2858
36005015700,5542,78,3193,2087,29,45,0,46,5464
36005015800,1442,513,775,72,0,40,1,12,929
36005015900,2481,23,2054,341,2,16,2,9,2458
36005016000,4003,1947,1513,165,14,219,0,74,2056
36005016100,5243,116,3322,1650,12,21,0,36,5127
36005016200,1908,708,915,96,2,114,0,43,1200
36005016300,34,5,18,10,0,0,0,0,29
36005016400,1221,523,559,42,0,65,0,22,698
36005016500,1097,17,520,517,1,14,0,15,1080
36005016600,2625,556,1541,234,0,196,2,44,2069
36005016700,3373,65,1577,1611,5,16,5,16,3308
36005016900,1586,20,674,834,0,16,3,3,1566
36005017100,10,0,1,7,0,0,0,0,10
36005017300,6395,98,3933,2149,2,61,0,58,6297
36005017500,6988,141,4045,2594,11,28,0,67,6847
36005017701,4754,224,2871,1502,4,39,1,33,4530
36005017702,4979,67,2930,1758,9,75,1,60,4912
36005017901,5124,66,3726,1042,10,201,0,44,5058
36005017902,3447,51,2130,1198,2,14,2,12,3396
36005018101,3299,72,1892,1219,3,28,0,17,3227
36005018102,5510,130,3058,1952,1,254,4,29,5380
36005018301,4423,262,2474,1292,6,233,0,55,4161
36005018302,3686,45,2238,1226,3,44,0,44,3641
36005018400,4329,1804,1955,211,5,252,0,41,2525
36005018501,3076,70,1436,1463,14,24,0,20,3006
36005018502,6442,144,3606,2478,16,32,3,45,6298
36005018900,8360,222,5509,2347,28,66,1,52,8138
36005019300,6020,97,3769,1967,8,61,3,38,5923
36005019400,2022,304,1294,254,15,84,9,19,1718
36005019500,7509,201,4927,2134,13,68,6,42,7308
36005019700,7213,59,5066,1403,19,513,2,58,7154
36005019900,7909,134,5663,1918,3,49,3,61,7775
36005020000,5235,278,2501,474,12,1834,2,54,4957
36005020100,4345,99,2777,1313,15,41,4,32,4246
36005020200,2789,240,1464,242,12,720,0,49,2549
36005020400,3129,196,1756,314,8,707,5,79,2933
36005020501,7859,99,5086,2492,17,11,0,55,7760
36005020502,2462,42,1638,719,4,15,4,14,2420
36005020601,3277,243,1587,347,17,927,1,43,3034
36005020900,4823,108,3164,1407,7,35,0,49,4715
36005021001,8946,232,3069,4001,14,1323,1,86,8714
36005021002,7855,188,2462,3306,17,1635,0,67,7667
36005021100,5822,79,3713,1899,8,30,2,25,5743
36005021200,6596,143,1694,2028,21,2509,4,47,6453
36005021301,1264,18,960,246,0,5,0,16,1246
36005021302,5830,44,3628,2043,13,29,0,30,5786
36005021501,4078,49,3005,929,0,21,0,28,4029
36005021502,6360,104,4385,1677,13,9,2,69,6256
36005021601,4701,304,2835,984,6,394,1,70,4397
36005021602,6237,168,1967,2037,15,1806,0,96,6069
36005021700,5006,122,2664,1998,3,49,3,52,4884
36005021800,6610,206,4278,1485,23,340,11,122,6404
36005021900,1176,32,916,192,4,16,0,4,1144
36005022000,2511,82,1654,626,1,51,2,41,2429
36005022101,4001,34,2969,793,5,114,1,39,3967
36005022102,5457,53,4609,660,8,38,0,46,5404
36005022200,3968,176,1891,416,26,1277,6,79,3792
36005022300,5063,74,4053,772,2,34,0,63,4989
36005022401,2787,333,1805,365,6,208,0,19,2454
36005022403,3275,414,2145,518,3,116,1,12,2861
36005022404,4489,742,2383,825,17,375,3,56,3747
36005022500,8141,126,5717,2042,20,90,4,58,8015
36005022701,5669,65,3574,1838,14,57,5,51,5604
36005022702,1634,35,1106,373,8,44,1,30,1599
36005022703,1699,39,1278,236,5,95,1,14,1660
36005022800,6336,1188,3284,922,7,744,1,83,5148
36005022901,5766,125,3844,1370,27,216,0,71,5641
36005022902,3401,48,2499,747,6,35,0,23,3353
36005023000,3001,549,1627,371,4,262,0,39,2452
36005023100,1464,11,1011,423,0,2,0,10,1453
36005023200,3000,695,1460,325,10,317,0,33,2305
36005023301,4577,78,3008,1310,11,36,1,63,4499
36005023302,3574,43,2901,544,4,19,2,40,3531
36005023501,3570,33,2915,517,3,14,0,35,3537
36005023502,4417,47,3339,836,13,94,0,45,4370
36005023600,2204,497,1146,251,5,133,0,28,1707
36005023702,1179,27,900,212,5,17,0,10,1152
36005023703,5086,141,3807,992,7,52,0,39,4945
36005023704,3970,51,2956,827,11,17,0,38,3919
36005023800,2750,655,1425,237,14,247,0,55,2095
36005023900,8213,86,6331,1500,16,155,1,47,8127
36005024000,4583,392,2839,914,11,203,0,117,4191
36005024100,6331,100,4078,1936,28,49,0,48,6231
36005024300,5577,92,3988,1266,12,68,0,65,5485
36005024400,2407,879,1051,113,0,274,0,24,1528
36005024501,5059,76,3917,923,16,26,0,29,4983
36005024502,3797,26,2884,787,5,27,2,29,3771
36005024600,2297,863,870,171,0,313,0,24,1434
36005024700,1921,53,923,866,0,40,0,17,1868
36005024800,3620,1508,1210,302,5,488,0,23,2112
36005024900,4,0,0,0,0,0,0,0,4
36005025000,2672,1397,775,48,0,374,0,19,1275
36005025100,6924,99,4714,1408,14,571,0,31,6825
36005025200,2682,1130,896,196,2,371,0,42,1552
36005025300,6234,100,4756,1001,19,204,0,69,6134
36005025400,2163,1018,749,79,12,213,0,48,1145
36005025500,8092,544,5871,1245,7,274,5,55,7548
36005025600,1908,466,922,241,2,193,0,40,1442
36005025700,1809,47,1421,283,2,16,0,20,1762
36005026100,2060,140,830,937,8,79,0,12,1920
36005026300,6788,283,5440,748,15,124,1,72,6505
36005026400,5693,1965,2586,404,7,561,3,46,3728
36005026500,7166,212,5590,753,3,455,0,83,6954
36005026601,3328,1096,1701,235,0,225,0,23,2232
36005026602,6409,1858,3425,505,3,448,0,53,4551
36005026701,3983,161,2917,316,1,507,2,32,3822
36005026702,7022,287,5627,842,16,102,2,84,6735
36005026900,4126,156,3089,709,2,89,0,36,3970
36005027300,7939,523,6083,1037,11,104,1,67,7416
36005027401,5136,3067,1538,124,0,241,0,58,2069
36005027402,3553,2390,894,94,0,113,1,20,1163
36005027600,23,5,10,5,0,3,0,0,18
36005027700,4968,399,3786,553,7,114,0,46,4569
36005027900,8145,1280,5246,988,13,340,1,84,6865
36005028100,3720,1091,1846,548,3,120,1,25,2629
36005028300,2084,141,1432,386,10,45,0,35,1943
36005028400,297,56,113,93,0,3,0,25,241
36005028500,3440,1384,1482,221,1,222,0,32,2056
36005028600,1395,619,445,66,2,206,0,30,776
36005028700,3953,670,2510,320,2,328,7,37,3283
36005028800,3055,1833,614,92,4,441,6,35,1222
36005028900,4736,819,3325,287,3,198,0,28,3917
36005029301,1954,1265,392,97,3,96,0,6,689
36005029302,5248,3034,1136,534,3,300,6,59,2214
36005029500,4615,2238,1433,342,1,356,2,54,2377
36005029600,2878,936,782,367,5,667,0,38,1942
36005029700,4005,2337,922,246,5,313,2,47,1668
36005030000,6591,2062,3214,492,8,580,2,83,4529
36005030100,1627,823,455,174,3,109,1,19,804
36005030201,4048,212,1032,2601,14,49,0,35,3836
36005030202,6063,208,1464,4116,4,71,3,35,5855
36005030701,5799,3998,1026,325,1,224,7,62,1801
36005030900,3947,2628,707,329,2,141,4,63,1319
36005031000,4372,1212,1612,729,0,636,0,50,3160
36005031200,1555,483,555,241,4,213,6,29,1072
36005031400,2071,625,757,263,0,333,0,27,1446
36005031600,2071,672,675,291,2,354,6,35,1399
36005031800,1961,587,702,295,1,286,0,40,1374
36005031900,454,206,136,66,0,17,0,24,248
36005032300,5001,2737,1249,538,0,262,3,57,2264
36005032400,3113,439,1531,847,5,149,0,41,2674
36005032600,3494,1099,1101,452,10,710,0,40,2395
36005032800,4133,727,2150,794,10,314,0,21,3406
36005033000,5837,1671,2672,980,17,344,0,58,4166
36005033201,4103,628,2565,691,2,106,1,43,3475
36005033202,4204,460,2324,1130,10,167,2,33,3744
36005033400,69,6,30,31,1,0,0,0,63
36005033500,2440,1578,477,153,4,120,0,21,862
36005033601,4306,116,2182,1743,17,96,0,55,4190
36005033602,1555,92,747,670,2,8,0,13,1463
36005033700,3838,2094,747,159,3,561,0,67,1744
36005033801,2337,168,1068,860,4,145,0,47,2169
36005033802,1737,78,698,817,9,64,0,22,1659
36005034000,4858,422,2305,1647,15,274,3,50,4436
36005034200,1732,103,635,826,4,93,1,30,1629
36005034300,1706,605,719,212,7,92,0,18,1101
36005034400,1930,96,736,870,0,162,0,23,1834
36005034500,3754,1443,1267,564,8,299,0,50,2311
36005034800,6640,274,2577,3263,28,277,1,79,6366
36005035000,2284,109,620,1227,4,195,0,46,2175
36005035100,3539,1680,1174,335,4,202,0,23,1859
36005035600,2261,79,522,1482,1,72,0,35,2182
36005035800,7542,98,1527,5478,8,131,4,102,7444
36005035900,3731,59,2333,1178,7,83,0,34,3672
36005036000,3024,341,955,1320,6,233,0,53,2683
36005036100,5569,42,4055,1259,11,58,0,29,5527
36005036300,7074,91,5051,1761,16,27,0,43,6983
36005036400,2603,33,463,1974,12,54,1,6,2570
36005036501,3897,26,2085,1683,9,13,0,29,3871
36005036502,2449,52,1623,672,11,22,3,30,2397
36005036700,2672,72,1605,887,5,26,7,41,2600
36005036800,2165,29,565,1435,7,47,0,39,2136
36005036901,1910,27,1405,423,4,10,0,23,1883
36005036902,2324,52,1320,870,4,7,0,11,2272
36005037000,2536,50,727,1535,8,114,2,28,2486
36005037100,4504,68,2846,1476,6,10,1,31,4436
36005037200,2289,67,826,1193,0,78,2,57,2222
36005037300,6117,109,3904,1880,11,43,1,44,6008
36005037400,3890,92,1755,1828,8,61,1,26,3798
36005037504,4023,112,2485,1308,8,20,0,27,3911
36005037600,2274,124,989,962,3,100,5,34,2150
36005037800,3569,120,1330,1930,12,32,1,42,3449
36005037900,6878,122,3319,3171,16,42,10,78,6756
36005038000,4938,110,1248,3305,0,109,3,56,4828
36005038100,6853,112,5093,1430,12,82,3,64,6741
36005038200,2852,47,618,2049,2,20,0,28,2805
36005038301,4635,82,3344,1051,6,66,0,35,4553
36005038303,3468,36,1820,1479,1,13,0,39,3432
36005038304,2508,61,1684,704,1,13,0,10,2447
36005038500,5362,124,3312,1706,25,30,1,44,5238
36005038600,7949,77,1246,6266,11,73,5,70,7872
36005038700,3401,355,2111,765,4,88,1,20,3046
36005038800,2941,48,651,2127,1,18,0,22,2893
36005038900,4819,913,2943,650,3,151,0,50,3906
36005039000,3323,54,857,2238,6,65,0,39,3269
36005039100,7210,560,5414,986,18,105,4,51,6650
36005039200,1809,37,557,1124,2,14,0,18,1772
36005039300,8033,261,5230,2307,12,33,0,74,7772
36005039400,4647,151,1655,2606,19,64,1,63,4496
36005039500,4254,81,2629,1419,7,30,0,41,4173
36005039600,4485,58,1177,2999,9,80,0,42,4427
36005039700,4492,2458,1143,325,3,318,3,43,2034
36005039800,3347,55,575,2573,22,20,0,13,3292
36005039901,5254,160,3664,959,7,302,0,75,5094
36005039902,5548,100,4081,1039,6,136,7,110,5448
36005040100,5009,158,3873,713,2,118,2,48,4851
36005040302,4197,75,3453,402,5,154,2,54,4122
36005040303,4843,132,3747,702,3,121,2,60,4711
36005040304,4125,108,3137,517,4,273,0,37,4017
36005040400,3530,39,775,2549,6,34,0,40,3491
36005040501,4385,111,3274,813,23,62,0,41,4274
36005040502,7320,175,4866,1870,35,167,2,93,7145
36005040600,3792,61,1018,2391,4,93,1,71,3731
36005040701,3235,204,2465,396,0,91,0,39,3031
36005040702,6968,514,4820,962,14,461,4,96,6454
36005040800,4475,110,1931,2078,14,166,0,53,4365
36005040900,3580,420,744,2110,13,217,1,31,3160
36005041100,3215,234,2302,513,7,102,1,20,2981
36005041300,7781,857,5257,1164,4,289,0,70,6924
36005041400,5342,200,1474,2862,44,280,3,242,5142
36005041500,5872,631,3789,861,15,388,0,87,5241
36005041800,3752,165,1250,1792,30,207,3,165,3587
36005041900,7205,566,4605,877,11,963,5,85,6639
36005042000,3905,98,1708,1771,16,129,2,94,3807
36005042100,6135,468,3776,812,18,864,2,84,5667
36005042200,3211,83,764,2148,13,65,0,50,3128
36005042300,4179,431,2614,558,14,442,0,54,3748
36005042400,2553,78,517,1795,0,52,2,38,2475
36005042500,7667,691,4496,827,11,1447,5,65,6976
36005042600,6982,91,1017,5548,19,86,0,74,6891
36005042800,2230,37,359,1655,4,29,5,47,2193
36005042901,3711,244,2160,540,8,675,1,27,3467
36005042902,4334,257,2576,1011,13,356,2,46,4077
36005043000,2952,69,565,2008,15,95,0,100,2883
36005043101,5185,236,2812,869,21,1070,0,110,4949
36005043102,5050,200,3531,943,5,232,0,55,4850
36005043400,3649,179,898,2059,27,159,5,160,3470
36005043501,1192,13,470,624,4,29,1,12,1179
36005043502,2,0,0,1,0,0,0,1,2
36005043503,122,29,45,35,0,4,0,1,93
36005043600,2061,56,395,1373,2,78,0,56,2005
36005044200,3877,51,929,2570,11,95,0,75,3826
36005044400,3984,100,583,3047,29,55,0,80,3884
36005044800,2007,30,268,1581,2,35,0,34,1977
36005044901,1946,1348,368,132,0,30,7,8,598
36005044902,2229,1499,486,157,1,33,0,12,730
36005045101,1817,1229,318,146,0,72,1,3,588
36005045102,2142,1450,381,162,2,48,0,33,692
36005045600,3056,435,702,1693,5,48,0,62,2621
36005045800,5662,44,3275,2181,13,30,1,20,5618
36005046000,2890,42,842,1861,7,22,0,42,2848
36005046203,6599,415,2180,3669,18,109,0,37,6184
36005046204,5552,326,1543,3399,13,68,0,46,5226
36005046205,4445,235,1335,2658,5,38,0,32,4210
36005046206,4434,194,1002,3011,23,72,0,23,4240
36005046207,6228,340,1665,3935,25,83,0,27,5888
36005046208,5155,122,1192,3591,4,65,7,49,5033
36005046209,3707,19,1384,2137,7,31,3,39,3688
36005048401,3888,65,802,2830,7,44,0,36,3823
36005048402,41,0,14,20,0,0,0,0,41
36005050400,5,0,2,0,0,0,0,0,5
36005051601,4445,2735,1139,210,0,200,0,32,1710
36005051602,0,0,0,0,0,0,0,0,0
36007000100,3180,1667,279,503,5,475,1,16,1513
36007000200,3247,1913,258,507,14,296,5,35,1334
36007000300,2789,1748,198,454,5,195,0,24,1041
36007000400,2244,1513,158,310,13,31,1,18,731
36007000500,1961,890,304,491,8,33,3,21,1071
36007000600,2252,1339,234,442,5,45,1,14,913
36007000700,3501,2755,199,244,12,73,1,14,746
36007000900,1717,1095,162,304,7,40,0,4,622
36007001100,2147,1160,268,423,9,159,0,7,987
36007001200,1797,1221,195,150,18,130,0,3,576
36007001300,2932,1650,319,526,14,233,1,18,1282
36007001401,2338,1296,229,283,3,382,0,29,1042
36007001402,2875,1938,190,244,7,334,0,20,937
36007001500,4530,3559,221,306,0,184,0,12,971
36007001600,2277,1837,89,133,8,92,0,15,440
36007001700,4090,3009,318,380,7,99,0,26,1081
36007001800,4092,2486,534,677,25,46,2,20,1606
36007010200,5168,4776,46,46,14,25,0,9,392
36007011901,2809,2609,58,17,2,7,0,12,200
36007011902,2509,2267,36,17,3,8,0,5,242
36007011903,2691,2486,39,12,9,5,0,6,205
36007012000,1581,1465,36,10,1,0,0,1,116
36007012101,3732,3461,60,24,4,12,0,13,271
36007012102,3953,3582,80,43,3,47,0,11,371
36007012103,3274,2941,82,46,6,57,1,1,333
36007012201,2492,2288,62,32,6,6,0,4,204
36007012202,3937,3608,71,16,16,4,0,23,329
36007012300,4868,4426,92,17,8,14,0,27,442
36007012400,2239,2039,80,38,0,1,1,5,200
36007012501,2543,2300,57,15,10,3,0,16,243
36007012502,3261,3009,67,22,5,15,1,7,252
36007012600,5481,4854,151,90,13,55,2,15,627
36007012701,5008,4458,129,48,10,37,0,16,550
36007012702,4617,4151,87,46,8,98,0,22,466
36007012800,5100,4183,225,385,5,81,4,4,917
36007012900,1272,1165,26,16,1,9,1,2,107
36007013000,4218,3636,151,105,0,147,1,6,582
36007013100,2794,2118,185,211,2,84,1,14,676
36007013201,2286,1971,96,65,0,35,4,6,315
36007013202,3186,2788,108,91,0,77,0,3,398
36007013301,4851,4188,183,186,8,72,0,15,663
36007013303,2570,2254,93,48,0,42,2,7,316
36007013304,5951,5201,165,164,7,146,0,27,750
36007013400,4499,3611,217,283,11,93,6,28,888
36007013500,1988,1160,234,295,8,82,0,20,828
36007013600,3928,2953,336,321,10,28,10,22,975
36007013700,3252,2461,234,277,7,62,0,31,791
36007013800,3463,2725,145,184,0,163,0,35,738
36007013900,1992,1167,169,276,6,200,3,16,825
36007014000,3181,1807,324,441,2,384,1,16,1374
36007014100,3089,2485,150,141,4,138,5,12,604
36007014200,3618,2968,142,108,0,244,3,16,650
36007014301,5382,3525,180,210,4,1240,0,22,1857
36007014302,10881,6686,1162,580,36,2226,1,34,4195
36007014400,4744,4015,169,120,10,262,0,8,729
36007014500,3155,2800,113,60,4,62,0,10,355
36007014600,5151,4510,90,64,10,219,2,21,641
36009940000,498,239,19,0,212,0,0,1,259
36009940200,13,8,1,0,1,1,0,2,5
36009940301,3136,1580,110,30,1107,11,0,5,1556
36009940302,3528,2250,156,38,740,10,0,7,1278
36009960100,3415,3288,20,8,8,17,0,4,127
36009960200,4427,4124,49,7,18,13,0,7,303
36009960300,4344,4084,70,24,37,10,2,0,260
36009960400,4067,3634,82,26,152,15,0,20,433
36009960500,4859,4577,69,19,30,1,0,10,282
36009960600,3372,3127,46,45,46,8,0,0,245
36009960703,1751,1549,26,2,47,1,0,11,202
36009960704,1086,986,27,6,8,6,0,4,100
36009960800,4120,3820,91,13,33,20,0,1,300
36009961000,4395,4089,51,23,14,38,0,11,306
36009961100,3987,3655,60,35,29,68,2,15,332
36009961200,3426,3198,64,25,16,8,0,4,228
36009961301,2442,2278,33,12,28,2,0,5,164
36009961302,2465,2123,105,140,0,59,0,6,342
36009961400,5002,4656,108,26,42,9,5,32,346
36009961500,2165,1906,52,44,11,31,0,6,259
36009961600,3752,3154,106,124,8,58,0,20,598
36009961700,3554,2799,123,195,28,89,0,19,755
36009961800,4466,3880,95,139,34,78,0,19,586
36009962200,2772,2550,52,15,12,7,0,3,222
36011040101,1650,1536,38,3,10,1,1,3,114
36011040102,3223,3008,45,12,4,4,3,1,215
36011040201,2445,2277,41,7,3,7,1,4,168
36011040202,2142,1946,27,13,8,1,1,9,196
36011040300,3905,3576,69,13,6,11,12,18,329
36011040400,4314,3921,87,42,17,27,2,9,393
36011040500,3008,2820,47,13,7,3,0,12,188
36011040600,3304,2978,77,65,10,40,3,17,326
36011040700,3552,3390,64,12,2,16,1,2,162
36011040800,4460,3643,207,403,29,9,3,8,817
36011040900,3827,3541,50,11,3,8,0,12,286
36011041001,3051,2640,289,9,3,7,0,7,411
36011041002,1655,1434,87,62,0,19,0,7,221
36011041101,2477,2269,101,5,7,12,1,13,208
36011041102,1531,1309,168,0,4,5,0,3,222
36011041201,2227,1971,94,38,1,9,13,6,256
36011041202,2611,2416,56,12,7,14,1,16,195
36011041300,3978,3264,139,212,17,13,8,23,714
36011041400,4803,4212,117,158,14,55,0,13,591
36011041500,2745,2340,91,112,7,26,0,9,405
36011041600,2498,2215,79,60,2,11,2,16,283
36011041700,3957,3437,127,141,6,32,0,17,520
36011041800,4799,3823,151,405,17,29,0,18,976
36011042100,4086,2347,385,919,40,20,2,10,1739
36011990200,0,0,0,0,0,0,0,0,0
36013030100,3413,2468,549,110,20,32,0,11,945
36013030200,3984,2946,602,146,16,9,1,19,1038
36013030300,1973,1143,421,235,11,8,0,2,830
36013030400,4015,3375,270,95,16,25,2,3,640
36013030500,3284,2189,738,139,14,23,0,16,1095
36013030600,3436,2552,445,137,17,17,8,19,884
36013030700,4324,3498,425,107,9,29,0,7,826
36013030800,4283,3406,393,155,19,14,0,22,877
36013035100,4313,3794,185,34,79,18,0,16,519
36013035300,2564,2322,131,10,10,7,0,1,242
36013035400,3049,1514,1278,136,21,17,1,4,1535
36013035500,2876,1582,1066,111,9,10,1,16,1294
36013035600,3443,2074,1039,158,10,10,0,11,1369
36013035700,3375,1838,1132,251,4,23,0,11,1537
36013035800,3422,2813,348,67,3,46,0,15,609
36013035901,4542,3812,350,64,11,128,0,16,730
36013035902,2159,1522,214,255,8,42,4,10,637
36013036000,4152,3471,395,65,20,14,0,15,681
36013036100,4629,4303,129,37,10,10,0,7,326
36013036300,4309,3462,335,269,15,17,5,24,847
36013036401,2628,2370,110,52,8,5,0,0,258
36013036402,3425,3160,71,16,9,14,11,12,265
36013036500,4553,4138,207,20,6,37,3,13,415
36013036600,3330,3101,66,12,8,10,1,8,229
36013036700,4382,4185,41,4,3,11,2,9,197
36013036801,2241,2109,39,0,3,6,0,1,132
36013036802,2072,1953,34,15,2,2,2,11,119
36013036901,2769,2591,48,8,8,8,0,2,178
36013036902,3135,2953,50,7,5,14,0,4,182
36013037000,3406,3217,55,15,5,6,0,8,189
36013037100,4137,3722,110,22,21,95,2,11,415
36013037200,3728,3358,114,54,9,49,0,1,370
36013037300,5040,4677,114,22,7,15,1,11,363
36013037400,3711,3513,71,12,7,5,0,12,198
36013037500,4853,4557,74,25,13,12,0,2,296
36013037600,2702,2375,120,26,61,8,5,13,327
36013990000,0,0,0,0,0,0,0,0,0
36015000100,2635,1726,124,424,19,7,0,5,909
36015000200,2642,1924,145,376,6,18,0,2,718
36015000300,1471,356,283,788,22,6,0,2,1115
36015000400,2113,1743,98,126,2,20,1,0,370
36015000500,2912,2154,142,371,5,37,1,11,758
36015000600,2864,2030,184,386,9,35,4,11,834
36015000700,2407,1499,151,501,8,25,3,16,908
36015000900,3355,2603,173,233,11,40,0,4,752
36015001000,2770,1982,163,300,12,10,1,15,788
36015001100,3354,2642,133,240,4,7,1,15,712
36015010100,3345,3100,50,11,5,10,1,10,245
36015010200,5896,5385,111,33,15,36,0,27,511
36015010301,4615,3997,87,87,6,225,0,20,618
36015010302,3176,2832,69,43,4,86,0,5,344
36015010400,3552,3196,63,48,6,102,0,8,356
36015010500,3009,2525,112,71,7,125,0,9,484
36015010600,3013,2644,74,92,4,41,0,1,369
36015010701,3063,2406,78,79,8,361,0,5,657
36015010702,4420,4000,86,59,7,66,0,3,420
36015010800,3513,3061,102,88,12,41,0,2,452
36015010900,5015,4425,111,143,2,62,2,20,590
36015011000,3807,3589,43,20,5,15,0,8,218
36015011101,2934,2557,61,102,5,19,0,14,377
36015011102,3827,3371,94,126,5,21,0,9,456
36015011200,4440,3812,201,262,9,11,1,6,628
36017970101,3021,2850,35,9,4,6,0,6,171
36017970102,2876,2669,54,17,7,13,0,1,207
36017970201,1868,1737,28,9,4,2,0,4,131
36017970202,2163,1970,80,5,7,5,0,3,193
36017970300,3932,3534,114,42,4,52,1,14,398
36017970400,3119,2645,151,61,7,46,1,11,474
36017970501,2334,2086,26,5,9,11,0,7,248
36017970502,2975,2663,50,7,3,15,3,12,312
36017970601,3822,3489,94,46,6,5,0,3,333
36017970602,3554,3296,81,14,3,11,1,3,258
36017970700,2214,2001,71,23,5,11,1,1,213
36017970801,3660,3424,81,25,2,17,2,2,236
36017970802,3570,3326,77,19,4,17,0,5,244
36017970901,2632,2451,45,20,2,13,0,7,181
36017970902,2111,1935,65,20,10,0,0,16,176
36017971000,3369,3077,65,23,16,12,6,14,292
36019100101,2664,2455,46,22,18,20,0,7,209
36019100102,3081,2822,77,24,11,15,3,0,259
36019100200,4096,3767,51,38,17,21,0,4,329
36019100600,5508,5052,129,45,5,33,2,17,456
36019100700,3606,3387,65,16,4,28,1,8,219
36019100800,4682,4187,125,50,15,65,1,19,495
36019100901,2864,2397,99,108,4,56,6,12,467
36019100902,2078,1692,106,99,17,35,0,28,386
36019101000,4150,3589,139,87,6,153,2,19,561
36019101600,1623,1422,44,35,4,14,0,5,201
36019101901,4820,4356,125,89,8,48,0,10,464
36019101902,1212,1074,38,5,1,4,0,10,138
36019102100,1975,1760,34,32,5,24,3,5,215
36019102200,3199,2682,118,114,13,23,1,27,517
36019102800,3484,3149,73,35,9,32,0,8,335
36019103000,2232,1376,335,306,5,138,0,5,856
36019103100,2841,2148,216,215,11,87,0,23,693
36019103200,2477,2144,94,67,9,55,0,14,333
36019103512,6748,4717,621,1144,24,34,0,18,2031
36019103800,5702,5331,70,12,14,17,1,13,371
36019103900,4885,4457,85,34,13,32,1,8,428
36019104200,5916,5287,166,176,25,23,3,10,629
36021000100,2514,2140,114,72,0,29,0,25,374
36021000200,1570,1414,61,14,2,17,0,7,156
36021000300,4104,3692,126,47,6,32,0,21,412
36021000401,2384,2227,62,14,2,18,6,10,157
36021000402,5946,5063,403,106,8,102,0,8,883
36021000500,1931,1657,130,23,3,23,1,11,274
36021000600,2670,2117,228,110,2,32,1,19,553
36021000700,5303,4673,243,111,9,38,0,19,630
36021000800,1625,1492,43,13,0,13,0,9,133
36021000900,1831,1616,98,23,0,18,0,8,215
36021001000,6058,5168,309,215,9,39,0,37,890
36021001100,4473,3153,320,466,4,238,2,35,1320
36021001200,3168,1534,302,630,4,495,1,36,1634
36021001300,2726,1668,311,344,8,172,3,8,1058
36021001400,3628,3125,158,83,4,26,0,25,503
36021001500,1231,1057,64,23,0,19,0,3,174
36021001600,3346,2883,179,44,1,32,0,31,463
36021001700,1440,1259,63,18,3,10,0,13,181
36021001800,1628,1412,84,20,2,20,0,9,216
36021001900,2058,1739,156,18,0,29,2,9,319
36021002000,1936,1706,88,27,3,21,0,5,230
36023970100,3420,3103,83,18,8,6,0,7,317
36023970201,2434,2279,49,1,4,6,0,5,155
36023970202,3254,3034,81,10,5,29,0,5,220
36023970300,3039,2767,67,23,6,28,3,10,272
36023970400,2812,2570,51,16,6,8,0,15,242
36023970500,3656,3146,111,119,12,53,1,13,510
36023970600,3049,2529,141,126,11,21,0,19,520
36023970700,4000,3543,155,87,1,30,0,15,457
36023970800,2781,1710,339,121,8,563,0,26,1071
36023970900,4070,3398,183,140,8,31,0,27,672
36023971000,5597,4788,210,124,24,220,0,26,809
36023971100,4601,4190,102,18,9,8,1,18,411
36023971200,4096,3744,86,26,11,15,1,18,352
36025970101,1442,1293,76,11,2,15,0,0,149
36025970102,2955,2641,110,30,7,21,1,19,314
36025970200,3028,2768,79,18,0,46,1,6,260
36025970300,2288,2069,69,20,5,27,0,12,219
36025970401,1829,1651,55,10,0,26,1,9,178
36025970402,3707,3194,192,74,1,58,3,11,513
36025970501,2165,1763,58,247,5,10,0,2,402
36025970502,1791,1632,50,14,6,15,0,0,159
36025970601,2398,2160,84,15,2,24,0,5,238
36025970602,2872,2605,89,11,5,23,0,18,267
36025970700,2251,2038,72,11,11,22,1,6,213
36025970800,3528,3123,138,71,1,64,0,9,405
36025970900,1267,627,255,313,6,23,0,9,640
36025971000,2658,2368,108,53,5,17,0,13,290
36025971100,2247,2060,68,27,2,19,0,0,187
36025971200,3336,2789,320,25,18,43,0,20,547
36025971300,1782,1590,53,19,2,15,0,11,192
36025971400,2764,2450,109,34,15,12,0,4,314
36027010000,3769,2974,425,87,16,70,0,17,795
36027020003,4226,3204,546,186,5,135,0,12,1022
36027020004,2853,2282,313,96,1,53,0,10,571
36027020005,5272,4216,566,134,0,143,3,22,1056
36027030000,4037,3521,196,75,3,56,1,10,516
36027040001,4595,3236,890,156,5,74,0,22,1359
36027040003,3820,2500,748,216,3,192,0,14,1320
36027050102,4180,3068,583,178,0,182,0,27,1112
36027050103,5482,4235,650,182,13,204,2,24,1247
36027050104,6837,5056,765,344,3,380,0,45,1781
36027050203,5212,3898,695,216,2,177,0,26,1314
36027050204,2812,2093,334,97,0,175,0,24,719
36027050205,5184,4053,652,113,11,136,0,38,1131
36027060100,6189,3221,1118,1322,19,300,0,30,2968
36027060201,3297,2306,468,233,8,127,2,29,991
36027060202,4302,3086,661,304,1,81,1,9,1216
36027060301,4334,3156,622,216,2,183,0,21,1178
36027060302,2658,1619,342,204,3,393,2,17,1039
36027060400,2166,1478,324,176,3,91,0,19,688
36027070101,4382,3484,316,281,0,91,1,15,898
36027070102,3379,2671,285,200,2,28,0,22,708
36027070201,2979,2230,275,248,6,80,0,15,749
36027070301,6008,4543,535,458,9,106,0,36,1465
36027070401,4273,2477,578,407,18,505,0,24,1796
36027080103,5116,3590,596,366,7,312,0,28,1526
36027080104,3678,2885,399,119,5,103,2,19,793
36027080201,4588,3366,551,239,4,178,0,35,1222
36027080202,2593,2011,237,118,0,114,2,19,582
36027090000,2245,1912,131,32,6,30,0,14,333
36027100000,2971,2318,419,48,2,53,1,9,653
36027110003,3780,3073,393,102,5,62,0,23,707
36027110004,2237,1747,337,48,1,25,3,7,490
36027110005,1995,1376,448,51,6,46,0,13,619
36027120000,2218,1921,126,18,4,30,1,6,297
36027130003,5341,4159,502,273,6,137,0,38,1182
36027130004,1737,1443,106,50,0,23,0,25,294
36027130005,2721,2215,258,61,0,24,3,17,506
36027140101,7043,4575,1008,839,6,278,2,42,2468
36027140201,2437,1505,410,297,3,93,1,18,932
36027140202,4835,3146,560,679,6,228,0,25,1689
36027140301,3024,1549,492,650,6,160,0,12,1475
36027140302,2876,1325,601,604,5,144,0,36,1551
36027140400,5360,3767,537,323,0,523,1,40,1593
36027140500,2650,1517,333,391,5,282,2,8,1133
36027140602,2872,1791,434,306,0,179,1,31,1081
36027140700,6761,4685,953,459,2,376,0,57,2076
36027140801,2838,1845,653,148,0,82,0,7,993
36027150003,1782,1443,126,31,3,84,0,18,339
36027150004,3481,2986,273,45,6,73,1,7,495
36027150005,2715,2342,150,48,1,58,1,3,373
36027150006,1975,1610,184,24,0,84,0,4,365
36027160003,2429,2106,156,32,0,41,0,7,323
36027160004,2470,2127,144,32,2,52,0,20,343
36027160005,2697,2277,206,33,3,61,0,13,420
36027170000,3682,3073,277,135,5,43,0,20,609
36027180001,4558,3926,312,74,3,78,2,21,632
36027190101,3870,2754,555,193,13,192,3,19,1116
36027190102,1865,1278,266,126,4,64,0,26,587
36027190203,2644,1724,492,208,0,108,0,26,920
36027190204,5404,3798,814,296,10,316,0,21,1606
36027190301,3609,2217,723,382,1,133,4,21,1392
36027190401,2320,1666,364,137,3,51,2,11,654
36027190402,3328,2222,601,258,5,103,0,22,1106
36027200001,3067,2490,273,79,8,42,0,12,577
36027200002,1455,1176,177,24,0,23,0,5,279
36027210101,5437,3307,984,725,5,108,1,33,2130
36027210201,4128,2148,954,666,6,109,3,50,1980
36027210301,4158,2740,729,341,1,71,7,49,1418
36027220101,4045,1523,1022,1154,9,70,0,44,2522
36027220102,856,256,147,297,0,94,2,4,600
36027220201,3424,738,900,1538,5,28,0,29,2686
36027220300,4938,663,1123,2785,18,31,7,24,4275
36027220700,2576,834,377,1161,3,48,0,13,1742
36027220801,3948,1953,640,1052,7,70,2,22,1995
36027220901,4272,1557,951,1451,5,50,0,35,2715
36027221001,3636,2568,342,496,4,80,1,17,1068
36027221100,3882,761,1603,1231,13,34,0,26,3121
36027300000,6103,3257,1630,589,5,318,0,58,2846
36027410000,3848,2116,596,350,6,442,0,209,1732
36027610000,1821,250,456,1069,11,25,0,3,1571
36027640001,767,168,173,416,6,3,0,1,599
36027640002,559,113,133,298,4,4,0,6,446
36029000110,2673,1779,505,245,11,22,0,5,894
36029000200,4450,2902,782,393,17,98,0,17,1548
36029000500,2112,1512,361,121,8,15,0,8,600
36029000600,4563,3836,306,194,10,32,2,9,727
36029000700,3551,3193,148,61,12,27,0,3,358
36029000800,4636,3824,406,187,4,45,0,6,812
36029000900,2349,1850,224,119,32,26,0,7,499
36029001000,6270,4264,803,698,45,97,1,28,2006
36029001100,3324,2449,377,268,22,35,0,9,875
36029001403,1781,37,146,1519,9,17,0,5,1744
36029001404,1202,28,326,801,2,12,0,3,1174
36029001500,1612,144,98,1216,5,80,0,8,1468
36029001601,1616,260,192,742,9,304,25,3,1356
36029001602,1358,163,185,691,3,233,1,7,1195
36029001700,1908,1017,221,457,5,66,0,14,891
36029001900,3189,2340,285,315,18,35,1,25,849
36029002300,3566,2056,412,729,24,154,0,23,1510
36029002400,4647,2279,616,1082,29,365,0,30,2368
36029002502,2048,203,207,1520,6,32,0,5,1845
36029002703,1843,181,67,635,8,875,0,28,1662
36029002704,2335,175,90,407,7,1550,1,26,2160
36029002801,1512,228,169,803,14,211,0,11,1284
36029002802,1138,167,116,601,3,178,0,9,971
36029002900,2475,148,196,1531,14,459,0,48,2327
36029003000,3092,330,255,1863,14,511,1,15,2762
36029003100,2361,185,173,1838,14,63,0,10,2176
36029003301,3800,395,239,2901,8,112,0,11,3405
36029003302,3877,202,306,2994,17,223,0,21,3675
36029003400,3588,95,216,2929,0,197,0,16,3493
36029003501,1722,60,256,1203,0,136,0,13,1662
36029003502,2272,58,136,1787,12,205,4,11,2214
36029003600,2826,177,180,2113,11,229,5,8,2649
36029003700,4909,299,391,3474,29,535,0,17,4610
36029003800,3181,289,272,2283,1,192,0,7,2892
36029003901,1126,81,50,894,0,65,1,1,1045
36029004002,1495,286,111,824,8,164,1,18,1209
36029004003,3251,192,240,2052,8,658,2,6,3059
36029004100,4813,315,227,3826,9,270,3,24,4498
36029004200,3689,147,184,3144,8,88,0,26,3542
36029004300,6373,658,446,4439,4,568,4,52,5715
36029004401,4475,198,232,3696,12,180,0,21,4277
36029004402,2900,56,383,2312,5,22,0,10,2844
36029004500,5529,3524,307,1316,32,116,3,20,2005
36029004601,3394,1656,175,624,8,756,6,22,1738
36029004701,2766,221,149,1945,3,332,1,14,2545
36029004702,4752,1304,368,2344,3,507,3,24,3448
36029004800,3874,3092,223,347,18,60,1,14,782
36029004901,1418,1013,123,181,2,19,0,16,405
36029004902,4643,3209,307,731,31,93,1,25,1434
36029005000,2538,1534,225,536,17,93,0,8,1004
36029005100,4616,2775,392,1068,29,97,1,19,1841
36029005201,3104,2205,175,501,4,95,0,22,899
36029005202,2778,777,236,1583,3,87,1,12,2001
36029005300,1184,627,88,358,5,29,0,12,557
36029005400,3867,2855,262,476,11,109,1,18,1012
36029005500,4363,1810,844,967,29,476,0,9,2553
36029005600,4682,1583,1081,1304,43,427,2,21,3099
36029005700,3516,1038,1092,612,17,600,2,16,2478
36029005801,3641,1589,794,414,68,599,0,8,2052
36029005802,5582,1738,1364,899,61,1231,1,26,3844
36029005900,4051,1521,983,728,32,571,2,46,2530
36029006100,5155,1413,1196,1370,38,881,0,27,3742
36029006301,4405,3163,376,440,26,124,2,37,1242
36029006302,2693,2299,127,90,15,43,0,12,394
36029006501,2999,1990,298,299,23,227,0,30,1009
36029006601,2498,1438,379,336,20,242,2,5,1060
36029006602,2382,1694,136,407,2,58,1,7,688
36029006701,3412,2171,453,466,19,133,0,28,1241
36029006702,3314,2156,238,610,7,173,0,19,1158
36029006801,1063,596,137,205,3,70,0,7,467
36029006802,2835,2039,325,249,27,78,0,13,796
36029006901,4201,877,1320,876,27,985,3,15,3324
36029006903,1473,643,251,297,21,203,0,7,830
36029006904,2440,1129,701,306,21,172,6,11,1311
36029007000,3432,961,1306,766,12,242,1,18,2471
36029007102,2482,749,1045,578,13,21,0,10,1733
36029007103,1397,289,671,372,6,24,0,9,1108
36029007104,2646,341,1603,559,8,60,0,15,2305
36029007202,1564,713,474,334,0,20,0,1,851
36029007303,7031,6039,200,203,36,283,1,7,992
36029007304,6283,5454,201,123,22,270,1,19,829
36029007305,2637,2377,91,40,13,23,0,4,260
36029007306,5438,4854,176,85,25,113,0,3,584
36029007600,2873,2604,78,27,11,59,0,6,269
36029007700,4690,4037,241,128,15,33,0,7,653
36029007800,5303,4729,201,100,22,65,2,7,574
36029007901,3025,2552,130,128,1,113,0,6,473
36029007902,5791,5224,173,128,5,100,0,12,567
36029007903,3348,3001,132,55,9,53,0,5,347
36029007904,3169,2811,92,84,8,63,0,8,358
36029007905,4488,3917,161,134,9,122,0,6,571
36029008001,5598,4387,309,441,17,169,0,16,1211
36029008002,5246,4404,263,237,12,85,1,17,842
36029008003,5159,4094,235,375,12,214,4,20,1065
36029008101,5833,5076,238,164,18,128,0,25,757
36029008102,4493,3990,167,135,10,60,3,9,503
36029008201,2534,2197,113,75,17,58,0,2,337
36029008202,3871,3258,205,160,16,88,3,4,613
36029008300,2491,1500,319,428,22,26,0,9,991
36029008400,2385,1830,133,142,19,140,1,16,555
36029008500,2569,2112,147,129,18,35,0,7,457
36029008600,4713,4066,163,206,21,73,1,15,647
36029008700,4666,3795,280,293,24,85,0,9,871
36029008800,3257,2588,181,207,18,96,0,10,669
36029008900,4200,3749,134,104,1,77,0,9,451
36029009004,3486,2912,93,98,11,229,0,25,574
36029009007,7707,6005,172,179,7,1052,5,15,1702
36029009008,5355,4245,102,137,4,759,0,13,1110
36029009009,5905,4713,194,181,8,591,0,22,1192
36029009010,6221,4813,121,274,13,768,0,15,1408
36029009011,3127,2586,113,90,5,240,0,8,541
36029009012,4502,3139,137,197,3,884,1,15,1363
36029009104,4165,3501,101,161,6,240,1,29,664
36029009106,3144,2453,148,251,0,164,0,9,691
36029009107,6150,3714,357,1217,27,481,0,28,2436
36029009109,3282,2284,98,136,6,678,0,11,998
36029009110,6512,3549,606,932,8,1203,3,40,2963
36029009112,3295,2560,107,150,4,332,0,8,735
36029009113,6787,5561,228,200,2,558,0,33,1226
36029009114,4186,3258,147,186,6,402,0,27,928
36029009115,4478,2196,251,300,9,1584,1,19,2282
36029009116,5472,3780,191,403,8,877,3,31,1692
36029009200,4570,2944,183,562,11,685,0,24,1626
36029009301,5625,2708,307,1122,13,1192,1,30,2917
36029009302,2767,1936,128,296,8,282,0,6,831
36029009401,5763,4360,238,464,18,457,0,13,1403
36029009402,4290,3754,152,121,6,119,0,10,536
36029009501,5199,4153,171,487,9,173,1,19,1046
36029009503,2559,2170,113,123,0,75,1,10,389
36029009504,4097,3450,134,222,8,150,1,24,647
36029009601,1441,1117,93,60,4,96,0,10,324
36029009602,5310,4212,158,256,4,487,0,20,1098
36029009701,3056,2627,122,87,0,150,0,18,429
36029009702,4481,4006,164,98,9,64,0,8,475
36029009800,1712,1528,56,34,3,13,0,8,184
36029009900,3775,3045,189,296,16,54,0,14,730
36029010001,2934,2426,129,161,3,68,0,13,508
36029010002,4434,3828,134,173,7,150,0,6,606
36029010003,4084,3078,145,326,8,312,0,24,1006
36029010101,4566,3752,153,383,5,90,0,20,814
36029010102,3903,2261,234,1020,6,178,0,22,1642
36029010103,3864,3222,165,259,6,69,1,8,642
36029010201,2727,1587,121,772,0,130,0,20,1140
36029010202,4018,1328,312,1853,9,345,0,11,2690
36029010300,1356,398,85,715,13,90,0,6,958
36029010400,2516,938,217,966,6,263,1,3,1578
36029010500,2435,1321,102,729,5,143,1,8,1114
36029010600,2581,1987,123,259,5,111,5,13,594
36029010700,2749,2050,94,329,5,152,0,11,699
36029010803,1992,1712,39,116,2,65,0,4,280
36029010804,4113,3703,97,126,4,89,0,6,410
36029010805,5036,4675,111,93,1,55,0,3,361
36029010807,5490,4438,252,509,13,138,0,4,1052
36029010808,3928,2916,170,424,15,254,4,6,1012
36029010809,3261,2929,88,109,4,67,0,5,332
36029010901,2336,2031,70,108,5,37,2,3,305
36029010902,4540,3491,149,650,3,121,0,9,1049
36029011000,1824,1501,86,105,14,30,1,3,323
36029011100,2166,1830,86,100,5,60,0,2,336
36029011201,1441,1366,30,3,1,10,0,0,75
36029011202,5370,5055,102,46,11,34,2,6,315
36029011300,4624,4171,146,83,12,67,0,17,453
36029011400,2333,1906,157,135,8,16,0,6,427
36029011500,1487,1293,80,27,2,8,0,7,194
36029011600,2170,1911,77,73,2,35,0,1,259
36029011700,3988,3609,185,49,9,26,3,0,379
36029011800,3658,3389,99,51,7,28,0,0,269
36029012001,4677,4253,157,60,12,40,0,6,424
36029012002,3755,3442,118,99,2,22,0,5,313
36029012003,5067,4729,143,39,8,52,0,13,338
36029012300,3843,2702,392,337,8,176,1,40,1141
36029012400,2364,1801,175,168,15,59,0,5,563
36029012501,4931,4152,292,204,19,22,0,17,779
36029012502,1842,1662,75,23,3,27,0,6,180
36029012800,2539,2211,139,52,10,22,0,5,328
36029012902,4129,3734,137,102,0,67,2,5,395
36029012903,2938,2601,126,43,6,46,0,7,337
36029012904,4133,3602,199,107,5,41,0,13,531
36029013001,2996,2662,153,44,10,15,0,9,334
36029013002,6053,5518,229,62,14,47,0,9,535
36029013101,6415,5917,174,42,18,67,1,27,498
36029013103,4541,4191,139,29,14,32,0,2,350
36029013104,4486,4168,108,23,11,38,0,6,318
36029013201,6236,5690,190,116,11,49,2,25,546
36029013202,5440,5023,158,58,14,37,0,6,417
36029013300,3585,3355,108,9,8,15,0,10,230
36029013400,6594,6112,175,58,18,58,0,4,482
36029013501,7309,6848,163,43,14,82,0,8,461
36029013502,7120,6641,155,16,6,102,6,12,479
36029013600,2942,2714,71,21,5,33,0,11,228
36029013701,6368,5860,177,53,15,78,3,11,508
36029013702,5947,5471,173,83,7,78,0,16,476
36029013801,2685,2554,48,4,6,5,0,8,131
36029013802,5384,5084,109,13,11,43,0,12,300
36029013900,2180,2082,24,1,3,8,0,10,98
36029014000,3694,3492,67,12,1,26,0,11,202
36029014101,6404,6037,94,29,4,31,0,18,367
36029014102,5317,5066,79,20,0,21,0,9,251
36029014204,4810,4493,74,55,10,29,0,9,317
36029014206,7957,7410,137,56,11,124,0,4,547
36029014207,5404,4954,113,130,1,104,0,13,450
36029014208,7058,6375,158,147,6,166,0,12,683
36029014209,3921,3697,66,38,12,44,1,13,224
36029014300,5763,5385,147,57,2,21,0,17,378
36029014400,4264,3865,154,36,7,29,2,14,399
36029014501,3601,3312,85,58,7,24,1,21,289
36029014502,2328,2016,102,77,10,21,0,5,312
36029014601,5261,4603,126,110,2,261,0,12,658
36029014603,4753,3901,115,71,3,516,0,11,852
36029014605,4041,3481,111,52,3,278,1,7,560
36029014606,4273,3550,151,62,7,316,2,33,723
36029014701,5771,5301,113,38,3,96,0,34,470
36029014703,4731,4215,162,46,5,179,0,17,516
36029014704,4120,3900,72,23,6,42,2,10,220
36029014801,2604,2363,32,23,59,11,0,0,241
36029014804,3995,3748,61,23,19,12,0,11,247
36029014805,2090,1980,28,0,13,0,0,5,110
36029014901,2604,2431,46,38,9,23,0,1,173
36029014903,5992,5694,70,29,12,9,0,2,298
36029015001,5189,4935,56,15,4,21,1,4,254
36029015002,3009,2773,38,7,2,8,0,11,236
36029015003,3281,3084,57,10,9,8,0,7,197
36029015101,3121,2969,50,6,2,8,0,8,152
36029015102,2716,2580,23,11,8,7,0,2,136
36029015201,3094,2927,60,7,0,10,0,1,167
36029015202,4854,4598,85,4,5,14,0,8,256
36029015301,4859,4537,90,25,18,15,1,8,322
36029015302,2714,2534,108,3,9,10,0,0,180
36029015401,2472,2268,77,15,15,33,0,3,204
36029015402,4889,4533,110,6,23,9,3,16,356
36029015501,2046,1822,60,29,58,2,0,7,224
36029015503,2438,2225,65,18,30,7,2,6,213
36029015504,3463,3203,80,15,33,4,0,20,260
36029015600,1912,1667,55,21,66,2,0,11,245
36029015700,3504,3222,103,20,35,1,0,6,282
36029015800,4094,3954,55,8,8,13,0,3,140
36029015900,4222,3922,90,36,20,24,0,7,300
36029016200,2333,1997,138,104,12,7,0,6,336
36029016300,2567,1496,473,359,34,54,0,9,1071
36029016400,3062,1031,674,1199,11,42,0,12,2031
36029016500,2354,1303,282,551,18,108,1,6,1051
36029016600,2887,119,205,2061,6,375,0,5,2768
36029016700,2641,1814,260,351,23,15,2,15,827
36029016801,2065,181,107,1631,2,53,0,8,1884
36029016802,1713,126,99,1347,6,54,8,2,1587
36029016900,3519,2246,216,795,10,105,0,18,1273
36029017000,2988,92,173,2530,4,54,1,12,2896
36029017100,5394,1706,976,1809,59,593,4,36,3688
36029017200,2263,1967,114,44,21,12,0,19,296
36029017301,2973,2761,88,18,2,26,1,13,212
36029017302,3957,3673,105,50,1,26,0,4,284
36029017400,4636,2308,758,1206,20,26,0,24,2328
36029017501,1453,1204,54,25,117,4,0,1,249
36029017502,2248,2109,35,4,35,4,2,7,139
36029940000,2135,525,67,38,1387,0,1,0,1610
36029940100,20,5,2,0,11,0,0,0,15
36029980000,1599,319,311,869,5,32,0,13,1280
36029980300,2193,828,400,918,34,8,0,0,1365
36029980400,1110,380,147,567,5,7,0,1,730
36029980500,963,429,108,199,0,195,1,4,534
36029990000,0,0,0,0,0,0,0,0,0
36031960100,2476,2266,34,31,6,6,0,2,210
36031960200,2486,2272,36,20,1,6,0,18,214
36031960300,2585,2385,73,5,9,5,0,9,200
36031960401,1120,964,36,27,6,7,0,8,156
36031960402,1215,1044,49,19,0,45,0,3,171
36031960501,2473,2272,51,24,0,22,0,6,201
36031960502,2672,1965,239,326,9,21,0,7,707
36031960700,1914,1749,31,18,3,4,0,5,165
36031960800,1905,1807,13,6,8,7,1,0,98
36031960901,1519,1390,22,14,2,1,1,13,129
36031960902,2148,2000,49,8,3,5,2,9,148
36031961001,1512,1381,34,10,3,3,0,8,131
36031961002,3204,2854,114,79,5,16,3,15,350
36031961100,2042,1914,39,3,4,6,0,6,128
36031961201,1882,1765,27,5,4,10,0,3,117
36031961202,2907,2634,62,10,7,29,0,13,273
36031961300,1880,1711,47,5,4,22,0,6,169
36031961400,1441,1341,22,0,0,14,0,2,100
36033940000,3663,129,30,2,3438,0,0,0,3534
36033950200,4542,3839,69,17,407,5,0,12,703
36033950301,5147,4841,66,5,43,18,0,13,306
36033950501,3168,2854,103,38,24,30,0,1,314
36033950502,4551,2296,681,1441,54,18,0,6,2255
36033950601,1155,1097,10,2,5,0,0,4,58
36033950701,1295,1180,28,3,13,0,0,3,115
36033950800,2324,2101,45,31,3,15,0,9,223
36033950900,3277,2983,65,38,5,13,0,19,294
36033951000,1977,1791,46,12,7,23,0,2,186
36033951100,3355,3112,54,49,33,2,0,5,243
36033951200,1792,1698,15,16,3,9,0,1,94
36033951300,1593,1506,11,2,4,2,0,1,87
36033951400,4763,4416,92,14,33,43,0,8,347
36033952000,4953,4716,72,16,30,13,0,7,237
36035970100,2472,2288,61,6,3,9,0,7,184
36035970200,2489,2309,61,14,2,3,0,13,180
36035970300,3657,3283,67,11,2,41,0,11,374
36035970400,1809,1692,33,0,3,10,0,8,117
36035970500,3966,3692,56,23,13,5,0,1,274
36035970601,3999,3306,209,239,10,35,0,6,693
36035970602,2868,2595,93,17,3,6,0,5,273
36035970700,3475,2909,207,145,11,5,0,4,566
36035970800,2947,2500,146,115,2,5,0,10,447
36035970900,3480,2919,218,120,9,25,0,14,561
36035971000,2517,2122,130,73,10,32,0,6,395
36035971100,2712,2232,188,77,2,25,0,21,480
36035971200,3634,3246,150,34,1,15,0,11,388
36035971300,4570,4038,195,45,10,83,0,19,532
36035971400,3584,3194,155,18,3,21,0,19,390
36035971501,2906,2674,103,13,0,13,0,2,232
36035971502,2239,2052,62,16,5,10,0,7,187
36037940100,241,19,6,0,195,0,1,1,222
36037950100,5422,4769,386,14,10,23,0,18,653
36037950200,5309,4550,456,60,20,11,0,6,759
36037950301,2706,2570,44,17,3,5,0,4,136
36037950302,3160,2912,71,18,30,4,0,7,248
36037950401,3367,2759,215,145,20,47,0,15,608
36037950402,2923,2698,50,23,6,36,0,9,225
36037950501,1856,1574,76,62,4,25,4,3,282
36037950502,1033,870,61,40,2,12,2,5,163
36037950600,1918,1585,99,114,3,3,0,12,333
36037950700,2438,1918,161,154,4,14,0,4,520
36037950800,3237,2644,145,210,7,33,0,5,593
36037950900,2386,2047,116,71,6,42,4,4,339
36037951000,2732,1923,288,245,16,83,1,19,809
36037951100,5378,4956,194,46,7,16,1,10,422
36037951200,4711,4258,132,89,12,20,3,28,453
36037951300,4070,3713,177,24,9,7,0,13,357
36037951400,5501,5195,75,26,7,31,0,10,306
36039080100,3226,2912,97,41,1,8,0,24,314
36039080201,3741,3389,129,35,6,23,0,6,352
36039080202,2627,2355,139,19,9,18,0,15,272
36039080301,1708,1452,124,27,0,34,0,15,256
36039080302,1456,1317,38,16,0,12,0,11,139
36039080402,1898,1656,76,7,2,24,0,11,242
36039080403,1034,869,64,9,6,27,0,8,165
36039080404,2001,1775,102,6,5,31,0,10,226
36039080501,2675,2356,128,23,11,24,0,12,319
36039080502,3969,3404,255,65,11,31,0,20,565
36039080600,3305,2863,180,39,5,12,0,14,442
36039080700,2917,2479,185,81,1,19,0,9,438
36039080800,2160,468,535,1107,20,15,1,7,1692
36039080900,3916,3367,182,90,8,54,0,17,549
36039081001,1759,1307,152,149,1,29,0,7,452
36039081002,2518,1707,258,281,3,46,2,19,811
36039081101,4049,3412,231,56,9,54,0,13,637
36039081102,2972,2406,234,108,2,39,0,20,566
36041950100,1146,1066,37,3,4,0,1,1,80
36041950300,1363,1266,27,12,5,0,0,2,97
36041950400,1317,1238,20,3,4,0,0,0,79
36041950500,1281,1199,16,12,1,12,0,2,82
36043010100,5939,5559,82,21,13,29,0,10,380
36043010201,3258,2954,96,36,2,10,0,4,304
36043010202,3720,3508,48,37,7,17,2,9,212
36043010300,5631,5021,161,94,1,31,2,19,610
36043010400,2638,2270,112,56,2,13,0,0,368
36043010501,2431,2229,60,12,1,9,0,1,202
36043010502,1596,1447,47,7,0,3,5,3,149
36043010701,2541,2239,101,21,2,19,5,10,302
36043010702,2064,1821,98,12,4,14,4,9,243
36043010900,3164,2974,42,2,3,16,0,9,190
36043011001,1927,1766,43,2,2,11,0,7,161
36043011002,2889,2703,46,3,1,4,0,9,186
36043011100,2198,1908,89,38,2,17,3,4,290
36043011200,5799,4852,245,277,9,102,3,23,947
36043011301,1569,1473,24,13,0,7,0,1,96
36043011302,3296,2998,106,27,14,29,3,14,298
36043011400,4355,4136,54,14,2,3,2,13,219
36043011502,2211,2078,28,7,4,13,0,2,133
36043011503,1684,1598,23,2,3,11,3,3,86
36043011504,1229,1119,25,1,4,1,0,3,110
36045060101,2030,1896,33,4,7,8,2,11,134
36045060102,1974,1821,31,15,9,9,1,4,153
36045060201,1773,1642,35,7,0,19,0,0,131
36045060202,2360,1699,196,380,7,12,0,6,661
36045060203,2419,2259,55,10,6,0,0,4,160
36045060301,1633,1525,35,0,5,8,0,7,108
36045060302,2351,2178,46,9,7,6,1,3,173
36045060401,3896,3590,81,19,10,24,3,0,306
36045060402,2382,2097,102,16,3,24,4,3,285
36045060500,5514,4630,276,156,24,123,3,23,884
36045060601,3411,2908,178,96,2,29,3,11,503
36045060602,3858,2214,638,516,11,152,21,32,1644
36045060700,4204,3834,113,35,5,23,1,19,370
36045060803,9418,5166,1693,1456,99,439,125,51,4252
36045060805,4343,2461,638,607,21,204,35,57,1882
36045060806,3359,1833,554,541,24,154,23,26,1526
36045060901,3067,2511,138,116,16,28,14,9,556
36045060902,2656,2299,109,35,11,39,9,12,357
36045061000,3707,3135,193,85,14,33,3,30,572
36045061101,2427,2088,123,40,4,33,2,6,339
36045061102,2892,2297,179,115,7,87,7,9,595
36045061200,3092,2193,334,219,21,51,4,12,899
36045061300,3101,2396,193,179,21,38,2,14,705
36045061400,3146,2565,169,143,22,45,2,18,581
36045061500,4053,2840,334,427,9,126,13,21,1213
36045061600,5175,4228,249,224,23,111,4,19,947
36045061700,2117,1952,56,18,4,13,3,4,165
36045061801,3531,3234,81,40,19,6,0,4,297
36045061802,3406,3076,108,26,2,26,0,8,330
36045061900,3560,3044,173,76,4,91,0,21,516
36045062100,3818,2925,252,225,19,58,2,17,893
36045062200,3915,3124,248,147,12,94,6,29,791
36045062400,4630,3889,231,242,13,50,3,8,741
36045062500,3305,3103,74,10,0,14,1,2,202
36045980000,198,103,42,37,0,8,3,1,95
36045990001,0,0,0,0,0,0,0,0,0
36047000100,4616,3180,412,295,5,448,0,28,1436
36047000200,1205,99,957,57,1,55,0,11,1106
36047000301,3850,3127,238,90,1,209,1,13,723
36047000501,4404,3329,310,107,6,433,0,22,1075
36047000502,2640,2057,177,75,0,201,0,8,583
36047000700,4415,3188,390,131,0,378,0,28,1227
36047000900,5167,3565,434,188,5,613,1,43,1602
36047001100,1578,772,178,163,2,375,0,3,806
36047001300,2465,1171,276,232,0,569,0,36,1294
36047001501,5161,1293,997,1279,14,1341,0,43,3868
36047001502,5801,2335,608,687,2,1804,2,42,3466
36047001801,2563,898,734,874,1,21,0,0,1665
36047001802,6,0,3,0,0,1,0,0,6
36047001803,16,5,5,0,0,4,0,1,11
36047001804,0,0,0,0,0,0,0,0,0
36047002000,1694,140,1285,145,8,97,2,6,1554
36047002100,5975,4113,541,220,3,638,0,58,1862
36047002200,4589,761,2813,193,8,682,6,61,3828
36047002300,3940,69,1128,1926,9,676,0,31,3871
36047002901,3149,103,886,1433,26,590,1,14,3046
36047003000,1811,966,380,30,0,336,0,29,845
36047003101,3395,1176,382,830,0,743,2,30,2219
36047003102,0,0,0,0,0,0,0,0,0
36047003300,4807,2258,652,828,6,702,4,47,2549
36047003400,3489,2081,543,79,0,653,1,19,1408
36047003500,2402,1066,260,631,5,259,6,18,1336
36047003600,3959,2404,660,104,1,653,0,20,1555
36047003700,4565,2240,453,478,7,1083,2,49,2325
36047003800,1529,1054,165,16,0,203,0,17,475
36047003900,2644,1419,380,351,6,273,0,27,1225
36047004100,3398,2184,387,290,2,318,0,18,1214
36047004300,3810,2428,453,233,2,424,0,29,1382
36047004400,2448,1938,209,20,0,213,0,10,510
36047004500,3476,2674,263,54,3,268,0,25,802
36047004600,1154,892,110,8,0,100,0,6,262
36047004700,1951,1143,352,191,8,124,0,11,808
36047004900,2412,1604,312,173,9,167,0,23,808
36047005000,2535,1915,298,23,1,212,0,14,620
36047005100,2658,1754,402,92,0,197,2,25,904
36047005201,1879,1350,142,17,0,332,0,8,529
36047005202,2668,2068,264,38,1,197,0,15,600
36047005301,2164,1256,466,163,2,119,6,33,908
36047005302,86,56,13,2,0,14,0,0,30
36047005303,0,0,0,0,0,0,0,0,0
36047005400,3426,2347,564,53,1,349,0,18,1079
36047005601,2692,1907,415,44,4,235,0,29,785
36047005602,1734,1264,221,20,0,168,0,13,470
36047005800,3450,2236,637,69,4,380,0,37,1214
36047005900,1742,821,503,269,1,44,2,19,921
36047006000,2876,1572,705,42,0,422,0,25,1304
36047006200,2958,1851,535,75,0,374,0,25,1107
36047006300,2007,1483,219,40,1,133,1,9,524
36047006400,3623,2254,720,57,1,469,0,26,1369
36047006500,5461,4267,514,81,6,280,0,23,1194
36047006600,3974,2237,928,76,4,512,0,39,1737
36047006700,3618,2860,256,35,0,213,0,15,758
36047006800,5491,2607,1486,161,9,986,2,69,2884
36047006901,1631,1189,175,46,2,105,0,5,442
36047006902,1962,1367,261,57,3,131,0,16,595
36047007000,2454,1290,510,104,0,458,0,16,1164
36047007100,4362,887,1481,1485,14,311,0,36,3475
36047007200,2082,264,1141,41,2,587,0,2,1818
36047007400,5829,411,3629,53,8,1638,0,27,5418
36047007500,4691,3483,535,79,3,269,5,33,1208
36047007600,4872,553,3004,76,5,1099,0,88,4319
36047007700,5690,4111,588,207,0,416,0,36,1579
36047007800,5333,524,3808,168,11,719,0,37,4809
36047008000,4024,453,2839,104,8,503,0,43,3571
36047008200,4008,634,2667,112,2,445,3,46,3374
36047008400,3311,624,2213,153,2,215,0,30,2687
36047008500,6673,109,3152,2752,11,380,2,68,6564
36047008600,0,0,0,0,0,0,0,0,0
36047008800,3258,800,1710,101,5,531,0,25,2458
36047009001,1886,216,958,21,4,638,0,12,1670
36047009002,1391,115,602,37,0,609,0,3,1276
36047009201,2087,301,665,12,1,1071,0,5,1786
36047009202,3424,303,1394,98,2,1514,0,47,3121
36047009401,3127,152,661,9,6,2246,0,27,2975
36047009402,3168,621,468,39,1,1977,0,17,2547
36047009600,6462,804,3283,141,0,2113,1,23,5658
36047009800,7440,298,3342,81,1,3653,2,26,7142
36047010000,7741,434,2425,71,11,4701,1,30,7307
36047010100,4590,1430,2343,340,7,300,8,40,3160
36047010200,6578,297,1487,46,3,4690,0,17,6281
36047010401,3015,156,208,18,0,2600,1,10,2859
36047010402,2965,247,214,25,0,2445,0,0,2718
36047010601,3037,134,451,10,0,2399,0,17,2903
36047010602,2820,77,160,3,7,2554,0,5,2743
36047010801,2876,84,396,6,1,2372,0,4,2792
36047010802,2840,240,411,31,5,2128,0,7,2600
36047011000,2709,648,1142,47,7,789,0,39,2061
36047011200,6636,2283,1944,135,0,1963,4,143,4353
36047011400,4150,1947,640,184,8,1113,0,151,2203
36047011600,5529,478,558,42,0,4388,2,23,5051
36047011700,2672,1425,729,103,1,252,0,28,1247
36047011800,2578,203,283,21,3,2036,1,16,2375
36047011901,1589,879,350,156,1,119,4,12,710
36047011902,0,0,0,0,0,0,0,0,0
36047012000,1176,93,144,3,0,906,0,4,1083
36047012100,1916,1046,463,76,0,222,0,13,870
36047012200,5521,630,2357,73,7,2394,1,19,4891
36047012600,3085,1053,735,80,0,1098,0,16,2032
36047012700,4036,1117,1183,1265,2,265,0,37,2919
36047012801,2567,494,214,18,0,1799,0,4,2073
36047012901,2333,1266,405,197,5,272,1,12,1067
36047012902,3318,1681,466,610,2,319,0,19,1637
36047013000,5347,2661,1163,141,7,1100,0,59,2686
36047013100,3979,2263,692,434,4,328,3,20,1716
36047013200,2870,746,413,17,9,1617,1,4,2124
36047013300,4411,2919,525,190,1,462,1,21,1492
36047013400,4212,2168,839,71,5,941,0,35,2044
36047013500,3799,2447,454,233,8,351,2,23,1352
36047013600,4079,2446,830,58,0,546,1,39,1633
36047013700,3406,2176,506,180,3,280,1,31,1230
36047013800,3247,1937,665,72,17,430,0,32,1310
36047013900,3727,2280,625,273,5,313,0,16,1447
36047014000,2136,1418,288,18,5,357,3,13,718
36047014101,1621,829,309,216,0,176,2,8,792
36047014102,1858,1088,343,67,8,231,0,11,770
36047014200,3434,1988,728,74,4,535,0,21,1446
36047014300,3705,1903,1072,138,5,349,1,37,1802
36047014500,4404,2087,1494,209,10,302,0,40,2317
36047014700,2242,1287,631,77,1,122,1,28,955
36047014800,1244,907,143,4,0,169,0,5,337
36047014901,1529,1002,192,84,2,139,0,4,527
36047014902,3601,2260,655,105,0,302,0,28,1341
36047015000,1791,1045,218,3,0,493,0,1,746
36047015100,3696,2713,369,105,0,265,1,31,983
36047015200,2545,1481,370,36,1,563,0,27,1064
36047015300,2633,1976,247,71,0,198,1,16,657
36047015400,9,3,2,0,0,0,1,0,6
36047015500,3466,2625,277,109,0,222,0,18,841
36047015700,4447,3339,325,150,4,298,2,46,1108
36047015900,5206,3802,378,273,0,384,3,62,1404
36047016000,4462,2154,1115,142,1,892,3,52,2308
36047016100,3450,2051,436,380,2,327,4,24,1399
36047016200,2218,1296,373,130,1,305,0,25,922
36047016300,4088,2312,368,664,2,415,1,47,1776
36047016400,775,319,189,105,4,81,0,12,456
36047016500,5080,3825,427,128,4,359,2,51,1255
36047016600,1968,1548,120,4,0,252,1,9,420
36047016700,4754,3525,504,110,1,275,2,43,1229
36047016800,1695,1016,107,17,0,527,0,1,679
36047016900,4459,2694,797,137,9,543,0,38,1765
36047017000,3604,1587,406,13,0,1521,1,20,2017
36047017100,3717,2822,316,69,3,261,0,34,895
36047017200,3300,1237,422,46,1,1518,1,10,2063
36047017400,1950,938,237,9,0,720,0,15,1012
36047017500,5,0,2,0,0,2,0,0,5
36047017600,2418,970,454,30,1,911,2,9,1448
36047017700,15,2,5,7,0,0,0,0,13
36047017800,2959,966,545,45,2,1336,0,8,1993
36047017900,3895,954,590,1818,15,291,0,16,2941
36047018000,3125,1033,681,36,0,1313,0,13,2092
36047018100,4204,2477,367,764,5,334,0,35,1727
36047018200,3745,924,523,17,3,2196,0,13,2821
36047018300,2784,1630,306,425,1,156,0,38,1154
36047018400,2460,895,146,7,0,1360,0,0,1565
36047018501,4461,316,1332,2138,14,493,6,21,4145
36047018600,2364,809,287,20,5,1216,0,0,1555
36047018700,1336,667,217,236,0,102,1,33,669
36047018800,2955,1121,526,19,1,1243,0,22,1834
36047019000,4853,1262,1353,61,3,2087,0,30,3591
36047019100,3427,1634,570,562,3,411,2,55,1793
36047019200,3541,1492,677,23,0,1194,0,104,2049
36047019300,6279,1942,891,2073,19,973,10,112,4337
36047019400,3570,681,804,32,0,1995,0,5,2889
36047019500,3684,1773,509,899,10,236,0,62,1911
36047019600,4691,1541,973,38,0,2050,2,15,3150
36047019700,3585,1879,312,866,4,249,0,21,1706
36047019800,2061,900,322,22,3,765,0,15,1161
36047019900,3978,1838,472,1039,4,349,0,34,2140
36047020000,2442,1005,419,24,1,936,2,12,1437
36047020100,3862,2037,324,1020,1,220,0,40,1825
36047020200,2147,1062,220,21,4,802,0,6,1085
36047020300,2132,1070,295,324,1,264,0,40,1062
36047020400,2040,1115,144,0,0,732,0,15,925
36047020500,3405,1942,295,555,2,312,0,48,1463
36047020600,2505,1214,381,14,1,854,0,5,1291
36047020700,4871,2745,495,911,9,366,0,56,2126
36047020800,3782,1111,430,34,2,2159,2,0,2671
36047021000,4488,1130,562,26,3,2657,0,21,3358
36047021100,2505,708,613,793,7,246,0,31,1797
36047021200,5278,950,691,79,7,3499,0,22,4328
36047021300,3880,857,434,2177,10,132,3,36,3023
36047021400,2502,1017,184,12,0,1185,0,69,1485
36047021500,5569,2552,556,1686,3,357,5,40,3017
36047021600,4280,3141,208,23,2,661,0,136,1139
36047021700,4351,1377,718,1585,2,355,0,35,2974
36047021800,4191,3162,439,43,0,258,0,210,1029
36047021900,4225,1594,395,1633,0,294,0,28,2631
36047022000,5660,4419,399,31,5,350,1,359,1241
36047022100,3897,1321,565,1495,12,215,0,64,2576
36047022200,5633,4407,506,82,4,183,0,281,1226
36047022400,6117,4282,917,34,0,596,0,195,1835
36047022600,2664,984,1027,65,5,435,3,64,1680
36047022700,4515,1446,545,1816,5,338,3,44,3069
36047022800,3638,2008,423,112,4,927,0,99,1630
36047022900,3923,1629,376,1358,6,262,0,36,2294
36047023000,4442,2948,888,67,2,352,1,131,1494
36047023100,3832,1742,386,1115,7,276,0,33,2090
36047023200,6382,5038,398,50,0,483,0,270,1344
36047023300,5961,1720,1223,2304,12,420,0,48,4241
36047023400,5923,5299,107,40,4,77,0,270,624
36047023500,5921,3948,755,532,3,360,0,151,1973
36047023600,6548,5712,78,8,1,278,0,326,836
36047023800,5414,4624,184,12,1,114,0,317,790
36047024000,5165,4348,204,36,5,136,0,281,817
36047024100,3175,1702,485,460,6,254,1,113,1473
36047024200,3289,2401,216,24,2,116,0,463,888
36047024300,4347,1532,694,1587,14,214,2,43,2815
36047024400,3651,2540,453,32,1,427,0,146,1111
36047024500,4257,1218,391,1926,6,421,1,43,3039
36047024600,3436,1924,345,37,0,1036,1,38,1512
36047024700,2820,644,298,1461,6,248,3,37,2176
36047024800,2647,1093,443,29,0,988,0,34,1554
36047024900,4264,1259,443,2100,10,170,5,22,3005
36047025000,1748,264,275,9,0,1179,0,9,1484
36047025100,4209,771,794,2156,12,237,0,37,3438
36047025200,5300,1882,941,35,3,2324,0,19,3418
36047025300,3517,1296,496,1262,6,212,4,53,2221
36047025400,3650,1055,431,47,14,2012,0,24,2595
36047025500,4799,58,2815,1721,2,89,0,29,4741
36047025600,3366,958,373,33,0,1906,0,30,2408
36047025700,2822,1227,867,434,1,139,0,52,1595
36047025800,5073,1843,864,50,0,2155,4,12,3230
36047025901,2328,773,744,598,4,93,0,5,1555
36047025902,3560,52,1707,1593,24,72,0,24,3508
36047026000,3656,1066,650,35,6,1839,0,16,2590
36047026100,6479,1787,1469,2440,8,367,4,76,4692
36047026200,2726,623,453,12,0,1554,0,9,2103
36047026300,2088,454,389,1058,9,76,0,13,1634
36047026400,5103,1494,1282,31,4,2193,0,32,3609
36047026500,4385,994,714,2228,5,170,1,64,3391
36047026600,3961,1201,565,47,0,2066,0,20,2760
36047026700,4228,1197,389,2075,0,213,0,52,3031
36047026800,4686,1779,843,75,1,1854,0,21,2907
36047026900,3005,689,298,1568,5,223,0,25,2316
36047027000,2719,1309,231,19,1,1067,0,14,1410
36047027100,3493,488,423,2082,12,309,0,25,3005
36047027200,3633,1363,619,31,1,1513,3,7,2270
36047027300,3131,574,260,1998,4,98,3,42,2557
36047027400,3272,1172,482,53,5,1473,0,3,2100
36047027500,4071,1107,383,2118,20,162,4,34,2964
36047027600,3886,1140,895,63,4,1672,0,11,2746
36047027700,4351,543,671,2820,6,74,2,25,3808
36047027800,3542,1459,474,46,1,1423,0,31,2083
36047027900,3674,714,501,2135,10,97,2,27,2960
36047028000,1862,584,379,52,0,784,1,20,1278
36047028100,4800,718,1674,1922,20,246,0,29,4082
36047028200,3282,1452,349,36,1,1274,0,19,1830
36047028300,3933,474,1369,1764,8,137,2,48,3459
36047028400,4396,1706,973,53,4,1503,0,7,2690
36047028501,636,202,263,104,0,40,1,2,434
36047028502,2658,13,1312,1227,4,33,0,6,2645
36047028600,6094,2358,610,124,9,2640,1,31,3736
36047028700,3103,603,1036,1037,10,265,4,24,2500
36047028800,3900,1486,734,23,1,1561,2,26,2414
36047028900,3933,764,1078,1672,3,173,3,44,3169
36047029000,4377,2103,662,83,5,1238,1,48,2274
36047029100,3042,641,472,1627,7,98,0,36,2401
36047029200,2781,1086,505,35,5,999,0,16,1695
36047029300,3402,530,598,2027,18,79,1,20,2872
36047029400,2298,1180,229,97,0,656,0,6,1118
36047029500,3851,932,375,2128,11,129,0,26,2919
36047029600,5993,2936,679,64,0,2064,0,31,3057
36047029700,3921,693,339,2560,13,102,0,26,3228
36047029800,3955,1446,838,42,4,1487,0,0,2509
36047029900,2496,270,601,1375,3,135,1,19,2226
36047030000,4224,1192,568,23,1,2320,0,12,3032
36047030100,2970,287,420,1994,5,58,1,44,2683
36047030200,4391,1324,388,58,0,2522,2,16,3067
36047030300,4952,158,817,3600,28,96,1,26,4794
36047030400,4686,1627,593,105,6,2158,1,19,3059
36047030500,7249,2916,1104,2160,6,577,9,77,4333
36047030600,2215,695,412,40,4,1019,0,12,1520
36047030700,5625,302,1119,3721,32,127,1,60,5323
36047030800,2314,1137,316,127,6,678,0,8,1177
36047030900,2209,168,417,1390,0,111,0,22,2041
36047031100,3191,590,411,1743,7,154,0,46,2601
36047031300,5109,966,615,3030,11,119,6,49,4143
36047031401,5142,2819,660,69,1,1486,2,25,2323
36047031402,0,0,0,0,0,0,0,0,0
36047031500,5613,1881,560,2490,4,298,1,52,3732
36047031701,3999,1289,349,1804,14,238,0,41,2710
36047031702,3714,1400,465,1348,6,180,0,36,2314
36047031900,3452,1153,270,1664,10,85,0,77,2299
36047032100,5488,979,909,3094,7,180,3,56,4509
36047032300,3509,686,504,1957,4,93,0,35,2823
36047032500,6218,799,525,4459,6,113,0,50,5419
36047032600,7075,883,2197,2654,18,1058,1,55,6192
36047032700,3074,805,364,1567,9,140,3,13,2269
36047032800,3090,288,612,1034,6,1081,0,6,2802
36047032900,5707,1848,721,2564,7,98,0,191,3859
36047033000,4423,775,1192,1946,11,299,3,37,3648
36047033100,4217,2476,178,1217,0,10,0,186,1741
36047033300,4503,3002,208,949,0,32,0,181,1501
36047033500,3231,1840,195,813,2,67,0,195,1391
36047033600,4765,3480,464,267,9,327,12,85,1285
36047033701,2510,1088,177,991,3,54,1,67,1422
36047033702,2116,1152,136,562,0,16,0,175,964
36047033900,4676,1102,454,2586,4,181,1,83,3574
36047034000,1958,614,509,716,0,72,0,3,1344
36047034100,2685,638,268,1543,4,55,0,31,2047
36047034200,7060,1933,1615,2689,9,516,2,79,5127
36047034300,5024,446,1007,3131,2,133,0,47,4578
36047034500,2738,374,355,1725,0,65,1,51,2364
36047034700,3645,257,483,2628,6,56,0,42,3388
36047034800,2828,664,1324,186,1,517,0,29,2164
36047034901,2067,99,311,1470,0,23,0,45,1968
36047034902,3347,322,405,2332,1,65,0,33,3025
36047035000,3082,2932,42,21,1,32,0,6,150
36047035101,2243,244,331,1409,4,75,4,19,1999
36047035102,2626,884,312,1146,7,35,0,97,1742
36047035200,1367,637,251,331,0,90,2,9,730
36047035301,2566,389,311,1645,5,39,0,35,2177
36047035302,2811,932,427,1234,1,63,0,59,1879
36047035400,5493,5073,135,102,0,61,3,13,420
36047035500,5192,1029,494,3303,11,40,0,93,4163
36047035601,2902,2650,92,94,1,1,0,12,252
36047035602,5474,4882,155,104,3,139,0,44,592
36047035701,2322,80,441,1605,5,65,1,16,2242
36047035702,15,3,7,3,0,0,1,1,12
36047035900,5617,253,876,4085,19,47,0,57,5364
36047036001,3387,2882,116,25,0,201,0,20,505
36047036002,4203,3431,191,28,3,353,0,20,772
36047036100,2964,137,592,2014,6,41,0,12,2827
36047036200,4140,1721,1159,128,1,952,0,22,2419
36047036300,5385,124,1025,3808,9,46,2,71,5261
36047036400,3006,1383,585,55,4,830,0,29,1623
36047036501,2959,94,354,2287,8,52,0,13,2865
36047036502,1902,113,552,1118,10,23,6,9,1789
36047036600,4681,1889,1053,61,4,1481,0,26,2792
36047036700,1796,107,655,880,6,49,0,27,1689
36047036900,6136,672,1613,3323,20,159,4,59,5464
36047037000,4750,2881,507,154,6,1080,2,41,1869
36047037100,4503,403,698,3021,4,114,0,41,4100
36047037300,4385,502,988,2522,9,103,2,31,3883
36047037401,4696,3105,397,160,5,786,0,62,1591
36047037402,5367,3214,517,219,2,1146,0,22,2153
36047037500,3809,772,862,1684,12,224,3,20,3037
36047037700,3970,783,433,2371,12,80,0,32,3187
36047037900,3851,435,493,2562,8,71,0,44,3416
36047038100,5313,660,842,3428,22,131,0,18,4653
36047038200,5882,336,1817,1797,8,1754,0,36,5546
36047038300,4338,866,433,2548,17,133,0,46,3472
36047038500,3969,793,660,2082,9,150,5,53,3176
36047038600,3812,1383,775,28,0,1487,1,19,2429
36047038700,4908,1012,922,2313,7,345,3,48,3896
36047038800,4047,2714,461,98,0,597,0,51,1333
36047038900,3570,1041,1614,452,12,284,10,35,2529
36047039000,2321,1960,147,7,1,157,0,25,361
36047039100,5776,2003,2376,560,4,502,10,48,3773
36047039200,2908,2214,310,33,1,253,0,24,694
36047039300,4141,1251,1746,655,19,273,1,36,2890
36047039400,2187,1738,195,10,0,144,0,48,449
36047039500,4030,1136,1617,771,6,292,9,62,2894
36047039600,1948,1580,169,35,0,112,0,14,368
36047039700,3868,950,1193,1326,18,176,0,30,2918
36047039800,2841,957,522,25,0,1278,0,15,1884
36047039900,4378,837,1804,1342,11,180,7,32,3541
36047040000,3281,1235,621,49,0,1298,0,12,2046
36047040100,3778,781,1341,1209,1,171,13,80,2997
36047040200,3025,735,492,22,0,1710,1,11,2290
36047040300,3892,727,1272,1502,13,162,1,55,3165
36047040400,2812,885,320,33,0,1491,0,14,1927
36047040500,1829,298,744,602,7,94,1,16,1531
36047040600,3599,1044,448,17,0,2009,0,18,2555
36047040700,6,1,2,0,0,0,0,0,5
36047040800,3933,924,770,28,0,2120,0,36,3009
36047040900,3800,617,2311,588,1,130,3,27,3183
36047041000,2136,1055,292,39,0,701,3,17,1081
36047041100,3332,571,1484,980,4,131,1,26,2761
36047041200,3375,1354,543,53,10,1351,0,7,2021
36047041300,3951,672,1720,1203,12,136,0,37,3279
36047041401,1480,1106,171,19,0,147,0,3,374
36047041402,1855,1480,86,24,0,137,0,12,375
36047041500,4032,697,2019,965,0,151,1,43,3335
36047041600,2112,1720,134,74,1,100,0,41,392
36047041700,3348,352,2114,650,3,152,0,17,2996
36047041800,2645,1921,310,35,0,260,0,32,724
36047041900,3880,601,2334,639,4,151,3,30,3279
36047042000,1912,1516,207,36,5,45,0,41,396
36047042100,4866,1238,2574,537,8,351,0,33,3628
36047042200,3663,2408,587,71,1,417,2,36,1255
36047042300,4566,1291,2554,251,6,259,1,24,3275
36047042400,4175,1588,680,96,3,1613,0,16,2587
36047042500,3026,845,1731,192,3,115,2,33,2181
36047042600,4350,1531,769,26,0,1862,1,15,2819
36047042700,4920,1523,2658,240,8,268,0,73,3397
36047042800,4290,2275,349,89,0,1355,3,22,2015
36047042900,5556,1498,3282,170,10,361,0,58,4058
36047043000,3842,1583,552,41,1,1483,1,17,2259
36047043100,4884,1449,2750,165,7,290,0,53,3435
36047043200,4514,1391,1010,53,2,1897,3,24,3123
36047043300,3843,584,2487,399,4,246,8,35,3259
36047043400,3866,1616,522,44,0,1528,2,20,2250
36047043500,4709,812,2801,632,2,256,2,59,3897
36047043600,4694,1948,955,42,1,1504,1,18,2746
36047043700,5282,1149,2791,883,20,183,5,70,4133
36047043800,2905,1910,255,75,1,467,1,21,995
36047043900,4097,654,2530,418,3,333,0,40,3443
36047044000,2878,2100,380,29,1,266,0,35,778
36047044100,5526,1015,3607,190,22,504,0,62,4511
36047044200,2631,2316,178,20,0,52,0,23,315
36047044300,5195,1385,2931,174,14,502,8,50,3810
36047044400,3260,2531,304,64,1,252,0,44,729
36047044500,4207,1100,2160,111,18,624,4,56,3107
36047044600,2026,802,427,25,0,723,0,3,1224
36047044700,2459,805,1080,357,0,125,4,30,1654
36047044800,1965,1454,156,42,4,207,2,34,511
36047044901,2694,518,1113,865,6,77,1,23,2176
36047044902,44,20,16,2,0,0,0,0,24
36047045000,645,561,51,8,0,13,0,8,84
36047045200,2618,2327,76,54,0,79,0,28,291
36047045300,1886,827,694,180,6,74,4,22,1059
36047045400,2036,1587,178,24,3,149,0,41,449
36047045600,2767,1481,220,140,0,738,2,13,1286
36047045800,1558,1421,28,5,0,49,0,29,137
36047046000,3828,1586,413,180,0,1402,0,66,2242
36047046201,2700,1693,238,70,1,503,0,37,1007
36047046202,1891,1349,227,37,4,134,0,33,542
36047046400,2732,2263,171,31,4,108,0,93,469
36047046800,2138,1908,58,9,0,52,0,80,230
36047047000,2823,2420,60,13,1,68,0,179,403
36047047200,3099,2805,58,16,0,20,0,150,294
36047047400,3232,2771,60,12,1,137,1,129,461
36047047600,4054,3533,173,20,0,113,0,120,521
36047047700,4226,2821,660,158,4,363,0,29,1405
36047047800,5308,3428,871,81,5,483,1,250,1880
36047048000,3824,2154,613,152,0,630,1,80,1670
36047048100,3105,1658,847,81,4,310,4,39,1447
36047048200,6122,2378,684,429,3,2133,1,113,3744
36047048400,5922,3306,822,250,2,1101,0,112,2616
36047048500,2470,1209,736,212,5,161,3,42,1261
36047048600,3597,711,775,113,5,1876,0,45,2886
36047048800,4536,1931,668,261,7,1382,0,108,2605
36047048900,3757,62,2176,1401,2,32,0,17,3695
36047049000,6036,2569,829,448,11,1679,1,72,3467
36047049100,6366,1338,2157,812,3,1885,1,46,5028
36047049200,3366,1110,658,413,2,941,0,64,2256
36047049301,1897,53,1260,495,2,45,1,15,1844
36047049302,5476,1515,2878,580,16,280,2,37,3961
36047049400,5527,2488,743,615,12,1299,0,63,3039
36047049500,3114,1739,762,122,7,302,2,28,1375
36047049600,4646,1625,968,220,6,1685,0,27,3021
36047049700,3141,2253,359,97,1,271,0,22,888
36047049800,4517,1818,730,136,5,1642,0,30,2699
36047049900,2147,1512,268,36,0,193,1,23,635
36047050001,2062,1248,272,153,2,237,0,25,814
36047050002,1607,941,251,91,0,217,0,12,666
36047050100,2951,1964,530,37,6,250,3,17,987
36047050202,2312,1700,226,75,2,138,1,23,612
36047050300,2759,1680,634,56,3,237,3,28,1079
36047050401,2997,1879,395,213,1,286,0,23,1118
36047050402,2004,871,381,206,14,402,0,20,1133
36047050500,4567,1222,1816,700,6,648,4,21,3345
36047050600,5612,1010,1895,1873,5,502,1,71,4602
36047050700,3545,2625,559,142,1,35,0,96,920
36047050801,4311,460,1011,2410,5,148,2,45,3851
36047050803,2548,515,470,1261,3,120,1,40,2033
36047050804,6196,1358,1666,2422,11,344,2,71,4838
36047050900,5112,4435,308,38,1,77,0,159,677
36047051001,3740,469,664,2319,13,66,0,31,3271
36047051002,4600,593,970,2536,13,206,0,33,4007
36047051100,4545,1484,1684,312,3,882,0,38,3061
36047051200,5946,896,1451,3027,5,257,4,53,5050
36047051300,5526,2711,1738,278,7,486,4,33,2815
36047051400,7023,1275,1887,2825,8,682,0,53,5748
36047051500,2451,1658,362,84,1,208,1,14,793
36047051601,5407,599,963,3244,1,242,4,70,4808
36047051602,3874,349,741,2374,23,121,0,49,3525
36047051700,2636,1841,309,60,7,259,0,30,795
36047051800,3528,1045,470,1369,9,420,0,34,2483
36047051900,6101,4131,822,114,3,676,0,47,1970
36047052000,4175,1175,873,618,4,1279,0,51,3000
36047052300,5405,1860,2875,172,3,321,0,33,3545
36047052500,3720,2050,952,301,5,161,0,130,1670
36047052600,4353,1515,808,717,4,1012,2,48,2838
36047052700,6045,1745,3640,166,1,272,3,47,4300
36047052800,1804,869,160,141,1,501,0,41,935
36047052900,4299,3839,254,31,8,33,0,73,460
36047053000,3606,1808,444,227,0,915,0,50,1798
36047053101,2997,2638,116,7,0,55,0,125,359
36047053102,5890,5320,169,19,0,46,0,219,570
36047053200,2510,1333,293,204,0,548,0,62,1177
36047053300,7115,6540,175,17,7,6,0,216,575
36047053400,4777,2523,400,342,2,1237,1,60,2254
36047053500,4469,3889,289,37,5,31,1,136,580
36047053700,4304,3912,80,46,2,39,0,119,392
36047053800,5535,3671,474,256,0,832,0,83,1864
36047053900,2668,2114,366,85,5,8,0,45,554
36047054200,4750,3559,461,76,4,408,0,94,1191
36047054300,5,1,4,0,0,0,0,0,4
36047054400,3785,2759,199,43,0,591,2,70,1026
36047054500,7304,4402,1819,795,5,33,0,106,2902
36047054600,5409,3516,383,207,6,887,0,50,1893
36047054700,7855,5764,1097,289,4,363,3,122,2091
36047054800,2189,1870,91,20,3,86,0,22,319
36047054900,4748,3225,772,163,8,302,0,79,1523
36047055000,3956,2699,399,120,0,477,0,44,1257
36047055100,6343,3163,2232,251,0,381,2,59,3180
36047055200,3735,2266,286,109,2,827,3,23,1469
36047055300,3078,1895,588,168,0,266,2,22,1183
36047055400,4813,2780,597,75,13,999,0,33,2033
36047055500,8688,5321,1400,263,12,1141,5,61,3367
36047055600,3880,2853,305,27,0,506,0,34,1027
36047055700,1848,1345,225,31,0,138,1,13,503
36047055800,2736,1772,216,25,0,569,0,28,964
36047056000,3882,3028,161,59,0,427,0,8,854
36047056100,3460,2632,428,64,4,165,5,21,828
36047056200,1695,1458,48,13,0,141,0,11,237
36047056301,4923,2982,1064,196,12,381,4,53,1941
36047056302,2002,845,614,282,4,155,0,18,1157
36047056400,2626,1815,157,67,0,519,0,22,811
36047056500,3738,2699,567,69,3,189,0,24,1039
36047056600,2548,1224,194,310,0,709,1,19,1324
36047056800,1310,774,86,22,0,407,0,9,536
36047056900,1624,1197,191,27,3,130,1,19,427
36047057000,3534,1797,379,257,2,1015,1,15,1737
36047057100,4267,3468,367,42,0,219,1,15,799
36047057200,5221,548,1422,2585,21,422,1,31,4673
36047057300,2590,2061,230,49,0,135,0,23,529
36047057400,2560,1039,175,57,1,1234,0,18,1521
36047057500,4902,3258,901,76,1,424,0,37,1644
36047057600,2912,1130,203,56,1,1408,1,11,1782
36047057800,3332,1572,374,74,20,1143,0,26,1760
36047057901,1416,764,396,70,5,115,0,16,652
36047057902,0,0,0,0,0,0,0,0,0
36047058000,3502,1449,400,95,1,1410,0,24,2053
36047058200,3044,1578,309,53,1,959,0,8,1466
36047058400,3797,2553,262,50,0,798,0,12,1244
36047058600,2655,738,207,106,0,1564,3,12,1917
36047058800,3532,2345,295,67,0,712,0,25,1187
36047058901,1781,1464,117,30,3,95,0,5,317
36047058902,0,0,0,0,0,0,0,0,0
36047059000,2014,693,284,100,2,833,0,15,1321
36047059100,3856,2969,494,51,4,165,0,22,887
36047059200,4268,2380,298,75,2,1229,0,12,1888
36047059300,2274,1645,370,33,6,111,0,6,629
36047059402,5105,3212,280,49,3,1394,0,20,1893
36047059403,3779,1830,211,51,0,1544,0,15,1949
36047059404,4426,2421,330,58,0,1442,0,18,2005
36047059600,2569,2013,128,61,1,290,1,14,556
36047059800,3617,2492,221,165,0,439,0,24,1125
36047060000,6844,5226,368,88,0,866,0,32,1618
36047060600,3178,2075,309,112,0,583,1,6,1103
36047060800,4015,2811,268,149,3,621,0,3,1204
36047061002,5064,4669,104,29,0,127,0,37,395
36047061003,2418,613,810,25,4,839,0,28,1805
36047061004,6669,5059,523,78,1,679,7,41,1610
36047061200,1063,961,31,6,0,22,0,14,102
36047061600,1854,1692,58,28,1,28,0,18,162
36047062000,1767,1633,41,5,0,55,1,1,134
36047062200,3325,2315,257,392,5,211,1,31,1010
36047062600,3152,1554,339,246,2,856,1,39,1598
36047062800,5222,3862,573,44,1,620,3,23,1360
36047063200,1476,1073,144,38,0,171,3,5,403
36047063600,1317,846,132,18,0,273,1,23,471
36047063800,1617,1082,122,78,1,293,0,6,535
36047064000,1620,1253,117,23,3,191,0,1,367
36047064200,2865,2019,305,123,2,288,1,28,846
36047064400,2702,1844,278,130,0,343,0,49,858
36047064600,2226,1663,165,107,12,172,1,59,563
36047064800,1993,1129,233,274,3,233,2,26,864
36047065000,1439,335,239,544,0,254,0,7,1104
36047065200,1197,743,127,42,0,211,1,22,454
36047065400,1681,1229,145,30,1,209,1,16,452
36047065600,1795,1323,170,5,1,257,0,6,472
36047065800,1844,1165,205,31,1,380,0,11,679
36047066000,1762,1229,165,11,3,311,0,1,533
36047066200,1497,849,201,62,1,345,0,7,648
36047066600,1,0,1,0,0,0,0,0,1
36047067000,2876,466,388,1377,1,482,1,12,2410
36047067200,1435,135,149,936,2,111,0,33,1300
36047067400,1992,241,203,1174,7,205,0,46,1751
36047067600,1622,133,141,1127,4,84,0,32,1489
36047067800,2874,259,195,2193,5,87,0,16,2615
36047068000,1887,206,264,1141,2,149,0,17,1681
36047068200,2489,381,289,1362,6,253,0,28,2108
36047068600,1749,710,199,520,0,232,0,20,1039
36047068800,1706,383,233,853,2,136,0,14,1323
36047069000,1880,274,300,1077,1,119,0,25,1606
36047069200,2512,220,230,1812,5,107,0,28,2292
36047069601,3932,1131,481,1929,4,199,0,43,2801
36047069602,6275,3578,540,1443,13,478,0,58,2697
36047069800,1417,1057,134,108,0,82,1,2,360
36047070000,1650,1356,153,45,0,48,0,10,294
36047070201,6719,5918,308,72,0,247,0,64,801
36047070202,21,12,3,5,0,0,0,0,9
36047070203,0,0,0,0,0,0,0,0,0
36047070601,2703,2342,168,44,2,69,0,16,361
36047070602,4,2,0,0,0,0,0,0,2
36047072000,2205,94,135,1806,3,74,1,15,2111
36047072200,2893,74,138,2341,8,103,1,21,2819
36047072400,1911,35,85,1672,0,21,0,16,1876
36047072600,2582,52,301,1950,9,79,0,34,2530
36047072800,3645,145,183,3006,9,64,0,29,3500
36047073000,2170,100,125,1711,2,90,0,30,2070
36047073200,2173,66,179,1604,0,114,0,39,2107
36047073400,1818,63,155,1332,0,112,0,31,1755
36047073600,3473,167,406,2205,5,462,0,68,3306
36047073800,3290,964,333,1534,8,266,0,46,2326
36047074000,3446,307,355,2131,5,392,2,65,3139
36047074200,3023,1269,236,1183,0,103,3,39,1754
36047074400,2481,2179,63,122,0,68,0,22,302
36047074600,2100,1334,156,360,4,173,0,23,766
36047074800,1936,1333,112,353,1,43,0,47,603
36047075000,2928,2162,136,389,1,99,0,82,766
36047075200,1042,961,12,12,1,12,0,3,81
36047075400,1402,1343,8,13,1,0,0,14,59
36047075600,1934,1560,84,69,2,136,1,31,374
36047075800,2005,1654,59,39,0,144,0,22,351
36047076000,2832,2139,178,49,0,324,0,26,693
36047076200,4391,2127,518,423,6,1045,0,83,2264
36047076400,3783,941,644,1676,9,316,5,34,2842
36047076600,1990,236,258,1268,3,103,0,13,1754
36047076800,4049,2687,320,131,9,673,0,68,1362
36047077000,2776,311,471,1637,17,111,0,48,2465
36047077200,3070,1007,395,1249,4,176,1,41,2063
36047077400,3029,545,396,1698,4,229,0,29,2484
36047077600,3784,209,337,2700,8,235,1,47,3575
36047078000,2197,54,149,1710,1,49,1,45,2143
36047078200,4081,65,267,3281,6,94,2,61,4016
36047078400,2441,137,218,1830,11,39,0,50,2304
36047078601,2374,90,315,1536,4,278,0,16,2284
36047078602,2073,141,215,1536,10,53,0,31,1932
36047078801,2040,77,248,1449,4,82,0,12,1963
36047078802,1328,18,80,1097,3,9,0,10,1310
36047079001,1347,133,189,882,3,36,0,7,1214
36047079002,3769,181,338,2850,17,101,1,50,3588
36047079201,1743,128,269,1161,2,48,2,15,1615
36047079202,3171,140,492,2241,2,120,0,24,3031
36047079400,2742,203,407,1888,4,36,3,52,2539
36047079601,4125,1010,529,2135,1,175,4,48,3115
36047079602,4489,711,700,2597,7,158,0,65,3778
36047079801,2957,836,289,1513,2,104,0,35,2121
36047079802,5647,1584,680,2652,13,310,1,73,4063
36047080000,3562,1019,363,1815,9,118,1,12,2543
36047080200,4521,802,536,2613,7,191,0,52,3719
36047080400,3327,661,283,1933,0,142,0,50,2666
36047080600,3781,1442,201,1758,1,73,0,100,2339
36047080800,1940,179,445,1126,7,93,3,25,1761
36047081000,2907,520,187,1896,0,91,3,68,2387
36047081400,3121,172,166,2422,36,114,0,44,2949
36047081600,2580,101,231,1989,4,87,1,50,2479
36047081800,4830,565,521,3160,7,201,2,44,4265
36047082000,5495,609,586,3708,8,155,1,53,4886
36047082200,7201,866,850,4809,14,219,5,56,6335
36047082400,4963,303,535,3616,11,134,3,72,4660
36047082600,5165,256,421,3962,10,99,0,48,4909
36047082800,4206,211,470,3150,10,92,0,56,3995
36047083000,6167,122,501,4875,7,112,0,83,6045
36047083200,2362,43,150,1836,9,119,0,36,2319
36047083400,1733,29,118,1373,7,55,1,17,1704
36047083600,2160,20,157,1763,5,85,0,12,2140
36047083800,2226,34,128,1756,10,42,0,20,2192
36047084000,2324,36,145,1928,0,24,1,43,2288
36047084600,1986,23,126,1604,1,26,0,43,1963
36047084800,1728,16,101,1353,0,69,1,35,1712
36047085000,1509,26,73,1263,1,16,0,13,1483
36047085200,32,0,5,19,0,6,0,0,32
36047085400,1962,64,155,1488,5,70,1,26,1898
36047085600,3568,138,330,2677,2,66,0,48,3430
36047085800,2474,42,137,1974,0,125,0,33,2432
36047086000,3809,39,374,3035,4,52,0,42,3770
36047086200,3427,39,242,2834,9,51,1,33,3388
36047086400,2499,45,148,2122,4,18,0,13,2454
36047086600,3385,135,216,2715,5,21,0,83,3250
36047086800,3413,86,199,2803,5,31,0,26,3327
36047087000,3570,99,208,2885,5,46,1,18,3471
36047087200,3128,132,125,2514,3,59,2,32,2996
36047087401,3740,619,311,2487,5,22,0,80,3121
36047087600,2098,538,171,1175,2,45,0,48,1560
36047087800,2730,78,183,2233,0,26,6,34,2652
36047088001,2127,187,186,1625,3,8,0,42,1940
36047088002,1374,140,61,1036,0,22,0,17,1234
36047088200,6804,175,606,5473,11,57,0,51,6629
36047088400,5513,105,355,4580,13,41,2,112,5408
36047088600,4547,68,409,3715,5,22,0,30,4479
36047088800,4001,18,371,3305,4,16,0,40,3983
36047089000,6683,150,653,5375,28,38,1,54,6533
36047089200,3673,70,519,2808,19,20,4,31,3603
36047089400,3834,43,445,3017,8,32,0,36,3791
36047089600,4081,71,412,3268,15,33,0,39,4010
36047089800,2329,36,310,1755,5,28,1,32,2293
36047090000,5434,49,1139,3938,6,20,0,24,5385
36047090200,3817,77,860,2620,14,73,1,39,3740
36047090600,4534,62,1521,2747,7,48,0,32,4472
36047090800,5893,158,1858,3579,14,39,11,36,5735
36047091000,5814,69,1914,3516,16,100,1,33,5745
36047091200,6572,53,2127,4077,15,60,2,42,6519
36047091600,5309,62,837,3930,22,95,0,92,5247
36047091800,2703,29,1116,1421,4,15,0,21,2674
36047092000,3491,29,529,2667,13,36,0,18,3462
36047092200,3031,19,262,2508,7,21,3,29,3012
36047092400,3628,73,603,2693,4,17,2,44,3555
36047092800,2861,57,190,2330,9,22,0,33,2804
36047093000,2567,8,91,2311,4,6,9,36,2559
36047093200,1277,13,56,1049,5,50,1,11,1264
36047093400,2466,40,126,2086,8,29,0,19,2426
36047093600,1854,4,91,1620,1,7,0,12,1850
36047093800,2662,67,263,2106,4,10,5,15,2595
36047094401,3447,58,128,3030,1,20,0,19,3389
36047094402,2810,66,458,2147,6,18,0,21,2744
36047094600,2079,25,103,1756,3,18,0,18,2054
36047095000,3170,111,142,2704,0,32,0,24,3059
36047095400,5156,100,219,4450,3,38,0,42,5056
36047095600,4391,168,252,3594,3,66,1,64,4223
36047095800,3770,119,220,3135,0,103,0,34,3651
36047096000,6,0,1,3,0,0,0,0,6
36047096200,1701,78,150,1336,1,27,0,13,1623
36047096400,2621,146,187,2005,2,76,0,22,2475
36047096600,2353,96,188,1793,0,72,0,44,2257
36047096800,1555,65,179,1160,2,31,0,20,1490
36047097000,2357,113,258,1795,6,47,0,19,2244
36047097400,2911,145,395,2170,2,36,0,43,2766
36047098200,4076,22,1035,2822,26,9,0,17,4054
36047098400,2074,40,79,1862,6,5,0,11,2034
36047098600,2814,50,214,2238,1,66,0,48,2764
36047098800,3083,90,334,2390,2,56,0,35,2993
36047099000,1652,63,132,1262,1,72,0,39,1589
36047099200,2056,108,150,1568,0,69,0,29,1948
36047099400,2116,96,97,1774,2,29,1,12,2020
36047099600,4052,197,200,3420,0,49,1,24,3855
36047099800,4234,148,156,3620,15,43,0,43,4086
36047100400,2901,51,122,2503,1,37,0,25,2850
36047100600,2662,152,171,2149,0,47,0,22,2510
36047100800,2189,124,150,1694,0,73,0,17,2065
36047101000,2605,144,194,1932,8,126,1,17,2461
36047101200,2115,90,152,1632,3,76,0,49,2025
36047101400,2268,84,185,1771,7,98,0,22,2184
36047101600,1551,41,73,1323,5,31,0,9,1510
36047101800,2030,98,151,1661,2,22,0,16,1932
36047102000,2186,111,128,1740,0,65,4,11,2075
36047102200,2313,131,173,1750,0,136,0,30,2182
36047102400,2257,131,155,1691,11,98,0,35,2126
36047102600,2973,120,140,2521,2,33,1,23,2853
36047102801,1754,53,122,1397,0,60,0,28,1701
36047102802,5,0,1,0,0,0,0,0,5
36047103401,3980,156,929,2711,14,13,0,11,3824
36047103402,0,0,0,0,0,0,0,0,0
36047105801,7013,1387,1278,3760,16,259,0,44,5626
36047105804,6482,1152,1257,3639,8,132,0,56,5330
36047107001,3543,56,809,2474,9,33,0,30,3487
36047107002,0,0,0,0,0,0,0,0,0
36047107003,0,0,0,0,0,0,0,0,0
36047107800,4112,64,527,3316,4,22,1,21,4048
36047109800,2290,47,411,1615,2,30,0,36,2243
36047110400,5068,87,863,3723,7,41,2,56,4981
36047110600,4558,46,1180,3152,26,17,0,21,4512
36047111000,3037,24,716,2155,13,10,1,19,3013
36047111600,3434,56,778,2307,5,41,0,34,3378
36047111800,3507,98,938,2095,2,158,0,47,3409
36047112000,3480,52,1130,2001,2,94,1,21,3428
36047112200,3514,81,696,2332,14,63,5,43,3433
36047112400,4288,92,895,3021,9,43,0,26,4196
36047112600,4368,56,1105,2945,10,15,0,39,4312
36047112800,4461,173,871,3059,4,32,0,66,4288
36047113000,4460,79,952,3075,11,32,0,26,4381
36047113200,2427,28,455,1734,6,38,4,22,2399
36047113400,2658,59,912,1565,13,12,0,23,2599
36047114201,1880,86,1187,407,1,107,0,11,1794
36047114202,2670,128,1518,802,7,86,3,34,2542
36047114400,2414,72,996,1181,15,33,2,12,2342
36047114600,3134,74,2012,697,4,157,0,55,3060
36047115000,3123,59,1452,1380,8,42,0,59,3064
36047115200,3496,80,1202,1825,11,140,8,30,3416
36047115600,4452,110,1642,2418,19,55,0,44,4342
36047115800,3260,60,886,1975,10,81,4,31,3200
36047116000,2630,12,814,1641,0,14,1,21,2618
36047116200,2374,41,497,1545,12,63,0,24,2333
36047116400,3275,52,1013,1836,18,148,0,35,3223
36047116600,3484,60,1529,1306,12,289,0,75,3424
36047116800,2273,58,1370,524,3,136,1,80,2215
36047117000,1974,45,1312,378,9,105,0,53,1929
36047117201,2602,49,1862,456,7,96,0,84,2553
36047117202,4266,130,2764,841,10,217,0,153,4136
36047117400,4331,103,3188,520,36,204,0,121,4228
36047117601,2760,110,2031,342,6,92,1,115,2650
36047117602,3492,90,2503,484,24,176,2,100,3402
36047117800,1820,30,1055,214,11,280,0,122,1790
36047118000,7,0,5,0,1,0,0,1,7
36047118201,3345,79,2426,375,14,240,0,106,3266
36047118202,3275,75,2363,331,21,251,0,130,3200
36047118400,5434,113,3833,618,20,550,0,164,5321
36047118600,3147,79,1499,358,21,891,3,174,3068
36047118800,5156,119,1600,479,50,2461,0,225,5037
36047119000,2217,63,815,431,24,615,5,154,2154
36047119200,3636,73,1648,1335,26,324,0,57,3563
36047119400,4320,69,1449,2054,9,395,0,97,4251
36047119600,6458,109,1544,1862,38,2469,0,155,6349
36047119800,3696,133,2185,1120,7,112,0,57,3563
36047120000,2873,73,722,1059,12,754,1,126,2800
36047120200,1972,33,392,215,55,1050,0,92,1939
36047120801,3999,59,880,2047,6,649,2,78,3940
36047120802,3770,16,520,3015,15,32,0,23,3754
36047120803,2010,86,599,961,2,203,2,44,1924
36047121000,3688,11,1781,1742,9,61,0,17,3677
36047121400,4100,59,1746,2115,11,35,0,19,4041
36047122000,6169,98,1272,4222,12,117,9,81,6071
36047123700,8586,7085,744,128,5,57,0,397,1501
36047150200,2616,1772,426,57,0,202,0,34,844
36047152200,3287,1493,458,477,19,590,0,33,1794
36047990100,0,0,0,0,0,0,0,0,0
36049950101,2580,2458,31,2,6,7,1,1,122
36049950200,4506,4243,53,22,8,9,0,6,263
36049950301,3429,3128,105,32,5,18,2,12,301
36049950302,4100,3817,100,9,3,16,5,6,283
36049950401,2536,2392,19,9,1,5,0,0,144
36049950500,2358,2186,87,3,5,2,0,12,172
36049950601,1245,1177,6,6,3,1,1,0,68
36049950700,4952,4700,46,20,9,7,2,12,252
36049950800,876,841,13,0,0,0,0,3,35
36051030100,4154,3730,89,102,4,35,0,13,424
36051030201,4613,4034,243,78,7,49,0,11,579
36051030203,2458,2221,92,29,9,34,0,7,237
36051030204,3540,3135,170,31,11,23,0,23,405
36051030300,3399,3070,126,36,3,20,1,16,329
36051030400,3536,3093,165,47,2,110,0,12,443
36051030500,2809,2121,256,167,1,177,0,31,688
36051030600,4154,3747,119,33,4,39,0,13,407
36051030701,2673,2488,45,27,1,5,2,11,185
36051030702,4824,4353,142,38,10,24,0,13,471
36051030800,5060,4462,332,19,4,34,1,13,598
36051030900,2898,2237,451,30,14,27,0,8,661
36051031000,875,380,132,341,12,3,1,0,495
36051031101,2009,1856,50,8,7,5,0,3,153
36051031102,2597,2420,41,8,10,11,0,3,177
36051031200,3451,3184,62,12,2,3,0,8,267
36051031300,4351,4121,39,11,14,16,1,11,230
36051031400,4433,3959,167,54,10,38,0,7,474
36053030101,2340,2076,51,45,16,15,1,11,264
36053030102,4674,4206,121,54,47,32,2,13,468
36053030103,3315,2916,50,25,134,57,0,5,399
36053030200,3405,3111,45,24,32,13,3,14,294
36053030300,5363,4822,127,79,37,28,1,7,541
36053030401,4931,4490,125,37,25,32,0,16,441
36053030402,3103,2865,52,22,5,13,0,13,238
36053030403,3736,3470,61,11,19,6,0,12,266
36053030404,3024,2812,49,20,9,14,2,10,212
36053030501,3112,2738,134,79,9,34,2,7,374
36053030502,3628,3365,98,13,5,16,0,20,263
36053030601,3099,2834,63,11,31,0,0,3,265
36053030602,3470,3157,71,14,31,6,0,5,313
36053030701,4284,3430,181,434,17,18,0,13,854
36053030702,1890,1757,29,4,6,4,0,9,133
36053030800,3250,3034,47,13,3,8,0,8,216
36053030900,4269,3252,270,157,2,346,0,18,1017
36053031000,4876,4560,72,21,7,16,0,3,316
36053031100,2247,2070,27,8,0,6,0,0,177
36055000200,2621,409,552,987,12,497,0,7,2212
36055000700,1953,122,821,896,3,35,2,14,1831
36055001000,3354,2474,245,392,7,82,3,15,880
36055001300,1957,71,592,974,2,258,0,2,1886
36055001600,2747,186,1076,1359,3,13,3,9,2561
36055001800,5420,2057,1131,1737,13,229,1,27,3363
36055001900,2699,722,592,1159,10,61,0,21,1977
36055002000,4658,1283,1019,1953,14,124,3,50,3375
36055002100,3693,902,609,1709,7,258,0,14,2791
36055002200,3044,478,624,1491,9,253,1,16,2566
36055002300,4366,704,1119,1942,23,350,2,21,3662
36055002400,3637,693,926,1657,2,99,2,30,2944
36055002700,1477,37,189,1155,8,11,0,5,1440
36055002900,3691,2897,240,284,4,101,0,18,794
36055003000,2089,1370,183,333,5,63,0,16,719
36055003101,2588,2266,99,82,7,43,1,15,322
36055003102,1908,1574,76,123,1,44,0,7,334
36055003200,2043,1030,271,557,9,81,0,10,1013
36055003300,1709,1104,144,278,9,71,0,2,605
36055003400,2304,1400,160,368,5,216,0,15,904
36055003500,1507,1189,84,103,3,44,0,9,318
36055003600,2642,1874,194,280,8,107,1,15,768
36055003700,2935,2291,234,217,6,35,3,27,644
36055003806,5321,2346,396,1142,5,1220,2,45,2975
36055003807,4302,2459,331,369,14,971,1,25,1843
36055003900,1861,136,769,859,5,39,2,5,1725
36055004000,1446,294,404,616,6,34,0,7,1152
36055004100,1731,294,482,787,4,61,0,4,1437
36055004602,2501,509,687,1170,2,36,0,8,1992
36055004701,3081,771,1177,957,4,41,0,14,2310
36055004702,2086,334,839,725,6,78,1,8,1752
36055004800,2293,199,1001,953,0,45,0,15,2094
36055004900,1732,80,749,827,2,6,0,5,1652
36055005000,1857,116,891,708,6,69,0,3,1741
36055005100,1373,81,474,726,3,38,3,9,1292
36055005200,1468,58,597,707,0,43,0,12,1410
36055005400,3655,917,869,1658,6,33,0,13,2738
36055005500,1914,136,674,1009,3,32,0,11,1778
36055005600,2339,257,669,1270,4,38,0,8,2082
36055005700,1920,235,464,1114,5,11,0,4,1685
36055005800,3885,900,739,2004,11,15,4,10,2985
36055005900,1625,248,319,928,10,13,0,11,1377
36055006000,3216,1909,266,834,4,23,1,9,1307
36055006100,2317,1908,114,188,4,22,0,6,409
36055006200,3098,491,263,2215,5,13,1,13,2607
36055006300,3076,390,260,2272,7,22,0,0,2686
36055006400,2510,113,290,1992,4,3,6,10,2397
36055006500,1608,101,203,1197,7,14,0,13,1507
36055006600,1931,186,196,1471,9,10,0,3,1745
36055006700,2875,414,258,2051,9,10,1,16,2461
36055006800,2730,597,214,1709,3,17,0,22,2133
36055006900,2555,647,259,1370,5,140,1,19,1908
36055007000,3303,1072,213,1627,6,215,0,23,2231
36055007100,2986,637,176,2010,4,53,2,7,2349
36055007500,2963,271,367,2143,8,21,1,13,2692
36055007600,2824,2057,215,349,11,36,0,19,767
36055007700,2740,1849,185,414,3,113,0,7,891
36055007801,2465,2034,101,141,3,90,0,9,431
36055007802,1520,1280,58,88,4,33,0,7,240
36055007900,1838,167,855,724,0,10,0,6,1671
36055008000,2274,148,798,1188,6,4,0,4,2126
36055008100,4368,639,1741,1750,4,77,0,17,3729
36055008200,3100,421,1284,1225,6,29,4,6,2679
36055008301,3834,988,1252,1400,3,34,0,9,2846
36055008400,2789,263,1063,1302,2,24,1,21,2526
36055008500,3602,2449,440,488,7,39,0,18,1153
36055008600,4531,2719,740,701,13,56,0,36,1812
36055008702,1500,390,306,670,13,26,0,2,1110
36055008801,6004,1575,1394,2248,35,492,0,20,4429
36055009200,1322,93,865,297,0,14,1,6,1229
36055009301,2554,316,815,1233,3,89,0,4,2238
36055009302,1693,979,199,324,0,97,2,6,714
36055009401,2260,1051,347,606,10,126,4,12,1209
36055009402,2092,1065,205,513,0,194,1,20,1027
36055009403,653,185,66,394,0,3,0,0,468
36055009404,633,357,54,145,2,54,0,0,276
36055009500,3046,1270,412,1088,7,135,0,14,1776
36055009601,1791,237,230,1210,7,19,0,11,1554
36055009602,1618,250,342,868,0,25,1,1,1368
36055009605,3445,638,1078,1400,10,121,0,13,2807
36055010100,3555,3006,266,91,3,38,0,9,549
36055010200,3884,3479,134,60,0,45,0,6,405
36055010300,3737,3246,199,89,8,39,1,11,491
36055010400,5268,3504,775,639,5,103,0,8,1764
36055010500,4477,3898,200,123,10,70,0,26,579
36055010601,2697,1908,315,299,2,62,0,4,789
36055010602,3964,2897,391,412,0,84,0,18,1067
36055010700,3359,2759,234,158,9,33,0,15,600
36055010800,2902,2399,214,155,6,33,1,15,503
36055010901,5032,2170,1138,1334,7,157,2,24,2862
36055010902,3253,2235,391,430,8,59,0,6,1018
36055011000,5065,3651,500,629,12,78,0,23,1414
36055011100,4034,3189,297,323,6,34,1,7,845
36055011201,3528,3191,89,54,0,73,0,13,337
36055011203,2068,1861,77,27,0,26,0,2,207
36055011205,5775,5188,181,78,0,133,2,15,587
36055011207,5319,4515,275,175,10,110,0,6,804
36055011209,4127,3376,270,192,3,163,2,14,751
36055011210,1206,1114,20,7,0,28,0,0,92
36055011302,5755,5147,245,65,0,71,2,22,608
36055011303,3007,2751,109,20,4,40,0,2,256
36055011304,4963,4381,159,105,8,158,1,6,582
36055011401,3419,2579,343,301,4,42,2,5,840
36055011402,3550,3184,145,55,5,43,0,1,366
36055011403,2610,1933,174,154,8,194,1,33,677
36055011503,5892,5158,227,148,8,149,3,14,734
36055011504,7331,6352,269,151,5,308,0,23,979
36055011505,6414,5477,254,181,6,254,3,11,937
36055011506,3971,3588,97,69,9,99,0,13,383
36055011507,3969,3268,248,158,3,143,0,16,701
36055011601,5742,4989,212,165,4,171,0,12,753
36055011603,1230,1027,69,31,4,23,1,2,203
36055011604,2650,2343,67,61,12,74,0,7,307
36055011605,2239,1952,81,43,1,56,0,7,287
36055011705,2615,2348,69,22,0,87,0,9,267
36055011707,7072,6324,196,111,3,167,0,16,748
36055011708,3724,3341,129,33,3,110,1,26,383
36055011709,2853,2508,65,38,1,135,0,8,345
36055011710,5967,5171,238,133,8,181,1,15,796
36055011711,2046,1827,63,31,0,76,0,2,219
36055011712,5482,4761,183,100,1,190,0,11,721
36055011800,5345,4706,173,118,5,87,2,15,639
36055011901,6319,5201,266,285,14,303,0,13,1118
36055011903,1969,1783,55,18,1,50,1,5,186
36055011904,4085,3720,101,55,10,68,0,14,365
36055012000,2611,2128,182,100,3,38,0,5,483
36055012100,3725,3113,214,126,12,49,4,8,612
36055012201,5944,5089,278,197,6,140,0,26,855
36055012202,3630,3196,103,70,2,134,0,8,434
36055012301,5998,4827,216,113,0,553,0,32,1171
36055012304,4436,3566,124,60,8,426,2,19,870
36055012305,4502,3534,122,101,8,514,0,20,968
36055012307,2726,1685,91,13,2,804,0,5,1041
36055012308,3381,2668,88,50,2,468,5,10,713
36055012401,3003,2735,82,35,7,32,0,15,268
36055012402,6092,5572,116,39,9,125,1,17,520
36055012500,4316,3767,172,108,6,85,0,20,549
36055012600,5126,4331,185,204,15,171,1,19,795
36055012700,3913,3241,167,104,0,182,1,14,672
36055012800,4577,3256,323,266,5,504,0,13,1321
36055012900,5460,4085,230,232,7,619,3,22,1375
36055013003,1675,1292,83,78,3,113,0,14,383
36055013004,5052,3324,264,454,15,732,1,37,1728
36055013005,4621,2396,333,651,17,1048,6,17,2225
36055013006,2397,1298,113,245,1,616,1,17,1099
36055013101,6633,4779,265,577,17,700,1,28,1854
36055013103,7916,5139,590,491,18,1232,0,42,2777
36055013104,5405,3169,389,644,13,887,0,37,2236
36055013203,5504,4080,233,444,7,407,0,21,1424
36055013205,5713,3442,320,590,8,1065,0,34,2271
36055013206,7467,4495,458,850,10,1276,0,30,2972
36055013207,5980,4518,207,323,6,628,0,37,1462
36055013208,2478,1790,131,181,5,238,2,4,688
36055013300,3490,3128,72,78,7,66,0,18,362
36055013401,3906,2714,446,468,4,85,0,12,1192
36055013402,3415,2958,154,108,15,33,1,10,457
36055013503,5501,4884,198,149,14,90,0,13,617
36055013505,3777,2723,386,376,5,111,0,12,1054
36055013507,5667,4864,244,232,8,135,0,18,803
36055013508,4361,3869,160,103,3,76,1,13,492
36055013509,2657,2211,117,145,4,82,0,13,446
36055013510,3600,3011,137,166,3,179,4,1,589
36055013511,2455,1554,178,416,7,175,3,6,901
36055013601,4895,3342,519,608,17,145,3,20,1553
36055013603,5619,4627,281,303,10,147,0,29,992
36055013604,5742,4027,496,913,13,78,0,11,1715
36055013701,2274,1701,199,202,5,38,2,16,573
36055013702,3594,2746,368,286,0,47,0,13,848
36055013800,5787,4029,653,661,15,107,0,30,1758
36055013901,3912,2909,358,328,3,146,0,12,1003
36055013902,4207,2136,697,964,7,156,1,25,2071
36055014001,5039,4015,393,327,9,134,2,10,1024
36055014003,4641,3369,450,435,12,131,2,14,1272
36055014004,3990,2742,404,512,10,127,0,23,1248
36055014102,3729,2788,272,359,1,162,1,8,941
36055014103,4336,3346,335,330,4,107,0,24,990
36055014104,3822,3076,238,319,2,75,0,7,746
36055014202,7473,5751,428,766,16,228,1,22,1722
36055014204,2565,1901,111,323,0,97,2,3,664
36055014205,3012,2054,265,371,5,121,1,11,958
36055014206,3519,2439,273,414,4,245,2,16,1080
36055014301,2927,1849,360,423,8,127,0,10,1078
36055014302,4956,3440,462,545,13,269,0,14,1516
36055014400,4715,3165,372,757,8,150,6,21,1550
36055014501,4550,3807,153,288,3,89,0,25,743
36055014503,3300,2532,189,322,6,65,6,20,768
36055014504,5401,4023,240,590,8,259,3,21,1378
36055014505,5309,4254,291,378,4,121,0,17,1055
36055014601,5580,4551,286,353,6,113,0,22,1029
36055014602,4983,3516,277,672,17,235,5,36,1467
36055014700,4897,4187,204,184,18,67,9,18,710
36055014802,5281,4835,139,64,9,33,0,16,446
36055014803,3797,3504,112,26,10,17,0,14,293
36055014805,3464,3070,137,103,6,17,0,10,394
36055014806,3675,3316,137,95,0,15,0,8,359
36055014901,5614,4971,248,128,8,38,2,26,643
36055014903,5099,4621,165,74,2,22,0,4,478
36055014905,5640,4821,267,252,7,103,0,7,819
36055014906,3917,3480,121,87,5,53,0,5,437
36055015000,5586,5120,149,71,4,58,0,25,466
36055015101,4651,4091,191,111,18,26,1,35,560
36055015102,4074,3615,181,35,9,9,0,15,459
36055015200,6904,5981,322,145,9,96,4,23,923
36055015301,2143,1530,190,275,2,35,0,9,613
36055015303,3154,2629,175,137,1,37,0,4,525
36055015304,3933,3217,232,174,14,36,0,24,716
36055015400,4014,3495,194,76,4,46,2,14,519
36055980000,0,0,0,0,0,0,0,0,0
36055980100,31,24,2,1,0,0,0,0,7
36055980200,17,16,0,0,0,1,0,0,1
36055990000,0,0,0,0,0,0,0,0,0
36057070200,2242,1345,652,89,3,49,1,18,897
36057070300,2060,834,933,109,15,30,0,18,1226
36057070400,1996,1189,580,78,5,47,2,16,807
36057070500,2703,1820,631,73,11,34,0,26,883
36057070600,2011,1042,759,76,3,32,0,10,969
36057070700,2625,1731,671,79,5,13,1,7,894
36057070800,2959,1459,1125,159,6,40,0,6,1500
36057070900,1623,666,760,102,1,17,0,13,957
36057072100,5557,4878,351,51,2,64,0,19,679
36057072200,3572,3211,131,26,5,27,1,3,361
36057072300,3189,2962,64,15,0,12,0,12,227
36057072400,2598,2358,80,4,6,4,1,10,240
36057072500,4166,3741,138,52,7,11,1,0,425
36057072600,3660,3235,138,22,10,31,2,24,425
36057072700,4549,4134,159,32,2,27,0,15,415
36057072800,4022,3632,140,20,2,41,0,13,390
36059300100,5619,4680,214,88,0,307,4,23,939
36059300300,4680,3325,573,96,0,450,0,31,1355
36059300400,6465,4442,631,49,5,1047,1,66,2023
36059300500,5847,4355,197,29,2,1032,0,61,1492
36059300600,6740,3703,217,53,5,2544,3,46,3037
36059300700,6604,4010,575,126,5,1671,0,30,2594
36059300800,4358,1702,323,60,0,2119,0,24,2656
36059300901,2828,1039,103,12,1,1587,0,19,1789
36059300902,5464,3245,151,53,0,1878,3,24,2219
36059301000,5706,4763,253,45,2,479,0,22,943
36059301101,6956,3195,2487,106,4,995,2,36,3761
36059301102,4582,3507,419,41,0,441,3,33,1075
36059301200,6191,4710,740,43,2,453,0,16,1481
36059301300,4944,2467,1492,233,6,557,2,26,2477
36059301400,2193,1684,207,17,1,203,0,3,509
36059301500,3250,2525,188,11,4,441,2,17,725
36059301600,4794,3423,280,32,7,904,0,29,1371
36059301700,2809,2141,149,29,1,378,1,8,668
36059301800,5076,2440,721,591,5,1167,0,12,2636
36059301900,3100,2166,147,6,3,696,0,8,934
36059302000,5330,3680,612,58,4,809,3,23,1650
36059302101,4431,3430,232,50,0,585,0,29,1001
36059302102,3534,2712,165,37,1,520,0,13,822
36059302200,3882,1644,607,341,5,1139,0,38,2238
36059302300,5044,1986,197,58,6,2647,0,29,3058
36059302400,5220,2867,468,25,6,1700,1,39,2353
36059302501,2865,1559,93,34,5,1100,0,13,1306
36059302502,2766,1645,109,105,0,786,0,16,1121
36059302600,2519,1335,350,33,8,689,0,22,1184
36059302700,4593,1455,369,41,9,2552,2,63,3138
36059302800,6607,2714,483,35,19,3165,3,60,3893
36059302900,4457,2419,378,32,9,1521,3,36,2038
36059303000,6038,2159,745,63,16,2858,3,45,3879
36059303101,3649,1287,237,32,6,1974,0,42,2362
36059303102,4398,1487,196,27,18,2522,3,36,2911
36059303203,3502,1102,221,33,10,2032,0,24,2400
36059303204,4483,1600,778,190,9,1710,2,50,2883
36059303301,3343,1814,220,31,4,1138,1,24,1529
36059303302,4248,3211,533,50,0,310,0,36,1037
36059303400,2645,2060,150,5,0,340,0,7,585
36059303500,5410,3444,941,43,1,805,0,46,1966
36059303600,8658,4627,2177,317,11,1132,3,91,4031
36059303700,6743,4433,955,168,1,926,0,63,2310
36059303800,5005,3434,740,148,6,488,0,44,1571
36059303900,4008,1220,638,1460,16,478,1,50,2788
36059304001,2621,1831,460,19,2,217,0,25,790
36059304002,4729,2250,1671,296,6,355,1,42,2479
36059304100,4576,596,2379,984,4,451,2,29,3980
36059304202,3593,501,2149,625,0,224,0,35,3092
36059304203,5659,60,2845,2539,17,79,0,30,5599
36059304204,4877,84,2918,1713,1,99,1,15,4793
36059404300,3502,1497,776,187,16,844,2,60,2005
36059404400,4984,4019,484,74,0,292,1,28,965
36059404500,4321,2839,735,96,6,529,1,11,1482
36059404600,4348,3302,498,59,0,379,1,21,1046
36059404700,6224,3584,927,152,16,1354,1,49,2640
36059404800,6782,1154,1892,2191,33,1184,0,91,5628
36059404901,5234,199,704,3536,11,447,3,81,5035
36059404902,4363,327,1206,2010,12,564,1,89,4036
36059405000,5453,780,1460,1773,22,1022,3,134,4673
36059405100,8317,754,1228,4884,12,930,0,218,7563
36059405200,6857,1226,1918,1900,20,1383,8,198,5631
36059405301,3712,2147,722,194,7,538,0,30,1565
36059405302,4295,2760,841,103,5,473,0,29,1535
36059405400,8264,3608,2091,774,21,1415,3,114,4656
36059405500,5574,3780,1030,106,6,538,2,24,1794
36059405600,4163,3163,519,45,1,321,2,27,1000
36059405700,4895,3146,776,163,0,662,1,69,1749
36059405800,4119,3160,475,42,7,348,0,10,959
36059405900,5395,3703,672,482,11,313,0,75,1692
36059406001,4761,2807,1041,287,7,414,0,85,1954
36059406002,3612,2289,699,339,4,115,0,35,1323
36059406100,3006,1696,577,311,6,299,0,38,1310
36059406201,3061,827,967,830,5,297,0,42,2234
36059406202,6077,152,1123,4249,17,157,0,126,5925
36059406300,3883,3210,231,22,1,290,0,19,673
36059406400,6948,6045,363,35,1,370,5,29,903
36059406501,7110,5799,493,110,4,488,2,37,1311
36059406600,4381,3491,326,38,6,400,0,25,890
36059406701,3621,350,1808,1216,5,110,3,36,3271
36059406702,5274,844,1771,2319,6,178,1,57,4430
36059406801,5183,227,3151,1494,6,157,3,51,4956
36059406802,5556,92,4171,1072,7,78,5,54,5464
36059406900,7949,190,3852,3427,18,132,0,100,7759
36059407000,8169,123,3669,3835,46,196,1,53,8046
36059407101,5161,162,2189,2481,21,102,0,61,4999
36059407102,5838,214,2174,3099,7,108,0,62,5624
36059407201,5969,234,4235,1299,9,58,0,54,5735
36059407203,3601,166,1641,1570,6,48,0,67,3435
36059407204,2848,465,979,1229,16,75,4,26,2383
36059407301,6616,3857,889,981,15,558,8,39,2759
36059407302,5373,676,2667,1736,4,132,0,42,4697
36059407401,5971,350,2711,2579,18,97,4,63,5621
36059407402,3571,348,1617,1291,10,193,0,22,3223
36059407501,5279,202,2706,2069,23,76,0,81,5077
36059407502,5663,211,2344,2887,6,63,0,41,5452
36059407600,5623,3071,1088,168,1,1116,0,37,2552
36059407700,4907,2794,944,82,1,956,1,27,2113
36059407801,5531,2995,1042,118,7,1168,0,47,2536
36059407802,1114,506,226,284,0,80,0,7,608
36059407900,5865,3776,712,487,15,649,5,58,2089
36059408000,6490,3703,1127,221,7,1225,1,45,2787
36059408100,6889,4237,959,197,2,1289,0,64,2652
36059408200,6848,3766,1283,185,6,1396,2,54,3082
36059408300,7147,4185,1151,247,7,1262,3,66,2962
36059408400,3953,2806,533,167,3,300,1,24,1147
36059408500,6352,4636,758,193,0,570,0,45,1716
36059408600,4456,2679,717,75,16,799,0,38,1777
36059408700,4943,2876,940,88,10,856,0,33,2067
36059408800,6838,4592,1114,79,1,875,1,9,2246
36059408900,5784,3556,1156,76,7,766,3,43,2228
36059409000,5742,3692,1129,78,11,662,1,40,2050
36059409100,5221,3486,898,48,0,582,0,37,1735
36059409200,6055,4062,1044,73,6,672,0,35,1993
36059409300,4285,3157,650,81,13,277,1,16,1128
36059409400,4473,3399,574,53,1,290,0,19,1074
36059409500,3961,3354,395,24,0,121,0,13,607
36059409600,5074,3971,695,66,0,194,0,35,1103
36059409700,4258,3510,466,50,0,124,0,28,748
36059409800,5790,304,722,3711,15,647,0,131,5486
36059409900,8312,1065,1290,3423,43,1946,5,180,7247
36059410000,4095,1266,665,977,16,922,1,101,2829
36059410100,6011,4452,745,284,5,296,0,85,1559
36059410200,3834,2513,547,310,6,307,0,44,1321
36059410300,6647,1014,1761,2279,26,1118,11,183,5633
36059410400,5647,669,1539,2067,22,914,0,228,4978
36059410500,7819,1942,2253,1669,24,1396,1,186,5877
36059410600,7741,2700,1804,1363,25,1392,0,133,5041
36059410700,7165,2788,1895,1148,19,943,0,110,4377
36059410800,5615,2337,1420,817,4,740,9,138,3278
36059410900,6386,2125,793,1674,20,1376,2,159,4261
36059411000,6132,1953,3084,656,5,272,4,76,4179
36059411100,5208,727,2913,1264,4,159,0,38,4481
36059411200,7374,5803,1040,151,0,189,0,74,1571
36059411301,4329,3414,233,314,0,184,0,109,915
36059411302,7369,6678,173,145,0,170,2,80,691
36059411400,6971,5699,554,298,0,232,2,91,1272
36059411500,3250,2826,137,35,11,154,0,18,424
36059411600,6809,6095,308,85,0,93,0,116,714
36059411700,7262,4989,1086,303,4,630,1,56,2273
36059411800,6563,4643,1063,324,3,363,0,22,1920
36059411901,3704,2468,684,222,2,218,0,19,1236
36059411902,3746,2363,634,232,15,319,0,30,1383
36059412000,6425,3736,1466,567,2,370,1,83,2689
36059412100,6527,5078,846,190,0,222,0,29,1449
36059412200,5749,4477,833,148,6,133,0,24,1272
36059412301,3357,2494,579,113,0,77,0,20,863
36059412302,3663,2609,731,118,3,112,0,8,1054
36059412400,6179,3918,976,880,13,200,0,23,2261
36059412500,4397,3855,267,62,0,74,0,22,542
36059412600,4305,3781,266,77,2,81,0,14,524
36059412700,4129,3666,211,67,1,75,0,23,463
36059412800,3406,1852,836,506,10,79,2,33,1554
36059412900,6310,660,1322,3761,13,210,1,100,5650
36059413001,4140,3105,683,86,2,147,0,21,1035
36059413002,3878,2784,661,100,0,188,0,28,1094
36059413100,4993,3894,633,123,10,195,0,24,1099
36059413200,6668,5116,1041,107,2,221,0,41,1552
36059413300,6976,5539,916,122,4,219,1,49,1437
36059413400,5982,4821,595,120,1,211,0,54,1161
36059413500,7583,1952,1706,3218,13,280,2,82,5631
36059413600,6085,1847,1856,1772,9,283,0,118,4238
36059413700,5700,2302,1457,1319,17,305,1,85,3398
36059413803,4384,1510,679,1626,3,293,0,91,2874
36059413804,3857,1560,568,1293,0,205,4,59,2297
36059413900,8495,202,4306,3638,18,50,3,70,8293
36059414001,4448,75,1680,2464,6,60,3,44,4373
36059414002,5123,66,2420,2417,8,59,5,59,5057
36059414100,6832,303,2635,3421,12,73,5,103,6529
36059414201,5440,586,3052,1429,16,142,0,72,4854
36059414202,4694,188,2696,1614,9,41,0,51,4506
36059414301,3825,727,2082,817,3,54,0,38,3098
36059414303,4640,1080,2299,990,3,107,4,39,3560
36059414304,3963,362,2831,562,7,72,2,64,3601
36059414400,5150,385,2982,1563,12,50,3,56,4765
36059414501,5626,1883,1648,1656,18,133,0,84,3743
36059414502,4302,2118,1087,778,9,120,1,38,2184
36059414600,3666,2964,373,70,0,163,1,34,702
36059414700,4619,3796,426,68,2,205,0,23,823
36059414800,6775,5234,751,178,2,423,3,37,1541
36059414900,7456,5573,865,274,3,477,0,43,1883
36059415000,5948,4484,762,86,2,366,0,40,1464
36059415101,2790,2232,312,76,3,100,0,11,558
36059415102,5122,4399,370,76,0,167,0,42,723
36059415201,3676,3031,361,30,1,168,0,15,645
36059415202,4504,3928,261,71,2,127,0,23,576
36059415300,5903,4586,735,87,0,312,0,14,1317
36059415401,5442,4413,522,98,2,229,0,26,1029
36059415402,4952,4238,313,57,0,196,0,15,714
36059415500,2599,2192,255,22,3,57,0,8,407
36059415600,5573,4793,438,19,7,201,0,25,780
36059415700,5932,5141,455,25,0,139,0,21,791
36059415802,7108,6277,506,15,0,155,0,18,831
36059416000,4079,3450,354,36,0,119,0,29,629
36059416100,6410,5463,522,53,0,176,0,27,947
36059416201,4026,2963,649,95,6,178,0,39,1063
36059416202,4928,2729,1645,149,9,203,8,60,2199
36059416300,3817,3435,215,11,0,46,0,25,382
36059416401,3966,3472,327,33,2,51,2,12,494
36059416402,3331,2783,298,85,8,64,0,27,548
36059416500,6465,2330,2136,1279,22,403,10,85,4135
36059416600,5638,4694,506,104,4,184,7,24,944
36059416701,4695,3295,851,123,2,205,0,55,1400
36059416702,4458,3495,603,113,1,116,1,26,963
36059416801,2197,1900,192,17,0,20,0,15,297
36059416802,4279,3562,457,66,3,64,1,29,717
36059416900,4281,3864,221,23,0,70,0,9,417
36059517000,3662,2475,592,148,8,336,0,13,1187
36059517101,5560,2512,2238,419,14,231,0,35,3048
36059517102,2483,1762,409,45,0,196,0,21,721
36059517201,4471,1457,2089,609,9,178,0,40,3014
36059517202,3916,1823,1692,170,5,144,0,4,2093
36059517301,3090,1759,966,115,5,156,2,21,1331
36059517302,5183,2987,1766,89,17,208,0,42,2196
36059517400,5062,4160,475,82,2,148,1,14,902
36059517500,3998,3226,363,26,3,257,1,24,772
36059517600,4837,3786,546,32,2,330,0,26,1051
36059517701,7679,5179,387,121,4,1774,5,40,2500
36059517705,2506,1775,119,45,2,507,0,10,731
36059517801,3782,3125,326,26,0,194,1,9,657
36059517802,3571,2408,861,90,0,124,0,23,1163
36059517901,4676,3982,444,15,1,88,0,17,694
36059517902,2923,2419,343,19,2,86,2,4,504
36059518000,7075,4997,1409,228,8,240,0,22,2078
36059518100,2792,2362,222,26,0,111,0,8,430
36059518201,4498,3641,223,37,1,438,0,24,857
36059518203,4617,3106,402,91,2,910,0,28,1511
36059518204,4718,3775,130,36,0,701,0,15,943
36059518300,5933,3582,380,38,2,1766,0,18,2351
36059518400,4254,2394,197,43,13,1456,0,24,1860
36059518501,7332,3452,263,190,2,3232,2,45,3880
36059518502,3119,1165,208,81,5,1569,0,14,1954
36059518600,4494,1841,132,33,0,2399,1,20,2653
36059518700,5733,2868,249,32,3,2409,1,28,2865
36059518800,3339,1801,145,5,1,1313,1,4,1538
36059518900,7320,2309,1845,514,30,2384,2,51,5011
36059519000,6500,3135,1052,138,6,1961,1,52,3365
36059519100,6276,3088,1076,72,13,1844,0,51,3188
36059519200,6675,2968,1101,94,8,2240,0,63,3707
36059519300,6613,2153,1644,207,8,2414,0,56,4460
36059519400,4406,2283,610,51,7,1310,4,24,2123
36059519500,6079,3137,675,53,3,2025,0,29,2942
36059519601,4566,2846,378,24,0,1176,0,20,1720
36059519602,2168,1611,91,11,0,412,0,7,557
36059519702,5663,4544,203,19,5,792,1,23,1119
36059519703,3761,2568,167,24,1,908,0,20,1193
36059519704,3239,2392,141,17,0,617,0,12,847
36059519801,2499,1578,155,5,5,679,0,15,921
36059519802,5204,3595,463,31,10,964,0,9,1609
36059519900,5416,4127,491,14,5,663,4,21,1289
36059520001,6860,4988,689,67,1,949,0,27,1872
36059520002,4382,3177,555,70,1,454,0,19,1205
36059520100,6403,5293,340,17,0,597,0,17,1110
36059520200,3161,2187,423,34,3,427,5,12,974
36059520300,6356,4990,670,138,0,388,10,36,1366
36059520401,4256,2970,667,158,0,324,0,39,1286
36059520402,4210,3049,624,122,9,294,0,22,1161
36059520501,3625,2688,538,54,0,262,0,11,937
36059520502,5105,4160,560,57,3,182,0,29,945
36059520600,5615,3974,980,173,8,329,0,31,1641
36059520700,4738,4064,417,29,0,145,0,16,674
36059520800,3898,3340,366,15,0,100,0,2,558
36059520900,4495,3917,386,14,0,93,0,12,578
36059521000,4698,4048,372,49,4,121,0,14,650
36059521100,4459,3811,438,16,0,84,0,4,648
36059521200,2786,2440,193,20,0,62,1,7,346
36059521301,2245,1913,183,27,1,45,2,3,332
36059521302,5457,4848,334,31,2,114,0,11,609
36059521400,6408,5649,438,18,6,127,0,22,759
36059521500,4865,4252,386,15,4,91,0,29,613
36059521601,4213,3750,260,22,2,73,0,11,463
36059521602,3327,2974,232,9,4,43,0,10,353
36059521700,4704,4129,357,32,2,99,0,12,575
36059521801,3596,2986,351,60,0,94,0,16,610
36059521802,3886,3382,278,32,0,98,0,6,504
36059521902,4500,4026,286,16,6,42,0,19,474
36059522000,7883,3089,1861,2307,9,252,2,99,4794
36059522700,4762,4138,363,22,2,133,0,10,624
36059980100,939,795,71,7,0,38,0,0,144
36059981100,995,873,66,14,0,12,0,0,122
36059982100,883,169,171,464,3,42,0,3,714
36059990100,0,0,0,0,0,0,0,0,0
36059990200,0,0,0,0,0,0,0,0,0
36059990301,0,0,0,0,0,0,0,0,0
36059990302,0,0,0,0,0,0,0,0,0
36059990400,0,0,0,0,0,0,0,0,0
36061000100,0,0,0,0,0,0,0,0,0
36061000201,2012,221,784,244,0,702,0,11,1791
36061000202,7266,1575,2683,942,12,1832,0,55,5691
36061000500,5,0,0,1,0,2,0,0,5
36061000600,11616,1145,2946,1227,16,6027,6,42,10471
36061000700,10542,6782,927,353,7,1894,10,88,3760
36061000800,10871,1233,532,228,4,8708,5,53,9638
36061000900,2016,1148,223,151,0,357,4,28,868
36061001001,1767,1085,259,49,0,272,0,29,682
36061001002,6300,134,3702,1264,3,1050,0,44,6166
36061001200,3776,1705,1104,118,6,666,0,29,2071
36061001300,5402,3339,522,169,0,1045,0,49,2063
36061001401,3543,2080,416,88,0,718,1,40,1463
36061001402,3418,957,996,287,7,1023,0,44,2461
36061001501,8385,4745,763,364,0,2102,8,58,3640
36061001502,10378,6335,993,474,10,1951,5,79,4043
36061001600,7698,1347,444,229,4,5470,0,33,6351
36061001800,7934,2551,1122,378,0,3579,3,70,5383
36061002000,4648,77,2829,867,5,765,2,24,4571
36061002100,7811,5223,547,122,3,1337,5,76,2588
36061002201,6969,1629,2844,799,6,1457,0,39,5340
36061002202,2488,1308,474,209,1,374,5,32,1180
36061002400,4518,81,2719,975,4,645,2,11,4437
36061002500,4630,86,1780,879,7,1753,6,29,4544
36061002601,3609,1121,1446,401,0,503,2,23,2488
36061002602,4816,2406,981,391,6,789,2,43,2410
36061002700,1370,232,53,22,0,1022,1,8,1138
36061002800,6819,2164,2609,731,10,1013,3,57,4655
36061002901,1096,228,318,415,1,119,3,1,868
36061002902,4359,556,158,29,3,3495,1,10,3803
36061003001,4663,2575,754,165,4,938,2,31,2088
36061003002,3035,1577,640,143,43,493,1,26,1458
36061003100,2989,1270,433,340,8,623,3,60,1719
36061003200,8372,5592,1019,233,6,1126,10,60,2780
36061003300,6458,4832,380,94,0,747,5,26,1626
36061003400,7012,4459,1139,244,7,759,10,67,2553
36061003601,3513,1030,1195,419,10,742,9,23,2483
36061003602,3000,1778,388,210,0,473,0,30,1222
36061003700,3092,2198,290,82,0,338,1,26,894
36061003800,9070,5909,1132,318,3,1245,8,53,3161
36061003900,7036,5216,525,213,10,622,0,68,1820
36061004001,3743,2645,418,135,3,359,3,25,1098
36061004002,5090,3149,545,185,10,804,7,76,1941
36061004100,7523,2594,569,210,3,3829,5,74,4929
36061004200,5216,2641,557,367,2,1386,2,35,2575
36061004300,4158,2556,545,67,4,760,6,42,1602
36061004400,17222,11076,1615,560,12,2978,2,127,6146
36061004500,1093,688,53,17,0,251,0,19,405
36061004700,2644,1987,220,40,5,248,0,14,657
36061004800,6955,4766,622,267,6,959,3,61,2189
36061004900,4777,3619,355,83,0,434,3,34,1158
36061005000,5223,3935,286,72,1,686,0,25,1288
36061005200,3808,2457,284,161,6,487,1,76,1351
36061005400,4909,3676,294,73,2,617,1,26,1233
36061005501,4564,2990,384,191,4,678,0,39,1574
36061005502,1956,1483,126,48,2,180,2,14,473
36061005600,4281,2541,498,449,12,545,3,33,1740
36061005700,2998,2388,127,39,0,311,0,14,610
36061005800,5109,3543,484,146,0,735,1,36,1566
36061005900,5707,4259,394,119,2,631,5,46,1448
36061006000,5290,3682,397,147,0,683,3,66,1608
36061006100,5494,3542,554,316,3,708,2,52,1952
36061006200,3686,1646,442,414,1,971,0,60,2040
36061006300,6707,5319,454,127,2,447,3,77,1388
36061006400,8744,5815,919,285,4,1211,47,77,2929
36061006500,6721,4737,608,197,0,828,2,29,1984
36061006600,12341,6310,2211,1052,23,2136,81,94,6031
36061006700,5547,4397,461,83,0,374,1,29,1150
36061006800,7706,4983,732,456,17,1123,3,86,2723
36061006900,2799,2073,219,89,0,226,3,37,726
36061007001,4550,2943,411,185,0,778,6,33,1607
36061007002,4865,3408,389,82,0,754,0,28,1457
36061007100,5851,4501,490,195,4,367,11,39,1350
36061007200,9358,6451,766,343,4,1447,9,58,2907
36061007300,6180,4962,444,98,5,374,3,44,1218
36061007400,5698,3637,486,291,1,1040,1,57,2061
36061007500,4000,3231,267,88,0,210,0,31,769
36061007600,2921,1125,344,269,5,1067,5,12,1796
36061007700,6192,4898,480,92,3,449,1,33,1294
36061007800,9109,5421,692,264,11,2296,0,44,3688
36061007900,4442,3546,263,90,5,279,0,45,896
36061008000,5906,4062,441,243,2,933,0,36,1844
36061008100,7853,5517,876,229,11,784,5,68,2336
36061008200,3414,2230,268,86,3,656,1,22,1184
36061008300,3853,1682,1126,458,2,432,1,23,2171
36061008400,1985,736,266,282,0,609,4,7,1249
36061008601,4853,2441,408,190,4,1591,7,43,2412
36061008602,0,0,0,0,0,0,0,0,0
36061008603,5347,4178,345,58,0,550,0,75,1169
36061008700,6510,4565,697,122,3,770,6,60,1945
36061008800,8852,5305,741,262,1,2123,0,63,3547
36061008900,5957,3787,933,330,7,581,9,64,2170
36061009000,8830,5226,622,288,5,2233,6,86,3604
36061009100,7362,4859,689,420,12,1025,0,40,2503
36061009200,1866,1048,221,94,1,427,0,10,818
36061009300,9325,5696,1667,690,19,834,4,79,3629
36061009400,109,55,15,10,1,26,0,0,54
36061009500,3892,1735,1376,290,5,378,4,22,2157
36061009600,608,122,128,242,2,82,2,9,486
36061009700,5071,2231,1334,558,16,666,9,37,2840
36061009800,8078,5413,589,168,4,1508,16,51,2665
36061009901,2093,1406,245,88,3,246,0,5,687
36061009902,3848,2184,565,271,8,591,0,27,1664
36061009903,2380,959,378,227,4,688,3,26,1421
36061010000,2170,1291,240,112,2,427,5,6,879
36061010100,2596,832,377,360,9,910,8,24,1764
36061010200,283,204,35,3,0,31,0,8,79
36061010300,4095,1438,1413,215,2,861,2,26,2657
36061010400,983,643,96,28,0,168,0,14,340
36061010601,8256,6989,432,46,1,555,0,36,1267
36061010602,5489,3500,422,313,1,947,3,49,1989
36061010801,3297,2307,260,66,4,543,0,19,990
36061010802,3805,2889,233,46,2,484,3,16,916
36061010803,2696,1888,171,24,2,515,2,14,808
36061010900,407,134,56,77,0,124,0,1,273
36061011000,7671,5492,639,173,6,1024,9,45,2179
36061011100,6138,2362,1152,800,14,1559,3,32,3776
36061011201,1233,891,139,9,0,148,0,10,342
36061011202,500,370,44,11,2,67,1,0,130
36061011203,1420,961,85,10,0,289,0,14,459
36061011300,216,78,35,48,0,49,0,0,138
36061011401,1361,1076,81,36,0,124,0,14,285
36061011402,2620,2050,160,42,1,241,1,21,570
36061011500,3863,1386,616,273,9,1407,4,32,2477
36061011600,3263,2177,344,90,5,484,2,28,1086
36061011700,5256,2149,949,422,6,1452,7,48,3107
36061011800,9688,7729,508,98,2,936,1,45,1959
36061011900,1666,389,440,708,11,47,2,10,1277
36061012000,3905,3288,181,54,2,250,2,20,617
36061012101,3408,1575,567,365,7,775,2,27,1833
36061012102,5236,3325,882,311,8,440,0,39,1911
36061012200,3425,2930,193,21,1,184,1,24,495
36061012400,10845,7749,826,207,7,1588,0,71,3096
36061012500,2901,1015,415,287,2,1078,8,29,1886
36061012601,7437,5797,468,91,0,814,0,36,1640
36061012602,6400,5292,363,76,0,437,1,38,1108
36061012700,7282,3933,1548,295,1,1108,2,66,3349
36061012800,6545,5623,321,42,0,341,0,60,922
36061012901,7959,3378,1290,825,13,2074,5,60,4581
36061012902,3144,1491,784,303,8,392,0,24,1653
36061013000,3911,3388,208,45,4,191,0,12,523
36061013100,3962,1862,610,270,0,1069,0,24,2100
36061013201,3146,2313,211,46,2,452,1,11,833
36061013202,4237,3029,368,103,3,497,4,23,1208
36061013203,3747,2739,269,70,1,493,7,12,1008
36061013300,6782,3511,1201,242,4,1479,2,46,3271
36061013400,11882,9155,938,184,9,1130,5,56,2727
36061013501,5504,2281,1422,373,0,1193,0,37,3223
36061013502,6358,2484,1452,664,3,1417,2,53,3874
36061013601,1962,1700,93,4,0,104,0,11,262
36061013602,5070,3845,399,94,1,507,0,34,1225
36061013603,4387,3474,301,78,2,340,0,21,913
36061013604,5057,3800,410,92,3,504,0,34,1257
36061013700,7308,4646,731,358,6,1283,1,48,2662
36061013800,13109,9967,913,281,3,1438,1,60,3142
36061013900,9988,6091,1218,513,6,1726,2,82,3897
36061014000,8050,6601,464,73,2,619,1,25,1449
36061014200,4463,3842,264,8,0,208,0,24,621
36061014300,129,32,32,49,3,2,0,2,97
36061014401,5040,3994,379,76,5,381,0,20,1046
36061014402,7151,5446,593,128,4,669,0,38,1705
36061014500,7532,4628,765,256,9,1472,0,73,2904
36061014601,4481,3230,369,97,5,564,0,39,1251
36061014602,9061,6687,671,142,2,1103,0,49,2374
36061014700,2987,1643,265,60,3,845,1,23,1344
36061014801,3221,2485,185,28,0,350,0,24,736
36061014802,7494,5889,464,65,2,751,0,57,1605
36061014900,6351,4817,397,117,2,720,0,24,1534
36061015001,2321,1968,80,15,1,147,0,19,353
36061015002,5642,4862,266,30,0,306,0,24,780
36061015101,3756,468,1670,1047,12,434,7,21,3288
36061015102,8254,4036,1247,599,6,1913,0,60,4218
36061015200,7730,4107,1562,926,3,794,4,75,3623
36061015301,3684,2949,269,41,0,272,0,17,735
36061015302,6032,4416,413,67,3,825,0,26,1616
36061015401,5189,3636,454,195,0,623,2,32,1553
36061015402,4503,3025,457,130,1,631,2,33,1478
36061015403,5738,3348,868,416,2,846,0,42,2390
36061015501,5091,3875,226,55,2,693,1,29,1216
36061015502,5759,4122,397,128,4,860,4,49,1637
36061015601,5568,3371,730,309,3,921,0,41,2197
36061015602,2154,661,719,311,4,369,1,25,1493
36061015700,11197,8492,871,264,21,955,3,169,2705
36061015801,5600,4278,435,109,5,502,0,32,1322
36061015802,4516,2443,706,317,6,833,2,29,2073
36061015900,10054,7555,632,186,9,1117,5,94,2499
36061016001,3852,3273,220,33,0,198,4,18,579
36061016002,3607,2288,476,152,0,566,1,25,1319
36061016100,6617,5116,539,125,0,505,2,34,1501
36061016200,9033,585,3862,3364,6,920,0,67,8448
36061016300,7292,5282,651,326,9,612,4,43,2010
36061016400,7371,831,3681,1888,16,736,1,53,6540
36061016500,6659,5151,551,140,4,479,3,14,1508
36061016600,7012,1453,3477,1205,7,565,3,67,5559
36061016700,7210,5546,562,206,0,540,1,77,1664
36061016800,4964,926,2276,1338,13,291,0,22,4038
36061016900,8526,6244,1027,254,4,598,0,81,2282
36061017000,7991,870,4251,1272,12,1283,3,81,7121
36061017100,9694,7188,979,411,10,586,2,103,2506
36061017200,5441,755,2985,1026,13,419,0,56,4686
36061017300,8699,5779,1274,569,11,569,1,52,2920
36061017401,5449,717,2420,1610,12,510,0,26,4732
36061017402,2276,435,820,687,3,225,1,16,1841
36061017500,11110,8126,1313,440,2,697,3,111,2984
36061017700,9382,4755,2241,1253,7,612,2,83,4627
36061017800,3860,818,2016,687,6,146,4,39,3042
36061017900,9103,6057,1302,573,2,726,0,89,3046
36061018000,7429,779,4354,1541,15,487,1,51,6650
36061018100,8941,5108,1421,1024,7,879,2,95,3833
36061018200,7675,754,4130,2002,19,473,4,98,6921
36061018300,8534,5494,1125,484,12,907,0,108,3040
36061018400,7820,680,3718,2609,12,441,5,78,7140
36061018500,5243,3072,482,465,4,934,2,60,2171
36061018600,5127,348,1946,2356,10,206,5,72,4779
36061018700,9383,5752,1482,838,8,764,1,110,3631
36061018800,5697,856,3288,1074,15,269,0,44,4841
36061018900,11556,3061,4692,2620,19,715,1,70,8495
36061019000,3679,756,753,1617,10,312,5,31,2923
36061019100,9005,5528,1431,731,1,887,5,62,3477
36061019200,3971,187,2064,1403,12,184,0,24,3784
36061019300,8736,2473,3458,1347,13,1023,1,96,6263
36061019400,6978,578,3871,1990,19,260,0,51,6400
36061019500,7828,4453,1407,401,8,1120,0,70,3375
36061019600,4031,554,1837,1241,14,227,1,24,3477
36061019701,1278,385,196,155,1,482,1,22,893
36061019702,2601,914,431,734,0,316,0,25,1687
36061019800,2370,561,452,1034,1,212,0,10,1809
36061019900,9598,4967,1300,784,28,1927,8,76,4631
36061020000,2855,859,412,1205,4,171,3,24,1996
36061020101,1863,839,219,173,11,523,1,16,1024
36061020102,4077,1173,850,1566,3,196,2,27,2904
36061020300,3874,1427,606,504,19,1097,0,39,2447
36061020500,5023,2991,465,274,4,928,2,60,2032
36061020600,3628,613,870,1801,10,115,0,24,3015
36061020701,3035,1466,302,153,4,910,0,30,1569
36061020800,5255,1001,794,2955,12,186,1,47,4254
36061020901,3665,267,1608,1497,6,168,2,17,3398
36061021000,6748,162,2009,4177,11,145,0,36,6586
36061021100,10529,3340,2853,1736,19,2028,0,155,7189
36061021200,4899,611,909,2893,12,211,0,49,4288
36061021303,5583,1171,1852,1966,3,295,2,61,4412
36061021400,3075,312,427,2036,7,133,4,21,2763
36061021500,3856,434,1032,2083,4,112,0,35,3422
36061021600,8567,2073,1877,3590,15,524,0,97,6494
36061021703,545,202,101,123,6,89,0,6,343
36061021800,6530,1365,1153,3348,16,292,0,63,5165
36061021900,5696,278,3213,1920,25,115,4,37,5418
36061022000,6114,1457,1151,2808,20,257,0,70,4657
36061022102,2382,570,328,1226,0,93,3,23,1812
36061022200,3293,829,566,1522,5,182,4,26,2464
36061022301,7258,1104,5087,534,6,291,2,87,6154
36061022302,3101,432,1747,577,2,246,0,14,2669
36061022400,7346,637,2543,3718,4,163,3,65,6709
36061022500,9895,1498,5891,1800,13,303,3,98,8397
36061022600,4890,803,1055,2600,7,193,6,40,4087
36061022700,5387,1296,1513,2027,14,220,7,57,4091
36061022800,5961,915,1143,3387,10,160,9,53,5046
36061022900,7975,1307,4472,1622,4,261,1,71,6668
36061023000,9111,924,2087,5391,24,233,8,70,8187
36061023100,6273,1397,2062,2156,11,267,4,58,4876
36061023200,8061,396,2561,4646,38,134,4,53,7665
36061023300,6368,1517,2770,1466,17,292,1,46,4851
36061023400,5112,761,1286,2622,18,154,5,32,4351
36061023501,6720,1191,2724,2308,12,157,2,42,5529
36061023502,2206,235,484,1295,4,86,0,13,1971
36061023600,9907,265,1749,7431,37,91,5,44,9642
36061023700,6792,1215,3542,1547,10,185,0,61,5577
36061023802,4791,1512,686,585,108,1574,80,35,3279
36061023803,3625,1425,478,585,1,885,2,43,2200
36061023804,3306,1314,276,67,0,1438,15,49,1992
36061023900,2675,417,1273,790,4,78,0,24,2258
36061024000,1302,170,466,621,2,13,3,3,1132
36061024100,7612,1649,3828,1517,11,295,4,54,5963
36061024200,4448,189,1995,1961,8,136,0,34,4259
36061024301,3993,629,2093,1052,4,84,2,22,3364
36061024302,7237,81,3436,3327,11,177,2,52,7156
36061024500,13385,1678,9641,1249,18,459,3,101,11707
36061024700,6521,1241,4229,612,7,204,1,47,5280
36061024900,1084,158,627,173,1,78,0,9,926
36061025100,2287,240,1640,238,2,103,0,21,2047
36061025300,10081,1584,7341,532,0,368,4,73,8497
36061025500,5697,1805,2370,370,5,896,3,49,3892
36061025700,4270,1348,755,1577,3,251,0,53,2922
36061025900,4029,711,1176,1677,0,215,2,62,3318
36061026100,10733,559,9181,679,5,91,2,89,10174
36061026300,7969,926,6224,429,14,179,6,65,7043
36061026500,6850,2111,3874,316,6,288,0,59,4739
36061026700,2083,1135,835,36,0,27,0,19,948
36061026900,7848,777,6356,454,2,120,1,43,7071
36061027100,7623,2020,4945,215,0,197,1,97,5603
36061027300,6519,4029,1571,229,4,315,4,80,2490
36061027500,3063,2075,480,117,0,209,0,24,988
36061027700,6423,658,5234,306,3,89,0,39,5765
36061027900,10019,2066,7058,381,3,206,8,105,7953
36061028100,3108,2107,520,152,2,151,0,37,1001
36061028300,7740,1466,5211,509,12,315,2,56,6274
36061028500,6794,676,5539,294,11,135,0,44,6118
36061028700,3772,1149,2209,173,8,89,0,28,2623
36061029100,10509,796,8885,482,14,117,2,87,9713
36061029300,8035,604,6838,295,4,103,0,76,7431
36061029500,7039,2362,3762,390,5,242,1,46,4677
36061029700,16,0,6,5,0,0,0,0,16
36061029900,3598,78,2647,763,3,25,0,27,3520
36061030300,3691,1331,1873,176,1,133,4,35,2360
36061030700,3427,1896,946,225,2,155,0,23,1531
36061030900,8594,547,6008,1658,18,130,1,56,8047
36061031100,12,0,8,2,1,0,0,0,12
36061031703,5847,3840,449,107,0,1029,2,31,2007
36061031704,10422,6349,832,161,5,2435,5,77,4073
36061031900,3,0,2,0,0,0,0,0,3
36063020100,3333,2609,109,321,31,71,0,22,724
36063020200,2811,293,228,2016,14,31,3,36,2518
36063020300,2288,1442,129,523,20,24,0,13,846
36063020400,1492,550,127,654,21,10,0,14,942
36063020500,2065,973,142,694,56,35,1,4,1092
36063020600,1276,370,94,653,35,14,1,0,906
36063020700,2650,1279,166,930,49,32,0,29,1371
36063020900,2442,986,149,994,65,34,0,21,1456
36063021000,2778,1674,132,683,43,67,2,13,1104
36063021100,1444,613,139,480,34,47,1,4,831
36063021200,2310,969,203,784,51,96,0,16,1341
36063021300,2224,995,190,707,46,107,0,9,1229
36063021400,2113,1297,135,438,40,19,0,6,816
36063021700,3358,1815,189,896,68,72,0,18,1543
36063022000,3272,2567,128,209,36,87,0,17,705
36063022100,2201,1841,45,86,28,60,1,9,360
36063022200,3549,3012,103,174,38,33,0,15,537
36063022300,2440,2015,81,89,45,79,0,12,425
36063022401,1817,1544,35,79,38,22,1,10,273
36063022500,2808,2266,100,229,28,64,0,3,542
36063022601,2194,1882,62,75,36,5,4,8,312
36063022602,5709,4712,181,325,87,101,0,14,997
36063022702,7035,6587,103,49,5,52,0,11,448
36063022713,3229,2953,66,48,23,45,0,6,276
36063022714,4854,4232,100,180,28,172,0,13,622
36063022715,1865,1699,45,27,10,34,1,5,166
36063022716,3609,3177,85,132,25,71,0,9,432
36063022717,5074,4731,82,45,14,69,0,15,343
36063022803,3499,3281,67,27,17,27,0,6,218
36063022804,3155,2930,68,37,7,9,3,0,225
36063022901,2256,2059,78,21,10,9,0,5,197
36063022902,2892,2673,66,36,27,5,0,6,219
36063023001,2208,1932,90,59,21,18,2,6,276
36063023100,2372,2064,130,32,7,13,0,8,308
36063023200,2849,2516,90,62,20,36,0,11,333
36063023301,2941,2748,72,17,9,19,0,8,193
36063023302,3824,3307,175,100,22,40,0,5,517
36063023401,6903,5772,359,379,19,50,0,23,1131
36063023402,4211,3813,84,134,9,25,0,20,398
36063023404,5174,4423,186,251,19,70,0,11,751
36063023405,4275,3498,279,211,26,46,3,7,777
36063023500,2725,2100,158,237,9,11,0,16,625
36063023600,3803,2841,284,339,16,18,2,9,962
36063023700,2116,1424,133,336,13,16,0,14,692
36063023800,3306,2523,226,282,17,14,0,2,783
36063023901,3923,3282,163,216,15,33,7,15,641
36063023902,5003,4374,176,200,12,35,2,11,629
36063024001,5962,5558,138,67,13,12,0,10,404
36063024002,1729,1568,41,40,9,11,0,0,161
36063024101,3700,3416,77,30,14,11,0,15,284
36063024102,2597,2311,93,10,14,14,1,4,286
36063024201,6609,6124,93,56,44,24,1,25,485
36063024202,2695,2435,129,27,14,3,0,5,260
36063024301,1247,1180,33,2,4,0,0,0,67
36063024302,4600,4198,137,28,41,14,1,14,402
36063024303,5743,5259,107,128,33,22,0,5,484
36063024401,2531,2304,51,16,19,47,0,11,227
36063024404,4775,4415,105,47,22,64,0,13,360
36063024405,5510,5063,128,45,62,43,1,13,447
36063024406,3128,2676,129,134,59,29,2,29,452
36063024501,2741,2532,83,6,11,35,0,13,209
36063024502,3772,3457,83,35,32,20,0,21,315
36063024600,4507,4148,113,39,8,43,2,5,359
36063940001,1145,404,46,0,586,0,3,19,741
36063940100,0,0,0,0,0,0,0,0,0
36063990000,0,0,0,0,0,0,0,0,0
36065020102,1359,767,253,219,9,15,0,8,592
36065020300,1477,634,233,433,1,88,1,9,843
36065020705,2074,1330,233,265,6,94,2,13,744
36065020802,4637,2056,685,1080,12,599,0,25,2581
36065020803,2731,882,606,553,4,561,0,10,1849
36065020900,2171,866,486,465,11,137,1,15,1305
36065021000,1872,729,425,372,1,232,2,15,1143
36065021103,1540,806,290,281,12,60,5,7,734
36065021104,4114,1754,654,983,15,426,3,36,2360
36065021201,2302,491,454,451,4,817,0,12,1811
36065021202,3271,882,419,612,0,1192,1,13,2389
36065021301,1401,1265,48,41,0,21,0,2,136
36065021302,4807,3057,432,460,8,662,2,4,1750
36065021303,3956,2610,499,353,6,300,0,11,1346
36065021401,2664,1461,429,481,7,143,0,7,1203
36065021402,2028,1120,333,313,2,129,0,5,908
36065021500,2768,362,587,769,8,953,2,11,2406
36065021601,5116,4045,335,388,0,102,5,19,1071
36065021602,2438,2188,110,65,2,31,1,0,250
36065021701,3205,2842,115,101,2,58,0,15,363
36065021702,2741,1949,296,245,1,107,0,3,792
36065021900,1694,1281,155,113,4,31,1,5,413
36065022000,3438,2585,327,244,2,24,6,14,853
36065022100,2537,2059,213,91,6,12,0,5,478
36065022200,2648,2361,96,61,0,41,0,10,287
36065022400,3397,2795,206,130,7,94,0,11,602
36065022500,4742,3479,454,364,20,73,0,9,1263
36065022701,2046,1778,76,66,5,50,0,5,268
36065022702,3882,3450,113,105,4,28,0,16,432
36065022800,2690,2444,60,28,12,28,3,8,246
36065023000,5924,5487,129,55,3,27,0,5,437
36065023200,4230,3666,172,98,3,50,1,21,564
36065023300,2657,2248,154,117,7,21,0,6,409
36065023400,4503,3954,213,125,10,49,1,10,549
36065023501,2290,2142,59,1,4,13,0,3,148
36065023502,4338,4096,93,15,0,39,0,11,242
36065023702,3733,3446,89,16,2,23,1,15,287
36065023901,2187,2037,46,12,0,23,0,8,150
36065023902,1796,1684,41,7,0,14,0,1,112
36065024000,4297,4033,61,16,1,24,0,15,264
36065024101,1477,1422,22,1,6,0,0,3,55
36065024102,2842,2679,35,7,9,8,1,0,163
36065024200,4518,4254,52,20,4,25,2,11,264
36065024301,2782,2556,68,36,4,14,3,7,226
36065024302,3389,3150,61,37,3,6,0,2,239
36065024303,2511,2373,32,4,0,15,0,12,138
36065024400,3923,3519,109,142,7,10,0,4,404
36065024500,4787,4440,82,31,7,9,0,7,347
36065024700,5974,5545,80,30,57,40,0,13,429
36065024800,3077,2846,45,11,5,47,0,5,231
36065024900,5241,4861,67,27,41,35,2,16,380
36065025001,3230,2927,96,59,4,55,0,5,303
36065025002,3730,3403,114,26,2,57,1,8,327
36065025003,3115,2469,185,80,2,212,2,10,646
36065025100,1859,1629,89,39,1,43,0,6,230
36065025200,4486,4079,122,55,0,87,5,12,407
36065025300,7149,6200,274,60,10,381,4,17,949
36065025400,5938,5154,187,63,0,342,0,14,784
36065025500,4332,3991,98,28,2,16,5,14,341
36065025601,1966,1839,41,11,0,5,0,12,127
36065025602,2021,1903,19,10,1,7,2,3,118
36065025700,2327,2189,30,8,3,11,0,8,138
36065025800,1507,1290,67,20,3,2,0,17,217
36065025900,1338,484,278,542,25,8,0,0,854
36065026100,2542,2213,103,98,5,21,0,3,329
36065026200,6625,5895,230,140,14,117,2,37,730
36065026300,3692,2687,319,313,15,40,2,26,1005
36065026400,5573,1397,1002,1428,23,1466,1,14,4176
36065026501,755,520,86,108,1,14,0,16,235
36065026502,265,218,13,25,2,3,0,1,47
36065026600,2152,741,435,916,26,22,0,0,1411
36065026700,5260,4974,61,20,23,13,2,8,286
36065980002,12,5,2,0,0,0,0,0,7
36065980003,6,0,1,0,1,0,0,0,6
36065980100,23,11,7,0,1,0,0,0,12
36067000100,1049,814,50,84,6,53,2,10,235
36067000200,3642,1655,321,904,62,437,0,17,1987
36067000300,1565,876,116,263,11,208,1,10,689
36067000400,3720,2306,247,569,20,369,2,13,1414
36067000501,2471,863,251,658,16,495,0,24,1608
36067000600,3664,1154,300,1215,46,684,2,18,2510
36067000700,1892,561,182,602,13,396,1,21,1331
36067000800,2913,1055,306,855,36,446,0,9,1858
36067000900,3120,2212,213,340,4,174,0,15,908
36067001000,4023,2088,382,1040,35,130,0,40,1935
36067001400,3225,708,200,1065,31,1031,0,11,2517
36067001500,2781,836,221,979,24,499,0,8,1945
36067001600,3270,1740,309,906,19,118,6,25,1530
36067001701,2460,1184,336,545,43,117,3,9,1276
36067001702,2572,1498,255,525,21,77,0,20,1074
36067001800,2713,1804,205,373,25,107,0,17,909
36067001900,3824,2691,243,518,24,87,0,28,1133
36067002000,2171,1293,272,357,27,10,0,10,878
36067002101,2789,1370,378,624,63,36,2,16,1419
36067002300,1665,627,141,572,16,153,1,19,1038
36067002400,1837,693,316,522,26,141,0,13,1144
36067002700,1819,1276,144,253,18,17,0,4,543
36067002901,2628,2070,192,183,26,26,0,1,558
36067003000,2137,486,768,746,16,12,0,7,1651
36067003200,3465,1747,274,704,11,568,0,31,1718
36067003400,2673,1174,233,622,5,533,0,15,1499
36067003500,2452,816,423,895,13,184,0,24,1636
36067003601,2312,488,404,1199,24,34,1,25,1824
36067003602,2132,541,282,1100,9,57,0,10,1591
36067003800,2377,640,613,837,25,12,0,19,1737
36067003900,3192,663,860,1326,43,10,1,27,2529
36067004000,1341,268,435,498,17,16,0,6,1073
36067004200,2226,162,531,1393,9,8,0,25,2064
36067004301,1911,855,297,620,1,66,0,18,1056
36067004302,7606,4945,785,797,2,777,2,17,2661
36067004401,3508,2517,224,222,5,363,0,16,991
36067004500,2795,1688,210,302,5,448,3,26,1107
36067004600,5150,3590,274,876,5,144,1,27,1560
36067004800,1351,1093,54,124,7,8,1,13,258
36067004900,1554,785,213,354,19,32,2,14,769
36067005000,2617,1608,238,552,12,33,0,20,1009
36067005100,2287,421,367,1315,33,1,0,12,1866
36067005200,1930,142,239,1387,5,4,1,21,1788
36067005300,1866,295,178,1277,7,13,0,9,1571
36067005400,2403,219,200,1818,16,2,0,13,2184
36067005500,4754,1970,309,1669,18,478,20,30,2784
36067005601,1539,1091,61,185,3,103,0,17,448
36067005602,2869,2000,244,335,0,143,2,10,869
36067005700,1941,576,181,1020,23,5,0,7,1365
36067005800,2121,238,185,1572,17,7,0,1,1883
36067005900,1669,201,213,1138,14,5,1,22,1468
36067006000,3667,1426,336,1514,72,14,2,15,2241
36067006101,4451,1720,184,2188,58,16,0,25,2731
36067006102,1984,876,113,484,17,408,0,9,1108
36067006103,2533,1594,118,550,47,30,0,8,939
36067010100,2854,2612,72,35,18,22,0,4,242
36067010200,6086,5392,167,76,16,74,0,24,694
36067010301,5233,4598,140,124,24,104,3,20,635
36067010321,2901,2543,63,59,17,79,0,9,358
36067010322,3722,3260,108,57,12,87,0,9,462
36067010400,4028,3595,76,87,19,49,0,13,433
36067010500,2400,2135,52,75,0,33,0,0,265
36067010600,2170,1869,93,67,8,35,0,12,301
36067010700,2041,1710,77,50,23,36,0,11,331
36067010800,4703,3978,237,122,22,52,0,11,725
36067010900,2331,2097,61,24,11,41,0,5,234
36067011011,3445,2893,88,98,15,238,0,24,552
36067011012,4157,3086,156,324,14,357,1,23,1071
36067011021,2821,2362,114,136,6,68,0,12,459
36067011022,3081,2620,113,104,10,71,0,23,461
36067011101,5914,4809,219,362,17,195,1,16,1105
36067011102,3906,2522,301,632,22,136,1,25,1384
36067011201,3775,3149,146,164,16,49,0,24,626
36067011202,4670,3991,166,159,8,172,0,17,679
36067011231,4650,3877,183,226,9,113,1,35,773
36067011232,4322,3635,144,171,7,129,1,4,687
36067011241,2586,2236,61,73,17,86,1,6,350
36067011242,6014,4893,215,321,15,268,0,15,1121
36067011300,4152,3577,120,120,6,158,0,7,575
36067011401,7253,6508,232,121,14,100,7,21,745
36067011402,4160,3832,88,18,9,18,2,13,328
36067011500,6573,5828,189,146,12,83,0,25,745
36067011600,5088,4581,182,58,14,61,0,14,507
36067011700,4199,3735,134,45,16,76,0,18,464
36067011800,6165,5407,187,129,43,47,4,13,758
36067011900,4003,3618,99,40,14,43,0,1,385
36067012000,5476,5009,149,19,16,27,1,15,467
36067012100,5202,4791,124,53,22,54,0,9,411
36067012200,1188,1041,47,31,5,7,1,10,147
36067012300,3431,3111,112,39,2,61,0,10,320
36067012400,4379,3828,145,116,12,79,5,1,551
36067012500,3749,3049,157,207,16,109,0,4,700
36067012600,5334,4753,128,153,28,88,0,7,581
36067012700,2036,1796,77,40,13,17,2,5,240
36067012800,2872,2623,62,37,12,10,0,0,249
36067012900,2508,1854,212,169,52,11,1,14,654
36067013000,4137,3430,261,155,32,50,1,16,707
36067013100,4598,4163,143,74,13,42,0,22,435
36067013200,3004,2699,76,87,15,31,0,0,305
36067013300,2256,2014,77,64,11,13,1,8,242
36067013400,5482,4699,178,185,13,175,4,11,783
36067013500,4876,4060,137,170,9,341,0,9,816
36067013600,3222,2458,177,195,17,199,0,5,764
36067013701,4510,3481,222,247,32,254,0,20,1029
36067013800,2169,1907,56,23,6,60,0,2,262
36067013900,2741,2200,135,106,21,89,0,5,541
36067014000,3642,2717,218,260,26,170,2,8,925
36067014200,4315,3108,231,354,28,316,0,10,1207
36067014300,3078,2373,158,225,34,40,0,20,705
36067014400,2428,1933,114,151,7,90,0,6,495
36067014500,3974,3270,135,142,19,225,0,16,704
36067014600,5212,3516,359,755,12,257,4,23,1696
36067014700,6123,4846,149,301,7,566,0,21,1277
36067014800,3282,2763,104,78,12,187,0,2,519
36067014900,1977,1541,50,145,26,97,0,1,436
36067015000,4604,4002,113,45,10,219,0,16,602
36067015100,5913,5097,135,155,27,298,0,10,816
36067015201,3339,2727,127,116,9,233,0,17,612
36067015202,4724,3716,162,77,20,568,0,13,1008
36067015203,2763,2261,86,54,1,251,0,5,502
36067015400,5952,5317,177,86,32,77,0,23,635
36067015500,2780,2550,51,30,6,65,0,5,230
36067015601,2074,1902,44,23,10,12,0,3,172
36067015602,1563,1326,58,27,1,67,0,10,237
36067015701,2345,2147,67,9,3,14,0,14,198
36067015702,4735,3990,116,55,6,337,0,31,745
36067015800,4910,4441,88,38,92,30,0,15,469
36067016001,3373,3057,77,46,26,19,2,1,316
36067016002,2820,2618,52,13,17,22,0,3,202
36067016100,2478,1733,72,98,8,436,0,10,745
36067016200,2132,1470,101,247,98,20,0,11,662
36067016300,8108,6653,308,563,76,157,2,24,1455
36067016400,4026,3346,155,288,18,44,0,20,680
36067016501,1782,1667,33,2,5,8,0,1,115
36067016502,4284,4013,68,25,4,28,0,11,271
36067016600,4656,4334,86,5,9,45,0,16,322
36067016700,2456,2281,78,3,0,22,0,5,175
36067016801,1588,1506,18,0,2,10,0,1,82
36067016802,2368,2177,44,4,16,6,0,8,191
36067016901,2676,2473,52,17,7,33,0,5,203
36067016902,2006,1846,46,8,18,8,1,5,160
36067940000,831,450,56,1,277,0,0,41,381
36069050101,3298,2936,117,29,3,128,0,13,362
36069050103,3289,2896,116,37,5,81,0,20,393
36069050104,4206,3741,116,40,2,162,1,7,465
36069050105,3426,3100,102,37,5,42,0,13,326
36069050106,1641,1507,41,10,7,14,0,0,134
36069050203,4357,3315,547,157,14,59,1,34,1042
36069050204,3168,2934,74,30,5,20,0,7,234
36069050205,4886,4128,283,131,3,77,1,17,758
36069050206,1759,1479,104,56,7,40,0,9,280
36069050302,4045,3696,132,26,16,21,1,9,349
36069050303,2839,2454,186,52,2,12,0,5,385
36069050304,2520,2249,125,13,8,8,2,0,271
36069050401,3294,3003,124,31,2,16,0,0,291
36069050402,3343,3062,128,18,3,8,2,24,281
36069050501,3640,3327,72,30,18,22,0,15,313
36069050502,2740,2515,102,0,6,6,2,10,225
36069050601,5774,5387,105,32,7,67,0,20,387
36069050603,2790,2457,98,37,8,57,0,5,333
36069050604,2545,2238,97,62,4,17,0,7,307
36069050800,3074,2726,78,70,9,21,0,21,348
36069050900,2362,2092,86,54,1,44,1,6,270
36069051001,1844,1628,71,27,5,13,2,6,216
36069051101,1793,1493,68,62,9,6,0,4,300
36069051102,1503,1347,51,23,2,18,4,16,156
36069051200,3931,3465,129,110,5,20,0,12,466
36069051301,1584,1476,46,5,1,3,0,8,108
36069051302,2522,2346,32,21,2,9,0,23,176
36069051400,2644,2439,101,13,0,8,0,5,205
36069051501,1968,1739,111,29,1,27,0,2,229
36069051502,1496,1008,250,127,4,28,0,12,488
36069051600,1670,1401,123,43,0,19,4,13,269
36069051700,2556,1318,734,333,0,18,1,12,1238
36069051801,5407,3449,1094,467,5,87,0,23,1958
36069051900,3188,2482,268,179,3,123,0,7,706
36069052001,1668,1546,44,6,9,1,0,5,122
36069052002,1691,1577,28,12,2,8,0,7,114
36069052003,1669,1570,24,4,2,14,0,3,99
36069052101,1641,1546,21,13,0,10,0,5,95
36069052102,2284,2103,40,9,5,12,1,13,181
36069052200,2403,2222,45,4,7,28,0,0,181
36071000100,3137,1143,947,852,5,54,2,29,1994
36071000200,2638,712,1262,510,9,35,0,26,1926
36071000301,2136,125,1412,503,2,25,0,17,2011
36071000302,4327,685,2826,639,4,35,0,15,3642
36071000400,5086,769,1838,2230,12,30,1,36,4317
36071000501,3310,359,2193,628,5,30,1,23,2951
36071000502,4208,401,2601,1004,14,12,0,31,3807
36071000600,4014,639,2006,1179,4,25,4,21,3375
36071001100,4775,1101,2537,770,9,142,0,49,3674
36071001200,2564,406,1619,378,7,54,0,26,2158
36071001300,3377,1320,1020,590,10,268,1,44,2057
36071001500,5514,1462,2433,1190,5,177,1,39,4052
36071001601,5294,1423,1636,1711,21,274,0,47,3871
36071001602,2762,1033,1117,452,4,49,0,17,1729
36071002100,3255,2283,487,241,2,38,1,33,972
36071002200,3401,2127,499,349,20,112,0,53,1274
36071002300,2119,1433,325,137,11,31,0,43,686
36071010101,4880,3204,1006,402,3,73,0,31,1676
36071010102,5690,3340,1221,709,9,142,0,67,2350
36071010200,5042,3100,935,520,6,240,1,24,1942
36071010300,3554,1986,841,436,1,124,2,16,1568
36071010400,4208,2345,1051,509,18,90,0,41,1863
36071010501,3520,2023,870,405,13,76,0,17,1497
36071010502,5091,2412,1142,1114,5,184,0,46,2679
36071010601,3500,2763,372,154,4,62,0,24,737
36071010602,3772,2768,621,109,7,80,0,19,1004
36071010701,2570,1441,619,321,9,44,2,20,1129
36071010702,4248,2668,977,276,7,75,2,27,1580
36071010801,3979,2281,953,486,5,55,0,32,1698
36071010802,5297,3897,797,317,5,74,1,19,1400
36071010901,3458,2642,525,101,2,52,1,7,816
36071010902,5672,4205,845,245,9,86,0,52,1467
36071011000,5114,3351,913,453,22,125,0,56,1763
36071011101,3094,1130,904,728,11,141,1,42,1964
36071011102,4659,1854,1424,938,16,225,0,32,2805
36071011200,5236,1727,1675,1351,6,246,5,29,3509
36071011301,4695,1652,1590,1017,16,219,2,58,3043
36071011302,3452,1107,1136,868,9,174,0,34,2345
36071011400,4170,2631,809,354,21,154,0,46,1539
36071011500,6537,4079,1143,756,17,298,0,58,2458
36071011601,3927,3025,334,86,10,268,3,12,902
36071011602,3582,2826,323,125,12,60,0,30,756
36071011701,4689,3652,626,144,7,54,0,46,1037
36071011702,4621,3657,618,127,5,45,0,32,964
36071011801,4802,3186,990,343,2,99,0,37,1616
36071011802,2732,2086,345,108,4,91,0,12,646
36071011900,6581,4263,1426,463,24,218,0,24,2318
36071012100,3844,2318,1068,242,2,96,0,31,1526
36071012200,4146,3023,639,183,3,159,1,11,1123
36071012300,5415,4040,776,175,4,202,0,35,1375
36071012601,4184,1983,1065,805,1,118,2,35,2201
36071012602,3368,1259,1139,695,9,158,0,18,2109
36071012700,4012,1986,1226,521,4,92,0,26,2026
36071012800,4975,2820,1267,604,8,128,2,23,2155
36071012900,3190,2561,314,79,5,59,0,19,629
36071013000,4578,3236,735,196,5,190,0,30,1342
36071013100,5116,3964,615,139,7,159,3,47,1152
36071013201,4975,3009,1246,416,17,120,0,14,1966
36071013202,2354,1367,527,274,9,47,2,15,987
36071013301,4609,2922,1078,231,35,105,0,56,1687
36071013302,2827,1923,512,166,0,88,0,34,904
36071013400,4046,2760,550,300,12,41,2,263,1286
36071013500,6337,3651,1397,554,8,361,0,181,2686
36071013600,7306,5005,772,730,42,434,28,16,2301
36071013700,2640,1155,774,453,10,85,0,18,1485
36071013800,2993,2075,520,150,7,79,0,32,918
36071013900,5189,3164,1061,285,2,331,0,212,2025
36071014101,4849,2361,1729,331,0,229,0,57,2488
36071014102,5819,2685,1736,685,3,465,3,50,3134
36071014201,4059,2601,829,275,6,182,1,39,1458
36071014202,6801,4493,1206,402,3,412,0,59,2308
36071014301,5229,2958,1154,633,10,230,2,42,2271
36071014302,7417,5107,1292,425,5,268,0,63,2310
36071014400,4703,3389,755,267,8,110,3,20,1314
36071014501,4349,3406,597,86,5,65,0,30,943
36071014502,5624,4572,564,156,7,84,0,45,1052
36071014601,3694,3099,399,49,2,45,0,14,595
36071014602,3066,2345,433,105,10,60,0,13,721
36071014700,3711,2440,668,372,7,69,0,28,1271
36071014801,3842,2902,519,159,10,141,0,22,940
36071014802,3038,2260,494,74,7,48,0,27,778
36071014900,3811,2831,466,182,0,191,0,26,980
36071015003,8363,5875,209,21,0,1,7,2075,2488
36071015005,7452,5020,110,4,9,11,0,2111,2432
36071015007,5319,3751,29,12,3,0,0,1439,1568
36071015008,4517,3322,72,5,0,1,3,1051,1195
36071015009,2722,2034,39,9,1,2,1,592,688
36071015010,5111,3506,47,6,4,0,1,1419,1605
36071015100,6125,1503,2922,1213,17,171,1,53,4622
36071015201,4549,3124,777,333,7,82,2,46,1425
36071015202,4981,2399,1239,721,7,425,2,28,2582
36071015203,1766,922,389,290,4,56,7,8,844
36073040200,3107,2868,92,24,11,11,0,12,239
36073040300,2297,2064,68,49,10,7,0,6,233
36073040400,3491,2836,184,180,16,32,0,8,655
36073040500,2610,2084,164,178,7,13,4,18,526
36073040601,1764,1602,43,24,9,0,0,2,162
36073040602,1472,612,234,604,15,3,0,0,860
36073040603,3616,3166,177,75,13,8,0,18,450
36073040701,2664,1949,231,288,2,22,1,4,715
36073040702,3192,2486,183,248,18,7,5,9,706
36073040801,3315,3029,73,30,15,7,1,18,286
36073040802,4796,4156,295,45,12,25,1,17,640
36073401200,3455,3151,96,31,26,12,0,8,304
36073401300,4564,4034,247,64,23,7,0,21,530
36073990000,0,0,0,0,0,0,0,0,0
36075020101,2165,2036,19,10,7,10,0,2,129
36075020102,1221,1121,24,3,4,0,0,17,100
36075020201,2510,2355,38,10,10,7,0,6,155
36075020202,1303,1205,14,10,3,11,0,0,98
36075020301,2186,2016,42,7,10,36,2,4,170
36075020303,1779,1689,22,0,4,6,0,6,90
36075020304,1672,1569,28,4,2,7,0,1,103
36075020400,5259,4875,78,35,18,21,0,10,384
36075020501,1930,1776,27,6,10,5,0,1,154
36075020502,2581,2416,38,9,17,3,0,10,165
36075020503,1141,1059,16,7,14,1,0,0,82
36075020600,4778,4408,73,15,12,15,0,19,370
36075020703,5013,4682,80,14,22,8,0,9,331
36075020704,1874,1771,20,11,0,12,0,2,103
36075020705,2214,2074,23,6,12,6,1,14,140
36075020706,2434,2248,37,12,8,9,0,6,186
36075020707,1895,1752,21,10,10,3,0,9,143
36075020800,3470,3181,51,21,12,11,0,5,289
36075020901,2226,1985,73,10,0,10,0,2,241
36075020903,2465,2290,24,9,9,5,2,0,175
36075020904,2174,2004,27,11,12,10,0,2,170
36075020905,1104,988,16,0,2,7,0,0,116
36075021001,2544,2348,57,10,7,7,0,5,196
36075021002,2028,1859,47,3,4,5,0,7,169
36075021003,1099,1043,17,2,1,4,0,0,56
36075021101,3652,3148,215,20,26,19,5,6,504
36075021102,2135,1787,120,25,19,17,1,4,348
36075021103,2941,2654,94,35,10,16,0,1,287
36075021104,2661,2382,95,44,13,9,0,12,279
36075021201,1257,1119,41,0,3,0,0,11,138
36075021202,2469,2223,81,22,9,5,0,15,246
36075021203,2794,2550,50,25,17,12,1,6,244
36075021300,4525,4159,106,17,22,13,4,4,366
36075021401,7914,6261,613,507,38,237,0,14,1653
36075021402,1643,1497,38,5,4,10,0,9,146
36075021501,2931,2699,56,15,10,17,0,14,232
36075021503,2398,2225,56,12,8,9,2,1,173
36075021504,2635,2417,65,12,10,8,1,3,218
36075021505,1584,1364,52,35,11,31,0,9,220
36075021601,2441,2059,147,82,4,35,0,12,382
36075021602,2821,2396,188,78,8,50,0,9,425
36075021603,3803,3362,151,44,7,45,0,18,441
36075021604,4375,3693,292,109,14,94,0,15,682
36075021605,3481,2965,244,48,14,24,0,2,516
36075990000,0,0,0,0,0,0,0,0,0
36077590101,2575,2400,42,14,0,13,0,7,175
36077590102,1882,1699,36,7,0,68,0,0,183
36077590201,1952,1748,59,9,0,26,0,9,204
36077590202,3641,3214,133,47,1,112,0,12,427
36077590301,2065,1910,39,13,9,12,0,3,155
36077590302,1767,1665,28,13,3,7,1,4,102
36077590401,1907,1795,39,12,0,5,1,1,112
36077590402,3441,3220,79,9,3,5,0,6,221
36077590500,2827,2554,81,54,6,21,2,3,273
36077590600,1868,1740,37,5,4,5,0,6,128
36077590701,1760,1629,45,21,1,3,0,0,131
36077590702,2112,1894,99,8,1,10,0,8,218
36077590800,5065,4260,261,220,11,92,2,18,805
36077590900,2266,1773,154,112,2,100,0,11,493
36077591000,3584,2882,263,136,7,112,0,13,702
36077591100,2514,2001,177,129,4,44,1,15,513
36077591401,2756,2448,96,18,9,24,0,10,308
36077591402,2311,2046,76,22,4,15,0,26,265
36077591500,3400,3122,86,18,1,19,0,12,278
36077591601,1811,1657,34,12,7,8,0,1,154
36077591602,2305,2152,62,15,1,8,0,0,153
36077591700,4715,3681,466,295,35,104,0,15,1034
36079010100,3602,2349,886,128,7,76,1,19,1253
36079010201,4312,3237,700,141,6,80,1,22,1075
36079010202,3627,2286,971,178,0,97,0,17,1341
36079010300,4716,3095,1228,156,8,78,0,22,1621
36079010400,3277,2174,815,88,2,76,0,19,1103
36079010500,4907,3694,775,115,8,116,0,41,1213
36079010600,3738,3168,287,46,0,64,0,17,570
36079010700,2610,2223,191,9,5,66,0,8,387
36079010800,3483,2696,438,95,2,78,1,27,787
36079010901,3591,2467,756,118,8,75,0,40,1124
36079010902,4175,3180,632,101,2,77,0,15,995
36079011000,3996,3212,464,73,0,99,5,16,784
36079011100,5113,3853,825,169,1,104,0,16,1260
36079011201,2549,2023,340,58,1,41,0,9,526
36079011202,4056,3077,755,48,3,81,0,33,979
36079011300,4121,3193,631,99,1,70,0,23,928
36079011400,5157,4097,751,65,2,117,0,23,1060
36079011501,3978,2815,775,163,9,100,0,30,1163
36079011502,2960,2197,492,65,1,93,0,6,763
36079011600,5642,4576,732,85,2,92,0,39,1066
36079011700,4834,3852,665,91,2,102,3,22,982
36079011801,3742,1488,1923,101,5,114,0,28,2254
36079011802,4259,3075,909,86,5,80,0,16,1184
36079011900,5223,3915,819,147,0,170,1,53,1308
36081000101,4659,2292,671,176,1,1224,0,52,2367
36081000102,7484,4156,730,235,1,1832,1,185,3328
36081000103,33,9,0,2,0,18,1,0,24
36081000104,27,1,13,7,0,1,0,1,26
36081000200,3084,367,1830,118,4,607,1,76,2717
36081000400,4918,225,3301,263,35,795,7,160,4693
36081000600,4177,302,2591,246,22,671,7,194,3875
36081000701,3460,1739,508,66,1,896,2,55,1721
36081000702,4260,1963,816,186,7,1056,2,36,2297
36081000800,3580,336,2169,167,9,670,4,110,3244
36081001000,3789,320,2382,128,5,812,3,77,3469
36081001200,4183,674,2353,149,19,849,0,81,3509
36081001400,4114,611,2507,144,10,714,0,69,3503
36081001600,3041,316,1871,94,4,666,0,43,2725
36081001800,3044,310,1792,124,6,641,0,81,2734
36081001901,1434,649,163,49,1,467,2,11,785
36081001902,8645,2716,792,337,2,4358,2,107,5929
36081001903,2214,821,188,52,0,1075,1,14,1393
36081002000,1871,196,1027,62,11,468,0,29,1675
36081002200,2290,322,1448,122,5,315,0,33,1968
36081002400,2195,240,1342,143,5,353,0,50,1955
36081002500,7242,178,2945,3128,23,673,0,57,7064
36081002600,2150,363,1030,208,9,383,4,94,1787
36081002800,3304,304,1906,210,43,484,1,222,3000
36081003000,1479,200,778,54,15,299,0,79,1279
36081003100,2157,741,638,174,6,457,4,46,1416
36081003200,1791,171,1018,127,21,273,0,69,1620
36081003301,4399,1650,547,246,1,1707,4,35,2749
36081003302,2166,414,652,186,3,792,0,31,1752
36081003400,2442,196,1227,172,25,630,0,105,2246
36081003600,4195,277,1858,217,40,1519,1,154,3918
36081003700,2,1,1,0,0,0,0,0,1
36081003800,2490,265,1338,114,13,500,0,93,2225
36081003900,1462,376,778,45,5,190,0,21,1086
36081004001,2403,475,1051,140,13,487,0,137,1928
36081004002,1361,118,472,73,12,514,0,61,1243
36081004200,4505,277,1384,228,33,2254,0,166,4228
36081004300,2326,107,1026,945,4,141,1,26,2219
36081004401,3916,270,948,166,20,2180,0,158,3646
36081004500,3252,1681,670,141,3,611,0,34,1571
36081004700,4090,899,1335,1099,8,541,0,42,3191
36081005000,0,0,0,0,0,0,0,0,0
36081005100,2512,750,530,49,8,1040,0,37,1762
36081005200,3080,223,1024,221,32,1281,0,163,2857
36081005300,5397,2689,979,68,7,1243,5,124,2708
36081005400,5609,887,2134,433,102,1510,0,335,4722
36081005500,1367,380,459,32,3,402,1,25,987
36081005700,4277,1790,1288,65,5,909,0,59,2487
36081005800,6194,1398,2705,539,12,1238,4,137,4796
36081005900,4231,2334,918,94,2,637,3,39,1897
36081006100,6291,3446,1301,91,2,1083,0,97,2845
36081006201,5389,3011,1633,299,8,263,0,56,2378
36081006202,6949,2777,2873,384,9,608,6,80,4172
36081006300,5877,3405,1255,103,4,753,0,79,2472
36081006501,3645,1983,843,79,3,512,1,73,1662
36081006502,4004,2295,930,50,1,545,0,36,1709
36081006900,5196,2357,1584,98,7,897,0,66,2839
36081007100,4355,2276,939,109,7,733,0,67,2079
36081007300,4470,2535,886,92,6,726,8,37,1935
36081007500,4477,2196,992,90,3,944,2,62,2281
36081007700,2114,917,523,74,5,433,0,66,1197
36081007900,3628,1403,1064,95,10,846,2,97,2225
36081008100,1761,810,471,74,1,294,1,27,951
36081008300,3515,1191,1326,371,15,425,2,36,2324
36081008500,1979,456,676,474,10,245,7,41,1523
36081008600,2989,766,1284,143,10,468,0,188,2223
36081008700,5176,580,2078,1958,30,274,0,67,4596
36081008800,3449,1114,1501,246,11,364,0,110,2335
36081009100,2733,1385,738,87,0,363,3,24,1348
36081009400,2919,160,650,508,97,768,0,436,2759
36081009500,2510,1623,432,49,0,271,0,36,887
36081009600,3127,191,579,488,102,887,3,541,2936
36081009700,3860,2704,549,51,4,317,0,39,1156
36081009800,2631,172,365,290,127,830,0,416,2459
36081009900,0,0,0,0,0,0,0,0,0
36081010000,3383,262,786,375,121,985,14,522,3121
36081010100,2654,1870,409,39,5,183,0,41,784
36081010200,2866,238,497,351,61,980,13,313,2628
36081010300,4150,2521,721,82,0,623,1,36,1629
36081010400,3315,234,525,370,119,1144,0,557,3081
36081010500,4641,2212,1348,232,6,626,4,49,2429
36081010600,3417,174,532,363,60,1373,17,487,3243
36081010701,7,1,6,0,0,0,0,0,6
36081010800,3034,113,609,328,83,1238,4,410,2921
36081011000,3190,145,830,282,157,1025,8,501,3045
36081011100,2902,1797,595,37,0,343,0,29,1105
36081011200,2497,290,781,146,49,772,4,246,2207
36081011300,4280,2438,992,77,0,566,0,55,1842
36081011400,1539,194,706,117,16,322,4,100,1345
36081011500,2414,1442,504,45,2,270,0,22,972
36081011600,2370,216,816,149,37,617,1,237,2154
36081011700,3840,2574,602,57,0,423,1,47,1266
36081011800,2690,174,839,128,58,1073,6,244,2516
36081011900,1729,1102,367,27,3,137,0,21,627
36081012000,2385,115,502,104,18,1357,1,170,2270
36081012100,2177,1476,344,19,4,224,0,19,701
36081012200,2802,185,1026,206,38,976,0,180,2617
36081012301,3272,2220,598,73,3,221,1,51,1052
36081012400,2873,202,1228,223,29,750,2,251,2671
36081012500,1735,934,422,37,0,241,2,22,801
36081012601,2596,216,1365,202,70,444,1,175,2380
36081012602,2715,219,1513,174,37,488,0,183,2496
36081012800,2212,610,982,101,39,283,0,86,1602
36081013000,1757,571,674,83,16,303,4,32,1186
36081013200,1919,643,674,136,0,347,6,38,1276
36081013400,5904,2711,1548,536,6,733,3,64,3193
36081013500,1526,1206,198,13,0,67,1,13,320
36081013600,1994,896,555,147,9,274,0,41,1098
36081013700,1747,1160,333,54,0,125,0,25,587
36081013800,3785,1154,1197,217,7,982,0,91,2631
36081014000,3952,1558,1091,271,13,713,0,112,2394
36081014100,1645,938,410,26,0,169,1,11,707
36081014201,4702,187,1978,556,55,1327,5,327,4515
36081014202,2870,145,1309,259,16,753,10,216,2725
36081014300,4007,2107,1002,77,6,574,4,65,1900
36081014400,2005,120,738,120,5,789,5,114,1885
36081014500,2368,1440,499,34,0,236,0,43,928
36081014700,2933,1764,648,60,1,258,1,53,1169
36081014800,2186,73,475,189,47,912,5,338,2113
36081014900,2477,1253,765,23,2,272,0,41,1224
36081015000,2418,82,529,236,74,990,0,234,2336
36081015100,2675,1455,646,51,2,335,1,58,1220
36081015200,2638,101,653,342,126,809,2,405,2537
36081015300,2131,1138,413,54,1,371,0,40,993
36081015400,2390,103,421,232,82,946,3,337,2287
36081015500,2344,1261,546,32,2,371,0,43,1083
36081015600,3210,64,457,464,75,1298,14,394,3146
36081015700,1655,599,523,39,1,401,0,37,1056
36081015801,3817,58,614,937,135,1015,8,619,3759
36081015802,4607,107,600,733,100,1183,4,1217,4500
36081015900,4010,2102,939,95,4,575,0,91,1908
36081016100,2291,725,898,32,4,466,0,48,1566
36081016300,4053,590,1664,1090,5,485,1,52,3463
36081016400,3306,54,344,739,89,797,2,719,3252
36081016600,3400,92,595,594,97,846,0,587,3308
36081016800,2764,81,631,493,115,597,10,492,2683
36081016900,5577,2567,1398,74,0,1304,5,29,3010
36081017000,2504,68,326,703,117,485,3,438,2436
36081017101,36,8,11,9,0,3,0,0,28
36081017102,27,1,9,7,0,6,0,0,26
36081017200,2224,26,278,663,73,390,0,479,2198
36081017400,2423,38,468,754,110,419,4,353,2385
36081017600,2181,54,331,750,63,476,4,266,2127
36081017800,2084,26,310,677,71,417,1,300,2058
36081017901,986,317,351,15,1,253,1,17,669
36081017902,124,26,26,67,0,1,0,1,98
36081018000,1365,96,231,398,28,316,4,132,1269
36081018101,3836,1310,1382,59,1,947,2,30,2526
36081018102,3800,1827,817,66,3,925,1,32,1973
36081018200,2540,63,467,1220,29,325,10,211,2477
36081018300,6044,2437,1850,101,5,1412,0,37,3607
36081018401,2174,13,246,1397,28,154,14,124,2161
36081018402,2412,18,277,1392,54,262,7,159,2394
36081018501,3502,1340,1068,85,2,828,1,47,2162
36081018502,3453,1361,1027,71,3,827,0,44,2092
36081018600,1802,48,243,789,50,223,4,184,1754
36081018700,3611,943,1286,300,12,901,4,62,2668
36081018800,1510,17,232,765,63,172,4,145,1493
36081018900,3457,947,1181,121,3,1063,12,37,2510
36081019000,2445,56,282,1343,39,231,1,245,2389
36081019200,2359,42,361,1224,118,298,4,166,2317
36081019400,3015,35,493,1453,97,431,1,273,2980
36081019600,3122,31,600,1460,84,409,2,274,3091
36081019800,3682,33,803,1387,75,892,4,276,3649
36081019901,1088,125,475,376,8,68,3,17,963
36081019902,317,38,93,169,3,0,5,2,279
36081019903,0,0,0,0,0,0,0,0,0
36081020200,1693,40,307,587,58,383,3,176,1653
36081020400,2278,51,609,716,38,623,0,118,2227
36081020500,1184,185,732,21,1,210,2,17,999
36081020600,2046,114,883,332,36,433,2,123,1932
36081020800,3513,279,1269,1115,52,472,1,120,3234
36081021200,2812,134,1693,254,14,426,2,135,2678
36081021400,6673,677,2130,725,45,2594,3,230,5996
36081021601,2678,1008,599,302,4,592,0,56,1670
36081021602,1506,145,705,205,7,308,4,87,1361
36081021603,0,0,0,0,0,0,0,0,0
36081021900,31,10,9,5,0,2,0,0,21
36081022001,6551,1662,1984,1136,16,1430,4,95,4889
36081022002,6010,1831,1422,661,16,1711,0,126,4179
36081022900,0,0,0,0,0,0,0,0,0
36081023000,1880,406,437,102,18,771,0,54,1474
36081023200,5264,774,1550,567,34,1926,7,142,4490
36081023501,4403,366,2495,34,7,1408,1,47,4037
36081023502,3373,442,1675,29,4,1129,0,39,2931
36081023600,3266,185,923,490,10,1475,0,87,3081
36081023800,4863,85,1828,627,38,1973,6,179,4778
36081024000,6252,189,2782,1098,46,1642,3,257,6063
36081024300,6231,1062,2429,47,8,2558,2,44,5169
36081024500,5544,1717,1783,170,1,1686,1,46,3827
36081024600,1,1,0,0,0,0,0,0,0
36081024700,1537,178,514,21,3,780,1,13,1359
36081024900,5724,1146,1418,107,2,2869,0,67,4578
36081025100,5818,1596,1966,146,0,1936,5,52,4222
36081025301,4510,1488,1704,81,2,1044,4,39,3022
36081025302,3013,676,1397,47,0,803,1,27,2337
36081025401,3899,29,662,1927,30,934,0,117,3870
36081025402,6180,129,1234,3283,20,1010,3,185,6051
36081025500,1603,363,545,20,0,630,0,4,1240
36081025700,1648,258,562,18,1,761,0,9,1390
36081025800,2289,11,379,1195,9,476,1,93,2278
36081025900,3542,449,1285,59,4,1655,0,30,3093
36081026000,2915,36,637,1557,18,471,0,82,2879
36081026100,7802,522,2845,101,9,4189,0,34,7280
36081026200,1652,8,276,960,12,204,1,56,1644
36081026300,6631,543,2216,75,1,3673,1,45,6088
36081026400,2736,21,456,1741,34,246,4,67,2715
36081026501,3213,234,680,38,13,2167,0,19,2979
36081026502,1622,84,448,16,0,1034,2,10,1538
36081026600,1949,25,219,1353,6,194,1,31,1924
36081026700,6196,279,2369,57,17,3321,1,69,5917
36081026901,5210,182,3083,39,0,1798,0,46,5028
36081026902,4244,181,1571,33,3,2378,0,25,4063
36081027000,1960,26,322,1174,20,177,2,110,1934
36081027101,5454,207,1861,56,3,3231,2,23,5247
36081027102,3112,188,2263,27,2,596,0,15,2924
36081027200,2065,34,283,1259,28,195,5,105,2031
36081027301,3673,75,3175,18,4,342,0,51,3598
36081027302,4765,211,3515,139,14,786,0,51,4554
36081027400,1927,10,273,1247,24,184,13,75,1917
36081027500,6773,539,4895,92,9,1080,0,65,6234
36081027600,1365,9,320,781,2,81,2,94,1356
36081027701,3448,195,2615,29,4,534,0,38,3253
36081027702,5196,587,3219,123,11,1104,5,72,4609
36081027800,2529,39,462,1774,14,82,1,51,2490
36081027900,6358,973,3941,106,14,1125,3,86,5385
36081028000,1901,5,249,1353,6,97,1,80,1896
36081028100,5991,1391,3256,114,3,1037,5,29,4600
36081028200,1801,24,194,1301,7,95,0,45,1777
36081028300,7523,1528,3889,116,4,1759,1,67,5995
36081028400,3766,46,353,2855,39,149,5,66,3720
36081028500,4858,1911,1787,72,5,828,1,80,2947
36081028700,6544,1701,2496,97,7,1941,0,77,4843
36081028801,2940,51,377,1861,40,267,13,98,2889
36081028802,1952,14,283,1341,12,61,0,71,1938
36081028803,8,0,1,6,0,0,0,0,8
36081028900,5202,1044,1733,65,9,2152,0,53,4158
36081029100,7341,889,1789,110,20,4331,0,74,6452
36081029300,1457,119,348,6,3,937,1,17,1338
36081029400,8072,139,1106,5920,51,271,4,161,7933
36081029500,3826,1419,888,129,10,1173,0,69,2407
36081029700,2258,762,660,29,0,733,0,15,1496
36081029900,5,0,3,0,0,0,0,0,5
36081030600,5287,109,529,3855,44,328,4,119,5178
36081030903,6748,720,3206,32,7,2627,0,76,6028
36081030904,3724,826,1784,50,8,956,1,47,2898
36081030905,3424,717,1260,38,10,1307,0,15,2707
36081030906,4924,686,1683,48,2,2391,0,41,4238
36081031700,6781,4259,1509,322,2,452,6,86,2522
36081032000,5200,165,633,3864,37,114,2,107,5035
36081032700,3932,388,2599,75,4,810,2,33,3544
36081032800,2660,59,216,2152,21,26,0,61,2601
36081032900,4251,441,2406,231,4,1030,7,77,3810
36081033000,7365,109,751,5705,43,203,0,124,7256
36081033100,0,0,0,0,0,0,0,0,0
36081033401,4196,41,515,3264,9,108,1,69,4155
36081033403,4874,17,178,4430,14,23,3,34,4857
36081033404,4723,34,223,4215,9,33,0,38,4689
36081033405,3653,13,212,3117,11,61,0,67,3640
36081033700,3765,187,2596,30,3,878,0,33,3578
36081033900,3481,325,2141,83,4,825,2,49,3156
36081034700,3688,241,2338,341,15,645,0,50,3447
36081035100,4178,413,2691,165,11,768,0,45,3765
36081035200,2550,14,238,2048,6,71,0,43,2536
36081035300,2828,85,2103,297,12,268,0,36,2743
36081035700,5593,514,2796,1340,1,748,3,56,5079
36081035800,4508,40,360,3719,22,42,0,73,4468
36081036100,2706,103,1890,412,4,224,0,46,2603
36081036300,2462,86,1824,319,4,173,0,25,2376
36081036500,4142,39,3414,429,6,168,0,38,4103
36081036600,3003,27,327,2347,14,96,0,34,2976
36081036700,3099,93,1688,772,8,429,1,41,3006
36081036800,2513,9,253,2020,7,44,0,51,2504
36081037100,1917,106,992,486,19,238,0,38,1811
36081037300,2887,50,2179,354,2,229,0,26,2837
36081037501,1479,24,1231,10,9,187,0,3,1455
36081037502,2778,64,2445,82,6,125,2,41,2714
36081037600,6373,64,541,5175,23,184,16,108,6309
36081037700,4493,51,3937,334,6,123,0,10,4442
36081037900,6504,72,5827,237,0,234,2,68,6432
36081038100,6966,90,5540,771,22,416,0,55,6876
36081038301,2,0,0,1,0,1,0,0,2
36081038302,44,3,17,13,0,3,0,3,41
36081038400,2720,22,174,2295,11,56,0,49,2698
36081039400,3332,36,359,2652,6,64,3,49,3296
36081039800,1688,22,180,1344,0,28,0,25,1666
36081039901,2875,61,2273,223,5,278,0,18,2814
36081039902,2285,86,1568,297,7,278,8,24,2199
36081040000,1474,7,160,1101,12,23,3,33,1467
36081040101,2847,44,2374,21,5,374,0,20,2803
36081040102,4808,22,4175,88,1,448,0,46,4786
36081040200,1474,9,100,1160,6,77,0,14,1465
36081040301,2768,42,2396,15,1,288,0,19,2726
36081040302,4760,58,4171,54,0,423,2,23,4702
36081040400,4270,58,458,3063,9,314,0,125,4212
36081040501,1183,48,1051,9,0,56,0,8,1135
36081040502,2175,35,1943,55,0,100,0,25,2140
36081040701,3162,36,2844,8,1,205,0,34,3126
36081040702,5131,28,4680,106,9,241,0,43,5103
36081040901,1951,38,1600,0,30,247,0,20,1913
36081040902,3534,53,3205,77,1,154,0,27,3481
36081041100,4532,74,3649,12,6,740,0,30,4458
36081041300,4752,154,3953,32,3,562,0,26,4598
36081041400,4526,39,824,2760,14,506,0,145,4487
36081041500,4365,195,3587,70,7,422,0,52,4170
36081042400,2295,19,196,1885,4,55,3,34,2276
36081042600,364,121,44,190,1,2,0,0,243
36081042700,4998,226,3999,55,11,647,0,31,4772
36081043200,1280,26,151,926,7,63,0,30,1254
36081043400,1717,13,196,1210,11,152,4,45,1704
36081043701,3683,451,2616,242,11,281,0,42,3232
36081043702,6998,425,4578,515,11,1319,6,77,6573
36081043900,4931,167,4296,44,7,371,0,20,4764
36081044000,4783,51,827,2324,74,907,22,270,4732
36081044301,4725,202,3378,336,1,698,0,54,4523
36081044302,5373,136,2533,490,11,2096,1,43,5237
36081044400,4562,127,1687,924,49,1278,8,239,4435
36081044601,4013,119,1763,1113,12,810,5,84,3894
36081044602,5472,188,1481,1172,20,2366,0,126,5284
36081044800,3063,204,574,321,2,1798,1,68,2859
36081045000,2070,314,504,84,6,1033,0,60,1756
36081045200,1209,240,139,135,1,650,0,12,969
36081045400,5207,204,468,496,20,3727,2,122,5003
36081045500,13200,1558,5172,3990,14,1790,1,163,11642
36081045600,1365,101,148,76,4,969,0,8,1264
36081045700,3536,184,891,40,1,2325,0,34,3352
36081045800,2271,142,299,226,6,1465,2,62,2129
36081045900,4150,174,1556,22,5,2299,0,64,3976
36081046000,6193,96,1935,793,37,2914,8,211,6097
36081046100,2903,76,1570,36,0,1166,1,14,2827
36081046200,8206,231,2389,1254,52,3439,5,414,7975
36081046300,4541,87,2925,37,25,1408,0,30,4454
36081046400,1841,344,341,451,7,595,2,28,1497
36081046500,4276,93,3519,14,24,551,0,39,4183
36081046600,3676,411,549,898,9,1633,0,65,3265
36081046700,7281,227,4495,97,8,2326,1,50,7054
36081046800,4173,148,858,400,34,1964,8,433,4025
36081046901,4346,167,1916,40,7,2124,0,30,4179
36081046902,4102,99,2681,78,0,1163,0,21,4003
36081047000,3343,54,759,326,39,1448,0,430,3289
36081047100,4785,163,1310,47,9,3134,2,39,4622
36081047200,3861,564,646,893,24,1413,33,106,3297
36081047300,4863,405,956,69,5,3313,3,28,4458
36081047500,5489,344,1442,59,4,3544,3,24,5145
36081047600,1374,576,107,180,3,401,0,45,798
36081047801,4065,591,857,1234,31,951,0,217,3474
36081047802,1511,48,248,275,19,658,0,149,1463
36081047900,6837,497,1472,356,1,4379,3,29,6340
36081048000,2666,102,499,423,32,1101,3,316,2564
36081048100,6321,273,2057,144,4,3721,0,46,6048
36081048200,1518,57,243,419,2,533,1,160,1461
36081048301,2145,150,398,18,1,1500,0,24,1995
36081048302,2092,213,701,19,2,1100,0,32,1879
36081048400,5569,131,878,1588,85,1652,4,702,5438
36081048500,5331,293,852,137,0,3926,0,35,5038
36081048900,1937,247,690,135,0,826,0,5,1690
36081049201,2888,150,537,1618,13,359,0,100,2738
36081049202,2018,95,253,493,20,768,1,255,1923
36081049301,2391,727,662,19,1,929,0,18,1664
36081049302,3498,1158,1391,41,0,838,5,17,2340
36081049500,1430,688,494,21,1,185,0,4,742
36081049600,3251,81,478,919,56,867,5,539,3170
36081049700,3381,933,791,39,0,1542,0,42,2448
36081049900,5477,716,1286,37,0,3361,2,19,4761
36081050000,4778,166,751,2858,65,526,5,202,4612
36081050201,1678,32,273,1057,12,169,2,55,1646
36081050202,1521,36,177,864,21,257,17,56,1485
36081050400,1872,26,209,1345,15,121,1,48,1846
36081050500,1768,476,493,58,1,698,1,19,1292
36081050600,1635,33,196,1056,7,139,5,73,1602
36081050700,3699,1710,693,44,4,1151,0,25,1989
36081050800,2084,38,207,1493,18,139,1,80,2046
36081051000,1616,15,199,1029,7,252,2,57,1601
36081051100,2494,1172,783,28,6,440,0,21,1322
36081051200,2748,41,384,1933,10,196,0,66,2707
36081051300,2638,999,719,64,4,799,2,23,1639
36081051500,3126,1802,771,30,0,459,0,13,1324
36081051600,2069,14,254,1551,6,138,0,26,2055
36081051700,2146,1318,550,35,1,196,0,26,828
36081051800,1948,13,209,1562,4,26,2,40,1935
36081052000,1593,10,121,1262,12,29,0,32,1583
36081052100,2197,1208,741,42,0,163,0,14,989
36081052200,1605,22,123,1302,3,37,0,33,1583
36081052400,1945,16,179,1536,1,61,0,43,1929
36081052500,2252,1096,821,32,0,229,0,32,1156
36081052600,1958,16,164,1524,14,79,0,59,1942
36081052800,1563,17,143,1259,5,37,1,14,1546
36081053000,2393,16,202,1974,13,43,0,13,2377
36081053100,3462,1786,1346,66,5,159,0,53,1676
36081053200,1886,34,155,1484,0,102,0,19,1852
36081053401,2104,15,215,1674,24,41,0,37,2089
36081053501,1058,336,667,18,0,10,0,12,722
36081053502,0,0,0,0,0,0,0,0,0
36081053601,1578,13,167,1160,11,107,1,41,1565
36081053800,1648,14,187,1249,2,75,0,25,1634
36081053901,3968,1174,1881,104,3,680,0,35,2794
36081053902,88,48,19,2,0,12,0,1,40
36081054000,4632,96,722,2783,26,547,5,167,4536
36081054200,5149,233,959,1139,98,1549,10,639,4916
36081054500,3648,904,2228,91,5,288,3,47,2744
36081054700,4166,975,2414,174,4,477,0,50,3191
36081054800,2336,74,303,407,54,1096,1,274,2262
36081054900,4932,1239,2759,156,11,543,6,55,3693
36081055100,4574,1869,1844,156,5,515,0,37,2705
36081055200,3174,179,732,767,22,1094,13,184,2995
36081055300,2856,658,1399,195,2,476,1,39,2198
36081055400,2487,239,500,418,13,1137,0,64,2248
36081055500,1935,324,1224,115,1,182,2,34,1611
36081055600,2242,160,473,268,24,989,3,183,2082
36081055700,3966,1165,2149,128,0,418,1,35,2801
36081055800,1710,146,412,284,36,549,3,171,1564
36081055900,1178,210,717,77,2,101,1,26,968
36081056000,1743,204,464,197,22,715,0,70,1539
36081056100,20,10,5,0,1,0,0,0,10
36081056200,1460,172,472,235,1,420,3,92,1288
36081056400,1559,189,490,237,24,418,0,93,1370
36081056500,1681,219,1298,71,0,48,0,14,1462
36081056600,1581,124,367,330,7,462,0,151,1457
36081056700,4751,1671,2687,75,8,194,2,43,3080
36081056800,4862,216,924,2818,21,517,2,161,4646
36081057700,4023,1799,1911,115,2,129,3,19,2224
36081057900,1743,796,836,15,1,52,1,20,947
36081058000,3589,60,431,2591,22,214,4,99,3529
36081058100,2785,1424,1073,84,0,144,0,10,1361
36081058200,4509,106,613,3143,11,213,3,128,4403
36081058300,3362,1755,1171,104,3,197,0,22,1607
36081058500,4128,2041,1546,64,3,382,0,18,2087
36081058700,3336,2015,890,70,3,272,3,32,1321
36081058900,4308,2202,1748,78,3,117,7,48,2106
36081059000,1182,20,105,962,5,14,1,24,1162
36081059100,5226,2014,2624,134,10,249,1,48,3212
36081059200,1186,30,65,1010,0,15,0,11,1156
36081059300,4092,2563,1041,78,2,273,1,33,1529
36081059400,1506,42,108,1238,1,14,0,22,1464
36081059501,2091,1099,708,34,5,202,0,14,992
36081059502,2712,996,1473,75,3,110,2,19,1716
36081059600,1373,26,83,1172,6,13,0,15,1347
36081059800,1764,27,102,1480,2,42,1,18,1737
36081059900,1594,904,448,30,2,177,0,7,690
36081060000,1223,19,90,1039,0,7,1,15,1204
36081060100,2414,1268,839,33,1,194,2,38,1146
36081060300,1854,1044,651,23,4,92,0,10,810
36081060600,1328,18,89,1125,3,25,2,9,1310
36081060701,3,3,0,0,0,0,0,0,0
36081060800,1475,11,73,1272,1,35,0,22,1464
36081061000,1204,6,63,1073,0,1,0,23,1198
36081061200,1552,13,76,1355,10,23,0,6,1539
36081061301,5763,3164,1825,119,0,479,0,60,2599
36081061302,0,0,0,0,0,0,0,0,0
36081061400,1205,22,88,1031,4,6,0,1,1183
36081061601,2095,11,116,1830,10,14,0,22,2084
36081061602,1402,29,143,1068,3,27,0,47,1373
36081061800,1736,31,110,1447,2,31,0,22,1705
36081061900,3097,1912,862,75,1,163,0,25,1185
36081062000,1419,22,120,1184,5,0,0,12,1397
36081062100,3151,1689,1145,90,0,128,3,28,1462
36081062200,1979,23,147,1690,0,23,2,26,1956
36081062300,1923,1087,672,50,2,61,0,18,836
36081062400,0,0,0,0,0,0,0,0,0
36081062500,2625,1529,916,41,1,74,0,31,1096
36081062600,2689,39,244,2229,11,31,1,31,2650
36081062700,3010,1604,1125,52,3,155,0,10,1406
36081062900,3042,1565,1231,63,4,86,1,23,1477
36081063000,1602,19,106,1353,1,4,2,7,1583
36081063200,2261,46,144,1932,10,17,0,20,2215
36081063301,1587,1039,405,20,3,78,0,11,548
36081063302,1665,1086,447,30,0,81,1,3,579
36081063500,2784,1689,906,31,4,77,0,20,1095
36081063700,3507,2145,830,148,3,289,0,14,1362
36081063800,3584,159,454,2570,7,110,7,68,3425
36081063900,2794,1496,845,111,3,263,0,19,1298
36081064101,2378,1503,569,34,3,209,0,21,875
36081064102,4,1,3,0,0,0,0,0,3
36081064500,2064,843,448,40,0,648,1,34,1221
36081064600,3025,37,218,2539,1,39,0,39,2988
36081065000,2831,29,175,2410,9,22,1,28,2802
36081065401,2836,113,323,2137,9,71,0,38,2723
36081065402,5,0,2,0,0,0,0,1,5
36081065501,3,0,2,0,0,0,0,0,3
36081065600,5423,136,545,4236,16,158,0,98,5287
36081065702,1775,1241,418,9,0,67,0,8,534
36081065703,2829,2170,440,16,0,127,0,19,659
36081065900,1850,1509,169,1,2,140,1,7,341
36081066000,3511,143,351,2689,11,90,0,43,3368
36081066100,1573,1252,203,5,1,86,0,1,321
36081066301,2713,1714,365,17,4,537,2,12,999
36081066302,4,0,4,0,0,0,0,0,4
36081066401,1923,99,284,1364,4,31,1,32,1824
36081066402,3942,148,328,3075,22,57,0,60,3794
36081066403,4480,103,495,3567,25,95,2,63,4377
36081066404,0,0,0,0,0,0,0,0,0
36081066501,3538,2713,508,32,5,188,0,17,825
36081066701,2789,1957,542,3,4,231,0,8,832
36081066900,1790,1329,261,3,0,161,0,9,461
36081067100,2248,1439,230,3,3,535,0,4,809
36081067700,1832,1365,196,0,1,223,1,11,467
36081067900,4397,1780,1464,195,8,770,0,27,2617
36081068000,5220,74,480,4259,25,85,1,45,5146
36081068200,1262,17,130,1047,2,8,0,13,1245
36081068300,4052,315,1446,136,9,2054,0,19,3737
36081068700,4597,1290,1051,78,25,1977,0,40,3307
36081069000,3787,33,292,3201,7,39,0,58,3754
36081069300,2887,928,793,89,0,905,0,55,1959
36081069400,3604,48,325,2985,12,47,0,67,3556
36081069500,2451,977,504,34,2,825,1,17,1474
36081069701,4435,1498,874,199,4,1506,0,75,2937
36081069702,3929,1542,620,29,5,1570,0,37,2387
36081070300,2225,892,589,43,3,611,0,21,1333
36081070700,2426,1167,317,10,0,806,0,24,1259
36081070900,2635,1063,344,63,0,1036,2,19,1572
36081071100,5687,2527,942,181,3,1740,0,80,3160
36081071303,5307,2862,927,113,1,1142,0,51,2445
36081071304,6386,3448,718,134,2,1616,1,100,2938
36081071305,5126,2431,727,252,0,1438,0,57,2695
36081071306,6181,2470,1212,252,3,1809,1,111,3711
36081071600,2,0,0,1,0,0,0,0,2
36081071701,5557,2429,887,172,19,1741,0,61,3128
36081071702,4660,1451,729,210,8,1977,0,89,3209
36081071900,2887,979,659,87,1,864,1,45,1908
36081072100,5040,2399,736,111,1,1471,0,79,2641
36081072300,2158,1047,184,25,3,782,0,18,1111
36081072900,1490,576,272,31,0,505,0,28,914
36081073100,1550,784,173,32,0,483,0,6,766
36081073700,2277,1183,266,48,0,649,0,27,1094
36081073900,5548,3000,631,131,2,1524,0,52,2548
36081074100,3164,1633,360,66,1,938,1,41,1531
36081074300,4433,2150,755,80,0,1166,4,60,2283
36081074500,3659,1693,798,276,0,620,0,64,1966
36081074700,3539,947,761,135,14,1496,0,49,2592
36081074900,1563,853,153,13,0,449,0,25,710
36081075701,5110,2161,712,157,3,1852,0,42,2949
36081075702,5071,2502,487,151,2,1677,2,39,2569
36081076901,4274,2278,675,130,3,953,1,40,1996
36081076902,1390,576,290,70,4,365,0,13,814
36081077300,2311,1091,489,105,1,506,0,15,1220
36081077500,2241,1181,444,113,3,356,0,49,1060
36081077902,5416,4182,335,114,1,604,0,64,1234
36081077903,2937,1189,700,115,9,836,0,24,1748
36081077904,6324,3169,944,245,1,1664,0,103,3155
36081077905,2586,854,527,315,4,781,0,19,1732
36081077906,3968,1820,411,87,3,1508,0,45,2148
36081077907,3349,2266,403,228,1,261,0,72,1083
36081077908,3838,811,827,698,12,1229,4,50,3027
36081078800,2002,31,340,1062,30,206,8,127,1971
36081079000,2875,52,466,1437,25,427,0,223,2823
36081079200,2717,39,365,1487,42,295,2,237,2678
36081079300,1,0,0,0,0,0,0,0,1
36081079701,7620,364,450,268,8,6338,0,61,7256
36081079702,5002,151,568,66,8,4167,0,14,4851
36081079900,3871,294,635,23,2,2863,0,35,3577
36081080301,4828,448,953,57,2,3284,1,42,4380
36081080302,3973,544,739,90,3,2506,0,29,3429
36081080900,7591,2952,1033,445,12,2823,2,105,4639
36081081400,4088,86,714,1446,71,962,4,383,4002
36081081800,3873,133,695,1126,140,947,3,414,3740
36081083700,6229,410,511,62,5,5155,0,25,5819
36081083800,5194,537,1170,663,165,1329,15,741,4657
36081084000,6644,381,1373,1094,154,1716,18,1051,6263
36081084500,5516,274,948,452,2,3736,0,31,5242
36081084601,3045,357,662,321,110,825,0,460,2688
36081084602,1496,146,395,493,18,257,2,114,1350
36081084901,3013,50,434,86,1,2403,0,19,2963
36081084902,4466,78,562,141,2,3637,0,15,4388
36081085300,5415,173,395,52,4,4734,0,13,5242
36081085500,6889,385,1244,155,4,4983,0,40,6504
36081085700,5770,236,1056,87,4,4287,0,45,5534
36081085900,6162,301,724,84,4,4965,1,21,5861
36081086100,2450,160,259,22,0,1987,0,14,2290
36081086300,7118,346,965,174,10,5536,0,36,6772
36081086400,2867,320,1098,266,29,675,3,257,2547
36081086500,5224,537,521,84,1,4009,0,10,4687
36081086900,2343,44,250,98,1,1914,0,8,2299
36081087100,6373,349,897,539,7,4435,4,30,6024
36081088400,7578,5255,1543,131,8,415,4,70,2323
36081088902,7015,482,1183,379,4,4872,0,32,6533
36081088903,4487,888,611,72,4,2837,0,26,3599
36081089201,7404,6080,816,28,3,298,0,53,1324
36081089202,0,0,0,0,0,0,0,0,0
36081090700,1584,365,571,64,0,562,0,5,1219
36081091602,12,6,1,5,0,0,0,0,6
36081091603,4456,4213,148,1,2,13,0,24,243
36081091604,0,0,0,0,0,0,0,0,0
36081091800,12,11,0,0,0,0,0,1,1
36081091900,6417,1070,2528,241,0,2405,1,40,5347
36081092200,2208,2005,107,10,0,35,2,12,203
36081092500,4356,613,2336,75,11,1243,0,26,3743
36081092800,3204,2911,170,3,1,36,0,25,293
36081092900,7638,1552,3481,90,3,2356,0,49,6086
36081093401,3732,3224,332,47,2,43,0,27,508
36081093402,3704,2657,583,215,4,122,2,32,1047
36081093800,4460,2621,919,642,6,100,6,47,1839
36081093900,6268,1100,2071,79,14,2834,3,42,5168
36081094201,3729,1013,1079,1215,4,188,0,54,2716
36081094202,4785,874,1398,1992,14,241,3,70,3911
36081094203,5676,3017,1047,1167,9,184,0,64,2659
36081094500,4327,1879,1060,75,0,1251,0,28,2448
36081094700,3035,597,1424,63,3,874,0,19,2438
36081095400,6108,752,1409,3134,47,303,6,128,5356
36081096400,6353,713,1216,3331,27,531,0,125,5640
36081097202,3460,49,864,2373,32,10,0,12,3411
36081097204,4078,292,1042,2448,3,81,3,46,3786
36081097205,4268,71,1641,2213,18,156,6,50,4197
36081097206,2910,43,775,1839,30,62,0,47,2867
36081097207,12,0,7,1,0,0,0,0,12
36081097300,2007,1448,277,9,1,223,3,20,559
36081098100,2353,1317,372,30,2,582,1,23,1036
36081098700,2543,1502,381,15,1,592,0,18,1041
36081099100,6642,4655,831,71,2,939,0,26,1987
36081099200,4348,261,1229,2445,3,139,4,71,4087
36081099701,3075,1658,384,13,0,926,0,23,1417
36081099703,3938,2232,410,105,6,1078,1,26,1706
36081099704,7280,3978,824,142,3,2181,0,39,3302
36081099705,2687,1133,392,43,0,1048,0,26,1554
36081099801,7853,368,2411,4230,30,293,10,127,7485
36081099802,5822,1221,1188,2774,31,229,5,99,4601
36081099900,0,0,0,0,0,0,0,0,0
36081100801,2496,913,311,927,7,68,3,111,1583
36081100803,4817,310,1754,2229,29,99,7,145,4507
36081100804,4315,1152,750,1987,5,113,0,91,3163
36081101002,4596,3258,329,800,7,22,2,79,1338
36081101003,3943,1123,1282,1288,11,43,2,58,2820
36081101004,6612,2018,1467,2652,22,199,6,94,4594
36081101700,6307,3435,727,38,0,1984,0,21,2872
36081102900,3786,1957,610,59,0,1097,0,14,1829
36081103201,6986,188,2659,3567,42,106,2,87,6798
36081103202,6860,2946,2213,1319,22,90,0,113,3914
36081103300,4459,2295,694,3,0,1384,0,30,2164
36081103900,6618,2600,1236,53,1,2613,0,28,4018
36081104700,7907,2250,1101,39,8,4365,2,32,5657
36081105900,3812,1902,318,16,1,1509,5,13,1910
36081107201,2370,1959,262,18,6,47,0,33,411
36081107202,0,0,0,0,0,0,0,0,0
36081108500,2778,1128,398,18,2,1183,0,11,1650
36081109300,3139,1561,238,57,0,1199,1,11,1578
36081109700,1797,877,265,19,1,594,0,4,920
36081109900,3538,1252,486,49,2,1682,3,16,2286
36081111300,2611,1070,295,30,0,1147,2,6,1541
36081112300,2126,754,390,30,0,879,0,15,1372
36081112900,2248,1055,270,39,0,815,0,15,1193
36081113300,1554,802,231,8,1,470,0,14,752
36081113900,3602,1352,735,58,2,1361,1,15,2250
36081114100,2580,1194,285,15,0,1028,0,6,1386
36081114700,1833,755,207,3,0,826,0,12,1078
36081115100,1087,455,122,5,0,494,0,0,632
36081115500,2132,363,618,30,0,1068,1,14,1769
36081115700,3529,400,442,22,0,2614,0,12,3129
36081115900,3922,488,604,79,0,2675,1,41,3434
36081116100,4585,316,607,136,0,3446,0,12,4269
36081116301,5178,375,1277,174,1,3277,0,17,4803
36081116302,3461,188,679,92,3,2431,0,20,3273
36081116700,2094,92,581,21,0,1357,1,11,2002
36081117100,2837,427,685,34,0,1649,0,13,2410
36081117500,5410,1249,833,99,6,3096,3,29,4161
36081118100,2015,632,286,31,1,1033,0,13,1383
36081118500,2357,245,674,28,0,1375,0,8,2112
36081118700,2648,204,569,70,0,1779,0,5,2444
36081118900,2625,211,382,20,5,1972,1,6,2414
36081119100,3694,320,1163,36,0,2144,0,7,3374
36081119300,2407,395,477,27,1,1468,0,7,2012
36081119500,1445,417,357,29,2,607,0,9,1028
36081119900,1699,226,247,11,1,1174,2,7,1473
36081120100,1840,102,261,18,3,1427,0,3,1738
36081120300,1818,142,196,16,0,1443,0,5,1676
36081120500,3144,125,240,32,0,2675,1,24,3019
36081120701,3058,681,573,34,2,1705,0,8,2377
36081120702,3,0,1,0,0,2,0,0,3
36081121100,2,0,0,0,1,1,0,0,2
36081121500,4737,485,976,85,0,3088,0,40,4252
36081122300,3822,964,556,54,8,2140,0,28,2858
36081122702,6959,870,2017,2244,25,1484,6,66,6089
36081122703,6801,1879,2386,863,9,1365,0,95,4922
36081122704,4444,964,874,364,1,2046,0,42,3480
36081124100,4004,1191,519,243,10,1862,0,53,2813
36081124700,3734,1665,262,58,2,1574,0,57,2069
36081125700,3642,368,870,446,4,1783,3,61,3274
36081126500,1595,376,262,99,3,786,4,34,1219
36081126700,4490,1742,788,581,2,1161,1,36,2748
36081127700,3600,2579,159,152,3,528,0,64,1021
36081128300,5,0,1,2,0,2,0,0,5
36081129102,3561,1933,319,105,2,1041,0,46,1628
36081129103,3811,1912,419,121,0,1241,0,17,1899
36081129104,4318,1715,615,151,8,1649,0,42,2603
36081130100,4203,758,804,600,20,1678,10,158,3445
36081133300,3915,1719,386,70,0,1590,1,45,2196
36081133900,1360,672,89,13,0,520,0,14,688
36081134100,3659,901,466,59,7,2134,0,28,2758
36081134701,5561,840,746,704,12,3087,0,45,4721
36081134702,5117,874,730,474,5,2848,0,39,4243
36081136700,6250,1571,497,90,0,3955,0,37,4679
36081137700,7309,1356,862,414,2,4443,0,57,5953
36081138501,4994,972,485,78,8,3375,0,27,4022
36081138502,85,63,16,0,1,4,0,0,22
36081139900,1769,553,121,18,0,1036,0,10,1216
36081140300,2406,631,206,33,2,1489,0,19,1775
36081140901,1020,254,105,25,1,602,0,5,766
36081140902,2906,608,254,29,2,1947,0,14,2298
36081141700,4975,1069,601,70,0,3122,0,34,3906
36081142900,3897,1348,440,37,0,1991,0,18,2549
36081143500,2364,660,226,17,0,1416,0,2,1704
36081144100,2957,925,286,34,1,1656,0,5,2032
36081144700,3131,362,502,352,0,1835,0,18,2769
36081145101,1501,553,205,9,0,720,0,0,948
36081145102,2597,527,393,87,0,1534,0,13,2070
36081145900,2870,994,450,25,0,1333,0,24,1876
36081146300,2929,933,575,104,7,1242,0,28,1996
36081146700,2807,1148,460,61,1,1051,1,15,1659
36081147100,3239,1140,419,38,2,1584,0,23,2099
36081147900,4279,1656,570,52,5,1854,0,18,2623
36081148300,2968,1639,238,20,0,963,0,17,1329
36081150701,2919,1524,235,23,2,1080,0,14,1395
36081150702,3049,1334,345,36,1,1281,0,4,1715
36081152901,6382,1900,633,200,7,3464,0,44,4482
36081152902,5665,2287,467,77,0,2712,2,28,3378
36081155101,1945,1808,46,16,0,43,0,5,137
36081155103,4373,2041,683,400,4,1091,0,52,2332
36081155104,3616,1189,488,318,2,1375,2,73,2427
36081156700,1470,168,187,378,0,683,0,11,1302
36081157101,7561,1595,821,377,20,4336,5,200,5966
36081157102,2109,322,260,90,12,1321,0,60,1787
36081157901,5184,1386,483,121,12,2942,0,98,3798
36081157902,3757,758,325,149,12,2300,7,99,2999
36081157903,4489,1152,526,157,6,2439,0,97,3337
36081161700,4541,1494,896,240,17,1682,0,86,3047
36081162100,6682,1093,1438,459,26,3242,12,187,5589
36081990100,0,0,0,0,0,0,0,0,0
36083040100,4017,2478,381,695,26,28,0,19,1539
36083040200,4279,2704,442,690,8,24,0,48,1575
36083040300,3350,1719,469,866,14,47,0,19,1631
36083040400,2531,792,465,1032,8,17,0,47,1739
36083040500,2055,911,266,660,3,61,0,15,1144
36083040600,2286,1258,222,356,5,302,0,11,1028
36083040701,3786,2139,409,656,8,325,0,31,1647
36083040702,1629,938,158,194,6,201,0,18,691
36083040800,1731,1178,162,232,1,33,0,17,553
36083040900,2950,1560,366,731,4,25,0,26,1390
36083041000,4536,2084,608,1262,18,122,2,27,2452
36083041101,3092,2404,156,262,6,79,0,5,688
36083041102,2682,1214,507,627,1,120,0,6,1468
36083041200,3269,2536,260,195,5,67,0,7,733
36083041300,5283,3510,384,387,8,724,4,26,1773
36083041400,3925,2794,198,368,2,387,0,13,1131
36083051500,2880,1869,201,309,11,260,0,23,1011
36083051601,2992,1825,235,312,8,357,2,16,1167
36083051602,3338,2523,207,182,1,249,0,21,815
36083051701,3495,3121,101,24,16,76,0,6,374
36083051702,3216,2913,82,26,3,8,3,17,303
36083051800,5540,5100,111,29,18,16,0,10,440
36083051901,3891,3530,67,24,14,13,0,9,361
36083051902,3554,3169,106,72,7,29,0,5,385
36083052002,1748,1631,31,9,0,9,0,3,117
36083052003,4326,3778,150,99,6,94,0,16,548
36083052004,6507,5632,194,194,18,210,0,18,875
36083052101,2051,1842,47,11,5,17,0,11,209
36083052102,1372,1277,34,4,0,6,0,4,95
36083052103,1808,1660,44,20,2,1,0,11,148
36083052201,4322,4012,95,20,2,17,0,2,310
36083052203,5919,5358,162,39,3,64,1,29,561
36083052204,2429,2240,58,15,3,9,0,6,189
36083052301,4822,3782,237,245,6,356,0,8,1040
36083052303,1117,1033,18,5,0,17,0,6,84
36083052305,2906,2639,51,46,0,46,0,11,267
36083052306,4447,3663,446,80,4,98,0,13,784
36083052402,2359,2090,75,42,6,52,0,1,269
36083052405,2522,2068,127,79,1,132,3,10,454
36083052406,4532,3471,177,201,8,468,0,17,1061
36083052407,4625,3752,188,170,5,280,0,17,873
36083052408,2710,2210,106,115,7,104,1,12,500
36083052501,6105,5428,237,71,5,65,0,18,677
36083052502,5327,4826,137,53,8,46,0,27,501
36083052503,1477,1280,67,34,0,6,0,8,197
36083052601,3498,3152,104,23,8,29,0,14,346
36083052602,1103,972,40,21,7,5,0,0,131
36083052603,2791,2535,94,13,5,10,1,2,256
36085000300,2348,953,509,343,1,402,0,31,1395
36085000600,2859,1459,693,222,9,402,0,28,1400
36085000700,5143,985,1468,2167,7,227,3,61,4158
36085000800,6268,2404,1868,261,10,1531,0,66,3864
36085000900,2240,376,784,774,2,170,1,34,1864
36085001100,4234,716,1858,1293,14,194,0,32,3518
36085001700,1865,599,673,322,7,195,0,13,1266
36085001800,495,238,154,40,2,15,3,4,257
36085002001,2524,1525,452,74,4,405,0,13,999
36085002002,3302,2166,431,106,3,494,3,14,1136
36085002100,5467,1236,2062,1466,17,476,5,45,4231
36085002700,2049,374,924,566,3,89,1,17,1675
36085002900,6871,417,2825,2837,35,494,0,41,6454
36085003300,3738,1408,997,789,3,348,0,33,2330
36085003600,2792,1011,761,155,2,768,0,31,1781
36085003900,2179,971,521,466,1,116,1,23,1208
36085004001,2775,380,879,840,10,574,0,24,2395
36085004002,3409,153,825,840,3,1520,0,24,3256
36085004003,4851,92,1116,3302,11,163,0,32,4759
36085004004,2807,344,824,699,0,838,0,15,2463
36085004700,3126,1803,525,286,2,409,1,34,1323
36085005000,4357,2274,650,201,1,1138,4,30,2083
36085005901,2854,2004,372,126,3,259,0,10,850
36085005902,5,0,2,1,0,1,0,0,5
36085006400,3698,1828,792,388,0,569,6,27,1870
36085006700,2927,2007,460,157,2,173,1,11,920
36085007001,2634,1697,423,32,1,422,0,9,937
36085007002,6215,3611,1030,228,9,1203,5,18,2604
36085007400,4962,2538,985,228,3,1070,2,27,2424
36085007500,4200,1346,1534,850,10,336,1,37,2854
36085007700,1762,178,776,667,8,66,0,13,1584
36085008100,4822,1186,1654,1317,12,412,1,58,3636
36085009601,4075,2816,425,89,1,666,0,8,1259
36085009602,3767,2526,546,86,0,518,0,22,1241
36085009701,4454,1433,1218,1318,10,281,2,44,3021
36085009702,8,7,1,0,0,0,0,0,1
36085010500,5597,1952,2002,914,7,526,0,56,3645
36085011201,5768,3755,663,75,5,1125,0,67,2013
36085011203,6791,4132,1067,113,7,1299,0,39,2659
36085011204,46,19,8,5,1,7,0,5,27
36085011401,3249,1458,757,470,7,419,4,37,1791
36085011402,3738,2450,526,73,0,603,0,27,1288
36085012100,3212,2539,384,31,0,156,0,15,673
36085012200,3938,3055,446,30,0,313,0,32,883
36085012500,3087,1120,1119,410,7,329,0,20,1967
36085012804,4644,2882,804,81,3,761,0,29,1762
36085012805,2390,1757,215,22,0,337,1,24,633
36085012806,6659,4130,1015,475,11,835,3,36,2529
36085013201,1659,1325,122,31,0,147,0,11,334
36085013203,5790,4536,559,28,7,524,0,28,1254
36085013204,5055,3803,583,27,8,508,0,10,1252
36085013301,1631,90,637,768,7,41,7,10,1541
36085013302,3733,376,1927,1075,14,213,3,42,3357
36085013400,4204,2875,715,60,9,406,1,31,1329
36085013800,6625,5307,588,26,7,539,0,26,1318
36085014100,2868,827,1139,382,17,367,1,39,2041
36085014604,6651,5287,673,52,5,513,1,12,1364
36085014605,3785,3165,309,15,1,222,0,7,620
36085014606,6288,5039,740,49,2,303,0,28,1249
36085014607,4650,3591,486,30,4,464,2,11,1059
36085014608,3640,2856,359,6,0,344,0,18,784
36085014700,3451,2631,441,79,0,179,0,24,820
36085015100,5449,3849,855,90,4,445,4,21,1600
36085015400,5,3,0,0,1,0,0,0,2
36085015601,6663,5522,650,45,7,334,0,23,1141
36085015602,3396,2942,219,9,4,140,0,13,454
36085015603,4776,3647,587,26,4,415,1,14,1129
36085016901,3213,1993,479,90,3,539,0,22,1220
36085017005,4845,3843,453,36,2,374,3,29,1002
36085017007,5526,3287,870,185,0,1038,1,23,2239
36085017009,4473,3788,385,24,6,206,0,14,685
36085017011,4587,3612,477,25,2,401,0,20,975
36085017012,4473,3385,512,31,3,416,1,19,1088
36085017013,4333,2902,728,99,6,478,0,20,1431
36085017014,4327,3315,579,54,3,295,0,19,1012
36085017015,2713,2204,279,14,10,126,0,21,509
36085017016,4637,3620,489,14,3,405,0,6,1017
36085017300,2535,804,533,511,2,572,4,13,1731
36085017600,4932,4150,302,17,1,344,1,17,782
36085017701,4724,3369,292,40,5,894,3,12,1355
36085017702,2353,1881,183,15,0,240,5,6,472
36085018100,3569,2608,350,135,2,379,3,13,961
36085018701,1836,1074,364,76,4,240,0,22,762
36085018703,3976,1753,573,266,7,1246,0,27,2223
36085018704,3780,2272,423,90,3,884,3,28,1508
36085018901,5725,3693,792,122,3,1007,0,18,2032
36085018902,5533,3371,501,164,14,1309,0,84,2162
36085019700,1958,1463,225,44,3,162,0,20,495
36085019800,6627,5484,582,64,4,350,2,17,1143
36085020100,3796,2020,1166,223,0,266,0,40,1776
36085020701,3942,269,2054,1197,11,255,0,18,3673
36085020702,3436,345,1947,916,4,126,0,22,3091
36085020803,7348,6049,674,56,2,374,0,58,1299
36085020804,5364,4481,469,13,0,256,2,29,883
36085020805,6433,5177,703,55,5,383,0,22,1256
36085020806,2714,2106,297,36,1,209,0,9,608
36085021300,5737,1362,3021,879,8,297,0,45,4375
36085022300,3134,490,1244,1126,5,127,4,44,2644
36085022601,6945,5468,790,89,0,468,0,19,1477
36085022602,1223,945,167,19,1,68,0,8,278
36085022801,95,31,35,2,0,19,0,1,64
36085022802,15,4,6,3,0,0,0,0,11
36085023100,4959,848,1976,1230,6,710,1,60,4111
36085023900,3605,780,1563,688,23,392,8,29,2825
36085024401,5687,4801,552,39,11,138,3,22,886
36085024402,4381,3803,356,21,0,106,0,15,578
36085024700,2893,810,1003,675,2,309,0,14,2083
36085024800,4798,3637,816,57,8,127,0,41,1161
36085025100,6030,4162,909,131,3,667,2,7,1868
36085027301,4811,2928,607,140,1,1007,6,38,1883
36085027302,4242,2850,317,125,1,847,0,45,1392
36085027702,6479,3925,996,250,3,1123,2,36,2554
36085027704,4612,2713,492,116,3,1194,0,34,1899
36085027705,5866,3214,811,112,1,1578,2,27,2652
36085027706,3043,1743,441,97,0,673,0,11,1300
36085027900,2110,1689,248,2,1,115,0,3,421
36085029102,3394,1963,748,111,6,459,2,22,1431
36085029104,7178,4101,1308,303,5,1270,0,39,3077
36085029105,4257,2813,578,67,6,682,0,17,1444
36085029106,3231,2102,556,99,0,415,0,14,1129
36085030301,5130,2022,1427,680,5,839,1,48,3108
36085030302,6669,1622,2306,1284,17,1219,2,61,5047
36085031901,3262,179,1218,1526,4,181,2,24,3083
36085031902,5500,472,1722,2904,30,111,0,55,5028
36085032300,1233,205,454,415,10,80,4,10,1028
36085990100,0,0,0,0,0,0,0,0,0
36087010101,5742,3965,900,382,6,263,0,28,1777
36087010102,4854,3043,1255,292,5,126,2,35,1811
36087010200,4217,2685,1053,237,4,116,0,20,1532
36087010501,5291,2845,1438,583,0,284,0,22,2446
36087010503,2875,1810,296,429,0,206,2,47,1065
36087010504,7657,2966,2607,1406,5,428,0,86,4691
36087010601,4058,1321,1848,578,3,171,2,19,2737
36087010602,6883,1387,3609,1391,5,353,0,24,5496
36087010701,4079,900,2294,615,12,158,0,20,3179
36087010702,4387,312,3735,210,6,61,3,27,4075
36087010703,3857,799,2729,222,6,52,0,14,3058
36087010801,4824,3376,503,296,3,500,0,57,1448
36087010802,5288,3703,563,175,3,691,0,35,1585
36087010803,5609,3504,784,307,2,820,0,32,2105
36087010804,4038,2647,717,138,4,419,1,30,1391
36087010901,4790,3267,672,179,2,530,0,12,1523
36087010902,4139,2323,831,191,6,666,0,34,1816
36087011000,2015,1571,182,70,0,76,2,17,444
36087011101,5857,3433,1040,454,3,726,3,25,2424
36087011102,5945,2959,1121,1185,5,464,0,39,2986
36087011200,6545,4557,808,199,7,771,0,34,1988
36087011302,5614,3110,1103,359,3,877,0,47,2504
36087011303,5667,3345,979,367,6,805,0,48,2322
36087011304,4651,240,2778,1475,3,47,0,32,4411
36087011305,3934,1223,1081,988,8,505,0,20,2711
36087011401,4257,2657,796,217,3,458,2,22,1600
36087011403,5548,3866,659,192,1,641,0,32,1682
36087011404,3961,2063,632,595,5,553,2,31,1898
36087011405,4173,1437,1026,911,2,603,0,55,2736
36087011505,3493,3199,85,91,1,27,0,28,294
36087011506,6888,6364,196,70,11,22,0,110,524
36087011507,4384,3616,257,247,1,96,0,28,768
36087011508,4216,3773,176,83,1,46,0,78,443
36087011509,3735,2303,631,432,2,245,0,35,1432
36087011510,4546,2897,789,543,8,137,0,100,1649
36087011511,3674,547,1441,1325,13,249,0,39,3127
36087011512,4202,272,1839,1648,33,328,0,28,3930
36087011601,3521,2763,272,172,0,227,2,18,758
36087011602,6667,5305,644,252,3,292,0,37,1362
36087011603,6069,4300,819,310,32,369,0,60,1769
36087011700,3036,2105,567,144,7,76,0,35,931
36087011800,930,354,290,115,31,40,0,9,576
36087011901,3943,2075,1264,246,12,236,2,19,1868
36087011902,3472,1676,1069,347,6,240,0,37,1796
36087012000,4026,2847,517,248,3,250,1,37,1179
36087012107,5463,5067,86,53,0,0,0,152,396
36087012108,5669,5400,26,4,1,1,0,131,269
36087012109,3152,2915,73,30,3,1,0,77,237
36087012110,3741,3494,101,20,1,9,0,63,247
36087012111,3273,3098,57,7,0,1,0,71,175
36087012112,4032,3801,74,16,0,6,0,73,231
36087012113,4489,4227,54,3,4,0,1,127,262
36087012114,2874,2622,120,15,1,8,0,30,252
36087012115,1721,635,645,369,3,26,0,25,1086
36087012116,3242,2930,134,39,0,23,0,73,312
36087012203,3531,2900,252,240,0,23,0,72,631
36087012204,3926,3461,154,84,2,12,0,113,465
36087012205,2669,568,864,1053,1,114,1,19,2101
36087012206,3134,115,830,1848,8,240,0,25,3019
36087012301,3457,1954,799,566,13,4,0,58,1503
36087012302,3813,551,2179,964,5,39,1,27,3262
36087012401,5307,1217,695,2672,14,559,0,39,4090
36087012403,2498,74,1722,594,3,70,1,12,2424
36087012404,2551,496,1229,654,1,82,1,48,2055
36087012503,2970,2203,201,346,15,121,0,44,767
36087012504,4119,2818,451,414,0,213,7,95,1301
36087012505,3243,2820,144,125,4,36,0,57,423
36087012506,3243,2575,238,166,2,95,2,92,668
36087012600,6172,4984,651,110,0,266,0,24,1188
36087012700,4363,3402,625,66,4,175,0,26,961
36087012800,7238,5942,502,103,3,478,0,60,1296
36087013001,2439,1707,319,87,0,230,1,20,732
36087013002,5452,3668,893,214,5,523,0,7,1784
36087013003,3265,2249,409,237,0,300,0,4,1016
36087013101,3285,1554,794,629,3,152,1,13,1731
36087013102,3098,1971,394,506,3,98,0,20,1127
36087013200,2699,1602,395,394,1,126,0,27,1097
36087013300,2517,1817,298,77,0,199,1,31,700
36087013401,4395,2979,638,96,6,510,0,30,1416
36087013402,3732,2587,510,58,2,423,1,18,1145
36089490100,3331,2931,63,33,82,13,0,9,400
36089490200,3633,3225,72,21,137,50,4,8,408
36089490300,5469,4665,112,32,377,52,0,8,804
36089490400,3050,2791,61,2,55,25,0,18,259
36089490500,3979,3713,83,13,16,8,0,5,266
36089490600,4453,4090,55,27,47,12,0,11,363
36089490700,6443,5888,85,29,124,41,1,28,555
36089490800,3393,2896,113,97,9,109,1,9,497
36089490900,3258,2629,131,70,16,251,0,11,629
36089491000,4456,4033,110,32,20,84,0,13,423
36089491100,2248,1408,133,493,0,67,0,33,840
36089491200,1546,994,207,240,11,2,0,50,552
36089491300,4221,3972,81,10,18,3,6,8,249
36089491400,4595,3460,341,608,30,36,0,8,1135
36089491500,3419,3207,52,18,10,33,0,7,212
36089491600,2050,1898,32,9,14,13,0,0,152
36089491700,4158,3991,32,10,12,13,2,7,167
36089491800,4472,4235,63,29,14,7,0,7,237
36089491900,1529,1330,90,40,2,20,0,0,199
36089492000,5618,5059,129,99,13,105,0,16,559
36089492100,4491,3715,245,320,22,53,0,9,776
36089492301,3421,3244,22,0,9,18,0,5,177
36089492302,2523,2372,31,16,9,26,0,2,151
36089492401,2167,2034,41,12,18,0,0,4,133
36089492501,2085,1948,22,22,6,7,0,5,137
36089492600,5813,5545,48,13,14,8,0,7,268
36089492700,6551,5471,304,474,22,19,5,3,1080
36089492800,2994,2828,51,10,12,6,0,1,166
36089492900,2057,1952,11,5,20,6,0,5,105
36089493000,1082,1032,12,4,4,2,0,1,50
36091060102,6304,5715,178,59,7,43,1,6,589
36091060103,1890,1755,23,2,0,7,0,12,135
36091060104,4264,3918,96,34,14,28,0,9,346
36091060200,3744,3353,87,41,9,26,2,18,391
36091060301,3109,2874,42,9,4,10,2,13,235
36091060400,2562,2355,57,8,6,3,0,8,207
36091060501,1976,1808,32,12,9,9,0,10,168
36091060504,1154,1093,20,2,1,0,0,1,61
36091060505,998,929,19,0,2,2,0,0,69
36091060506,1675,1555,17,11,0,15,0,0,120
36091060507,400,365,8,0,0,4,0,1,35
36091060601,3083,2744,94,40,5,8,0,13,339
36091060602,4921,4442,176,27,8,17,2,19,479
36091060703,3119,2773,112,30,14,30,0,8,346
36091060704,4786,4233,149,63,5,99,0,30,553
36091060705,3919,3359,153,93,5,118,2,20,560
36091060706,5537,4916,194,31,3,128,1,30,621
36091060800,5242,4632,183,35,10,33,0,13,610
36091060901,3961,3644,114,29,4,19,0,10,317
36091060902,1847,1696,59,16,0,3,3,5,151
36091061001,2432,2195,76,32,0,42,0,6,237
36091061002,1789,1468,111,49,0,72,0,2,321
36091061101,2002,1543,189,122,2,17,4,14,459
36091061102,3701,3359,123,28,1,69,2,8,342
36091061201,2232,2006,80,44,2,25,1,6,226
36091061202,3272,2820,135,78,3,68,0,24,452
36091061301,3956,3568,122,33,7,97,0,13,388
36091061303,2123,1368,220,145,0,268,0,0,755
36091061304,2831,2445,133,52,3,53,5,16,386
36091061305,4153,3502,210,115,5,120,0,24,651
36091061401,4920,4344,179,47,9,21,1,12,576
36091061403,6460,5719,238,103,10,110,2,14,741
36091061404,3081,2759,90,41,6,36,0,1,322
36091061500,3525,3248,67,24,1,13,0,11,277
36091061600,4328,4005,128,20,2,15,2,9,323
36091061701,6583,5588,291,134,9,272,1,15,995
36091061702,4228,3856,121,14,5,52,0,12,372
36091061800,5359,4644,240,106,10,52,7,23,715
36091061904,6092,5339,197,60,4,215,0,15,753
36091061905,3584,3133,109,39,3,112,5,11,451
36091061906,3271,2660,175,87,12,147,0,13,611
36091061907,4183,3528,195,64,11,183,1,8,655
36091062001,4700,4247,111,62,5,53,3,5,453
36091062002,2568,2400,65,2,0,16,0,4,168
36091062100,1754,1548,76,12,8,13,0,11,206
36091062200,3117,2712,135,64,4,38,0,8,405
36091062300,2046,1828,72,30,3,12,1,1,218
36091062404,3003,2698,75,42,0,125,0,6,305
36091062406,3928,3174,214,56,7,307,0,6,754
36091062407,4448,3616,166,104,8,253,0,30,832
36091062408,2772,2370,93,54,1,138,0,15,402
36091062409,3042,2468,185,66,2,170,0,16,574
36091062410,3978,2730,362,251,4,283,5,35,1248
36091062501,5138,4463,179,92,7,189,0,6,675
36091062503,5806,4710,246,140,7,403,3,24,1096
36091062505,4491,3790,94,47,3,336,0,21,701
36091062506,5729,4522,236,155,0,557,0,26,1207
36091062507,3830,2955,236,131,5,310,1,23,875
36091062508,4474,3587,245,100,4,300,0,12,887
36091062509,3328,2768,116,97,1,177,0,13,560
36091062601,2691,2408,64,40,0,82,0,10,283
36091062602,7033,5604,197,87,4,846,2,35,1429
36091062700,6170,5418,176,101,6,124,0,12,752
36091062800,2038,1739,65,40,8,51,0,31,299
36091062900,829,770,17,0,3,0,1,0,59
36093020101,2342,1428,145,259,2,287,1,54,914
36093020102,2605,983,507,584,20,114,0,118,1622
36093020200,2839,1203,455,567,23,120,3,114,1636
36093020300,1771,977,166,379,5,78,3,46,794
36093020500,4693,2890,445,548,33,218,1,186,1803
36093020600,3179,1607,428,455,32,213,1,188,1572
36093020700,5618,1380,716,1555,152,516,9,641,4238
36093020800,3943,1173,586,1247,54,193,17,263,2770
36093020900,3767,507,566,1151,101,421,13,507,3260
36093021001,926,398,114,306,15,22,0,10,528
36093021002,2311,548,543,914,28,57,8,40,1763
36093021200,2892,1690,344,419,9,94,1,90,1202
36093021400,3526,1011,627,909,57,258,0,242,2515
36093021500,3227,790,546,834,49,141,16,442,2437
36093021600,3709,1346,467,496,120,328,1,482,2363
36093021700,4167,1033,703,978,64,653,11,240,3134
36093021801,2099,1381,177,223,5,91,3,57,718
36093021802,4649,3173,352,565,12,204,5,61,1476
36093031901,4646,3504,159,204,9,557,2,29,1142
36093031902,3315,2603,147,145,5,236,0,35,712
36093032000,7108,5007,358,432,8,846,2,64,2101
36093032101,6027,4431,240,137,9,907,0,37,1596
36093032102,1827,1414,55,41,5,175,0,17,413
36093032200,4657,3906,256,111,1,120,0,17,751
36093032300,2615,2251,105,58,1,29,0,9,364
36093032402,3482,2907,104,93,1,203,0,20,575
36093032403,2174,1906,84,25,2,20,0,3,268
36093032404,6675,5918,204,159,3,85,1,24,757
36093032502,3494,3139,106,40,0,42,0,15,355
36093032503,4023,3562,169,51,2,38,4,9,461
36093032504,2206,2014,57,8,10,22,0,12,192
36093032601,2285,2004,97,54,5,32,0,8,281
36093032602,4328,3734,195,110,3,80,2,12,594
36093032700,4019,3301,242,105,12,52,2,33,718
36093032901,3808,3148,188,107,3,108,0,17,660
36093032902,4391,3596,282,108,6,99,0,33,795
36093033002,2541,2244,67,47,5,46,0,15,297
36093033003,3869,3362,142,106,7,91,3,7,507
36093033004,2987,2458,138,97,5,54,19,7,529
36093033101,2024,1864,42,4,10,9,0,2,160
36093033102,5863,5360,185,26,9,18,0,16,503
36093033200,3405,1949,382,445,12,125,1,136,1456
36093033300,2295,1850,99,109,3,35,1,28,445
36093033400,3219,2079,316,457,2,187,0,76,1140
36093033500,2515,1849,199,275,11,57,0,7,666
36095740100,4913,4422,122,31,9,30,0,18,491
36095740200,4996,4439,211,43,6,57,0,10,557
36095740300,1090,801,141,95,2,37,2,0,289
36095740400,5048,4617,165,22,19,26,0,25,431
36095740500,3538,3155,133,41,14,11,0,17,383
36095740600,2840,2561,82,9,8,11,0,21,279
36095740700,4628,4254,113,17,5,21,1,25,374
36095740800,2661,2409,108,19,5,17,0,7,252
36097950100,4895,4556,111,12,9,18,0,13,339
36097950200,1719,1586,51,14,7,8,0,0,133
36097950300,3045,2885,35,11,3,7,1,3,160
36097950400,3752,3455,63,30,10,54,0,12,297
36097950500,4487,4136,69,24,9,21,0,15,351
36099950100,2401,2215,55,24,4,9,0,0,186
36099950200,2668,2345,90,42,7,45,1,13,323
36099950300,3465,3008,111,74,86,56,0,4,457
36099950400,2894,2521,122,45,8,34,2,7,373
36099950500,3683,3205,151,92,7,22,0,15,478
36099950600,3695,3210,203,73,9,26,0,12,485
36099950700,3657,3359,118,24,2,23,0,0,298
36099950801,991,218,216,536,13,7,0,1,773
36099950802,3868,3480,121,85,2,9,0,8,388
36099950900,4329,3733,146,250,9,21,0,6,596
36099951000,2163,1979,34,18,4,16,0,14,184
36101960100,1258,1187,21,1,2,2,0,0,71
36101960200,3119,2851,60,31,9,16,0,17,268
36101960300,2269,2129,52,9,4,6,0,2,140
36101960400,3732,3447,53,25,17,10,0,17,285
36101960500,2729,2533,48,23,10,0,0,11,196
36101960600,4039,3717,63,41,2,39,1,8,322
36101960700,2858,2473,94,84,5,31,0,9,385
36101960800,2893,2494,65,81,5,44,1,33,399
36101960900,2507,2102,98,79,8,27,0,3,405
36101961000,3379,3132,67,24,11,5,0,5,247
36101961100,4174,3794,78,110,11,15,0,9,380
36101961200,3579,3254,53,81,12,24,0,8,325
36101961300,3671,3433,45,28,8,22,0,10,238
36101961400,2122,1978,26,19,5,7,0,14,144
36101961500,1815,1697,19,1,8,6,2,1,118
36101961600,1684,1520,28,7,2,7,0,2,164
36101961700,3160,2985,26,14,2,12,1,9,175
36101961800,3245,3064,39,10,5,4,2,9,181
36101961900,3295,3055,51,16,7,18,0,5,240
36101962000,4113,3955,36,10,4,8,0,12,158
36101962100,3055,2936,21,5,1,3,0,3,119
36101962200,2397,2225,38,20,9,15,0,3,172
36101962301,5257,3921,86,184,12,827,0,18,1336
36101962302,2838,2563,52,29,3,61,0,9,275
36101962400,2776,2373,102,88,8,57,2,25,403
36101962500,2307,2003,74,69,5,46,0,7,304
36101962600,2262,1941,46,64,0,80,0,11,321
36101962700,3206,2700,123,104,15,94,1,6,506
36101962800,3144,2807,45,52,6,60,0,13,337
36101962900,2839,2472,63,90,7,51,0,13,367
36101963000,3862,3597,46,17,0,19,2,9,265
36103110101,3571,3100,206,9,0,136,0,17,471
36103110103,1997,1726,141,18,0,34,0,11,271
36103110104,3057,2617,200,10,1,119,0,12,440
36103110200,5019,4385,289,54,1,119,1,26,634
36103110300,4677,4066,271,49,2,132,0,31,611
36103110401,2273,2067,114,9,1,32,0,8,206
36103110402,3471,3082,192,18,2,60,0,18,389
36103110501,3169,2825,157,3,0,62,1,20,344
36103110502,2960,2342,316,70,4,129,0,11,618
36103110601,4515,4098,207,23,3,75,0,16,417
36103110602,2832,2465,194,30,1,71,0,5,367
36103110801,1940,1753,97,7,0,28,0,15,187
36103110803,5867,5171,382,43,6,104,1,14,696
36103110901,2821,2263,322,65,1,72,2,7,558
36103110902,4299,1445,1812,718,5,144,3,59,2854
36103111001,2237,1631,276,144,6,95,0,19,606
36103111002,5902,1873,3086,561,8,207,0,41,4029
36103111101,2405,872,1224,122,0,126,0,7,1533
36103111102,2574,401,1852,222,1,56,0,13,2173
36103111103,4247,581,2744,667,8,148,1,24,3666
36103111201,4026,1119,2424,284,6,92,3,24,2907
36103111202,4879,2492,1700,179,1,356,0,26,2387
36103111300,4716,4041,289,77,0,178,2,23,675
36103111401,1377,977,203,70,3,73,1,7,400
36103111402,5054,3535,739,187,6,381,0,38,1519
36103111503,4002,2722,555,385,3,211,0,16,1280
36103111504,2025,1678,131,45,0,112,0,9,347
36103111506,3185,1773,645,358,1,279,0,21,1412
36103111507,2321,450,888,714,2,193,0,26,1871
36103111508,4434,2724,736,509,5,306,0,22,1710
36103111601,3927,3201,432,31,3,103,0,30,726
36103111602,3154,2655,370,27,2,36,0,9,499
36103111701,5693,4543,687,74,4,233,0,22,1150
36103111703,3182,2596,329,52,3,120,0,8,586
36103111704,3274,2818,259,20,1,85,1,7,456
36103111801,6160,4830,536,114,0,484,0,31,1330
36103111802,2860,2405,192,36,2,149,0,10,455
36103111803,2723,2165,218,51,4,206,0,22,558
36103111804,2328,1900,163,20,0,190,0,8,428
36103111900,5385,4231,530,108,3,377,0,19,1154
36103112001,4603,3065,885,82,4,451,0,17,1538
36103112002,4958,3799,543,128,1,322,0,17,1159
36103112102,3900,2833,340,132,3,459,0,24,1067
36103112103,4564,3715,355,70,3,318,0,10,849
36103112104,2251,1353,235,83,7,469,4,8,898
36103112204,3287,2612,247,78,0,235,1,17,675
36103112211,4449,3306,366,167,5,452,0,34,1143
36103112212,3312,2112,216,166,0,681,1,56,1200
36103112213,5566,3136,486,505,7,1176,3,51,2430
36103112215,3771,2707,287,358,2,315,0,11,1064
36103112216,4386,2774,368,253,6,842,0,39,1612
36103112217,2316,1585,213,104,0,318,0,24,731
36103112218,5489,4159,386,62,7,724,2,21,1330
36103112219,3482,2713,192,117,2,401,0,14,769
36103112220,3255,2463,176,179,1,322,0,15,792
36103122300,4311,2702,826,230,1,418,0,26,1609
36103122405,3507,527,648,1855,4,263,0,42,2980
36103122406,7088,144,3289,3317,27,57,0,70,6944
36103122407,1633,392,230,764,1,132,0,32,1241
36103122408,3642,2332,892,214,2,112,0,13,1310
36103122501,4788,231,1916,2388,13,55,0,64,4557
36103122502,4877,159,1322,3086,38,51,0,53,4718
36103122602,4759,2727,809,478,7,552,0,42,2032
36103122603,5485,3358,986,546,10,369,1,50,2127
36103122604,4076,2179,837,472,4,435,0,35,1897
36103122605,1903,988,312,291,9,258,0,5,915
36103122704,2659,989,463,768,3,344,0,12,1670
36103122705,3226,1803,557,367,9,385,0,32,1423
36103122706,4285,2576,625,283,21,617,0,45,1709
36103122707,3113,1915,522,192,5,348,1,40,1198
36103122801,5894,2082,1356,1773,18,433,0,65,3812
36103122802,4847,2551,1087,660,5,368,0,40,2296
36103122901,5905,4164,1034,258,11,266,0,25,1741
36103122902,4562,3186,791,264,0,185,1,21,1376
36103123001,5894,3673,1307,465,10,230,0,54,2221
36103123002,4900,2897,1114,489,3,217,2,23,2003
36103123101,3659,2467,652,280,0,139,0,32,1192
36103123102,3972,2795,663,251,6,132,0,22,1177
36103123201,2306,682,880,555,4,110,2,20,1624
36103123203,3253,107,1445,1497,28,36,1,28,3146
36103123204,5845,552,1910,2961,24,122,4,71,5293
36103123303,4284,194,1813,1992,35,49,3,62,4090
36103123304,5558,834,1903,2469,36,78,2,72,4724
36103123401,4138,2360,1214,245,6,204,0,30,1778
36103123403,1956,894,778,156,0,64,0,9,1062
36103123404,5609,3777,1226,233,8,172,0,42,1832
36103123500,5945,3227,1542,852,11,116,0,37,2718
36103123600,3652,3206,266,37,7,51,0,18,446
36103123701,7050,1286,4561,879,6,119,1,71,5764
36103123703,4147,1695,1868,335,5,120,0,26,2452
36103123704,4632,2071,1985,352,2,100,0,35,2561
36103123801,4058,3170,557,131,4,72,0,37,888
36103123802,3542,2521,663,139,1,113,0,17,1021
36103123900,5129,3642,1044,121,4,181,0,26,1487
36103124001,4588,3511,706,124,0,152,0,14,1077
36103124002,3374,2500,581,93,0,77,0,16,874
36103124101,4557,3390,827,65,5,134,0,23,1167
36103124102,3416,2725,450,102,7,44,0,9,691
36103124200,6084,4780,850,124,7,141,0,36,1304
36103124301,2139,1404,354,190,3,108,0,7,735
36103124302,4422,3241,651,219,7,108,1,22,1181
36103124401,3929,3286,380,67,4,95,0,18,643
36103124402,3437,2818,383,46,1,103,0,14,619
36103124500,4996,4067,467,131,6,157,0,26,929
36103124601,2763,2391,193,35,0,61,1,11,372
36103124602,4429,3763,407,33,0,76,0,15,666
36103134702,6321,5143,620,72,4,290,0,24,1178
36103134703,3785,3279,237,32,0,123,0,10,506
36103134704,2891,2489,173,54,0,113,0,21,402
36103134902,5013,3973,704,37,1,138,0,9,1040
36103134906,5379,4755,347,41,0,140,0,6,624
36103134907,3791,3231,356,32,0,61,0,20,560
36103134908,3356,2737,351,65,0,118,0,11,619
36103134909,4337,3661,301,49,0,150,0,25,676
36103135002,5322,4458,465,42,1,221,0,11,864
36103135003,4734,4030,329,36,6,211,0,7,704
36103135004,3084,2604,255,10,6,99,2,17,480
36103135005,3431,3012,243,39,0,81,0,9,419
36103135101,3965,3090,355,61,9,349,1,21,875
36103135102,4359,3616,307,54,0,279,0,21,743
36103135103,4835,4057,382,37,0,246,0,27,778
36103135104,5081,4262,356,69,5,218,0,30,819
36103135201,2071,1718,148,14,3,134,2,8,353
36103135205,5376,4006,527,250,0,415,0,51,1370
36103135208,2848,2273,220,37,7,230,1,11,575
36103135209,3151,2506,292,71,1,215,0,7,645
36103135303,4296,3337,502,73,0,283,0,12,959
36103135305,1741,1537,92,20,0,48,0,5,204
36103135306,4896,4062,368,52,3,238,0,24,834
36103135401,6422,5063,623,108,5,414,0,49,1359
36103135402,6785,5512,563,100,3,424,0,31,1273
36103135403,4314,3275,530,147,4,194,0,41,1039
36103135500,4712,4016,333,60,0,153,0,40,696
36103145601,6003,762,4417,503,14,157,3,61,5241
36103145602,6592,609,5088,618,10,115,0,79,5983
36103145603,7011,326,5681,709,17,99,0,66,6685
36103145604,5079,346,4038,434,10,106,0,64,4733
36103145605,3869,428,2820,488,3,68,0,29,3441
36103145701,5432,3477,846,260,2,642,1,59,1955
36103145702,6640,675,4910,719,5,135,0,108,5965
36103145703,6011,601,4114,831,12,163,0,167,5410
36103145705,2395,531,918,642,13,179,2,25,1864
36103145706,5359,661,3535,776,14,226,1,59,4698
36103145803,4742,3763,476,103,6,304,0,7,979
36103145804,3567,1651,1135,437,5,219,0,28,1916
36103145807,4239,3139,645,95,0,209,8,26,1100
36103145808,3065,2292,428,76,0,165,0,28,773
36103145809,2062,1385,323,74,1,154,0,29,677
36103145810,3970,2922,584,76,1,166,0,105,1048
36103145901,3458,1024,1677,485,1,123,0,46,2434
36103145903,5894,2882,1850,687,19,223,0,75,3012
36103145904,4579,346,3250,671,12,187,4,44,4233
36103145905,4543,648,2613,890,13,185,0,65,3895
36103146001,5096,391,4047,437,3,114,2,29,4705
36103146002,5499,511,3788,630,9,420,0,51,4988
36103146004,1941,354,1026,343,0,123,0,24,1587
36103146005,6603,1406,3092,1422,16,444,1,66,5197
36103146102,2756,379,1885,307,5,108,4,37,2377
36103146103,4032,2388,1042,244,10,218,0,34,1644
36103146105,7294,590,5376,988,15,149,1,106,6704
36103146106,4761,598,3419,548,4,94,1,48,4163
36103146201,5137,523,3946,500,4,59,0,44,4614
36103146202,5047,266,3262,1294,11,51,2,68,4781
36103146203,6027,638,3900,1175,8,125,0,46,5389
36103146204,6587,568,4880,896,4,71,1,88,6019
36103146205,2311,1660,440,92,2,44,0,7,651
36103146206,2443,1264,784,216,2,90,0,31,1179
36103146300,2607,1360,467,559,9,122,3,14,1247
36103146402,4392,3278,749,152,8,99,0,16,1114
36103146403,5845,494,3817,1198,18,146,3,61,5351
36103146404,3297,782,1822,515,12,68,0,24,2515
36103146500,5323,4023,836,146,13,147,1,34,1300
36103146607,2546,1890,336,88,0,156,0,3,656
36103146608,2629,2015,343,92,4,82,0,19,614
36103146611,3109,2438,283,93,5,206,0,18,671
36103146612,4908,3921,605,93,5,143,0,37,987
36103146613,3568,2835,449,43,0,151,0,19,733
36103146614,5556,4592,522,79,0,265,2,19,964
36103146616,3870,3268,401,22,1,97,0,9,602
36103146617,3436,2916,303,60,1,96,0,3,520
36103146618,5619,3903,834,227,13,472,0,29,1716
36103146619,3072,2247,362,186,1,173,1,11,825
36103146620,1888,1555,166,51,2,75,0,4,333
36103146703,4268,1537,1793,534,4,178,1,59,2731
36103146704,2024,1655,214,33,0,66,0,7,369
36103146705,3252,2811,276,19,1,102,0,6,441
36103146706,2582,2036,317,76,1,82,0,9,546
36103146800,5783,4981,499,24,5,113,0,14,802
36103146901,5273,4698,376,11,0,68,0,5,575
36103146902,4345,3486,684,20,0,62,2,14,859
36103147001,4295,3737,379,26,0,59,0,4,558
36103147003,4625,3680,495,133,2,137,0,18,945
36103147004,693,585,49,10,10,5,0,9,108
36103147100,3181,2718,250,82,0,46,0,3,463
36103147201,3714,2122,877,511,5,76,0,31,1592
36103147202,2905,756,1343,631,7,72,0,12,2149
36103147301,2909,532,1444,677,12,135,1,43,2377
36103147302,4772,2282,1409,730,22,139,3,37,2490
36103147401,5969,4131,1074,325,8,236,0,34,1838
36103147402,3663,3260,234,12,1,47,2,13,403
36103147502,6374,5569,497,39,0,88,0,32,805
36103147503,1977,1732,147,29,1,36,0,0,245
36103147504,1543,1326,103,18,0,60,0,9,217
36103147505,6014,4672,854,152,9,154,0,21,1342
36103147601,2293,2096,106,22,0,24,0,8,197
36103147602,5256,4553,422,64,6,84,2,5,703
36103147701,3525,2987,328,50,2,83,1,5,538
36103147702,4781,4203,339,45,2,67,0,11,578
36103147802,3881,3400,274,26,2,63,0,23,481
36103147803,3190,2811,178,33,5,85,2,7,379
36103147804,5973,5291,368,77,1,52,1,22,682
36103147901,4209,3398,450,131,1,97,0,14,811
36103147902,4400,3903,304,30,3,45,2,20,497
36103158001,3795,3122,218,23,0,254,4,21,673
36103158009,2717,2132,172,31,0,315,0,9,585
36103158010,3680,2912,220,36,0,383,0,20,768
36103158011,4705,3460,356,50,10,684,0,29,1245
36103158012,3829,2769,246,70,0,636,0,16,1060
36103158013,2856,2121,159,61,0,440,0,9,735
36103158014,1066,200,431,250,0,142,0,5,866
36103158015,9343,2458,1317,3266,3,1687,0,110,6885
36103158016,2137,1646,154,58,0,211,0,6,491
36103158017,4385,3520,260,56,2,343,2,32,865
36103158102,5053,3424,996,229,6,241,0,11,1629
36103158103,4343,2619,1033,216,4,316,0,29,1724
36103158107,4211,3024,531,129,5,410,0,9,1187
36103158108,2879,1744,271,98,0,667,1,8,1135
36103158111,3087,2084,539,144,0,212,0,40,1003
36103158112,4263,2653,941,133,5,380,0,12,1610
36103158114,3364,2689,395,100,1,95,0,10,675
36103158116,1928,1326,249,111,0,175,0,10,602
36103158117,2872,1939,565,91,2,189,0,11,933
36103158118,3672,2857,326,65,4,331,0,8,815
36103158119,5740,4021,960,179,13,379,4,25,1719
36103158120,3188,2090,691,100,12,209,1,19,1098
36103158205,1713,1402,151,3,3,92,0,5,311
36103158206,3928,3066,404,60,2,238,2,21,862
36103158207,4842,3864,362,57,0,341,0,33,978
36103158208,4820,3544,738,76,3,291,0,24,1276
36103158209,3296,1862,863,232,2,222,0,13,1434
36103158304,6648,5810,487,62,2,119,2,12,838
36103158306,5948,4944,514,107,12,210,0,16,1004
36103158309,4615,2571,847,751,7,221,1,28,2044
36103158310,4557,3504,468,326,5,102,3,31,1053
36103158315,4502,2810,818,484,6,206,0,27,1692
36103158317,5674,4709,574,96,7,99,5,17,965
36103158318,4268,3543,418,44,6,94,0,5,725
36103158319,3790,2601,583,235,0,250,2,24,1189
36103158320,6172,4432,899,404,3,213,1,25,1740
36103158322,2029,1546,126,35,2,265,0,19,483
36103158324,3096,1963,602,277,2,115,1,23,1133
36103158325,6610,3585,1134,919,11,674,4,41,3025
36103158326,1507,1042,273,61,0,80,1,14,465
36103158327,6601,4159,1743,231,14,255,0,46,2442
36103158328,5281,4354,450,111,6,225,5,19,927
36103158329,1561,1362,107,11,2,35,0,3,199
36103158401,1255,1039,116,19,0,23,0,3,216
36103158402,4330,3703,330,40,2,105,0,12,627
36103158403,2375,1617,316,262,7,84,3,11,758
36103158407,5880,4753,730,79,4,106,3,18,1127
36103158408,3972,3140,571,58,9,53,0,12,832
36103158409,3762,2959,331,167,0,187,2,9,803
36103158410,3389,3164,102,40,0,34,0,7,225
36103158411,3072,2384,362,92,3,91,0,22,688
36103158412,2204,1860,203,37,0,42,0,6,344
36103158502,3373,2617,413,110,1,135,1,15,756
36103158505,3664,2705,392,103,4,364,0,12,959
36103158506,3197,2570,329,45,0,146,0,6,627
36103158509,4871,3193,959,181,13,363,2,32,1678
36103158510,6907,4722,1231,295,4,348,1,59,2185
36103158511,6581,4681,1124,191,0,361,0,25,1900
36103158512,3134,2537,360,48,0,101,2,11,597
36103158513,3065,2032,519,161,3,245,1,34,1033
36103158514,6613,4799,942,170,7,469,0,29,1814
36103158604,4866,3558,719,157,7,305,0,25,1308
36103158605,4945,3605,790,104,2,282,2,15,1340
36103158606,4996,3552,967,109,1,186,2,28,1444
36103158607,3241,2308,560,81,4,188,0,21,933
36103158608,4101,2559,727,195,10,433,0,36,1542
36103158609,4609,3269,676,212,6,264,2,34,1340
36103158705,3981,649,1479,1478,55,91,0,46,3332
36103158707,1796,1345,261,87,2,20,0,15,451
36103158708,3614,2105,506,720,21,96,1,21,1509
36103158709,2822,2204,310,113,6,90,0,12,618
36103158710,3949,2686,514,490,12,70,0,25,1263
36103158711,5736,3621,1120,547,14,251,3,26,2115
36103158712,7744,4179,2366,608,9,257,0,69,3565
36103158713,3004,758,1144,890,8,56,0,20,2246
36103158714,2021,1122,461,180,7,160,0,20,899
36103158715,4482,2995,717,452,7,127,0,30,1487
36103158802,5156,4599,287,42,3,87,0,23,557
36103158803,5825,4380,848,149,5,289,0,22,1445
36103158805,3262,2274,721,103,5,76,2,17,988
36103158806,3505,2180,1078,76,2,55,0,25,1325
36103158901,3183,2136,675,207,3,88,0,9,1047
36103158902,4595,2522,1569,265,14,93,1,23,2073
36103159000,4614,2939,1269,190,2,61,0,16,1675
36103159103,6292,1205,2820,1746,89,78,0,40,5087
36103159106,6120,3223,1570,768,18,255,1,62,2897
36103159107,3711,2635,781,98,5,68,4,12,1076
36103159108,7056,4645,1706,292,3,182,1,25,2411
36103159109,2902,1706,1019,68,2,34,0,8,1196
36103159110,3578,2091,824,376,15,150,0,1,1487
36103159111,3159,2134,734,86,11,72,0,33,1025
36103159112,3810,2096,1081,285,6,167,2,21,1714
36103159201,2830,1949,699,55,0,33,5,7,881
36103159203,5301,4321,618,112,11,66,0,22,980
36103159204,4174,3067,586,286,11,58,0,26,1107
36103159300,2203,1924,118,46,5,34,0,4,279
36103159406,5703,4149,1048,248,7,63,0,20,1554
36103159407,6477,4209,1472,352,13,154,0,29,2268
36103159408,3414,2199,838,148,6,83,0,25,1215
36103159410,8067,6254,1008,408,11,130,1,29,1813
36103159411,3122,2304,583,67,7,33,0,16,818
36103159413,4821,4141,403,71,0,59,0,18,680
36103159414,3175,2443,415,105,2,77,0,10,732
36103159415,1883,1079,325,300,7,40,0,13,804
36103159416,5667,2666,1831,682,18,203,1,61,3001
36103159509,3181,1624,719,568,15,40,0,43,1557
36103159510,359,247,63,22,1,14,0,2,112
36103159511,7051,3255,2278,746,233,154,9,47,3796
36103159512,2312,1470,500,149,8,71,2,14,842
36103159513,4939,3149,1099,315,30,148,0,50,1790
36103159514,3350,2104,651,301,0,90,1,35,1246
36103159515,2493,1655,517,207,12,16,0,16,838
36103159516,5173,2944,1158,690,29,61,2,12,2229
36103159517,3572,2000,1044,231,11,125,1,37,1572
36103159518,5648,3108,1362,717,10,144,0,28,2540
36103159602,4060,3467,339,57,3,66,0,27,593
36103159603,1143,1022,65,21,0,14,0,9,121
36103159604,5058,4304,474,69,4,70,0,12,754
36103159700,2143,1741,182,19,2,128,0,2,402
36103169701,7731,6512,690,160,0,102,0,35,1219
36103169703,1546,1322,157,23,2,12,0,7,224
36103169705,2990,1773,844,212,8,64,2,18,1217
36103169706,4693,3656,712,157,7,37,0,22,1037
36103169800,7070,2394,3644,673,19,105,2,56,4676
36103169903,4482,2708,940,632,12,40,0,23,1774
36103169904,1668,946,398,243,3,25,0,5,722
36103169905,1609,1381,177,22,0,7,1,0,228
36103169906,4113,3189,700,71,2,44,0,8,924
36103170003,2790,2310,376,20,4,21,0,13,480
36103170004,3027,2458,389,51,3,33,1,9,569
36103170005,2552,2284,194,8,1,20,3,7,268
36103170006,1909,1460,337,41,0,17,0,10,449
36103170101,2583,1300,957,197,4,25,0,16,1283
36103170203,1994,1572,287,20,0,31,0,7,422
36103170204,4112,3433,493,47,3,47,0,14,679
36103170205,2289,1730,394,85,0,29,0,11,559
36103170206,2476,2153,183,16,6,32,3,11,323
36103180300,3253,2777,289,21,0,46,0,5,476
36103190402,2650,1904,541,84,4,40,0,14,746
36103190403,3942,2212,1536,46,3,60,0,25,1730
36103190404,3645,1316,1500,680,25,36,3,19,2329
36103190405,5097,1707,2764,421,5,36,0,39,3390
36103190502,3163,2323,598,73,8,69,0,16,840
36103190503,3871,3218,444,46,0,39,1,14,653
36103190504,2682,2182,381,16,2,36,0,17,500
36103190603,5201,3076,1881,52,15,46,0,46,2125
36103190604,5066,2957,1876,37,7,67,1,27,2109
36103190605,1662,1368,134,41,16,58,0,7,294
36103190606,4096,3117,799,17,1,53,0,17,979
36103190706,5245,3633,1118,113,29,140,3,43,1612
36103190708,2580,2305,142,27,4,30,0,15,275
36103190709,3101,1432,749,75,691,53,0,9,1669
36103190710,1894,1106,605,63,5,33,0,18,788
36103190711,3951,3206,525,42,5,62,0,16,745
36103190712,1960,1639,153,25,0,54,1,8,321
36103190713,2245,1862,224,18,4,55,0,21,383
36103190714,3254,2351,463,211,11,91,0,20,903
36103190801,2263,1797,275,44,7,66,0,9,466
36103190802,2287,1421,517,192,12,63,0,25,866
36103200901,1500,1240,174,24,0,24,0,7,260
36103200903,2275,1558,351,204,11,46,0,16,717
36103200904,2701,1412,1147,35,0,30,0,19,1289
36103200905,1941,1524,261,32,16,49,6,4,417
36103200906,2696,1854,602,51,10,61,1,33,842
36103201005,2676,1112,1249,184,8,45,0,19,1564
36103201006,2192,1829,215,42,0,29,2,26,363
36103201007,2024,1536,364,40,0,33,0,12,488
36103201008,2294,1659,440,46,5,29,2,22,635
36103201009,5369,2931,2135,88,5,95,0,15,2438
36103201010,2717,1952,593,24,2,33,1,13,765
36103201200,560,148,290,91,2,7,0,2,412
36103990100,0,0,0,0,0,0,0,0,0
36105950100,3366,2927,222,43,5,41,0,11,439
36105950201,2092,1675,215,35,4,23,0,10,417
36105950202,1198,1008,107,14,1,31,0,8,190
36105950300,1161,1014,72,20,10,10,0,3,147
36105950400,2989,2534,232,31,6,63,0,8,455
36105950500,3075,2093,624,105,13,62,0,16,982
36105950600,1652,1213,220,70,4,30,0,4,439
36105950701,3215,1582,1117,296,15,48,0,16,1633
36105950702,2217,1024,828,214,0,33,0,15,1193
36105950801,2324,1540,397,171,3,71,1,37,784
36105950802,2251,1623,351,118,1,43,0,5,628
36105950900,3518,1641,1316,302,4,98,1,77,1877
36105951000,2315,1119,743,298,1,43,0,23,1196
36105951100,3784,1663,1038,922,16,51,0,15,2121
36105951201,4319,3350,481,149,12,70,0,28,969
36105951202,4214,3162,619,124,7,32,0,27,1052
36105951301,1756,1394,145,51,11,40,1,18,362
36105951302,2366,1727,328,104,3,47,0,17,639
36105951500,2898,1896,556,196,4,64,0,65,1002
36105951600,3400,1967,719,402,6,79,0,26,1433
36105951701,3443,2364,553,212,3,123,0,30,1079
36105951702,808,695,38,18,0,23,1,3,113
36105951801,3008,1261,676,726,15,130,1,40,1747
36105951802,3801,1057,1215,1102,8,176,2,32,2744
36105951900,1546,1114,298,41,0,15,0,17,432
36105952000,2413,2038,205,53,4,17,3,10,375
36105952100,2203,1779,171,140,1,22,0,14,424
36105952200,1448,1272,80,22,0,9,0,7,176
36105952300,1405,1197,96,31,3,27,0,5,208
36105952400,2196,1918,144,27,4,17,0,8,278
36105952500,2243,1844,201,32,10,31,0,7,399
36107020101,2523,2302,36,13,10,10,0,19,221
36107020102,3642,3351,75,6,0,20,1,16,291
36107020200,5149,4679,123,37,8,15,0,15,470
36107020300,6782,6090,176,129,7,93,6,27,692
36107020401,4425,4090,105,28,3,20,0,17,335
36107020402,3916,3542,119,39,0,90,0,10,374
36107020500,3654,3243,121,41,4,44,0,4,411
36107020600,6787,6274,131,33,16,20,0,9,513
36107020701,2968,2665,80,25,3,25,5,19,303
36107020702,4292,4026,65,16,6,8,0,8,266
36107020703,4317,3933,86,67,5,25,0,14,384
36109000100,2064,1193,207,123,2,391,0,21,871
36109000201,3337,1400,274,74,6,1321,2,30,1937
36109000202,2539,1513,272,82,1,492,2,12,1026
36109000300,2780,1709,461,168,30,335,1,3,1071
36109000400,4968,2880,773,288,3,905,1,11,2088
36109000500,4489,2550,316,275,12,1013,0,22,1939
36109000600,5415,3675,333,142,18,942,0,61,1740
36109000700,3641,2566,274,148,4,391,2,31,1075
36109000800,2745,1754,230,275,2,279,0,27,991
36109000900,4201,3201,254,276,10,185,1,27,1000
36109001000,4530,2926,393,559,9,246,2,27,1604
36109001100,6162,4762,404,221,7,419,1,49,1400
36109001200,3324,2427,334,224,5,154,0,16,897
36109001301,3445,1828,252,95,6,1029,3,7,1617
36109001302,3972,2503,229,135,8,884,3,27,1469
36109001400,3595,2825,221,73,10,211,1,21,770
36109001500,6321,4519,280,227,25,864,1,16,1802
36109001600,4263,3729,147,57,5,40,6,16,534
36109001700,4368,3699,169,124,8,40,1,11,669
36109001800,4883,4136,151,146,17,42,1,43,747
36109001901,3105,2622,111,62,10,74,3,24,483
36109001902,3163,2648,139,84,7,43,0,33,515
36109002000,4291,3521,185,212,17,58,0,15,770
36109002100,4203,3539,285,64,6,30,1,32,664
36109002200,4431,3873,165,46,5,28,0,14,558
36109002300,5505,4739,218,94,15,71,3,26,766
36111950100,5010,4345,324,71,4,51,0,17,665
36111950200,3895,3085,453,97,8,54,1,17,810
36111950300,4518,3671,367,135,4,93,1,13,847
36111950400,4025,3468,231,43,0,57,0,26,557
36111950500,3271,2710,221,77,10,84,0,13,561
36111950600,3016,2615,127,39,6,74,0,30,401
36111950900,1297,1083,96,25,7,19,0,5,214
36111951000,4226,3640,248,47,6,59,1,33,586
36111951100,2276,1994,92,26,0,50,0,6,282
36111951200,3902,3293,264,81,37,64,1,13,609
36111951300,4400,3368,476,188,12,92,0,22,1032
36111951400,3640,2827,289,239,11,90,2,25,813
36111951500,3454,2797,258,104,3,78,0,31,657
36111951600,2099,1651,217,71,2,69,0,4,448
36111951700,4712,2886,645,651,6,63,1,36,1826
36111951800,1839,1125,226,285,5,32,0,13,714
36111951900,2848,1690,502,348,4,65,0,21,1158
36111952000,2815,1153,962,381,0,146,0,27,1662
36111952100,3687,1762,953,678,7,48,0,13,1925
36111952200,3761,2943,273,240,8,104,2,27,818
36111952300,1717,1119,239,183,0,82,0,6,598
36111952400,2690,1945,307,190,4,90,0,13,745
36111952500,3527,2819,249,190,0,58,0,22,708
36111952600,6021,5095,354,211,3,53,0,21,926
36111952700,2699,2272,164,60,0,31,4,23,427
36111952800,3083,2641,197,51,0,41,0,23,442
36111952901,3063,2615,176,44,0,61,0,25,448
36111952902,2595,2256,134,22,9,51,0,10,339
36111953000,1815,1524,128,46,4,21,0,18,291
36111953300,4372,3491,417,117,4,114,2,36,881
36111953400,4843,3616,494,256,13,213,0,31,1227
36111953500,5192,3139,924,378,3,448,7,162,2053
36111953600,6116,4445,692,455,5,229,4,49,1671
36111953700,5017,3984,465,226,9,95,7,15,1033
36111953800,3801,2909,462,233,3,51,0,13,892
36111953900,4911,3855,560,261,1,48,0,18,1056
36111954000,5120,4007,632,177,10,38,0,28,1113
36111954100,5304,3160,1423,344,6,49,5,55,2144
36111954200,5610,4657,452,83,3,96,0,36,953
36111954401,4255,3048,684,314,3,101,0,24,1207
36111954402,4734,3852,502,89,11,35,2,30,882
36111954500,4219,2395,723,832,26,55,0,25,1824
36111954600,1689,1255,269,28,8,13,1,27,434
36111954700,1750,1242,303,99,2,20,0,3,508
36111954800,5113,2409,1630,610,17,105,1,34,2704
36111954900,1590,1343,93,40,3,25,0,0,247
36111955001,2382,2041,148,31,4,27,2,12,341
36111955002,3075,2553,219,53,2,59,0,18,522
36111955300,2283,1865,178,24,4,48,1,40,418
36111955400,4574,3037,677,679,9,29,0,9,1537
36113070100,2785,2460,87,50,2,39,0,9,325
36113070200,1862,1542,83,61,5,35,0,7,320
36113070300,3745,3345,125,67,4,19,0,5,400
36113070400,3884,3419,143,46,17,44,0,12,465
36113070500,2554,2192,114,75,12,29,0,9,362
36113070602,1507,1404,30,3,4,15,0,14,103
36113070603,3794,3351,135,87,7,84,0,2,443
36113070604,2407,2188,67,33,2,30,0,8,219
36113070701,4375,3882,127,57,4,105,0,23,493
36113070702,4909,4426,132,35,11,57,0,9,483
36113070801,3959,3557,88,37,11,59,0,24,402
36113070802,3365,3041,76,41,8,37,0,8,324
36113070900,4853,4464,125,33,14,44,0,7,389
36113071000,3079,2826,45,3,4,16,0,7,253
36113072001,2012,1804,69,26,2,36,0,5,208
36113072002,1492,1383,33,4,3,5,0,6,109
36113073000,3959,3643,67,17,4,24,0,3,316
36113073500,1853,1705,40,9,6,6,0,4,148
36113074000,2143,1971,26,9,15,16,0,7,172
36113075001,1627,1511,52,10,3,5,0,6,116
36113075002,1459,1335,25,2,0,5,0,9,124
36113076000,2104,1986,31,6,1,10,0,0,118
36113078000,2010,1864,32,25,0,9,0,5,146
36115080100,4820,4197,93,90,15,40,1,17,623
36115080200,2607,2313,59,29,5,36,2,0,294
36115080301,3089,2757,89,36,4,26,3,10,332
36115080302,2452,2260,55,6,6,3,0,8,192
36115081001,1882,1752,25,13,1,4,0,4,130
36115081002,3930,2108,533,1161,34,19,0,7,1822
36115082001,4880,4533,116,18,15,16,0,5,347
36115082002,1104,1055,11,0,0,4,0,0,49
36115084001,3179,3006,35,20,2,7,0,4,173
36115084002,3036,2841,34,10,10,31,2,2,195
36115085000,2193,2015,36,6,4,6,0,9,178
36115086000,1786,1656,34,13,6,5,0,1,130
36115087000,3644,3346,69,19,3,1,1,14,298
36115088001,2379,2158,51,39,7,12,0,6,221
36115088002,3612,3261,94,20,10,12,5,13,351
36115089000,4868,4496,93,19,8,29,5,14,372
36115090000,2612,2366,97,16,8,10,0,3,246
36115091000,1718,1583,34,13,0,4,3,13,135
36115092000,3280,3017,71,14,6,29,0,6,263
36115093000,1952,1794,46,15,5,23,0,1,158
36115094000,2279,2091,86,6,0,2,0,6,188
36117020103,2675,2453,68,37,2,17,0,20,222
36117020104,2502,2323,70,10,4,10,1,11,179
36117020105,2947,2679,85,45,7,27,0,6,268
36117020106,2322,2071,65,43,7,8,0,14,251
36117020201,4722,4303,140,30,5,45,2,13,419
36117020202,4531,4160,113,43,4,46,0,12,371
36117020302,5372,4870,179,61,8,37,0,10,502
36117020303,3898,3467,137,25,14,52,0,15,431
36117020401,2897,2546,200,17,2,12,2,12,351
36117020402,3963,3347,219,152,18,11,0,3,616
36117020500,4566,4100,199,40,2,8,1,17,466
36117020601,1568,1464,28,13,2,1,0,4,104
36117020602,2402,2153,86,9,5,4,0,6,249
36117020700,3433,3052,108,51,10,26,4,10,381
36117020800,2909,2397,214,139,5,7,0,8,512
36117020900,5119,3717,632,416,14,21,1,19,1402
36117021000,6121,5510,225,101,13,25,0,15,611
36117021100,5084,4012,432,294,9,38,0,11,1072
36117021200,4533,3452,482,277,4,23,0,19,1081
36117021400,3672,2742,255,360,6,5,0,17,930
36117021501,1872,1684,80,35,1,3,0,5,188
36117021502,4002,3629,122,42,14,26,0,5,373
36117021600,4126,3756,166,39,5,4,2,3,370
36117021700,3876,3527,116,40,9,5,0,12,349
36117021800,2171,1816,93,78,1,12,0,5,355
36117990100,0,0,0,0,0,0,0,0,0
36119000101,5731,225,4186,1073,5,101,0,64,5506
36119000103,5850,321,3076,2079,17,176,6,58,5529
36119000104,1016,274,349,268,3,71,0,9,742
36119000202,3905,668,2144,802,1,158,1,45,3237
36119000203,3365,1117,1589,397,2,153,0,29,2248
36119000204,4108,137,3071,640,7,143,0,30,3971
36119000205,3928,203,2734,707,13,165,0,34,3725
36119000300,4638,172,3163,939,16,241,0,41,4466
36119000401,6059,700,2956,1925,4,205,4,57,5359
36119000403,3740,125,1535,1899,2,47,0,32,3615
36119000404,2239,195,1029,857,7,64,0,33,2044
36119000501,2477,106,1548,664,6,91,0,11,2371
36119000502,3544,111,2129,945,0,284,0,7,3433
36119000601,2878,345,1703,683,7,38,0,33,2533
36119000602,4478,560,2210,1319,6,242,0,29,3918
36119000701,3455,1410,1018,667,4,219,1,28,2045
36119000702,5272,1611,1634,1554,10,228,0,56,3661
36119000801,5950,2737,2014,539,18,440,0,57,3213
36119000802,2646,864,1207,325,6,153,2,27,1782
36119000803,4786,1542,2149,626,3,267,2,39,3244
36119000900,3607,1435,1315,418,5,327,2,11,2172
36119001000,1820,177,844,658,9,73,0,10,1643
36119001101,3907,229,2951,605,2,52,0,28,3678
36119001102,5598,727,3204,1255,30,198,2,70,4871
36119001200,5336,541,3788,752,6,142,0,25,4795
36119001301,3883,1058,1921,414,4,330,0,37,2825
36119001302,4101,577,2519,591,16,265,0,60,3524
36119001304,3630,305,2485,549,2,177,0,60,3325
36119001305,3505,222,2514,537,15,116,0,22,3283
36119001401,4244,2246,1217,242,6,394,0,26,1998
36119001402,2003,1292,397,86,0,161,1,19,711
36119001403,3353,1461,1238,276,11,258,0,29,1892
36119001502,3189,1899,733,263,13,171,0,28,1290
36119001503,3167,2247,618,106,0,146,0,15,920
36119001504,5020,2810,1354,377,10,306,2,34,2210
36119001505,2194,815,736,444,2,133,0,21,1379
36119001600,4105,1313,2026,482,5,152,0,19,2792
36119001701,3913,1787,1522,269,7,187,1,39,2126
36119001702,3125,1873,816,131,0,215,0,20,1252
36119001800,1803,192,681,755,0,91,1,29,1611
36119001900,1753,879,494,130,0,172,0,20,874
36119002000,4545,2474,1119,242,0,616,0,42,2071
36119002101,4035,1936,1040,458,3,484,0,28,2099
36119002103,3258,2748,278,48,0,103,0,13,510
36119002104,5290,2440,1595,557,2,550,0,28,2850
36119002105,1926,1308,175,76,0,320,0,5,618
36119002106,2602,396,732,803,2,563,0,17,2206
36119002107,1592,685,351,200,4,296,4,20,907
36119002201,2374,1502,410,135,3,263,2,15,872
36119002202,4709,3462,655,181,2,266,0,22,1247
36119002203,1645,908,393,158,4,134,0,14,737
36119002204,5144,3499,793,369,3,334,3,39,1645
36119002300,3930,2241,1094,239,8,242,0,31,1689
36119002401,1908,966,495,240,3,127,0,11,942
36119002402,3418,1547,1093,436,1,172,0,45,1871
36119002403,5891,2519,2011,732,10,364,0,82,3372
36119002404,2924,1271,997,216,4,314,0,39,1653
36119002405,3057,1560,1017,171,1,215,0,41,1497
36119002600,4349,109,490,3487,21,44,0,60,4240
36119002700,3757,36,403,3172,14,31,1,12,3721
36119002800,2732,28,248,2261,9,55,0,50,2704
36119002900,4273,40,738,3306,10,8,1,36,4233
36119003000,3228,63,389,2509,0,78,2,68,3165
36119003100,3211,115,371,2548,14,45,0,35,3096
36119003200,2954,73,408,2317,0,45,2,24,2881
36119003300,3993,70,485,3248,11,54,0,40,3923
36119003400,4912,158,726,3791,2,32,2,51,4754
36119003500,2354,114,762,1309,2,24,1,62,2240
36119003600,4499,361,1911,1751,5,114,2,129,4138
36119003700,4307,638,1342,1733,10,115,0,199,3669
36119003800,3342,1207,785,970,11,153,0,40,2135
36119003900,3801,1285,832,1079,7,107,0,151,2516
36119004001,3834,236,730,2556,6,54,2,76,3598
36119004002,2959,366,828,1288,2,32,0,191,2593
36119004100,3703,259,695,2463,4,84,0,49,3444
36119004200,4879,895,898,2668,4,95,3,106,3984
36119004500,1548,695,243,503,1,37,0,17,853
36119004600,3155,2400,198,30,0,345,1,31,755
36119004700,3501,2923,189,4,1,168,0,8,578
36119004801,3693,2425,474,396,2,258,0,15,1268
36119004802,3391,2108,487,216,0,414,0,33,1283
36119004900,3275,2403,301,96,0,360,0,17,872
36119005001,3738,2692,285,63,3,552,0,15,1046
36119005002,4572,3690,291,36,0,404,0,20,882
36119005100,4337,3102,512,95,0,474,0,31,1235
36119005200,4979,4109,380,100,0,225,1,36,870
36119005300,5355,3112,927,493,5,451,7,89,2243
36119005400,1971,1527,166,64,5,80,3,20,444
36119005500,5752,4391,563,160,1,313,0,58,1361
36119005600,0,0,0,0,0,0,0,0,0
36119005702,3266,1450,1008,564,4,145,0,24,1816
36119005703,3291,1563,1027,408,6,185,0,19,1728
36119005704,3172,1494,999,401,1,162,3,37,1678
36119005800,4181,1005,2304,521,13,167,0,61,3176
36119005901,5138,1217,2185,1185,3,330,3,65,3921
36119005902,5654,2666,1167,1182,1,387,0,57,2988
36119006000,4335,1480,1383,984,4,290,0,46,2855
36119006100,4099,997,1860,804,12,215,0,69,3102
36119006200,5796,887,4121,539,2,85,2,53,4909
36119006301,3713,454,1928,1009,7,185,2,46,3259
36119006302,3114,446,1798,599,6,191,0,30,2668
36119006400,5504,776,1918,2415,17,163,0,47,4728
36119006500,5762,1365,2180,1670,8,248,2,78,4397
36119006600,6406,3877,1145,860,6,221,1,118,2529
36119006700,5214,4025,365,420,1,190,0,24,1189
36119006801,5595,4260,381,320,4,413,6,65,1335
36119006802,5486,4047,488,443,0,282,1,48,1439
36119006900,6249,4684,580,179,0,464,1,38,1565
36119007000,6601,5305,530,63,4,351,4,62,1296
36119007100,6630,5259,645,149,3,262,0,30,1371
36119007200,7022,4589,1584,285,2,259,0,61,2433
36119007300,5256,2253,2332,245,3,208,0,75,3003
36119007401,4849,2814,1277,205,0,310,0,37,2035
36119007402,3024,2317,350,60,0,194,0,9,707
36119007500,5056,4015,322,26,6,400,3,19,1041
36119007600,6555,5441,425,56,3,374,1,13,1114
36119007700,4981,3596,641,107,3,411,0,25,1385
36119007800,4761,531,3579,471,6,90,0,35,4230
36119007901,3620,746,2584,107,7,61,0,31,2874
36119007902,5089,753,3945,173,0,80,0,66,4336
36119008000,5963,647,4778,271,6,97,0,72,5316
36119008100,5026,1362,3179,122,1,114,0,95,3664
36119008200,7401,3975,2691,189,6,293,0,60,3426
36119008301,2779,1341,1095,98,0,99,0,28,1438
36119008302,7101,5730,440,61,1,623,0,34,1371
36119008401,2233,1849,147,27,0,110,1,13,384
36119008403,3883,2457,579,67,0,617,0,43,1426
36119008404,5111,3191,875,156,1,682,0,54,1920
36119008500,3726,3122,238,40,0,188,1,14,604
36119008602,5387,3379,429,66,5,1310,1,29,2008
36119008700,5745,3657,1649,82,4,217,0,29,2088
36119008801,2031,435,1082,274,0,158,0,23,1596
36119008802,2637,1179,616,339,4,369,1,14,1458
36119008901,5676,2739,1448,521,5,700,0,50,2937
36119008902,3827,1274,1523,573,4,311,2,36,2553
36119009000,4199,1485,1461,598,1,511,0,24,2714
36119009100,5811,1234,3315,719,4,307,0,72,4577
36119009201,4265,1211,1717,683,2,484,0,44,3054
36119009202,3212,578,2060,364,2,85,0,37,2634
36119009300,3679,1027,1151,972,0,403,0,36,2652
36119009400,4290,1298,1959,471,4,399,2,29,2992
36119009500,5175,2292,1722,666,5,307,0,59,2883
36119009600,4541,3557,479,182,1,142,0,44,984
36119009701,3100,2340,320,115,1,171,3,26,760
36119009702,2826,2222,232,115,0,158,1,14,604
36119009703,4290,3371,341,154,0,242,4,35,919
36119009800,4815,3320,273,39,4,973,0,22,1495
36119009900,3126,2254,163,54,3,501,0,27,872
36119010000,5616,3791,228,86,0,1138,0,25,1825
36119010100,4696,2884,258,41,0,1204,0,53,1812
36119010200,5273,4045,462,120,0,283,1,37,1228
36119010300,3317,2332,509,100,4,206,0,18,985
36119010400,3913,2635,680,129,3,299,2,24,1278
36119010500,7628,5113,1023,336,4,755,0,52,2515
36119010600,5091,3242,531,179,3,895,2,31,1849
36119010701,6372,3609,491,128,3,1814,1,68,2763
36119010702,5479,3117,507,150,8,1379,0,46,2362
36119010801,3381,1923,442,287,1,581,0,33,1458
36119010803,3770,1992,696,542,2,369,0,43,1778
36119010804,2591,1518,473,172,0,324,1,23,1073
36119010901,2368,1217,374,476,1,162,0,28,1151
36119010902,5938,1661,1451,1977,8,554,1,91,4277
36119010903,5084,825,1688,2039,8,317,0,48,4259
36119011000,2473,610,726,738,4,287,0,20,1863
36119011101,6551,3316,965,955,11,1080,0,45,3235
36119011102,3106,1946,337,216,1,479,1,12,1160
36119011200,4550,1053,2161,814,12,383,0,37,3497
36119011300,6652,5128,475,108,2,596,0,36,1524
36119011401,4302,2969,663,213,3,276,0,25,1333
36119011402,2172,1324,254,183,1,286,0,17,848
36119011500,5386,2725,1913,279,4,277,0,37,2661
36119011601,3188,509,2417,154,6,38,0,22,2679
36119011602,3431,730,2413,88,1,111,0,32,2701
36119011700,2966,2212,433,32,0,128,0,22,754
36119011800,6722,5052,549,270,6,578,2,27,1670
36119011902,4528,3260,668,111,6,267,0,41,1268
36119012000,4625,3781,499,60,0,200,0,25,844
36119012101,5683,4712,336,38,3,405,0,17,971
36119012102,4659,3627,647,42,5,212,0,22,1032
36119012201,3180,2381,323,140,2,239,0,14,799
36119012202,4333,3143,736,69,1,243,0,13,1190
36119012301,2401,1171,868,130,0,159,0,8,1230
36119012303,5114,4203,317,39,0,376,1,28,911
36119012304,4893,4137,263,27,0,258,0,23,756
36119012400,5082,4264,344,65,3,165,0,19,818
36119012501,3032,2447,273,65,3,105,0,20,585
36119012502,5561,4617,376,66,5,225,0,31,944
36119012503,3672,3043,320,60,0,105,0,20,629
36119012600,4529,3702,430,65,5,122,0,25,827
36119012700,4643,3865,388,64,3,175,0,18,778
36119012803,2976,2344,323,52,2,118,0,24,632
36119012804,4123,2090,1581,156,0,150,0,38,2033
36119012900,4389,1518,2324,239,7,193,0,22,2871
36119013000,6570,3558,2245,200,13,320,1,45,3012
36119013102,6390,4687,481,92,0,784,3,53,1703
36119013103,5324,3876,417,129,2,682,0,19,1448
36119013104,6597,5261,345,46,1,678,0,54,1336
36119013201,3753,2888,210,86,0,392,0,9,865
36119013202,3131,2360,258,78,7,330,0,13,771
36119013301,3991,867,2158,732,6,109,0,46,3124
36119013304,5391,1202,3390,557,9,120,1,21,4189
36119013401,3208,1193,1139,439,1,334,0,22,2015
36119013402,4213,1501,2057,284,4,196,0,30,2712
36119013500,4060,1895,1618,228,4,168,0,27,2165
36119013600,5321,2011,2326,597,11,233,0,27,3310
36119013700,5626,3880,964,260,5,300,4,29,1746
36119013800,3384,2625,409,50,1,126,0,13,759
36119013900,4943,3436,856,159,8,248,0,32,1507
36119014000,2302,1479,529,77,9,64,0,18,823
36119014100,6525,2100,2894,1063,12,127,3,63,4425
36119014200,3994,1068,1951,645,10,122,0,59,2926
36119014300,4240,554,2587,863,5,87,0,36,3686
36119014400,5942,1589,2424,1451,5,240,2,38,4353
36119014500,4730,2409,1304,671,0,149,0,39,2321
36119014604,4363,2931,997,169,0,101,0,21,1432
36119014605,2933,1931,440,339,3,113,2,13,1002
36119014606,5964,4583,674,154,5,264,0,61,1381
36119014607,4447,2873,782,288,0,324,0,23,1574
36119014701,4977,2873,1225,501,5,169,1,29,2104
36119014703,6287,3671,1639,526,8,209,0,40,2616
36119014704,2164,1155,711,145,1,57,1,19,1009
36119014805,4449,3409,528,154,3,227,0,13,1040
36119014806,6591,4804,989,197,9,399,2,25,1787
36119014808,3382,2600,372,67,5,243,1,6,782
36119014809,6255,4630,817,216,1,372,0,44,1625
36119014810,2117,1729,236,70,0,43,0,7,388
36119014811,5736,4324,725,206,2,286,0,24,1412
36119014812,4324,3059,770,168,6,159,0,27,1265
36119014813,3715,2351,808,184,4,241,0,29,1364
36119014901,6280,5232,501,70,0,240,4,9,1048
36119014903,4006,3550,203,46,0,109,0,12,456
36119014907,4176,3267,533,63,0,162,0,15,909
36119014908,3673,2935,443,59,4,137,0,16,738
36119014909,3406,2928,227,40,0,128,0,11,478
36119015000,5243,4270,594,83,4,120,0,26,973
36119015100,5258,2329,719,1696,7,191,5,63,2929
36119981000,1121,523,238,256,0,80,0,3,598
36119982000,1367,135,373,835,6,13,0,2,1232
36119983000,1038,423,188,389,9,24,0,3,615
36119984000,781,384,285,86,5,4,0,4,397
36119985000,2133,1125,485,307,0,107,1,0,1008
36121970100,2592,2430,56,8,0,8,0,2,162
36121970201,2090,504,377,1171,26,12,0,0,1586
36121970202,3700,3473,66,16,4,16,2,18,227
36121970300,3235,3100,33,0,2,4,0,10,135
36121970400,3650,3462,95,5,2,3,3,3,188
36121970500,5316,4850,142,37,14,53,0,11,466
36121970600,5832,4490,475,585,15,47,1,7,1342
36121970700,2711,2493,91,8,1,13,0,6,218
36121970800,2764,2594,57,2,4,6,0,0,170
36121970900,1972,1881,23,4,0,8,0,5,91
36121971000,4187,3971,45,12,9,33,0,1,216
36121971100,2482,2331,30,4,6,14,0,14,151
36123150101,3441,3188,75,21,6,14,0,14,253
36123150102,2259,2100,72,9,0,11,0,6,159
36123150200,5791,5360,179,50,11,14,2,18,431
36123150301,2854,2691,58,5,5,4,0,5,163
36123150302,2296,2164,29,8,0,6,0,3,132
36123150400,3836,3526,138,41,6,31,2,14,310
36123150501,1815,1640,82,9,0,7,2,2,175
36123150502,2482,2380,41,2,0,6,2,15,102
37001020100,4040,2318,518,939,18,41,4,32,1722
37001020200,4137,1228,1447,1220,28,45,6,33,2909
37001020301,4213,1078,1345,1583,27,28,2,20,3135
37001020302,3974,976,1991,837,6,59,0,12,2998
37001020400,6556,1249,1668,3318,10,46,10,36,5307
37001020501,3965,2595,516,617,16,36,6,19,1370
37001020502,4299,1141,1201,1738,18,38,1,18,3158
37001020601,3170,2751,173,105,6,61,0,12,419
37001020602,2509,1860,229,274,6,38,0,7,649
37001020701,5018,3247,509,873,11,176,12,20,1771
37001020702,5063,2450,653,1592,19,82,10,17,2613
37001020801,1930,1042,335,418,4,39,3,2,888
37001020802,6175,1912,1924,2017,22,98,0,5,4263
37001020901,3871,2000,833,787,8,81,4,11,1871
37001020902,3887,2647,566,443,24,71,0,14,1240
37001021000,4091,1391,965,1479,23,29,2,18,2700
37001021101,3984,1986,589,1122,26,52,0,23,1998
37001021102,3587,2233,333,774,7,73,0,14,1354
37001021201,6305,2585,1607,1798,13,32,0,34,3720
37001021204,5217,3194,831,839,33,102,1,12,2023
37001021205,7963,4342,643,2188,24,283,8,41,3621
37001021206,5382,3127,601,1260,21,84,1,43,2255
37001021207,3498,2523,305,452,3,27,0,7,975
37001021300,6178,3770,458,1592,41,47,0,38,2408
37001021400,2668,2312,138,128,9,7,1,7,356
37001021500,4576,3949,161,287,15,6,5,28,627
37001021600,8913,6748,598,1004,19,164,0,31,2165
37001021701,3479,3080,105,167,2,55,0,5,399
37001021702,5897,4729,279,482,9,191,0,33,1168
37001021703,7974,4954,691,1424,20,484,3,56,3020
37001021801,4706,4054,211,249,23,19,3,20,652
37001021802,3618,3169,202,93,9,14,0,8,449
37001021803,3042,2642,145,120,4,4,0,15,400
37001021901,4630,3823,299,278,10,18,0,20,807
37001021902,4424,3270,611,290,9,31,0,18,1154
37001022001,3759,2864,333,333,12,57,3,12,895
37001022002,4717,3248,690,435,29,93,1,21,1469
37003040100,3248,2945,151,43,7,4,0,10,303
37003040200,3877,3547,95,100,9,24,0,8,330
37003040300,3090,2818,75,80,2,14,0,5,272
37003040400,6503,5096,427,640,33,50,0,22,1407
37003040500,6560,5329,630,295,11,51,0,10,1231
37003040600,6320,5066,244,650,37,92,0,13,1254
37003040700,6846,6092,214,111,12,155,1,15,754
37005950100,4058,3423,480,40,20,2,1,0,635
37005950200,3762,2969,615,57,9,13,3,2,793
37005950300,3068,2794,193,6,6,0,2,2,274
37007920100,2783,1252,40,1323,21,15,0,2,1531
37007920200,1411,869,27,462,3,15,0,2,542
37007920301,4504,3100,210,964,11,50,1,4,1404
37007920302,649,520,68,33,0,0,0,2,129
37007920400,2475,603,48,1739,18,18,0,8,1872
37007920501,944,329,17,562,3,10,1,0,615
37007920502,4442,1902,81,2245,14,78,0,13,2540
37007920600,3481,1335,126,1909,7,29,2,7,2146
37007980000,1366,683,48,601,12,6,0,0,683
37009970200,2497,2289,82,8,5,4,0,2,208
37009970300,2390,2275,38,3,3,9,0,5,115
37009970400,4360,3898,319,19,10,20,0,10,462
37009970501,3511,3146,224,36,19,14,3,3,365
37009970502,3007,2590,281,19,1,21,1,1,417
37009970701,3356,3099,120,11,1,10,4,8,257
37009970702,2527,2305,140,8,3,14,3,3,222
37009970801,2146,2016,69,6,2,1,0,4,130
37009970802,2783,2410,246,15,4,9,1,7,373
37011930100,3057,2704,168,54,7,21,0,21,353
37011930200,3431,3085,203,10,9,14,0,6,346
37011930301,3351,2977,229,19,13,9,1,8,374
37011930302,3030,2821,115,12,9,2,0,0,209
37011930400,4937,3962,272,554,20,10,0,9,975
37013930101,2889,2067,228,533,11,0,0,2,822
37013930102,1756,862,149,697,2,8,0,1,894
37013930200,5898,4076,452,1130,9,32,3,10,1822
37013930300,3892,1567,238,1912,12,23,0,17,2325
37013930400,5128,2412,483,2030,8,33,1,20,2716
37013930501,4440,2877,710,716,14,6,2,20,1563
37013930502,3422,2521,417,400,2,14,3,7,901
37013930600,3259,2997,124,45,9,9,0,2,262
37013930700,2663,2364,50,173,7,6,1,7,299
37013930800,2016,1114,60,754,2,1,1,5,902
37013930900,3875,3062,74,601,11,21,5,7,813
37013931001,2599,1696,281,509,2,2,0,11,903
37013931002,2815,1816,167,695,1,9,0,13,999
37015960100,4749,2424,91,2124,9,8,0,13,2325
37015960200,3232,1081,67,1962,3,6,0,9,2151
37015960300,2788,435,44,2210,7,1,0,13,2353
37015960401,3002,1329,26,1493,10,37,0,4,1673
37015960402,4163,1029,102,2885,28,11,0,10,3134
37017950101,2096,1361,263,390,17,0,2,2,735
37017950102,2660,1644,235,645,41,7,1,3,1016
37017950200,2734,1326,425,842,43,0,2,1,1408
37017950301,2524,1387,496,538,31,6,1,6,1137
37017950302,3246,1777,378,872,77,4,0,13,1469
37017950401,3509,1590,147,1633,25,10,0,11,1919
37017950402,2010,894,115,924,19,0,0,0,1116
37017950501,2278,1688,186,307,30,4,0,6,590
37017950502,3371,2289,118,805,51,9,0,0,1082
37017950601,2905,1373,139,1269,39,2,1,7,1532
37017950602,2273,501,44,1280,328,5,1,18,1772
37019020101,2698,1220,385,930,40,2,6,8,1478
37019020102,6040,4467,548,591,38,37,4,11,1573
37019020105,6376,5171,387,490,29,82,0,15,1205
37019020106,2828,2085,222,337,21,35,2,8,743
37019020107,2769,1670,412,491,13,31,0,16,1099
37019020108,3374,1886,386,898,22,25,0,18,1488
37019020201,5169,3833,288,638,29,51,17,39,1336
37019020203,2396,1824,120,313,26,3,0,3,572
37019020204,6424,5548,173,255,33,39,4,21,876
37019020205,8409,7259,269,486,14,112,2,18,1150
37019020206,2061,1583,108,177,16,10,4,8,478
37019020304,8816,8253,160,66,15,72,3,9,563
37019020305,3348,2825,79,268,15,35,1,23,523
37019020306,2578,2242,83,146,7,9,0,13,336
37019020307,268,243,9,10,0,1,0,0,25
37019020308,2024,1888,30,21,6,11,0,10,136
37019020311,2473,2204,46,139,13,9,2,5,269
37019020312,1101,852,69,103,2,5,0,9,249
37019020313,2876,2688,38,15,13,6,2,6,188
37019020314,558,518,18,2,1,0,0,2,40
37019020315,1910,1747,41,19,5,21,1,4,163
37019020316,652,619,10,1,1,0,0,2,33
37019020404,3006,2215,197,424,28,7,1,2,791
37019020405,3166,2708,107,168,30,12,0,8,458
37019020406,921,855,21,5,2,4,0,2,66
37019020407,1918,1696,87,31,14,8,2,5,222
37019020408,2885,2131,351,241,18,9,0,7,754
37019020409,2288,2019,103,35,18,6,1,5,269
37019020504,2024,1838,38,108,8,6,0,2,186
37019020505,3917,2498,430,790,20,19,2,9,1419
37019020508,3039,2742,106,93,12,22,1,3,297
37019020510,2405,2165,135,13,12,12,0,4,240
37019020511,2566,2307,95,41,19,9,1,5,259
37019020512,1170,1110,19,2,3,9,5,1,60
37019020513,1541,1148,167,145,22,4,1,1,393
37019020514,3004,2628,126,102,20,27,1,1,376
37019020515,3581,3150,87,222,7,27,2,4,431
37019020516,4717,4297,137,96,11,34,0,9,420
37019020517,2522,2168,193,47,23,10,0,9,354
37019020518,3234,2867,229,29,15,22,1,1,367
37019020601,4698,3239,377,817,34,13,7,11,1459
37019020602,5618,4103,342,829,55,12,1,15,1515
37019020603,3325,2207,192,758,13,22,1,14,1118
37019990100,0,0,0,0,0,0,0,0,0
37021000100,1563,1214,51,226,6,14,0,4,349
37021000200,1902,1074,76,529,5,18,38,33,828
37021000300,2183,1643,70,346,8,20,0,9,540
37021000400,4436,3518,296,251,23,99,6,76,918
37021000500,3725,3333,116,90,5,38,6,9,392
37021000600,1972,1592,105,141,4,28,0,14,380
37021000700,1648,1123,90,332,0,23,0,17,525
37021000800,3358,2671,165,303,4,36,14,29,687
37021000900,3552,1823,156,1336,10,30,25,22,1729
37021001000,4620,3467,266,480,9,48,24,27,1153
37021001100,5127,4103,316,341,9,54,3,24,1024
37021001200,5381,4304,449,209,9,90,3,27,1077
37021001300,4585,3168,581,492,6,46,50,31,1417
37021001401,5028,3574,802,341,30,38,8,20,1454
37021001402,2442,1044,902,362,3,24,17,2,1398
37021001500,2507,1851,340,100,9,63,3,10,656
37021001601,3432,3079,127,40,1,34,1,23,353
37021001602,3480,2961,207,87,7,46,7,13,519
37021001700,2887,2659,74,29,2,23,1,10,228
37021001801,3512,2540,153,548,12,54,4,28,972
37021001802,4671,3925,189,215,3,75,3,42,746
37021001900,3645,2961,242,182,6,68,9,32,684
37021002000,7131,4673,554,1366,13,62,0,52,2458
37021002101,1469,1363,42,12,0,15,0,0,106
37021002102,5650,3404,1073,708,25,114,4,30,2246
37021002203,6661,3515,1690,943,30,114,6,52,3146
37021002204,9841,7832,678,473,16,357,13,52,2009
37021002205,6815,5572,380,382,10,103,26,38,1243
37021002206,5053,4176,255,248,11,108,7,36,877
37021002303,6716,5308,542,282,17,262,12,18,1408
37021002304,1675,1404,124,16,2,40,0,2,271
37021002305,5967,5160,360,105,16,80,0,28,807
37021002306,3890,3104,400,142,9,59,1,21,786
37021002401,3554,3025,278,31,13,19,1,17,529
37021002402,5660,4417,809,86,9,36,23,27,1243
37021002503,4354,3441,579,82,30,16,0,12,913
37021002504,5135,4456,260,125,14,25,1,19,679
37021002505,5164,4357,394,175,6,34,3,14,807
37021002506,3961,2815,560,221,7,20,81,7,1146
37021002603,3784,3349,191,51,13,12,0,21,435
37021002604,6746,5885,348,63,30,70,5,20,861
37021002606,4158,3210,600,122,8,24,0,19,948
37021002607,4489,3603,503,127,12,47,0,3,886
37021002608,5199,4101,550,191,10,64,28,19,1098
37021002609,1297,1105,88,25,3,5,2,10,192
37021002701,4354,3457,428,226,12,66,0,5,897
37021002702,4633,4072,233,62,22,42,1,15,561
37021002704,4837,4344,164,61,17,28,6,25,493
37021002705,1391,1280,42,5,11,3,0,5,111
37021002803,4410,3482,668,51,14,20,1,16,928
37021002804,5343,4754,317,47,8,26,0,25,589
37021002900,3876,3535,121,34,6,15,0,24,341
37021003002,7296,5870,624,288,34,47,8,43,1426
37021003003,5582,4645,309,258,12,67,4,13,937
37021003004,2615,2312,113,42,3,27,0,12,303
37021003103,1943,1684,87,56,0,19,0,6,259
37021003105,4609,3925,224,201,28,26,0,27,684
37021003106,1696,1474,85,62,2,2,0,16,222
37021003107,4030,3297,332,150,12,32,1,21,733
37021003108,2467,2086,129,127,17,16,0,6,381
37021003201,1773,1564,105,19,0,15,0,11,209
37021003202,4846,4192,204,139,13,81,0,13,654
37021003203,6096,5103,429,165,26,51,0,45,993
37021003204,5925,5311,240,61,12,30,7,25,614
37021003205,1705,1573,37,7,3,6,4,10,132
37023020100,4048,3298,243,290,13,69,8,4,750
37023020202,4377,3427,241,385,17,103,0,14,950
37023020203,2860,2421,67,205,3,24,0,18,439
37023020204,2792,2187,70,356,8,29,0,4,605
37023020301,4691,3534,164,430,21,357,3,17,1157
37023020303,4698,3908,198,137,4,267,2,10,790
37023020304,2741,2414,79,33,10,112,0,7,327
37023020500,2969,1843,651,305,7,46,0,9,1126
37023020600,6363,3352,1997,594,20,104,13,35,3011
37023020801,5219,4097,324,282,19,278,1,4,1122
37023020802,3249,2658,157,120,9,139,9,8,591
37023020901,3598,3229,126,40,3,92,4,4,369
37023020902,3421,2979,99,72,1,121,6,14,442
37023021000,5165,4308,214,64,17,325,0,12,857
37023021100,5946,4885,367,91,17,363,2,18,1061
37023021201,3564,3137,161,40,8,115,0,4,427
37023021202,3902,3349,177,39,4,205,0,0,553
37023021203,4024,3593,90,52,9,147,0,15,431
37023021301,5442,4122,365,656,25,68,5,8,1320
37023021302,3389,3030,98,29,12,55,0,9,359
37023021400,5112,2893,1296,542,11,131,11,26,2219
37025040501,9545,4196,2155,2465,33,123,12,60,5349
37025040502,5641,4015,540,775,21,52,0,11,1626
37025040600,6238,5234,404,295,14,52,1,7,1004
37025040701,1823,1213,274,236,9,9,0,7,610
37025040703,2976,1222,500,1086,4,48,2,8,1754
37025040704,3720,1550,556,1356,6,54,0,30,2170
37025040705,3535,1640,504,1135,7,43,0,27,1895
37025040800,4136,2188,693,1032,7,27,6,8,1948
37025040900,2157,1362,236,433,5,25,0,10,795
37025041001,3495,1998,657,636,19,44,2,15,1497
37025041002,2887,1292,691,717,13,51,2,17,1595
37025041100,7370,4603,1004,1284,12,112,0,35,2767
37025041201,3385,2387,289,513,8,60,0,11,998
37025041202,6064,3875,453,1232,29,202,7,27,2189
37025041301,7633,5223,473,873,15,622,3,49,2410
37025041304,8674,4089,715,1481,17,1921,15,55,4585
37025041305,2688,1838,188,255,13,270,1,3,850
37025041306,6345,2341,474,1271,13,1950,0,96,4004
37025041307,7343,3792,465,1290,10,1430,3,52,3551
37025041503,6114,3212,553,1698,22,334,2,31,2902
37025041504,4409,2975,297,778,20,153,4,18,1434
37025041505,8107,4340,373,1655,24,1361,2,38,3767
37025041506,5302,3228,363,1059,10,376,0,29,2074
37025041507,4450,2538,587,492,16,602,2,22,1912
37025041602,3514,2942,247,134,9,35,0,0,572
37025041603,4992,3729,432,527,15,49,1,32,1263
37025041604,4288,3447,274,302,26,53,6,24,841
37025041701,4259,3827,102,135,26,15,0,12,432
37025041702,3448,3191,84,47,15,24,0,4,257
37025041901,2076,546,974,502,4,0,0,0,1530
37025041902,4360,1777,1406,925,5,22,4,15,2583
37025042000,5698,3058,1046,1238,5,80,1,18,2640
37025042101,3504,510,967,1877,5,3,0,19,2994
37025042102,3709,2045,612,814,6,25,6,33,1664
37025042201,3033,2066,397,352,7,30,1,15,967
37025042202,4601,3480,379,516,4,29,4,33,1121
37025042300,4922,2721,723,1165,15,54,3,14,2201
37025042401,3684,2725,346,398,4,79,3,15,959
37025042402,5870,2260,1079,2058,30,115,4,28,3610
37025042501,4740,3434,472,459,10,177,2,7,1306
37025042502,2728,1459,418,631,9,71,8,13,1269
37025042503,5925,3442,724,1183,5,266,5,19,2483
37025042504,1500,1214,89,117,3,31,1,3,286
37025042601,5626,4151,380,691,13,143,1,21,1475
37025042602,4789,2021,1431,981,14,175,0,27,2768
37025042603,9240,5819,872,1832,11,247,6,57,3421
37025042604,5261,3566,365,756,10,289,2,33,1695
37027030100,5614,3080,986,1179,12,35,5,31,2534
37027030200,5208,3979,437,558,11,6,0,24,1229
37027030300,3798,2673,286,630,10,29,1,12,1125
37027030400,4547,3551,451,315,11,46,0,2,996
37027030500,4792,4070,225,238,7,73,2,14,722
37027030600,4438,3853,338,58,13,26,0,17,585
37027030700,6690,6055,252,102,21,10,0,13,635
37027030801,3538,3182,149,35,11,18,0,11,356
37027030802,4108,3493,283,119,3,13,2,15,615
37027030900,4686,4289,112,74,7,30,3,15,397
37027031000,2804,2588,67,19,2,10,0,12,216
37027031100,4277,3852,126,88,10,14,0,18,425
37027031201,4300,3978,88,31,21,27,0,9,322
37027031202,4327,3881,222,52,11,22,0,4,446
37027031301,4394,3968,133,76,5,68,0,11,426
37027031302,4084,3679,149,65,10,24,0,9,405
37027031401,3191,2810,143,27,15,23,0,5,381
37027031402,3519,3017,211,91,12,37,0,9,502
37027031403,2337,1870,265,86,4,16,2,7,467
37029950101,5754,4505,208,630,25,47,1,33,1249
37029950102,4601,3695,132,419,15,71,0,20,906
37031970101,863,807,26,8,3,0,0,0,56
37031970102,2293,2106,38,50,11,6,2,13,187
37031970103,2689,2546,36,6,3,5,2,3,143
37031970200,1127,1090,9,5,0,0,0,2,37
37031970301,4689,3650,142,631,30,25,3,14,1039
37031970304,2247,1945,44,152,8,18,2,8,302
37031970305,1682,1289,47,280,0,7,2,3,393
37031970401,1834,1335,244,124,7,19,1,12,499
37031970402,1412,953,73,282,12,17,0,2,459
37031970403,1079,995,16,21,7,8,0,2,84
37031970501,2619,1965,243,223,11,27,2,19,654
37031970502,2083,1853,78,65,5,6,5,0,230
37031970503,2074,1692,99,157,4,12,2,5,382
37031970504,2053,1593,279,70,5,31,0,15,460
37031970601,1139,1011,62,21,6,7,0,6,128
37031970602,1159,1052,28,3,1,28,4,2,107
37031970603,1568,1157,261,84,10,6,1,8,411
37031970606,3471,3172,83,39,9,65,1,11,299
37031970701,1127,927,68,39,12,1,2,22,200
37031970702,3708,3069,213,151,30,39,7,5,639
37031970703,5068,3835,297,470,26,113,12,22,1233
37031970704,2244,1973,76,35,14,16,2,11,271
37031970801,3005,2692,98,60,1,16,1,7,313
37031970804,3979,3508,146,137,10,16,9,16,471
37031970805,1698,1441,77,43,10,12,0,3,257
37031970806,3752,3325,150,29,11,46,1,19,427
37031970903,1092,1016,29,3,1,6,0,1,76
37031970904,2757,2529,94,10,3,20,2,16,228
37031971003,1777,1701,21,4,2,10,0,3,76
37031971103,1398,1311,42,6,0,2,0,2,87
37031980100,0,0,0,0,0,0,0,0,0
37031990100,0,0,0,0,0,0,0,0,0
37031990200,0,0,0,0,0,0,0,0,0
37033930100,2297,1159,59,1005,6,3,0,0,1138
37033930200,5517,2571,201,2518,24,36,5,9,2946
37033930300,3787,2772,198,636,8,17,5,19,1015
37033930400,2563,1607,110,769,0,4,1,8,956
37033930500,3675,2519,227,791,12,0,2,4,1156
37033930600,4897,3408,207,1085,15,1,0,17,1489
37035010101,6170,4979,316,197,8,400,0,38,1191
37035010102,4318,3530,240,209,8,163,1,9,788
37035010201,4760,3277,578,179,6,474,1,16,1483
37035010203,3209,2255,312,108,11,383,1,11,954
37035010204,5177,3095,953,550,11,304,1,17,2082
37035010301,5055,3787,767,99,3,147,2,13,1268
37035010302,5913,4804,373,273,13,228,0,17,1109
37035010303,4248,2761,949,136,7,193,0,5,1487
37035010304,4424,2047,1482,421,11,247,1,44,2377
37035010402,5078,3053,853,776,31,112,2,12,2025
37035010403,5555,3564,777,640,9,280,0,30,1991
37035010404,2541,1793,257,261,1,96,2,10,748
37035010501,4092,3211,334,312,8,58,6,2,881
37035010502,3514,2957,190,96,7,128,0,7,557
37035010600,6650,4570,710,807,16,198,7,19,2080
37035010700,2651,1466,516,376,11,133,0,9,1185
37035010900,3607,992,570,1726,10,93,1,30,2615
37035011000,2414,1031,726,449,6,109,3,0,1383
37035011101,3597,2501,337,331,7,241,19,10,1096
37035011102,7367,5337,581,508,32,551,8,36,2030
37035011200,5949,3837,1013,660,7,185,0,16,2112
37035011300,7488,4474,1234,879,33,473,3,20,3014
37035011401,3518,2516,366,313,5,195,0,28,1002
37035011402,3982,3349,242,163,6,113,0,7,633
37035011501,5146,4382,219,265,14,69,0,16,764
37035011503,3822,3459,112,95,10,11,2,7,363
37035011505,3669,3223,126,117,13,34,4,2,446
37035011506,3166,2859,126,66,1,16,0,5,307
37035011601,4402,3135,525,273,2,268,1,17,1267
37035011602,5496,4639,384,173,10,46,1,9,857
37035011701,4267,3398,253,203,13,215,3,20,869
37035011702,7200,5608,429,499,7,323,1,16,1592
37035011801,6230,5181,262,247,20,271,0,27,1049
37035011802,5935,5050,265,221,22,180,8,14,885
37037020103,5520,3470,1199,384,5,250,1,25,2050
37037020104,6082,5039,403,242,13,164,3,18,1043
37037020105,7944,6312,476,350,29,312,6,31,1632
37037020107,2643,2170,134,148,6,38,3,25,473
37037020108,1949,1449,142,241,7,27,0,7,500
37037020201,3007,2340,327,201,10,11,0,14,667
37037020202,3382,2873,139,169,11,33,1,10,509
37037020203,2409,1737,140,395,9,10,0,8,672
37037020300,2742,1802,388,440,7,14,1,10,940
37037020401,5835,1872,2716,1013,5,48,2,36,3963
37037020402,4610,1023,2421,938,0,44,0,31,3587
37037020500,3605,3028,187,229,8,6,3,8,577
37037020600,5199,3780,314,850,19,14,0,10,1419
37037020702,4361,3364,325,379,20,79,0,18,997
37037020703,4549,3743,128,223,8,299,0,12,806
37037020704,2782,2261,112,172,1,123,0,9,521
37037020801,4513,3094,321,821,6,53,0,13,1419
37037020802,2775,1947,266,334,5,60,3,12,828
37037020803,2378,1783,234,239,4,31,1,11,595
37039930101,2284,1885,176,42,34,1,0,4,399
37039930102,2133,1898,53,13,43,22,0,6,235
37039930200,2232,1995,56,20,32,9,0,0,237
37039930300,2333,2084,38,10,64,5,0,3,249
37039930401,3934,3489,99,21,92,17,0,9,445
37039930402,2233,1797,66,141,30,39,0,5,436
37039930501,2002,1796,79,26,11,10,0,2,206
37039930502,3587,3127,142,47,23,31,0,15,460
37039930603,1872,1721,40,8,17,8,0,4,151
37039930604,1744,1518,48,18,34,9,0,10,226
37039930605,2025,1845,49,14,13,4,0,5,180
37039930606,2395,2211,53,13,24,3,0,3,184
37041930101,4905,2152,210,2361,14,26,1,8,2753
37041930102,2195,1500,67,540,2,0,0,6,695
37041930201,4347,3411,199,576,18,8,0,2,936
37041930202,2261,1205,54,899,9,5,0,2,1056
37043950101,2782,2562,81,8,13,11,3,6,220
37043950102,2729,2500,88,8,5,12,0,2,229
37043950201,2405,2140,137,18,6,9,4,1,265
37043950202,3173,2842,132,26,20,8,0,14,331
37045950101,5060,4746,123,70,10,13,2,2,314
37045950102,2636,2413,51,72,2,11,0,3,223
37045950200,4682,3573,123,759,15,16,1,9,1109
37045950301,4841,3340,284,892,8,32,2,23,1501
37045950302,5940,4729,234,643,5,48,4,17,1211
37045950400,7224,4971,307,1447,23,153,0,18,2253
37045950500,3707,2535,141,824,5,19,1,26,1172
37045950601,4019,3170,152,436,5,70,0,23,849
37045950603,3081,2395,78,395,10,91,6,11,686
37045950604,2884,2178,108,416,14,27,1,14,706
37045950701,3659,2348,129,1021,6,41,0,11,1311
37045950702,3804,2278,133,1184,5,64,0,18,1526
37045950800,4378,3014,197,943,6,18,0,24,1364
37045950900,3010,689,125,2040,9,21,1,3,2321
37045951000,3380,1915,132,1178,2,12,4,13,1465
37045951100,3523,1647,258,1411,12,27,0,10,1876
37045951200,5696,3104,321,1862,30,67,0,27,2592
37045951300,2796,2275,119,260,5,20,0,4,521
37045951400,6588,4949,282,1077,12,20,0,10,1639
37045951501,5773,4648,229,617,13,40,0,22,1125
37045951502,1325,1154,51,50,4,0,1,6,171
37045951503,2453,1931,88,331,5,9,0,9,522
37045951601,4344,2775,126,1239,9,20,0,17,1569
37045951602,4716,3386,248,867,7,15,0,7,1330
37047930100,3892,1980,265,1383,100,3,2,16,1912
37047930200,1843,807,69,472,407,4,0,4,1036
37047930300,2332,1553,26,266,396,12,0,7,779
37047930400,3567,1640,328,1174,276,9,0,0,1927
37047930500,4057,2338,160,1358,70,4,0,9,1719
37047930600,2950,2020,114,690,42,3,1,7,930
37047930700,4090,2125,132,1617,77,12,0,12,1965
37047930800,3934,2609,114,1047,37,45,0,11,1325
37047930900,4062,1572,219,2001,71,19,0,8,2490
37047931000,4863,2940,400,1226,81,8,4,15,1923
37047931100,3597,3078,106,307,23,6,0,0,519
37047931201,5120,2831,200,1879,48,23,0,38,2289
37047931202,1831,1001,88,672,12,1,0,3,830
37047931301,2267,1600,221,355,14,2,2,5,667
37047931302,2218,1925,171,56,16,5,1,8,293
37049960101,3787,3264,141,186,9,35,1,21,523
37049960102,4526,3625,227,442,24,20,2,3,901
37049960201,3642,2371,190,939,8,5,0,3,1271
37049960202,4589,2837,208,1334,46,8,0,19,1752
37049960301,3200,2041,153,869,2,21,1,8,1159
37049960302,3088,1930,214,813,6,9,0,8,1158
37049960401,4910,3361,226,874,16,187,4,27,1549
37049960402,3636,1854,146,1271,7,229,2,7,1782
37049960403,4074,3785,71,51,3,39,0,9,289
37049960404,2944,2449,93,264,5,22,5,14,495
37049960501,4149,2144,264,1257,8,243,1,29,2005
37049960502,4042,1742,532,1360,9,190,4,24,2300
37049960600,5335,2306,419,1451,19,908,2,26,3029
37049960700,1840,1318,113,197,0,108,5,2,522
37049960800,2659,640,129,1700,16,48,0,9,2019
37049960900,1669,945,66,536,7,40,0,12,724
37049961002,3902,3028,227,397,5,33,4,10,874
37049961003,6694,5173,420,641,12,132,6,26,1521
37049961004,5522,4197,307,653,13,81,10,35,1325
37049961101,5777,4084,493,602,17,170,15,19,1693
37049961102,3755,2440,362,518,11,129,26,17,1315
37049961201,2254,1280,461,260,12,58,5,19,974
37049961202,2428,1401,586,254,2,85,11,12,1027
37049961301,3316,2029,430,419,17,100,12,18,1287
37049961302,5109,2605,514,1343,25,130,30,45,2504
37049961303,3873,2084,203,1272,19,29,4,24,1789
37051000200,2041,178,115,1572,33,14,1,11,1863
37051000500,2096,834,221,823,66,24,8,10,1262
37051000600,5463,2771,402,1599,47,344,9,37,2692
37051000701,5515,3775,329,636,50,438,5,48,1740
37051000702,2260,1595,140,354,23,54,6,1,665
37051000800,2588,1487,192,682,27,21,0,22,1101
37051000900,4670,2588,403,1175,50,89,14,33,2082
37051001000,2910,361,142,2214,8,28,10,14,2549
37051001100,3937,145,143,3446,17,14,2,4,3792
37051001200,5677,1163,460,3599,59,46,10,40,4514
37051001401,3498,1864,245,1089,95,30,2,11,1634
37051001402,2600,556,130,1574,162,22,6,33,2044
37051001500,2816,1209,296,983,94,31,5,9,1607
37051001603,3703,1449,475,1376,68,41,3,25,2254
37051001604,7877,2349,925,3697,152,128,25,54,5528
37051001605,3765,1753,473,1140,53,61,15,20,2012
37051001606,3736,1475,399,1395,68,90,4,31,2261
37051001701,2742,1219,230,910,87,38,4,23,1523
37051001702,5681,1591,918,2511,114,104,24,28,4090
37051001800,2084,1016,222,570,44,68,7,8,1068
37051001901,2029,891,253,655,49,24,0,5,1138
37051001902,4438,1616,603,1721,51,83,17,18,2822
37051001903,4008,1666,542,1346,98,48,18,28,2342
37051002001,2921,978,430,1133,41,121,11,24,1943
37051002002,4548,1544,644,1859,26,122,38,28,3004
37051002100,4339,1951,474,1366,22,228,11,39,2388
37051002200,2488,933,372,822,9,113,6,26,1555
37051002301,3577,833,346,2099,28,47,8,34,2744
37051002302,1008,306,83,530,9,11,3,2,702
37051002401,1550,197,138,1105,20,3,4,4,1353
37051002402,3288,562,383,2039,25,39,16,21,2726
37051002501,8012,2192,788,4337,63,146,18,33,5820
37051002503,5220,2192,548,1984,25,141,24,40,3028
37051002504,8292,3482,904,2923,56,306,39,68,4810
37051002505,3427,1243,329,1479,37,68,7,32,2184
37051002506,3419,1283,387,1277,25,179,8,38,2136
37051002600,4754,3087,235,1109,57,46,3,18,1667
37051002701,2914,2028,183,453,55,19,1,29,886
37051002702,5570,3217,403,1358,94,74,43,30,2353
37051002801,4457,2816,325,858,101,44,0,19,1641
37051002802,2563,1984,126,195,96,14,5,3,579
37051002900,4197,2768,252,811,142,7,0,11,1429
37051003002,2777,1719,153,657,91,8,1,35,1058
37051003003,7343,3828,719,1810,246,130,11,47,3515
37051003004,7738,4685,661,1513,204,117,19,53,3053
37051003102,6518,3206,845,1348,139,357,7,56,3312
37051003103,6683,2991,755,2096,131,103,29,36,3692
37051003105,4650,2147,547,1422,129,70,8,23,2503
37051003106,2102,1121,219,487,110,8,0,19,981
37051003203,5654,1678,755,2623,73,137,18,61,3976
37051003205,5168,1398,624,2539,30,186,20,45,3770
37051003206,5873,2477,682,1999,72,171,27,41,3396
37051003207,7742,3957,929,1486,96,566,21,76,3785
37051003208,3726,996,459,1884,68,64,8,17,2730
37051003209,4600,1643,627,1714,26,180,30,42,2957
37051003302,5782,938,792,3493,42,176,15,46,4844
37051003304,7157,1858,945,3340,55,363,56,72,5299
37051003307,3885,768,482,2208,15,143,28,25,3117
37051003310,5085,1186,750,2519,44,122,35,63,3899
37051003311,2862,603,415,1570,27,67,8,18,2259
37051003312,6505,1865,956,2938,55,181,33,52,4640
37051003313,6951,1392,1039,3784,47,179,53,30,5559
37051003314,7345,1676,1075,3824,69,138,75,34,5669
37051003315,4191,1108,644,1883,22,215,35,15,3083
37051003316,2133,651,315,839,26,120,29,14,1482
37051003317,3577,1409,491,1242,19,153,26,19,2168
37051003318,2496,812,383,981,10,125,13,11,1684
37051003401,2630,1282,573,348,11,91,52,48,1348
37051003403,3524,1822,906,397,16,77,47,17,1702
37051003404,2469,1433,483,427,34,75,7,0,1036
37051003408,5252,2602,1129,792,36,187,71,35,2650
37051003409,3703,2237,739,385,23,170,19,13,1466
37051003410,4903,2358,1308,708,29,235,32,12,2545
37051003501,3532,915,634,1572,24,117,20,17,2617
37051003502,1752,388,297,921,12,29,8,11,1364
37051003601,2902,926,377,1237,30,106,15,17,1976
37051003602,2119,641,264,934,14,75,14,11,1478
37051003700,7506,4619,611,1501,79,110,17,47,2887
37051003800,2588,435,147,1825,45,8,5,16,2153
37051980100,427,211,87,94,1,11,1,0,216
37051980200,200,73,73,29,1,5,4,0,127
37053110101,1457,1301,70,26,0,19,1,0,156
37053110102,1486,1342,45,0,0,8,2,1,144
37053110201,5126,4086,201,374,17,90,7,23,1040
37053110202,3889,3315,156,154,9,36,2,18,574
37053110301,4721,4061,188,167,26,29,6,17,660
37053110302,3480,2746,154,314,16,33,0,14,734
37053110401,3568,3053,163,90,22,26,1,23,515
37053110403,1734,1392,118,119,1,13,1,8,342
37053110404,2639,2209,123,133,7,11,2,5,430
37053990100,0,0,0,0,0,0,0,0,0
37055970101,4462,4148,104,15,7,33,1,7,314
37055970102,3606,3258,166,17,3,25,3,8,348
37055970200,5056,4362,391,45,15,47,0,30,694
37055970301,4024,3583,197,25,11,40,1,16,441
37055970302,3098,2536,315,43,13,43,1,16,562
37055970400,3182,2894,121,26,5,25,0,17,288
37055970501,1161,952,129,12,5,3,0,3,209
37055970502,4272,3901,188,27,12,17,2,19,371
37055970601,6394,4821,841,449,26,22,2,14,1573
37055970602,1660,1466,102,19,2,5,0,10,194
37055990100,0,0,0,0,0,0,0,0,0
37055990200,0,0,0,0,0,0,0,0,0
37057060101,6265,3782,595,1306,27,279,0,35,2483
37057060103,2894,2641,101,24,7,34,2,12,253
37057060104,5393,4902,200,86,16,29,0,11,491
37057060201,5000,4186,145,463,6,32,3,3,814
37057060202,2342,1945,213,70,6,25,0,4,397
37057060203,6044,5244,300,223,14,43,1,16,800
37057060301,5054,4377,167,285,18,56,4,6,677
37057060302,4840,4089,228,268,13,46,0,18,751
37057060303,4498,4098,131,88,9,27,0,11,400
37057060304,3505,3216,126,44,8,8,2,5,289
37057060400,5628,4792,214,208,25,133,0,15,836
37057060500,5425,4886,211,69,24,22,0,8,539
37057060601,4548,3543,486,228,31,61,2,26,1005
37057060602,3208,2514,325,193,8,73,1,3,694
37057060700,5298,2061,1123,1795,18,69,0,26,3237
37057060800,4363,1722,728,1664,13,35,0,18,2641
37057060900,4888,3153,788,647,20,37,0,23,1735
37057061000,5240,2895,1041,955,27,105,5,19,2345
37057061101,2839,2375,219,76,7,59,1,9,464
37057061102,4353,3755,272,99,32,31,0,19,598
37057061202,3181,2658,256,65,7,71,0,4,523
37057061203,3792,2106,478,596,28,372,1,37,1686
37057061204,2674,1602,453,337,18,142,0,7,1072
37057061300,2291,1389,296,464,13,22,4,5,902
37057061400,3132,1096,617,1229,11,51,0,9,2036
37057061501,4773,1410,1012,2053,11,66,0,16,3363
37057061502,2332,1764,213,193,11,50,1,9,568
37057061600,3152,1634,656,620,23,64,0,21,1518
37057061701,5395,4407,359,288,17,116,3,3,988
37057061703,4306,3708,294,92,21,12,2,9,598
37057061704,3767,3281,177,121,20,5,4,2,486
37057061705,2856,2553,117,62,9,21,0,5,303
37057061803,3524,2395,407,447,22,77,1,22,1129
37057061805,2649,2400,100,48,8,23,2,3,249
37057061806,3333,3045,99,29,13,29,0,5,288
37057061807,2577,2324,56,63,8,11,0,8,253
37057061808,4023,3444,158,199,22,29,0,5,579
37057061902,5067,4690,133,52,27,20,0,1,377
37057061903,3528,3159,190,27,16,14,2,9,369
37057061904,2672,2431,86,29,11,8,0,11,241
37057062001,4525,4275,60,18,7,15,0,13,250
37057062002,3756,3540,72,16,13,18,2,0,216
37059080101,4038,3374,358,115,11,6,0,4,664
37059080102,3451,2800,276,212,14,4,1,11,651
37059080200,5435,4655,338,185,9,69,0,15,780
37059080301,5652,5072,161,146,13,70,3,10,580
37059080302,3449,3049,165,106,13,14,0,4,400
37059080400,5391,4805,184,156,14,15,0,21,586
37059080500,4702,3271,680,513,13,30,1,22,1431
37059080600,4527,3292,477,472,6,50,0,11,1235
37059080701,3298,2555,376,239,1,11,0,14,743
37059080702,2769,1936,360,269,2,8,0,12,833
37061090101,2787,1275,1275,157,4,11,0,13,1512
37061090102,2891,1760,874,162,13,1,0,9,1131
37061090103,1507,735,630,87,9,1,3,12,772
37061090201,1234,568,317,339,1,0,0,3,666
37061090202,2070,969,679,343,8,5,0,4,1101
37061090301,2562,668,483,1327,2,17,0,5,1894
37061090302,2282,705,501,1006,8,7,0,6,1577
37061090401,2410,884,604,842,5,6,0,10,1526
37061090402,2566,1274,293,881,1,8,0,12,1292
37061090503,3385,2714,307,245,17,8,1,2,671
37061090504,1745,1241,223,242,4,2,0,6,504
37061090505,2317,1797,157,263,11,8,0,1,520
37061090506,1829,1052,222,498,7,6,0,3,777
37061090600,2950,2328,173,368,5,14,0,7,622
37061090703,1778,1325,203,192,3,12,0,2,453
37061090704,1782,707,307,731,6,0,0,2,1075
37061090705,2673,1098,792,714,8,10,0,4,1575
37061090706,2840,1116,645,970,19,26,0,9,1724
37061090801,2695,812,1127,712,7,3,0,5,1883
37061090803,1787,896,340,512,4,0,0,3,891
37061090804,2625,1021,661,846,12,10,0,2,1604
37063000101,3282,984,824,1291,1,35,1,12,2298
37063000102,4430,1596,1318,1241,4,62,0,35,2834
37063000200,2893,1461,502,745,8,43,4,23,1432
37063000301,2644,1338,439,647,6,95,0,15,1306
37063000302,3672,2401,594,375,5,98,0,15,1271
37063000401,2564,2003,237,115,0,62,0,6,561
37063000402,2966,1998,314,114,7,363,0,19,968
37063000500,4192,1567,544,1461,11,407,0,54,2625
37063000600,5507,2705,1219,1148,16,174,1,23,2802
37063000700,3701,2211,253,856,6,186,3,18,1490
37063000900,1783,301,638,774,7,7,0,5,1482
37063001001,3879,597,1058,1991,16,85,0,24,3282
37063001002,6140,466,2822,2658,5,20,0,44,5674
37063001100,4151,734,986,2180,19,87,3,14,3417
37063001301,1432,152,208,970,3,14,4,5,1280
37063001303,4052,170,249,3545,0,23,0,21,3882
37063001304,2781,169,501,1962,15,9,0,15,2612
37063001400,2746,80,505,2051,6,13,0,12,2666
37063001501,3430,234,170,2916,0,64,0,0,3196
37063001503,1861,225,93,1467,0,31,0,0,1636
37063001504,3033,811,411,774,4,880,0,33,2222
37063001505,3951,1150,659,1097,10,851,1,25,2801
37063001601,6117,3319,753,1593,13,140,4,60,2798
37063001603,6846,4234,699,1305,20,263,0,33,2612
37063001604,6655,4759,399,1035,8,153,4,55,1896
37063001705,5794,2654,1280,1376,12,209,2,26,3140
37063001706,5252,2744,628,1107,13,484,7,35,2508
37063001708,4895,481,919,3215,12,90,6,41,4414
37063001709,8149,849,1764,5106,28,100,0,32,7300
37063001710,4646,1146,1262,1842,11,148,6,39,3500
37063001711,4748,1223,1121,2081,8,124,0,32,3525
37063001712,4150,3231,230,308,0,223,0,3,919
37063001713,3407,2580,260,282,7,116,0,15,827
37063001801,8293,1956,2412,3541,30,55,8,57,6337
37063001802,7548,716,2968,3558,19,60,1,64,6832
37063001806,6760,2235,1207,2962,12,76,0,44,4525
37063001808,11498,4860,1273,4070,30,666,1,66,6638
37063001809,7316,2841,1079,2649,12,371,3,56,4475
37063001810,3550,525,1359,1496,14,44,0,12,3025
37063001811,6378,1195,1151,3760,18,81,0,13,5183
37063001900,6201,4619,435,541,4,380,0,33,1582
37063002007,5080,2806,475,1410,11,152,0,31,2274
37063002008,3178,2580,155,152,6,123,0,3,598
37063002009,4800,216,1194,3229,2,30,0,19,4584
37063002013,4805,2605,538,1064,11,302,2,32,2200
37063002015,5328,2089,1364,1299,9,359,2,12,3239
37063002019,5134,3659,312,531,11,353,1,30,1475
37063002020,8403,4817,487,1599,10,967,0,53,3586
37063002021,4604,2191,429,1343,4,383,2,30,2413
37063002022,4524,2214,464,1363,8,230,1,39,2310
37063002023,2837,1809,164,597,3,127,1,10,1028
37063002024,7058,4511,490,1187,13,476,0,20,2547
37063002025,6410,2142,847,2649,10,455,0,42,4268
37063002026,6831,1050,1128,4218,5,223,2,38,5781
37063002029,3774,2410,333,491,8,348,0,5,1364
37063002030,4354,3208,232,261,9,339,0,22,1146
37063002031,2201,733,387,794,5,191,0,8,1468
37063002032,3320,721,1139,1031,11,286,1,16,2599
37063002033,4293,3128,261,392,0,310,2,25,1165
37063002034,6052,3385,493,1316,5,519,0,35,2667
37063002035,6682,2669,1008,2192,22,429,1,37,4013
37063002036,4307,1209,462,2143,8,283,1,22,3098
37063002037,7165,2687,482,1923,26,1651,7,55,4478
37063002038,5724,2687,466,1890,20,423,1,32,3037
37063002100,9056,5732,532,2354,53,106,0,24,3324
37063002200,3177,2116,269,483,5,160,0,21,1061
37063002300,2434,871,245,1109,9,90,0,14,1563
37063980100,9,3,5,0,0,0,0,0,6
37065020200,5084,776,138,4012,17,2,3,11,4308
37065020300,5372,483,174,4528,23,13,0,25,4889
37065020400,4335,228,101,3879,8,4,3,17,4107
37065020600,2417,545,242,1549,6,4,0,10,1872
37065020700,1750,571,147,982,4,1,0,1,1179
37065020800,3115,1458,249,1342,2,0,1,0,1657
37065020900,2062,176,100,1737,0,1,0,7,1886
37065021000,3125,1125,121,1738,5,14,0,18,2000
37065021100,3648,1350,503,1680,10,15,2,3,2298
37065021200,4969,2361,161,2262,14,30,0,19,2608
37065021300,4019,2384,316,1178,15,3,0,9,1635
37065021400,3490,2582,142,684,11,4,0,8,908
37065021500,2878,1472,149,1182,7,7,0,7,1406
37065021600,2636,1829,163,546,6,14,0,3,807
37067000100,3239,2027,231,723,0,138,0,10,1212
37067000200,1303,657,91,454,7,32,0,3,646
37067000301,1888,54,118,1646,9,0,0,19,1834
37067000302,1832,92,384,1277,4,1,0,7,1740
37067000400,3232,162,479,2465,12,3,8,8,3070
37067000500,2344,83,498,1714,5,0,2,4,2261
37067000600,1966,50,403,1450,1,1,0,9,1916
37067000700,1577,114,175,1226,0,18,0,3,1463
37067000801,2827,81,322,2306,21,5,1,8,2746
37067000802,2258,644,533,921,6,30,0,1,1614
37067000900,3589,1910,541,900,14,57,0,11,1679
37067001000,3946,2276,618,743,6,91,0,23,1670
37067001100,2765,1825,193,503,5,119,0,15,940
37067001200,2279,1948,62,168,6,20,0,13,331
37067001300,5265,3759,354,626,5,310,2,11,1506
37067001400,3883,628,1128,1936,19,30,1,22,3255
37067001500,4361,521,1826,1852,18,15,0,13,3840
37067001601,3607,148,405,2925,6,33,0,7,3459
37067001602,3101,116,490,2397,8,3,0,12,2985
37067001700,5527,787,861,3631,7,28,0,22,4740
37067001800,4478,373,1710,2239,13,4,4,30,4105
37067001901,1542,309,759,417,2,2,0,5,1233
37067001902,1871,1112,332,282,10,21,1,8,759
37067002001,2536,617,885,937,4,11,0,6,1919
37067002002,3445,976,1423,910,6,38,1,15,2469
37067002100,2111,1565,172,253,0,35,0,7,546
37067002200,3588,2829,183,269,3,134,0,19,759
37067002501,2680,2480,65,32,3,21,0,8,200
37067002502,3017,2742,82,63,0,45,0,1,275
37067002601,2798,2271,139,253,5,47,0,13,527
37067002604,6519,3999,1063,986,10,181,61,15,2520
37067002605,2569,1627,195,507,1,106,0,19,942
37067002606,4317,2953,377,679,15,96,0,24,1364
37067002701,6329,1348,1901,2722,18,57,43,64,4981
37067002702,6141,1321,1130,3230,11,127,10,73,4820
37067002704,3424,929,696,1533,6,65,12,19,2495
37067002705,3266,1842,230,889,6,156,2,4,1424
37067002801,4521,3699,208,436,6,19,1,7,822
37067002804,3706,1682,1006,854,10,25,2,20,2024
37067002806,3285,1053,757,1306,10,35,6,15,2232
37067002807,4889,3055,581,1001,17,23,3,26,1834
37067002808,3934,2710,352,670,11,25,1,19,1224
37067002809,3045,2005,205,637,9,41,4,19,1040
37067002901,4901,2377,960,1302,16,39,1,10,2524
37067002903,3756,1971,839,706,16,31,6,8,1785
37067002904,2027,1713,112,93,8,9,0,7,314
37067003002,4235,1784,399,1837,15,22,3,9,2451
37067003003,3610,2342,359,633,17,74,0,23,1268
37067003004,3824,2806,229,537,13,71,0,17,1018
37067003103,5934,4885,272,486,13,52,0,12,1049
37067003105,3914,2821,307,605,15,10,3,7,1093
37067003106,3152,2792,124,130,12,10,0,8,360
37067003107,4346,3312,324,470,14,31,0,12,1034
37067003108,3569,2059,1019,271,14,35,0,12,1510
37067003201,4937,3705,423,481,18,122,2,7,1232
37067003202,4244,2556,783,657,18,50,0,5,1688
37067003307,3798,2529,298,662,11,72,0,35,1269
37067003308,8301,5686,783,1235,29,175,1,37,2615
37067003309,5603,1652,1147,2518,5,69,0,10,3951
37067003310,4258,1973,703,1295,16,69,1,13,2285
37067003311,1970,1327,173,346,3,39,0,12,643
37067003312,4537,3275,298,676,7,105,5,25,1262
37067003313,1516,1169,226,59,9,14,2,5,347
37067003314,2935,2227,321,229,13,31,0,19,708
37067003315,3729,2663,356,452,13,69,0,22,1066
37067003402,2396,1697,420,137,17,17,0,22,699
37067003403,3375,663,1650,924,7,15,0,9,2712
37067003404,3876,584,1809,1333,11,8,2,12,3292
37067003500,8076,2390,2303,2933,21,86,2,40,5686
37067003600,7037,2994,1900,1670,16,163,3,27,4043
37067003701,4686,1268,1038,2017,23,85,4,18,3418
37067003702,5372,2299,954,1759,16,119,0,26,3073
37067003703,8478,3878,987,2847,20,302,5,75,4600
37067003803,4942,2800,572,1196,16,113,2,27,2142
37067003804,5253,2940,376,1445,17,268,2,28,2313
37067003805,6598,2917,1007,1899,16,455,0,42,3681
37067003806,3158,1897,470,530,11,118,0,3,1261
37067003903,4860,1832,803,1754,15,231,1,29,3028
37067003904,6820,4197,611,1176,17,515,1,31,2623
37067003905,3633,2402,316,577,3,180,5,15,1231
37067003906,3657,3132,140,114,4,133,1,9,525
37067003908,3265,2733,150,122,5,112,0,10,532
37067003909,4671,3634,235,397,4,213,0,22,1037
37067004005,4870,4202,180,225,3,111,1,4,668
37067004007,8016,6579,385,378,14,322,4,26,1437
37067004009,4456,3765,266,160,5,82,0,3,691
37067004010,5145,3680,346,316,11,598,0,25,1465
37067004011,5908,4685,340,404,16,207,0,25,1223
37067004012,6008,4387,474,595,12,273,6,20,1621
37067004013,4104,2508,955,304,12,173,1,22,1596
37067004014,3431,2583,324,244,0,157,1,6,848
37067004015,4624,3404,363,453,11,160,0,24,1220
37067004102,3128,2603,159,208,10,27,0,18,525
37067004103,4244,3099,248,440,13,263,1,20,1145
37067004104,4607,3371,289,533,2,226,2,13,1236
37069060100,4420,2304,340,1606,10,2,2,20,2116
37069060200,3279,2293,219,630,20,8,0,7,986
37069060301,5514,2894,357,2009,15,52,0,43,2620
37069060302,2647,863,456,1203,16,8,0,7,1784
37069060401,2678,1718,286,512,14,16,4,15,960
37069060403,2593,1375,242,865,7,7,0,6,1218
37069060404,3241,1053,324,1666,3,39,1,11,2188
37069060501,9585,6189,962,1810,22,164,0,39,3396
37069060502,9754,7077,847,1287,36,56,2,37,2677
37069060601,2946,2232,262,297,12,7,4,11,714
37069060602,6640,4640,671,980,22,38,0,31,2000
37069060701,1329,550,351,382,10,4,0,5,779
37069060702,2063,1468,162,331,15,3,0,4,595
37069060703,2423,1879,100,315,12,15,0,3,544
37069060801,4142,2022,634,1305,25,16,0,13,2120
37069060802,5319,3728,749,587,20,17,4,25,1591
37071030103,1688,1421,112,75,4,5,0,1,267
37071030104,2307,1941,98,126,5,48,0,4,366
37071030105,3148,2085,198,616,1,70,0,15,1063
37071030106,1306,802,83,297,3,60,0,4,504
37071030205,3827,3228,116,229,19,29,0,11,599
37071030206,2380,1391,237,588,6,39,0,10,989
37071030207,1149,1062,13,27,2,10,1,0,87
37071030208,599,541,20,11,2,5,0,1,58
37071030209,1706,1542,24,55,9,5,0,2,164
37071030301,2337,2037,77,84,8,13,0,0,300
37071030302,2587,2304,94,56,2,13,0,6,283
37071030401,4131,3635,170,129,8,20,1,12,496
37071030403,2002,1718,95,83,7,6,0,19,284
37071030404,2732,1966,192,455,2,46,2,3,766
37071030501,2524,2172,113,92,13,6,0,12,352
37071030503,2192,1825,65,172,9,8,0,11,367
37071030504,1682,1408,103,87,2,4,3,0,274
37071030601,2737,2330,159,114,5,16,0,14,407
37071030602,2469,1953,191,201,2,27,0,10,516
37071030700,3215,2493,131,429,10,14,0,6,722
37071030801,1495,1216,65,145,5,5,0,1,279
37071030802,4270,3213,307,538,14,25,0,11,1057
37071030901,2534,1812,193,327,14,24,3,15,722
37071030902,5069,2301,872,1548,18,66,1,29,2768
37071031001,2712,2022,440,76,5,43,1,12,690
37071031004,3296,2408,212,360,9,164,0,9,888
37071031005,2688,2183,161,191,14,25,3,19,505
37071031006,1824,1463,85,159,4,35,0,4,361
37071031101,2808,1935,145,521,14,47,0,8,873
37071031102,2207,1315,161,551,9,35,3,12,892
37071031202,2467,1693,313,306,12,44,0,9,774
37071031203,1893,1429,151,161,6,37,5,19,464
37071031204,1596,1191,125,156,13,41,0,10,405
37071031301,4497,2593,539,1046,16,116,0,20,1904
37071031303,1727,841,375,414,6,6,0,7,886
37071031304,2996,2190,211,308,12,76,0,21,806
37071031401,2743,1311,416,818,18,23,0,16,1432
37071031402,2364,1886,148,203,4,24,0,5,478
37071031500,3459,1516,534,1250,19,7,1,10,1943
37071031600,3591,2404,193,807,19,18,0,6,1187
37071031703,2990,1607,378,868,6,27,0,13,1383
37071031704,3681,2884,269,323,10,8,0,7,797
37071031705,2108,1621,210,128,17,8,2,16,487
37071031706,1545,1298,67,90,0,3,0,2,247
37071031800,3351,1079,603,1547,7,14,0,18,2272
37071031901,585,243,77,215,0,2,0,6,342
37071031902,2365,321,182,1733,7,1,0,3,2044
37071032000,3099,971,393,1571,12,23,2,18,2128
37071032100,2862,1170,440,1095,12,25,1,14,1692
37071032201,2436,1824,168,260,12,45,0,3,612
37071032202,1858,1503,84,161,12,16,0,9,355
37071032301,3309,2401,181,480,8,110,1,16,908
37071032302,3127,2347,223,233,14,147,11,15,780
37071032403,2961,2567,99,126,10,54,2,4,394
37071032404,3183,2526,131,307,7,66,0,18,657
37071032405,3342,2808,108,199,9,104,0,2,534
37071032406,2464,2037,96,112,21,78,0,10,427
37071032505,4541,1849,777,1533,6,163,2,31,2692
37071032506,3814,1604,666,1285,13,87,2,22,2210
37071032507,4031,2741,294,646,8,155,0,20,1290
37071032508,3028,2390,106,300,14,97,0,8,638
37071032509,2043,1699,72,137,7,60,0,4,344
37071032510,2550,2203,92,93,9,58,0,14,347
37071032600,3959,2672,450,644,6,36,0,9,1287
37071032702,2212,1426,165,433,5,83,0,19,786
37071032703,2020,1147,287,434,7,26,2,11,873
37071032704,4838,2594,611,1360,4,58,0,19,2244
37071032801,2439,1374,226,669,20,23,0,12,1065
37071032802,3721,1997,520,989,12,57,5,11,1724
37071032900,3759,1797,451,1315,6,23,0,9,1962
37071033100,3162,1114,644,1235,5,53,0,9,2048
37071033202,2351,1580,280,368,9,26,0,4,771
37071033203,2521,901,540,964,12,6,0,13,1620
37071033204,3666,1527,511,1434,7,16,0,14,2139
37071033303,3602,2983,149,256,3,73,0,7,619
37071033306,1554,1343,78,46,11,13,1,1,211
37071033308,1311,990,72,158,8,17,0,7,321
37071033309,1933,1536,105,158,7,15,0,5,397
37071033310,1940,1262,290,274,9,10,0,3,678
37071033311,789,651,34,51,0,12,1,1,138
37071033312,3800,2736,240,518,6,179,0,9,1064
37071033313,2297,1775,109,266,0,69,1,3,522
37071033400,2673,1650,459,427,12,5,2,5,1023
37071033501,2495,1907,78,343,21,22,0,13,588
37071033502,2674,2222,116,167,12,31,0,3,452
37073970100,4117,2712,91,1163,12,10,3,7,1405
37073970200,3476,2141,61,1058,21,5,5,6,1335
37073970300,2885,1852,49,801,31,6,2,16,1033
37075920100,2019,1848,36,6,47,1,1,1,171
37075920200,2703,2388,87,26,107,7,0,0,315
37075920300,3308,2649,96,14,416,12,3,3,659
37077970101,4918,3017,232,1509,14,10,0,8,1901
37077970102,3131,1819,148,1033,5,7,3,13,1312
37077970200,4327,2046,342,1788,8,35,6,7,2281
37077970300,3724,1705,389,1486,9,25,2,7,2019
37077970400,4059,1200,221,2473,4,32,0,8,2859
37077970500,3787,1779,459,1430,14,14,2,2,2008
37077970601,6305,4525,446,998,21,34,1,22,1780
37077970604,3946,2549,337,805,18,34,0,25,1397
37077970605,5351,4249,397,359,18,35,5,18,1102
37077970606,2239,1070,200,803,8,34,0,18,1169
37077970607,4945,2516,646,1437,19,74,0,48,2429
37077970701,5437,3887,472,810,17,9,3,20,1550
37077970702,2462,833,723,816,8,5,0,5,1629
37077970703,4329,1620,915,1655,13,10,2,6,2709
37077970704,2032,795,284,913,29,8,0,0,1237
37079950101,3451,1841,695,807,15,5,0,13,1610
37079950102,5807,2568,406,2641,60,10,0,23,3239
37079950200,4160,2106,849,1067,9,2,0,12,2054
37079950301,4304,1745,784,1648,7,4,0,18,2559
37079950302,2729,1384,202,1043,4,16,0,12,1345
37081010100,1626,148,396,994,2,6,2,14,1478
37081010200,4659,1627,354,2119,23,326,0,19,3032
37081010300,2633,546,331,1105,1,551,0,8,2087
37081010401,1484,1229,55,102,5,18,2,6,255
37081010403,1634,1242,69,215,5,39,0,0,392
37081010404,2533,2390,52,20,2,24,0,3,143
37081010500,2102,1741,106,144,4,19,1,5,361
37081010601,2857,2185,201,297,11,54,0,12,672
37081010602,6114,3253,392,2025,11,217,7,26,2861
37081010701,2036,1408,92,325,13,63,4,14,628
37081010702,6928,3177,713,2406,23,235,3,34,3751
37081010800,2946,1791,134,852,4,69,0,9,1155
37081010900,2387,931,151,1130,1,84,0,7,1456
37081011000,5224,91,371,4610,9,20,0,10,5133
37081011101,4194,128,375,3316,26,156,0,33,4066
37081011102,2753,63,253,2337,3,13,0,13,2690
37081011201,3378,527,253,2448,3,57,3,10,2851
37081011202,2818,89,235,2326,11,32,0,15,2729
37081011300,2956,170,346,2288,6,21,4,9,2786
37081011400,5547,413,519,4306,35,39,3,29,5134
37081011500,3866,1192,546,1827,15,102,3,22,2674
37081011601,2578,757,593,893,7,171,2,5,1821
37081011602,3140,608,1131,1096,16,156,2,11,2532
37081011904,5263,890,590,3302,23,225,1,33,4373
37081011905,4781,826,772,2784,15,218,0,27,3955
37081012503,4361,3200,244,582,11,152,1,23,1161
37081012504,3645,1346,355,1709,18,65,0,9,2299
37081012505,4410,3907,121,126,5,90,0,9,503
37081012508,3411,2756,129,244,14,90,1,25,655
37081012509,2325,2014,67,101,1,50,0,24,311
37081012510,3262,2586,133,197,4,218,0,12,676
37081012511,5059,4430,141,219,3,96,0,29,629
37081012604,4778,764,865,2432,27,461,4,32,4014
37081012607,2698,1158,418,824,10,143,1,18,1540
37081012608,2504,319,851,1150,17,71,6,14,2185
37081012610,3219,547,517,1192,14,807,3,20,2672
37081012611,3855,587,852,2122,17,137,0,13,3268
37081012612,6304,902,935,3920,27,259,0,42,5402
37081012617,3475,584,718,1732,13,259,18,18,2891
37081012618,3479,676,591,1948,24,53,2,46,2803
37081012619,3446,1350,267,1554,5,109,0,16,2096
37081012620,3806,691,838,1762,26,313,6,24,3115
37081012621,3914,912,729,1552,18,522,0,24,3002
37081012703,5505,2725,459,1644,22,431,1,29,2780
37081012704,3654,622,565,1716,17,591,0,12,3032
37081012705,4168,124,312,3484,1,90,0,5,4044
37081012706,3399,195,487,2487,8,106,1,18,3204
37081012707,2677,199,507,1788,13,66,3,9,2478
37081012803,9306,1687,977,5901,36,306,0,27,7619
37081012804,4299,319,363,3362,31,55,0,17,3980
37081012805,2817,327,215,2042,10,99,3,9,2490
37081013601,4668,3235,379,754,12,97,9,152,1433
37081013602,4111,1381,682,1646,20,175,1,25,2730
37081013700,4123,3018,221,488,11,223,3,21,1105
37081013800,3977,483,525,2634,24,150,0,29,3494
37081013900,4425,390,463,3260,14,59,1,32,4035
37081014000,3197,1132,757,956,25,209,0,14,2065
37081014200,4043,515,749,2195,6,384,2,34,3528
37081014300,2943,519,821,1108,11,399,0,14,2424
37081014406,2511,402,230,1540,11,235,1,15,2109
37081014407,6129,3573,502,1430,22,358,1,25,2556
37081014408,2427,525,536,1151,16,97,0,4,1902
37081014409,3038,1714,338,642,11,212,0,30,1324
37081014410,3974,1794,402,1348,17,228,1,25,2180
37081014411,5480,1459,567,2871,17,366,0,74,4021
37081014412,2823,1583,261,698,7,170,0,8,1240
37081014501,1225,480,374,224,17,89,0,4,745
37081014502,4692,1266,768,1366,18,1139,0,15,3426
37081014503,3435,524,510,1858,14,362,4,22,2911
37081015100,5594,3296,395,1561,18,96,4,21,2298
37081015201,5363,3646,339,1073,26,29,0,18,1717
37081015202,6477,3194,407,2269,18,166,0,41,3283
37081015301,5506,3143,344,1738,16,79,0,27,2363
37081015302,4621,1547,477,2278,13,76,5,22,3074
37081015401,5446,2843,344,1886,26,51,1,22,2603
37081015402,7760,2526,1095,3645,29,156,0,28,5234
37081015500,7211,1919,587,4188,30,106,0,41,5292
37081015601,5439,4488,221,365,15,150,4,12,951
37081015602,6245,4249,541,1030,30,110,5,18,1996
37081015703,6590,4048,399,1439,14,339,2,34,2542
37081015704,6347,4161,319,1196,13,286,2,47,2186
37081015705,2966,1751,195,754,12,103,0,14,1215
37081015706,6193,3661,389,1576,14,329,0,10,2532
37081015707,6473,4464,273,1244,25,195,2,29,2009
37081015800,8668,6903,557,418,16,421,4,38,1765
37081015901,6175,5199,364,272,30,96,0,21,976
37081015902,4615,3644,239,259,4,293,0,26,971
37081016003,4902,3617,278,373,2,418,2,25,1285
37081016005,1837,1370,74,127,5,204,0,9,467
37081016006,4211,2244,276,808,14,663,0,35,1967
37081016007,5059,3436,268,690,13,401,3,29,1623
37081016008,7620,5018,531,850,10,874,4,22,2602
37081016009,3888,2813,276,374,8,212,0,17,1075
37081016010,2698,1783,225,453,2,93,0,15,915
37081016011,5733,2152,626,2371,30,282,4,27,3581
37081016101,4684,3477,278,550,8,173,4,59,1207
37081016102,3788,1661,450,1346,16,83,2,24,2127
37081016103,5299,2207,564,1987,14,200,6,33,3092
37081016201,6753,5199,393,292,29,555,1,26,1554
37081016203,5221,3532,295,760,15,423,0,25,1689
37081016204,4557,2487,265,716,8,882,0,24,2070
37081016205,4650,2237,450,768,23,936,2,35,2413
37081016303,3380,2486,198,367,9,222,0,8,894
37081016304,3688,2640,215,453,4,212,6,25,1048
37081016305,3484,2395,186,496,6,252,3,19,1089
37081016306,5452,2579,511,1692,13,407,6,31,2873
37081016405,1770,603,166,866,10,24,0,17,1167
37081016406,4228,2072,361,1139,15,451,6,37,2156
37081016407,4496,2447,314,945,8,592,2,11,2049
37081016408,1972,1628,63,108,0,88,0,13,344
37081016409,2496,1862,89,334,4,83,2,8,634
37081016410,5450,2358,561,1735,17,512,0,35,3092
37081016502,6553,4070,685,1060,31,443,3,31,2483
37081016503,5480,2120,516,2061,18,507,1,28,3360
37081016505,5239,2395,431,1624,19,509,4,18,2844
37081016506,4845,2712,405,1010,22,452,0,22,2133
37081016600,2452,1661,256,167,13,266,1,4,791
37081016701,6046,1729,612,3202,39,203,0,35,4317
37081016702,3754,2943,458,135,31,22,0,5,811
37081016800,7802,3459,1242,2613,35,117,5,59,4343
37081016900,4697,4021,196,286,28,27,3,12,676
37081017000,4675,4167,174,138,12,10,4,21,508
37081017101,5582,4011,214,1013,27,96,0,17,1571
37081017102,2366,1509,192,520,19,42,3,14,857
37081017200,9369,5516,602,2577,53,196,0,65,3853
37081980100,0,0,0,0,0,0,0,0,0
37083930100,2908,624,55,2114,12,6,2,15,2284
37083930200,5164,3306,182,1367,29,147,1,6,1858
37083930300,4541,2900,219,1172,29,25,3,8,1641
37083930400,3467,1861,101,1330,18,50,0,6,1606
37083930501,3813,1563,191,1908,18,0,1,7,2250
37083930503,2025,1227,41,676,11,13,0,0,798
37083930504,3183,1045,88,1951,11,0,0,7,2138
37083930600,3636,1551,49,1921,19,13,0,12,2085
37083930701,1111,341,26,712,10,4,0,1,770
37083930702,2468,1372,49,951,21,7,0,12,1096
37083930800,4687,500,111,2467,1359,4,1,18,4187
37083930901,1342,284,14,998,12,2,0,11,1058
37083930902,2764,287,59,2334,15,0,3,6,2477
37083931000,3059,858,100,2027,20,4,0,13,2201
37083931101,1303,613,47,603,1,6,0,8,690
37083931102,3151,738,122,2206,8,0,0,12,2413
37085070100,3870,1959,399,1235,54,30,2,8,1911
37085070200,2937,1295,231,1272,27,12,0,3,1642
37085070300,4680,2813,425,1221,38,33,0,22,1867
37085070401,4133,2809,599,484,23,30,2,23,1324
37085070402,6658,4259,1260,811,39,21,3,34,2399
37085070500,6054,4018,726,977,69,13,7,7,2036
37085070600,4497,1960,344,1851,67,14,10,40,2537
37085070700,5514,2805,536,1826,41,37,6,37,2709
37085070801,2726,1845,411,343,18,23,0,14,881
37085070802,5289,3805,319,838,41,106,5,32,1484
37085070901,2844,1631,665,403,4,19,0,18,1213
37085070902,2816,1706,691,310,7,19,1,10,1110
37085070903,2293,1311,557,337,3,9,0,4,982
37085070904,3937,2398,837,495,23,20,0,23,1539
37085071002,3593,2815,347,270,18,10,6,17,778
37085071003,4034,2864,409,533,17,22,0,19,1170
37085071004,1915,1455,212,146,5,10,1,9,460
37085071101,3366,2280,580,354,8,19,0,2,1086
37085071102,5014,3142,798,814,21,15,9,17,1872
37085071201,3164,1920,363,621,27,28,9,14,1244
37085071202,4551,2035,644,1383,55,78,20,19,2516
37085071203,2692,1113,326,922,25,65,10,22,1579
37085071204,7201,4254,875,1344,57,114,15,71,2947
37085071301,4293,2642,572,782,25,34,15,12,1651
37085071302,7127,3935,1037,1405,46,87,14,64,3192
37085071303,12164,6462,1771,2554,81,310,38,87,5702
37085071401,4422,2436,838,773,39,52,3,20,1986
37085071402,11784,5909,2127,2465,100,178,66,59,5875
37087920101,3811,3512,152,14,16,17,0,10,299
37087920102,3997,3743,98,5,15,6,0,15,254
37087920201,1318,1173,60,12,10,0,0,3,145
37087920202,5239,4774,247,34,21,28,0,8,465
37087920300,3458,3007,108,152,21,12,0,9,451
37087920400,1964,1737,96,28,15,7,0,6,227
37087920501,2044,1824,128,6,8,4,0,9,220
37087920502,4596,3997,262,89,24,29,1,10,599
37087920601,2326,2056,164,9,10,24,0,7,270
37087920602,2772,2559,83,28,10,17,0,0,213
37087920701,2358,2126,87,9,11,32,0,5,232
37087920702,1789,1602,62,20,13,13,0,4,187
37087920800,3211,2956,97,15,21,13,0,4,255
37087920900,1819,1522,135,34,14,29,0,2,297
37087921000,3339,2910,208,75,17,25,0,5,429
37087921100,2620,2326,134,31,17,26,0,0,294
37087921201,1800,1495,127,44,14,16,0,6,305
37087921202,4115,3623,224,22,24,33,0,16,492
37087921301,4196,3885,127,6,14,17,0,13,311
37087921302,5308,4857,225,23,12,12,0,23,451
37087980100,9,1,5,0,1,0,0,1,8
37089930100,4622,3757,534,90,17,20,6,12,865
37089930201,3974,2931,796,49,12,19,27,15,1043
37089930202,3340,2111,988,67,11,35,4,6,1229
37089930301,4089,2801,888,161,7,70,2,16,1288
37089930302,3892,2774,887,64,18,17,12,12,1118
37089930401,2677,1966,453,112,7,21,1,7,711
37089930402,3021,2437,416,52,6,17,8,2,584
37089930501,5566,4179,616,311,10,192,2,24,1387
37089930502,4897,4056,421,144,13,79,1,18,841
37089930600,5437,4200,518,298,28,161,1,23,1237
37089930701,3669,3211,225,56,5,36,8,5,458
37089930702,4644,4136,240,43,13,23,17,25,508
37089930703,5849,5056,363,87,10,72,2,23,793
37089930800,5075,4175,533,88,10,70,20,16,900
37089930900,3346,2607,486,75,4,37,3,18,739
37089931000,6081,4431,1078,225,14,110,5,11,1650
37089931100,2324,1408,399,376,4,19,17,8,916
37089931200,2291,1589,319,274,4,12,15,7,702
37089931300,4055,2524,1215,99,12,52,8,26,1531
37089931401,3965,2182,1453,149,17,28,22,6,1783
37089931402,2323,1448,628,77,5,30,24,9,875
37089931500,3982,3648,135,60,7,23,4,8,334
37089931600,4874,4152,326,119,23,45,11,20,722
37089931700,2881,2651,88,25,1,17,7,16,230
37089931801,3319,3067,89,23,0,28,1,12,252
37089931802,4414,3931,240,57,4,24,1,4,483
37089931901,4086,3462,330,78,4,9,5,27,624
37089931902,3082,2801,112,24,5,16,3,14,281
37089932000,4506,4056,223,16,13,14,4,10,450
37089980100,0,0,0,0,0,0,0,0,0
37091950101,3483,1134,273,1941,14,21,0,37,2349
37091950102,3235,1029,150,1899,8,9,0,15,2206
37091950201,2182,711,35,1342,24,0,0,4,1471
37091950202,1650,469,44,1006,54,0,1,12,1181
37091950300,2633,1130,86,1273,16,0,1,10,1503
37091950401,3362,1381,58,1762,24,42,1,2,1981
37091950402,3792,804,82,2704,47,29,0,19,2988
37091980000,1215,63,851,288,1,12,0,0,1152
37093970104,4622,1722,663,1749,78,60,14,30,2900
37093970105,5511,1624,1090,2195,71,106,27,35,3887
37093970106,6500,3051,1018,1652,54,147,49,62,3449
37093970107,7622,2563,1507,2582,175,136,26,55,5059
37093970108,5264,2781,682,1151,157,61,18,55,2483
37093970109,3428,1274,619,1168,71,56,14,36,2154
37093970201,4129,2071,339,1118,264,42,9,18,2058
37093970202,3991,1294,499,1276,659,20,13,18,2697
37093970300,4758,1601,596,2127,183,38,1,6,3157
37093970401,3507,1219,314,619,1095,36,8,7,2288
37093970402,2742,461,360,748,996,14,10,14,2281
37093980100,8,6,0,0,0,0,0,0,2
37095920101,2305,1502,220,499,0,0,2,9,803
37095920102,2284,1426,127,653,7,7,0,6,858
37095990100,0,0,0,0,0,0,0,0,0
37095990200,0,0,0,0,0,0,0,0,0
37097060100,5926,3366,744,1447,15,66,0,37,2560
37097060200,2085,259,289,1421,12,4,0,2,1826
37097060300,2648,727,579,1176,1,35,0,9,1921
37097060400,4042,1495,567,1771,15,30,0,11,2547
37097060500,4342,2404,398,1286,6,42,0,26,1938
37097060601,6425,3135,918,1849,9,252,0,38,3290
37097060602,2030,1746,77,83,2,49,0,6,284
37097060603,1551,883,268,329,2,26,2,0,668
37097060701,3007,1998,566,271,5,52,1,7,1009
37097060702,4103,2998,497,370,15,80,1,17,1105
37097060703,2810,2162,252,251,9,49,0,4,648
37097060801,3503,2700,435,196,13,16,3,4,803
37097060802,3609,2716,396,305,8,11,0,17,893
37097060901,3282,2934,210,18,13,10,0,2,348
37097060902,3802,3418,165,102,6,11,0,9,384
37097061001,4048,2986,411,358,13,78,0,20,1062
37097061002,4063,3156,344,314,7,83,0,10,907
37097061003,3848,2868,258,506,10,52,0,10,980
37097061101,2724,2126,217,213,5,60,0,3,598
37097061102,3329,2474,276,288,6,152,2,13,855
37097061103,2812,2344,131,183,0,21,0,0,468
37097061104,2194,1750,176,154,11,22,0,13,444
37097061201,5186,4076,383,400,9,87,2,16,1110
37097061202,5086,4015,227,572,8,60,0,29,1071
37097061203,6614,5141,522,455,16,223,0,27,1473
37097061204,4390,3797,162,106,0,125,4,18,593
37097061205,3895,3530,116,133,3,12,0,7,365
37097061301,2874,2284,255,180,8,27,1,3,590
37097061302,5012,3900,413,374,20,33,3,18,1112
37097061303,5400,4394,292,296,16,110,6,16,1006
37097061304,5780,3880,582,736,27,275,0,29,1900
37097061401,5221,4555,238,68,17,154,2,4,666
37097061402,7339,5580,558,411,19,471,9,28,1759
37097061403,3812,2742,430,292,9,173,1,10,1070
37097061404,3115,2470,119,137,13,243,0,15,645
37097061405,3625,3134,217,44,5,83,3,13,491
37097061406,5067,4494,216,60,2,113,4,8,573
37097061407,4506,3935,181,141,5,78,2,4,571
37097061408,5389,4234,354,405,9,103,4,30,1155
37097061501,4898,3205,412,826,10,66,6,29,1693
37097061502,5000,3863,445,337,12,87,0,22,1137
37097061503,4928,3883,250,489,11,53,0,27,1045
37097061601,3402,1749,437,983,6,67,0,16,1653
37097061603,5467,3583,529,427,22,636,0,13,1884
37097061604,1459,1028,66,278,2,13,0,0,431
37097061605,3045,2276,199,214,5,225,2,16,769
37099940200,6141,2086,341,32,3203,71,0,12,4055
37099950200,1855,1665,57,10,34,2,0,2,190
37099950300,5538,4470,462,100,176,101,0,17,1068
37099950400,4335,3569,313,63,71,91,2,18,766
37099950500,5713,4942,259,47,190,36,2,20,771
37099950600,11518,9217,1096,433,129,142,6,17,2301
37099950700,2950,2557,184,36,39,19,0,7,393
37099950800,2224,1822,335,2,4,4,0,7,402
37099950900,2835,2472,245,13,3,31,0,5,363
37101040101,2802,1806,356,498,8,13,0,6,996
37101040102,2383,1632,412,196,7,5,0,25,751
37101040103,2223,1676,269,180,13,1,0,3,547
37101040204,4645,2513,1075,843,21,13,3,19,2132
37101040205,6321,4559,854,578,22,30,0,32,1762
37101040206,4570,3349,770,275,18,13,3,3,1221
37101040207,12721,8865,1151,1834,43,218,6,70,3856
37101040208,4567,2855,576,795,17,32,1,31,1712
37101040209,6811,4764,768,710,30,110,6,35,2047
37101040210,2303,1860,147,184,10,15,4,8,443
37101040301,4105,1493,1222,1179,10,25,1,5,2612
37101040303,3501,653,1533,1188,5,11,0,18,2848
37101040304,2188,1117,519,468,9,7,0,2,1071
37101040400,5070,3276,1117,461,5,11,0,19,1794
37101040501,4735,3464,503,545,14,35,7,19,1271
37101040502,2269,1694,321,157,9,7,3,5,575
37101040600,3461,1669,694,959,11,16,0,16,1792
37101040700,3406,1485,747,975,8,72,5,17,1921
37101040800,3495,1956,780,634,5,24,0,15,1539
37101040903,9106,6026,1283,1300,30,104,3,27,3080
37101040904,4839,2204,1262,1165,33,12,0,13,2635
37101040905,5298,3153,1093,780,29,24,0,20,2145
37101040906,2313,1513,371,288,9,17,0,8,800
37101041001,11160,4952,2202,3253,30,145,0,93,6208
37101041003,3727,2188,495,753,13,74,1,24,1539
37101041004,2344,1240,383,566,7,24,0,10,1104
37101041005,4075,2668,523,656,14,36,0,4,1407
37101041104,4880,3073,852,701,16,26,0,20,1807
37101041105,3918,2481,536,686,13,28,0,7,1437
37101041106,5392,3765,594,684,26,37,0,22,1627
37101041107,5155,3349,709,741,14,62,0,47,1806
37101041108,3910,2487,313,753,12,73,9,28,1423
37101041109,3207,2308,251,410,33,25,3,12,899
37101041110,3769,2479,379,687,12,28,0,32,1290
37101041111,3869,2455,356,837,11,44,3,20,1414
37101041112,6165,3784,745,1087,48,180,4,30,2381
37101041113,2149,1623,143,217,7,36,1,10,526
37101041203,1885,1343,411,39,20,1,1,1,542
37101041204,1625,919,536,137,4,4,2,5,706
37101041205,2751,1658,524,446,7,8,0,6,1093
37101041206,2663,1723,605,240,12,12,0,7,940
37101041301,2133,1281,476,302,5,4,0,15,852
37101041302,3975,2948,691,233,21,0,1,8,1027
37101041401,3241,2220,428,430,10,16,0,11,1021
37101041402,4435,2878,582,796,24,20,1,1,1557
37101041504,4004,2793,589,339,32,26,0,16,1211
37101041505,4434,3475,379,363,20,23,0,16,959
37101041506,2333,1594,396,212,17,5,0,10,739
37101041507,4192,3063,490,424,27,24,0,11,1129
37101041508,2682,1846,477,248,11,4,0,2,836
37101041509,4191,3123,480,402,26,41,0,13,1068
37101041510,1983,1421,416,50,13,8,1,8,562
37101041511,2620,1745,616,157,9,2,2,8,875
37103920100,3431,2032,94,1120,23,12,0,12,1399
37103920200,2532,1425,123,865,12,14,0,14,1107
37103920300,3209,2330,177,579,7,6,0,9,879
37105030101,4812,2392,1059,1066,9,60,12,21,2420
37105030102,5803,4230,645,532,20,120,5,24,1573
37105030200,3265,587,1782,767,9,9,0,12,2678
37105030300,2967,412,975,1473,5,12,1,18,2555
37105030401,3777,1180,1415,1039,10,15,0,10,2597
37105030402,7165,2241,2542,1936,23,131,2,39,4924
37105030502,2151,1115,674,298,3,1,0,4,1036
37105030504,6547,4848,849,554,21,34,6,20,1699
37105030505,3211,2231,451,394,11,14,5,10,980
37105030506,1385,661,405,221,11,23,0,5,724
37105030507,3720,2810,350,325,26,48,0,11,910
37105030601,3506,2669,272,348,7,49,2,3,837
37105030602,5525,4029,527,617,33,67,4,15,1496
37105030702,4368,3235,564,360,28,18,4,19,1133
37105030703,1922,1396,276,153,2,15,0,3,526
37105030704,3161,2019,336,618,13,27,2,13,1142
37107010100,4520,2124,357,1868,4,52,3,11,2396
37107010200,2276,116,50,2049,2,0,0,2,2160
37107010300,1465,38,38,1326,0,0,0,8,1427
37107010400,723,16,17,670,0,0,0,0,707
37107010500,3257,169,122,2859,6,10,0,6,3088
37107010600,3559,1483,63,1849,15,47,1,7,2076
37107010700,2116,432,89,1501,4,14,5,8,1684
37107010800,4952,2044,156,2496,4,103,4,21,2908
37107010900,3080,1384,227,1356,13,8,0,6,1696
37107011001,4435,2699,402,1140,13,34,0,10,1736
37107011002,3810,2509,367,785,16,16,6,14,1301
37107011100,5366,2608,472,2076,12,27,1,10,2758
37107011201,3295,2242,593,356,11,4,0,7,1053
37107011202,3471,2536,607,232,8,7,0,4,935
37107011301,1665,981,161,459,6,0,1,5,684
37107011302,2912,1851,285,638,12,2,0,7,1061
37107011400,4220,3350,359,374,8,8,1,9,870
37109070100,4896,3387,536,726,18,27,0,18,1509
37109070201,4736,2909,918,613,24,67,0,24,1827
37109070202,3323,2687,289,174,5,25,1,6,636
37109070300,4029,3252,340,222,11,25,2,12,777
37109070400,5881,5047,458,117,7,43,0,9,834
37109070500,4889,4381,263,72,11,18,1,6,508
37109070600,4226,3768,203,73,14,17,0,2,458
37109070700,3560,3194,192,32,11,12,2,7,366
37109070800,6249,4275,1030,616,11,40,2,16,1974
37109070901,3536,3097,191,67,10,16,0,3,439
37109070902,7143,6188,391,237,8,42,0,28,955
37109071001,5505,4590,339,291,31,16,0,9,915
37109071002,2719,2201,108,258,9,23,0,0,518
37109071101,7254,5986,450,386,20,112,5,21,1268
37109071102,6689,5831,250,262,15,69,1,23,858
37109071201,1862,1645,104,22,20,7,0,5,217
37109071202,3995,3565,130,98,4,56,1,14,430
37109071203,6318,5658,220,139,8,77,0,5,660
37111970101,2058,1779,145,23,4,0,0,13,279
37111970102,3264,2807,268,58,0,29,0,3,457
37111970200,4993,4390,233,139,18,41,0,10,603
37111970300,3090,2482,328,101,5,29,0,11,608
37111970400,2569,1821,521,90,7,31,0,15,748
37111970500,3877,2928,374,381,13,33,0,26,949
37111970600,3464,3021,207,62,8,37,0,14,443
37111970700,4089,3599,167,183,12,28,0,1,490
37111970800,4381,4073,90,33,20,15,0,14,308
37111970902,5026,4447,261,95,14,15,0,11,579
37111970903,4704,3878,114,486,15,73,0,5,826
37111970904,3063,2563,239,56,20,57,0,6,500
37113970100,2996,2683,115,19,17,12,0,9,313
37113970200,4167,3791,210,14,24,17,1,3,376
37113970302,4416,3677,491,53,21,49,0,20,739
37113970303,2126,1683,331,23,0,20,0,4,443
37113970304,2187,1637,388,23,8,29,2,11,550
37113970400,4331,3804,250,33,48,27,0,14,527
37113970501,1604,1392,130,11,3,13,0,8,212
37113970502,1882,1662,148,4,3,13,0,5,220
37113970600,6343,5436,620,28,26,30,0,19,907
37113970700,6962,5770,815,44,17,40,3,10,1192
37115010100,2785,2582,79,8,12,1,0,7,203
37115010200,2168,1996,46,5,1,8,0,3,172
37115010400,1854,1731,47,0,8,13,0,6,123
37115010500,4814,4396,191,9,11,16,0,3,418
37115010601,2577,2316,97,54,6,7,1,17,261
37115010602,4082,3551,208,117,6,25,0,32,531
37115010700,2913,2661,80,4,12,14,0,5,252
37117970100,3749,2576,169,888,8,5,0,2,1173
37117970200,4168,1663,233,2116,16,44,0,18,2505
37117970300,3790,1538,89,1994,18,38,0,13,2252
37117970400,2239,894,77,1205,8,2,1,7,1345
37117970500,5272,3932,128,1066,15,2,0,14,1340
37117970600,2813,925,199,1599,4,7,0,10,1888
37119000101,1182,833,65,134,2,101,0,2,349
37119000102,2749,1861,186,282,4,292,0,14,888
37119000103,2000,1303,130,375,0,109,1,3,697
37119000104,1876,1260,134,226,1,177,0,8,616
37119000301,1239,881,92,93,4,106,0,6,358
37119000302,1586,988,126,306,2,96,1,3,598
37119000401,1886,1413,110,211,2,78,0,5,473
37119000402,2132,1655,133,122,3,120,0,20,477
37119000501,2448,1332,178,742,12,97,3,11,1116
37119000502,1585,757,118,415,0,226,1,9,828
37119000503,1931,1133,133,515,11,58,0,12,798
37119000600,2753,1270,186,985,8,170,2,14,1483
37119000700,2480,1566,182,445,3,160,0,15,914
37119000800,2885,956,170,1545,4,91,0,5,1929
37119000900,1853,979,145,581,3,54,0,7,874
37119001000,3466,2826,157,218,16,79,1,16,640
37119001100,3317,2694,179,165,10,87,0,15,623
37119001200,5404,2786,1399,906,6,89,1,44,2618
37119001300,3850,1862,386,1287,14,123,0,31,1988
37119001400,3594,2435,327,492,10,130,0,29,1159
37119001504,6620,839,1863,3411,13,279,4,39,5781
37119001505,4325,955,1794,1198,29,199,3,25,3370
37119001507,4372,286,2042,1725,4,188,2,42,4086
37119001508,6762,1338,1920,2874,22,327,26,49,5424
37119001509,3045,260,713,1866,7,117,0,12,2785
37119001510,3202,254,741,1877,1,216,3,31,2948
37119001603,3974,1544,1088,1015,8,203,7,8,2430
37119001605,1651,535,451,513,5,74,0,3,1116
37119001606,4104,1218,1215,1069,16,427,4,37,2886
37119001607,2629,380,956,1082,6,101,0,36,2249
37119001608,4104,538,1601,1574,7,260,0,22,3566
37119001609,3202,500,1008,1319,6,277,0,23,2702
37119001701,4004,1479,1050,1099,15,183,5,17,2525
37119001702,6094,1492,2287,1507,15,583,7,45,4602
37119001801,1299,739,100,368,9,22,0,7,560
37119001802,3453,1950,357,793,9,168,0,19,1503
37119001910,5007,584,1741,1893,9,635,0,46,4423
37119001911,5812,1440,1834,1787,18,489,5,43,4372
37119001914,3464,1262,864,923,11,243,0,36,2202
37119001916,4641,1094,1164,1797,22,335,0,63,3547
37119001917,3775,1332,1206,838,22,205,0,22,2443
37119001918,3690,727,970,1737,16,110,0,26,2963
37119001919,4467,904,1092,1463,6,818,3,26,3563
37119001920,4883,775,1986,1505,6,446,1,46,4108
37119001921,2454,577,805,785,3,217,5,16,1877
37119001922,4594,743,1478,1940,12,278,1,24,3851
37119001923,3756,623,938,1830,6,175,8,49,3133
37119001924,2878,330,1199,802,3,464,0,19,2548
37119001925,4180,400,1234,2032,12,209,2,159,3780
37119001926,3564,968,628,1645,16,66,7,55,2596
37119001927,2948,501,891,1277,8,53,0,66,2447
37119002004,5189,3001,517,1149,8,185,4,47,2188
37119002005,2568,1837,141,297,0,169,0,37,731
37119002006,3998,3308,185,210,5,98,0,11,690
37119002007,2578,1519,225,651,7,53,0,20,1059
37119002008,3143,2582,191,166,2,100,2,11,561
37119002100,2764,1637,254,639,6,87,0,14,1127
37119002201,2718,2130,180,210,3,97,1,8,588
37119002202,3184,2647,120,204,3,106,3,23,537
37119002300,2937,269,305,2172,5,79,0,16,2668
37119002400,3100,2452,156,262,2,82,4,10,648
37119002500,2498,1867,166,265,2,84,0,24,631
37119002600,1521,848,89,434,2,84,1,12,673
37119002701,2307,2042,75,92,6,43,0,3,265
37119002702,6123,5376,230,192,17,138,0,13,747
37119002800,3901,3621,104,17,4,46,1,4,280
37119002903,4711,3748,274,327,7,182,0,21,963
37119002905,3784,3265,120,101,9,152,0,14,519
37119002907,3509,2535,225,301,12,309,0,9,974
37119002908,3813,3150,130,243,8,130,0,12,663
37119002909,1570,1345,67,65,0,36,0,9,225
37119002910,3452,2832,167,172,5,129,1,6,620
37119003006,4490,3553,265,256,8,260,0,14,937
37119003008,5742,3965,707,631,11,201,3,18,1777
37119003012,4419,3031,547,466,7,179,3,12,1388
37119003013,5841,4646,318,364,7,277,0,16,1195
37119003015,4691,3812,291,181,3,202,1,12,879
37119003016,5117,3272,302,450,10,777,1,86,1845
37119003017,3808,3044,196,228,3,184,0,18,764
37119003018,2743,1958,152,188,4,280,0,30,785
37119003019,2482,1964,145,174,2,71,3,18,518
37119003020,4648,4174,140,75,0,119,1,3,474
37119003021,2614,2090,111,110,6,208,0,5,524
37119003022,3822,3359,128,71,8,130,1,3,463
37119003102,4455,2438,1111,571,8,162,0,23,2017
37119003105,3733,3059,252,193,9,87,1,13,674
37119003106,4069,2048,1216,404,11,238,0,25,2021
37119003108,3228,1051,1170,798,11,93,0,15,2177
37119003109,4076,572,1968,1236,8,164,5,23,3504
37119003110,2141,1721,188,69,7,54,1,4,420
37119003111,3251,2407,287,251,3,129,0,39,844
37119003201,2430,1251,755,299,7,42,4,12,1179
37119003203,2888,1598,457,596,1,94,1,14,1290
37119003204,3512,2870,126,256,9,130,3,15,642
37119003301,1808,1380,163,134,0,67,0,3,428
37119003302,2581,1971,156,253,11,81,0,8,610
37119003401,2168,1747,135,63,0,118,0,9,421
37119003402,4111,3564,175,74,2,125,0,10,547
37119003500,2901,2495,108,92,3,77,0,14,406
37119003600,3777,1705,304,1511,8,91,5,12,2072
37119003701,1978,1402,97,351,4,60,0,5,576
37119003702,2280,857,178,1122,1,41,0,12,1423
37119003802,3615,309,494,2660,10,28,0,24,3306
37119003805,3228,1176,350,713,10,811,1,65,2052
37119003807,4569,328,2174,1808,26,85,3,41,4241
37119003808,5562,379,3891,1114,12,88,2,17,5183
37119003809,3362,507,1019,1444,1,276,1,41,2855
37119003810,4100,657,1517,1001,21,762,1,32,3443
37119003811,2793,588,912,917,13,296,0,6,2205
37119003902,4850,268,439,3730,25,219,1,24,4582
37119003903,2411,99,445,1761,15,33,0,2,2312
37119004000,4546,588,658,2913,18,229,0,16,3958
37119004101,2061,960,164,752,7,46,0,12,1101
37119004102,2858,1444,181,1044,2,73,2,17,1414
37119004200,3300,418,352,2365,14,23,4,10,2882
37119004302,5118,457,687,3410,19,360,2,17,4661
37119004303,2910,565,633,1406,10,197,0,20,2345
37119004304,3878,456,582,2367,16,291,0,22,3422
37119004306,2570,113,694,1595,12,82,0,7,2457
37119004307,3298,436,785,1757,7,193,3,10,2862
37119004400,4500,406,804,2938,20,163,15,35,4094
37119004500,3121,427,245,2056,12,283,4,14,2694
37119004600,2987,123,247,2525,3,30,0,14,2864
37119004700,1719,291,142,1234,9,14,5,1,1428
37119004800,3701,194,404,2910,5,55,0,12,3507
37119004900,702,39,54,584,2,1,2,5,663
37119005000,2566,473,145,1828,10,35,0,2,2093
37119005100,2522,153,197,1995,4,90,0,6,2369
37119005200,2419,337,147,1779,12,20,1,11,2082
37119005301,3637,486,983,1986,24,54,0,8,3151
37119005305,4528,163,1263,2900,0,84,2,10,4365
37119005306,2587,238,1022,1183,14,52,2,25,2349
37119005307,4222,366,1384,2176,9,129,8,22,3856
37119005308,3110,43,2009,982,2,21,0,13,3067
37119005403,5333,583,1250,3108,24,199,3,32,4750
37119005404,5315,515,950,3515,18,146,0,21,4800
37119005405,3295,325,642,2099,8,93,0,26,2970
37119005406,3986,168,375,3269,3,38,6,7,3818
37119005508,4140,1875,364,1503,7,173,4,34,2265
37119005510,6875,696,1931,3825,25,127,2,46,6179
37119005511,4242,897,415,2536,10,193,3,24,3345
37119005512,5246,752,851,3219,7,214,1,39,4494
37119005513,4581,1740,418,1962,12,201,6,45,2841
37119005515,2634,1332,253,763,3,146,0,14,1302
37119005516,1726,1038,100,415,1,95,0,0,688
37119005517,4347,2250,319,1338,14,205,6,38,2097
37119005519,6605,2426,596,2766,4,463,4,45,4179
37119005520,4829,976,518,2167,11,964,1,27,3853
37119005522,4793,812,436,2634,10,673,3,43,3981
37119005525,4350,1320,704,1848,10,276,0,33,3030
37119005526,3622,1038,371,1811,12,214,5,23,2584
37119005527,2622,1222,220,937,4,112,1,9,1400
37119005528,4253,1281,319,2257,19,166,4,61,2972
37119005529,1783,423,132,1042,2,87,0,4,1360
37119005530,3832,1204,331,1300,20,823,6,26,2628
37119005531,5678,1164,435,3485,13,313,0,44,4514
37119005532,3657,605,288,1591,23,1011,0,27,3052
37119005533,1277,440,129,452,1,214,1,3,837
37119005534,4990,1300,368,1711,24,1351,3,21,3690
37119005535,3945,355,463,2133,13,835,1,27,3590
37119005536,5887,1092,715,2846,66,977,2,35,4795
37119005604,8512,4283,752,2420,102,813,25,18,4229
37119005609,4240,1258,666,1288,5,814,1,74,2982
37119005610,3315,802,556,1655,14,119,0,21,2513
37119005611,3561,845,587,1784,8,155,9,23,2716
37119005612,5780,1163,1184,2910,13,277,2,36,4617
37119005613,3313,528,511,1908,2,207,2,25,2785
37119005615,2548,542,361,1397,5,129,2,14,2006
37119005616,1822,416,558,711,3,67,13,9,1406
37119005617,2906,562,711,1347,3,119,1,24,2344
37119005618,3272,1130,456,1432,4,115,0,17,2142
37119005619,4713,1188,957,2246,7,91,0,32,3525
37119005621,5038,2327,629,1709,20,103,3,25,2711
37119005622,3219,1365,376,1070,9,246,3,27,1854
37119005623,4654,1164,551,2514,14,185,4,30,3490
37119005624,2486,466,342,1499,16,99,1,23,2020
37119005625,5752,1197,674,3321,13,278,2,46,4555
37119005626,3637,580,898,1868,3,134,0,18,3057
37119005627,7602,1599,2096,3310,19,195,8,67,6003
37119005709,3840,2492,446,535,11,188,1,18,1348
37119005710,4523,1301,1184,1592,8,233,3,36,3222
37119005712,3814,2835,356,306,8,96,0,12,979
37119005713,4376,3360,278,376,7,139,0,4,1016
37119005714,5816,4243,299,665,28,267,2,27,1573
37119005715,3067,2269,378,257,12,22,0,21,798
37119005716,4892,1712,1143,1336,13,343,4,128,3180
37119005718,3677,1946,734,616,13,167,2,41,1731
37119005719,3778,2429,440,571,22,180,2,11,1349
37119005720,2510,1779,238,296,1,109,0,14,731
37119005721,3447,2599,292,344,14,53,4,2,848
37119005722,2731,1371,388,587,11,229,0,25,1360
37119005723,3573,1201,681,1303,16,163,2,35,2372
37119005811,4433,3097,475,525,7,117,2,35,1336
37119005815,3566,2705,285,244,8,157,3,29,861
37119005816,4303,3138,263,366,5,331,3,10,1165
37119005817,4363,3377,259,177,3,327,1,32,986
37119005824,4618,1423,1641,1149,18,219,2,36,3195
37119005826,2912,1463,862,345,9,93,5,24,1449
37119005827,2772,686,777,1169,5,40,3,6,2086
37119005828,3783,3150,277,192,6,53,0,14,633
37119005829,2511,881,689,705,15,111,3,17,1630
37119005830,3718,2397,643,359,7,117,2,19,1321
37119005832,3406,2555,150,179,6,375,0,35,851
37119005833,4941,4218,199,142,1,219,0,22,723
37119005834,4260,2862,371,489,14,296,8,36,1398
37119005835,2666,2116,211,124,12,100,1,13,550
37119005836,4064,2203,892,462,6,289,0,19,1861
37119005839,2763,1777,398,258,0,212,0,14,986
37119005840,2156,1537,146,188,1,167,1,12,619
37119005843,3362,2149,288,261,7,499,0,30,1213
37119005845,5926,2618,417,496,11,2135,8,43,3308
37119005846,4059,3132,244,154,6,362,0,20,927
37119005847,5101,3724,239,345,9,585,0,30,1377
37119005848,5333,4142,287,253,6,394,1,21,1191
37119005849,3826,2584,282,411,7,394,0,22,1242
37119005850,2848,1847,204,187,1,436,2,24,1001
37119005851,4378,2789,421,378,12,576,0,37,1589
37119005852,2140,1322,265,313,5,68,0,36,818
37119005853,2074,1183,292,391,9,85,0,25,891
37119005854,2308,828,316,241,2,806,4,19,1480
37119005855,5222,3012,443,604,4,890,1,22,2210
37119005856,2848,1179,287,375,6,848,1,18,1669
37119005857,2587,1275,241,378,9,560,2,14,1312
37119005858,4962,1955,590,778,8,1422,1,37,3007
37119005859,3102,2073,213,240,5,436,1,4,1029
37119005860,4157,2206,352,337,10,1033,2,37,1951
37119005861,3120,2044,242,218,3,444,4,22,1076
37119005862,3095,1953,249,201,4,527,0,4,1142
37119005863,3706,2081,318,301,3,839,1,15,1625
37119005864,5400,2845,315,455,15,1502,1,37,2555
37119005865,2248,1644,170,241,10,60,1,20,604
37119005866,4190,1681,714,1383,16,135,5,53,2509
37119005867,4281,1635,964,1213,5,317,3,17,2646
37119005868,1961,1180,290,339,7,39,0,18,781
37119005908,2241,1536,114,283,0,192,1,9,705
37119005910,5524,1618,1103,2208,8,259,7,49,3906
37119005913,6679,1793,2046,1984,15,586,0,44,4886
37119005915,2477,831,262,1087,1,180,0,18,1646
37119005916,2526,181,959,1176,4,93,1,25,2345
37119005918,4852,1783,1025,1332,9,418,9,47,3069
37119005919,3636,1848,760,595,19,274,0,10,1788
37119005920,2401,810,1179,228,11,98,0,10,1591
37119005921,3426,1276,380,1131,0,451,1,36,2150
37119005922,4903,1663,807,1600,20,573,0,20,3240
37119005923,4997,957,974,2141,3,718,0,34,4040
37119005924,5197,2219,926,1432,12,369,5,41,2978
37119005925,3254,1479,341,1034,8,210,3,30,1775
37119005926,7166,4250,473,1648,10,417,2,39,2916
37119005927,5109,1111,1332,1915,4,520,4,26,3998
37119005928,1576,483,527,361,5,153,0,0,1093
37119005929,3925,1321,617,1492,3,327,5,29,2604
37119005930,2702,849,640,982,13,91,10,13,1853
37119005931,4005,1630,814,1182,12,145,7,25,2375
37119005932,2465,762,424,838,3,295,0,17,1703
37119006005,3621,1245,698,1345,20,134,2,29,2376
37119006008,3795,1466,460,1545,9,109,0,18,2329
37119006009,3289,1066,398,1577,6,79,2,18,2223
37119006011,3535,607,737,1878,4,139,0,26,2928
37119006012,5100,1077,1060,2124,18,632,3,24,4023
37119006013,4002,665,546,2496,5,98,0,27,3337
37119006014,4374,2256,406,1343,12,112,4,24,2118
37119006015,4053,1311,555,1877,9,137,0,29,2742
37119006016,3426,379,1132,1675,15,106,1,9,3047
37119006103,4517,2435,321,1487,7,100,0,17,2082
37119006105,3144,1141,342,1382,11,115,2,17,2003
37119006108,4808,697,775,2960,6,202,0,20,4111
37119006109,4833,505,684,3402,10,107,2,30,4328
37119006110,5619,1144,772,3224,11,192,0,37,4475
37119006111,4461,1289,518,2137,15,252,0,35,3172
37119006112,2214,401,360,1247,5,72,1,18,1813
37119006113,3528,1334,262,1597,15,107,0,20,2194
37119006114,4374,684,834,2511,1,148,0,46,3690
37119006115,3330,705,337,1897,4,183,2,21,2625
37119006208,3471,2522,361,288,9,110,0,20,949
37119006209,4870,3588,417,501,17,124,2,20,1282
37119006210,4744,3691,293,333,8,196,1,17,1053
37119006211,6457,5094,431,405,5,262,0,30,1363
37119006212,3749,2330,369,580,12,285,4,13,1419
37119006214,4263,3282,299,376,15,79,0,18,981
37119006216,2062,1835,83,37,0,50,3,17,227
37119006217,3661,3179,135,130,5,75,0,22,482
37119006218,2853,2519,89,44,5,66,0,8,334
37119006219,2341,2060,71,52,3,60,0,13,281
37119006220,2960,2634,92,66,5,61,2,9,326
37119006221,3865,2733,373,444,2,136,0,11,1132
37119006222,3976,2890,261,504,10,141,0,18,1086
37119006223,2684,1559,351,581,3,42,2,14,1125
37119006224,3395,1655,970,472,9,143,0,10,1740
37119006305,3824,2385,206,782,0,270,0,14,1439
37119006306,1744,1174,158,236,7,84,0,9,570
37119006307,5792,3666,467,1122,11,314,0,19,2126
37119006308,4247,3371,214,320,4,171,0,13,876
37119006309,2251,1164,536,402,9,44,0,17,1087
37119006310,2911,1930,485,220,4,122,0,21,981
37119006311,4373,3605,272,178,7,86,0,17,768
37119006403,6588,5118,439,498,12,259,0,20,1470
37119006404,7065,6009,418,180,3,185,0,28,1056
37119006407,3734,2659,413,334,8,144,0,21,1075
37119006408,2969,2284,210,229,6,94,0,30,685
37119006409,3623,3002,163,236,6,108,0,5,621
37119006410,3531,2643,384,229,1,87,1,18,888
37119006411,2915,1956,413,365,4,59,0,19,959
37119980100,0,0,0,0,0,0,0,0,0
37119980200,6,0,4,0,0,1,0,0,6
37119980300,57,33,5,6,0,10,0,0,24
37121950100,2326,2205,44,0,8,8,0,0,121
37121950200,3575,3346,64,5,7,8,0,9,229
37121950300,4120,3584,344,22,9,10,1,10,536
37121950400,4882,4379,249,23,6,26,0,11,503
37123960101,1622,1346,200,29,3,3,0,0,276
37123960102,4416,2170,1430,694,11,21,0,9,2246
37123960201,1995,1523,109,304,5,2,0,7,472
37123960202,4420,2831,510,844,19,93,0,10,1589
37123960301,1629,1466,20,43,2,31,1,0,163
37123960302,2450,2295,41,20,9,16,0,0,155
37123960401,1975,897,26,934,13,41,1,5,1078
37123960402,2616,1913,76,418,2,140,0,4,703
37123960501,2443,743,973,653,8,30,0,6,1700
37123960502,2185,1320,539,253,4,14,0,6,865
37125950100,2594,2200,169,101,3,11,0,8,394
37125950201,2369,1291,856,118,7,12,0,7,1078
37125950202,4154,3356,425,249,15,13,0,8,798
37125950303,2269,1878,142,132,5,41,2,14,391
37125950304,2853,1717,427,555,26,10,3,4,1136
37125950305,3992,3328,190,298,14,31,1,16,664
37125950306,1920,1627,95,69,19,21,2,5,293
37125950402,3917,3045,194,430,55,23,2,10,872
37125950403,2345,1595,203,401,18,7,0,6,750
37125950404,2368,2046,111,87,20,14,0,3,322
37125950503,3098,2329,298,314,21,13,0,14,769
37125950504,3548,2664,346,280,26,34,4,15,884
37125950505,890,667,91,42,11,5,3,7,223
37125950506,6644,5618,364,162,24,105,4,34,1026
37125950507,4252,3319,367,315,26,30,0,21,933
37125950601,3805,3386,89,119,14,67,0,22,419
37125950603,4399,3092,293,653,19,93,4,29,1307
37125950604,3477,2897,158,252,10,54,0,7,580
37125950702,2728,2378,92,79,18,60,0,2,350
37125950703,2667,2095,135,233,19,74,3,10,572
37125950704,2528,2240,93,54,9,37,0,11,288
37125950801,6049,3275,289,2074,33,110,1,13,2774
37125950802,4319,3632,244,182,24,58,3,2,687
37125950900,2430,1881,169,218,9,33,1,15,549
37125951001,4246,3653,227,132,15,46,7,7,593
37125951002,1178,956,60,91,12,14,6,5,222
37125951101,3696,2224,265,869,77,38,4,11,1472
37125951102,6190,4165,416,1075,56,117,0,34,2025
37125951200,4802,2837,557,961,83,66,9,11,1965
37127010200,5058,738,178,3967,35,11,0,19,4320
37127010301,3441,835,119,2302,9,29,0,14,2606
37127010302,2944,1480,162,1163,12,21,0,11,1464
37127010400,2872,603,120,1975,13,29,0,12,2269
37127010503,2814,1304,218,1161,17,42,0,16,1510
37127010504,5651,3062,298,1999,15,104,8,30,2589
37127010505,3604,1172,144,1990,28,160,1,9,2432
37127010506,3760,1747,175,1629,17,61,7,17,2013
37127010601,2578,985,230,1181,22,55,0,22,1593
37127010603,1532,282,324,846,11,29,3,8,1250
37127010604,3830,1218,153,2138,35,147,1,21,2612
37127010700,2870,1163,108,1433,16,34,0,12,1707
37127010801,1316,574,50,617,13,5,0,17,742
37127010802,6027,4448,154,1172,58,30,0,23,1579
37127010900,5320,2544,280,2237,82,5,1,23,2776
37127011000,4235,2097,327,1611,30,6,0,12,2138
37127011101,6190,3479,255,2145,62,46,6,23,2711
37127011103,5158,2486,145,2280,33,28,0,24,2672
37127011104,2538,1528,192,716,28,7,0,5,1010
37127011201,3222,1994,126,980,10,25,0,10,1228
37127011202,3524,2857,177,381,13,5,1,5,667
37127011300,4910,3028,1176,580,14,0,0,17,1882
37127011400,4605,2596,930,868,19,10,0,16,2009
37127011501,2916,1434,612,753,7,9,0,15,1482
37127011502,4055,2663,669,555,16,6,0,26,1392
37129010100,2447,912,131,1236,17,16,3,17,1535
37129010200,3326,1711,184,1251,4,25,1,20,1615
37129010300,5755,1929,490,2988,22,25,0,47,3826
37129010400,2596,2215,113,159,4,29,0,5,381
37129010501,3396,1869,525,730,21,57,4,18,1527
37129010503,2089,1536,238,169,6,23,12,12,553
37129010504,6176,3769,798,1022,29,140,5,33,2407
37129010600,4584,3877,159,291,14,89,7,25,707
37129010700,3779,1749,454,1339,19,30,1,12,2030
37129010800,2371,985,919,370,9,4,0,9,1386
37129010900,2213,1644,188,216,4,19,6,7,569
37129011000,2075,989,75,868,7,3,4,12,1086
37129011100,2586,386,136,1929,6,9,2,13,2200
37129011200,2098,1197,111,666,7,15,0,23,901
37129011300,2014,1531,94,262,5,19,0,7,483
37129011400,1688,492,71,1038,6,8,0,5,1196
37129011501,2581,1795,196,356,3,77,6,10,786
37129011502,5494,3893,393,799,4,235,16,36,1601
37129011503,3657,1796,530,1138,22,13,7,14,1861
37129011504,5249,3860,511,577,29,33,3,8,1389
37129011605,5269,3017,859,1015,17,88,0,38,2252
37129011606,4407,3171,472,417,15,126,5,17,1236
37129011608,6127,4316,416,952,21,128,5,41,1811
37129011609,4534,3207,457,560,27,46,3,27,1327
37129011610,3409,2147,324,685,34,27,0,15,1262
37129011611,6606,4691,696,696,17,155,0,32,1915
37129011612,6185,4672,641,456,13,149,4,26,1513
37129011701,4562,3938,311,93,11,46,2,17,624
37129011703,4898,4482,168,45,8,48,0,17,416
37129011705,9620,8609,347,173,9,105,3,28,1011
37129011800,2476,2323,35,11,0,15,1,17,153
37129011904,2812,2572,85,33,8,20,3,6,240
37129011905,2441,1892,354,81,7,21,1,15,549
37129011906,2905,2250,314,187,1,42,2,8,655
37129012004,3830,3389,122,65,8,83,1,21,441
37129012006,4274,3586,171,195,4,102,9,24,688
37129012007,5345,4370,276,385,16,85,4,32,975
37129012008,6788,5030,426,797,30,166,2,31,1758
37129012009,6991,5821,275,442,13,177,0,27,1170
37129012010,5375,4443,338,180,13,156,3,17,932
37129012011,4706,3344,979,138,9,65,5,15,1362
37129012012,2630,2448,47,33,4,19,0,2,182
37129012103,4709,4229,136,97,6,91,0,8,480
37129012106,8662,7123,442,430,32,158,5,30,1539
37129012107,4401,3789,177,185,16,37,0,12,612
37129012108,3516,2987,124,185,25,33,0,15,529
37129012109,4051,3466,188,129,11,63,7,14,585
37129012110,4663,3147,996,218,12,61,0,14,1516
37129012111,5752,4675,311,401,19,88,3,30,1077
37129012201,2875,2646,80,27,3,23,1,7,229
37129012202,3700,3340,107,27,14,27,0,10,360
37129012203,2199,2032,37,10,6,18,2,7,167
37129012300,8808,7863,272,222,11,131,0,39,945
37129980100,2,0,1,0,0,0,0,0,2
37129990100,0,0,0,0,0,0,0,0,0
37131920101,1442,661,54,675,3,5,0,0,781
37131920102,1432,871,21,497,0,1,0,1,561
37131920103,1647,929,39,638,0,0,3,3,718
37131920201,1043,251,30,729,3,3,0,0,792
37131920202,2115,889,65,1077,10,5,0,7,1226
37131920301,1825,208,18,1551,0,2,0,11,1617
37131920302,1644,493,32,1051,5,3,0,8,1151
37131920303,1193,411,11,709,5,7,0,22,782
37131920401,3592,1110,67,2271,14,0,0,17,2482
37131920402,1538,1012,16,451,3,1,1,7,526
37133000103,6398,4463,540,819,41,62,11,27,1935
37133000104,2968,2397,241,91,12,32,10,16,571
37133000105,6990,5837,434,211,20,119,9,24,1153
37133000203,4668,3093,476,647,24,51,12,23,1575
37133000204,4466,3167,534,339,20,47,9,36,1299
37133000205,7191,4766,722,1062,40,96,16,26,2425
37133000206,4000,2939,449,322,12,12,7,14,1061
37133000207,4065,2842,364,524,18,43,2,27,1223
37133000303,1955,1657,140,51,9,10,5,1,298
37133000304,4222,3024,351,476,18,43,8,9,1198
37133000305,3151,2146,356,368,19,25,12,7,1005
37133000306,6847,4859,658,688,43,94,7,35,1988
37133000401,9813,7872,753,322,54,116,21,39,1941
37133000403,1339,1233,46,12,7,2,0,3,106
37133000404,1430,1156,90,42,4,18,0,0,274
37133000405,7684,6303,569,215,30,110,7,52,1381
37133000500,3349,2109,841,184,30,106,20,25,1240
37133000600,13330,7911,3699,875,85,344,52,163,5419
37133000700,6025,3744,1027,445,20,185,66,45,2281
37133000800,419,270,88,30,1,5,6,0,149
37133000901,1139,679,241,120,4,22,6,7,460
37133000902,3877,2212,857,382,10,133,48,11,1665
37133001000,6152,3233,1545,594,26,352,127,1,2919
37133001101,5068,3332,595,624,29,98,19,9,1736
37133001102,4035,2383,501,718,38,74,11,10,1652
37133001201,3367,1978,443,524,20,74,11,30,1389
37133001202,8048,4296,1046,1713,36,230,48,50,3752
37133001301,4048,1697,691,1165,14,135,19,19,2351
37133001302,3334,1527,597,707,7,179,11,30,1807
37133001303,2431,1358,325,494,5,91,5,19,1073
37133001304,7925,3674,1361,1736,40,412,31,35,4251
37133001400,4433,3190,412,364,18,108,8,25,1243
37133001500,2483,1120,345,757,13,39,12,31,1363
37133001700,2304,1228,325,531,13,25,5,20,1076
37133001800,1749,1141,140,318,7,17,5,14,608
37133002100,5900,3203,760,1241,28,159,19,48,2697
37133002201,4825,2573,724,961,14,214,11,24,2252
37133002202,4292,1737,751,1313,31,107,13,19,2555
37133002300,4431,2445,664,792,23,101,15,28,1986
37133002400,7558,3728,1240,1611,32,203,29,60,3830
37133002500,3263,2239,279,388,32,35,5,17,1024
37133002600,3202,908,442,1594,22,25,6,16,2294
37133002801,2049,1700,150,58,4,20,4,18,349
37133002802,2272,1639,193,156,23,37,6,10,633
37133002803,6081,4491,636,355,23,98,23,25,1590
37133990100,0,0,0,0,0,0,0,0,0
37135010701,2198,1342,260,360,0,114,1,7,856
37135010705,5036,3351,558,546,10,328,0,25,1685
37135010706,3668,2728,245,53,0,368,0,45,940
37135010707,3363,1967,508,487,7,228,1,25,1396
37135010708,2603,1019,718,449,11,264,3,13,1584
37135010709,1955,1078,332,277,6,130,4,10,877
37135010710,3335,2264,459,246,6,161,0,21,1071
37135010802,4820,3970,247,364,7,24,0,15,850
37135010803,3118,2179,199,523,9,23,0,14,939
37135010804,1930,1311,129,397,8,11,1,6,619
37135010902,6584,3946,1484,651,14,162,2,31,2638
37135010903,2589,2088,109,247,5,33,0,15,501
37135010904,3673,2330,1001,140,4,38,2,4,1343
37135011001,4733,3670,218,518,7,103,0,29,1063
37135011002,4291,3090,415,469,20,70,0,32,1201
37135011103,4104,1823,797,1231,11,70,0,13,2281
37135011104,1499,1119,109,185,3,10,0,9,380
37135011105,3399,2101,388,648,9,73,5,16,1298
37135011106,2471,1733,261,282,10,21,0,20,738
37135011107,4257,2696,646,574,6,158,2,20,1561
37135011204,3545,2504,499,134,7,210,0,46,1041
37135011206,4184,1865,343,540,5,1201,0,21,2319
37135011207,4599,2411,459,303,3,1218,1,29,2188
37135011208,5245,3221,429,485,6,765,0,25,2024
37135011209,2971,2152,353,223,0,68,0,29,819
37135011210,3459,2310,595,338,8,59,3,3,1149
37135011211,2336,1974,129,78,7,27,0,19,362
37135011300,3132,1860,196,628,8,298,3,4,1272
37135011400,3893,2835,218,148,8,490,0,20,1058
37135011500,1849,1383,112,110,8,104,4,10,466
37135011601,2114,1294,216,193,22,314,0,7,820
37135011602,6498,3200,532,998,33,1400,6,23,3298
37135011700,5791,4437,290,371,9,437,0,31,1354
37135011800,3076,1937,294,329,7,343,0,18,1139
37135011902,4367,2941,260,281,5,577,2,30,1426
37135011903,2162,1135,344,180,10,330,0,18,1027
37135011904,3096,2066,194,276,10,373,0,14,1030
37135012101,3913,1689,451,684,6,871,0,24,2224
37135012102,1543,1257,59,27,3,100,0,7,286
37135012103,2764,1951,158,161,4,345,0,7,813
37135012201,3084,2391,178,174,2,151,0,17,693
37135012202,5449,3919,420,263,10,545,3,26,1530
37137950101,3062,2444,160,282,18,11,1,20,618
37137950103,2491,1480,126,772,8,8,3,4,1011
37137950104,1094,614,6,411,4,3,0,2,480
37137950202,2134,1844,59,142,10,13,1,9,290
37137950203,1632,1182,56,315,5,10,0,15,450
37137950204,1863,1540,89,133,13,5,0,1,323
37137990100,0,0,0,0,0,0,0,0,0
37139960100,1415,459,145,739,3,8,2,8,956
37139960200,4261,1589,189,2217,11,49,0,23,2672
37139960300,2661,327,134,2050,8,18,1,13,2334
37139960400,4144,1854,304,1750,17,33,0,11,2290
37139960501,3341,2403,195,527,10,37,4,18,938
37139960502,5615,3233,282,1682,39,105,4,42,2382
37139960503,2520,1533,51,833,12,4,0,0,987
37139960600,7412,4291,410,2238,19,93,10,33,3121
37139960701,6131,3481,425,1866,24,80,5,22,2650
37139960702,3068,2407,102,414,7,31,2,8,661
37141920104,4632,3992,236,69,17,40,2,34,640
37141920105,1601,1233,92,167,2,11,0,8,368
37141920106,1813,1674,51,13,2,18,0,3,139
37141920201,7882,6756,346,247,11,71,5,53,1126
37141920202,8993,8024,364,160,25,71,3,18,969
37141920203,5740,4582,370,397,29,37,7,20,1158
37141920204,1833,1073,63,615,3,6,0,12,760
37141920300,3847,2609,346,748,14,1,0,9,1238
37141920401,2268,1227,310,621,0,11,0,9,1041
37141920402,3041,1795,215,877,27,9,0,14,1246
37141920403,3336,2336,268,578,7,13,0,13,1000
37141920501,4169,1989,428,1612,15,7,1,15,2180
37141920502,1677,1112,182,269,16,5,2,3,565
37141920601,2849,1545,728,439,4,5,0,10,1304
37141920602,6522,4471,983,732,23,14,3,22,2051
37141990100,0,0,0,0,0,0,0,0,0
37143920101,3575,2441,66,904,8,12,1,8,1134
37143920102,3122,2383,75,467,5,13,6,19,739
37143920201,2654,1685,100,746,6,2,0,6,969
37143920202,3654,2824,68,569,16,9,0,8,830
37145920100,6861,4371,256,1860,89,1,5,39,2490
37145920200,6374,4445,225,1447,47,26,0,18,1929
37145920300,6168,2909,489,2415,42,24,1,17,3259
37145920400,2690,1120,182,1275,7,17,0,2,1570
37145920500,7061,5274,373,1063,19,25,1,20,1787
37145920601,5145,3347,432,1173,25,13,0,13,1798
37145920602,4798,3666,238,646,11,18,1,12,1132
37147000101,2265,1600,136,378,6,25,1,15,665
37147000102,1982,753,105,1008,10,16,5,13,1229
37147000201,4185,2572,244,1054,9,85,6,21,1613
37147000202,2556,1444,126,767,17,67,0,13,1112
37147000301,3061,2151,334,393,8,62,0,7,910
37147000303,2307,868,139,1137,12,37,0,4,1439
37147000304,5083,3692,189,846,6,141,0,17,1391
37147000400,5208,3684,256,1014,17,58,0,21,1524
37147000501,6457,3162,283,2549,14,193,8,29,3295
37147000503,4362,2465,300,1198,15,172,4,22,1897
37147000504,2228,1369,94,576,14,67,1,15,859
37147000602,4868,1254,303,3022,4,87,0,25,3614
37147000604,5088,1871,258,2550,17,192,0,37,3217
37147000605,4579,1351,227,2575,19,183,3,32,3228
37147000606,3838,1704,192,1567,6,142,0,52,2134
37147000607,8700,3655,483,3888,25,213,12,77,5045
37147000701,3675,548,145,2778,15,62,0,11,3127
37147000702,2728,166,105,2381,0,10,1,2,2562
37147000800,3074,437,552,1986,0,3,1,17,2637
37147000901,3680,2048,437,1010,4,27,3,22,1632
37147000902,2882,986,677,1118,7,8,1,14,1896
37147001001,2206,1359,282,433,10,23,2,3,847
37147001002,6668,4676,520,1096,22,61,3,14,1992
37147001003,5877,4446,302,738,17,135,2,16,1431
37147001100,5082,3665,383,833,6,13,0,9,1417
37147001200,6349,4235,692,1007,21,127,6,16,2114
37147001301,4442,2138,219,1787,10,77,0,19,2304
37147001302,5900,3078,292,2199,10,73,4,13,2822
37147001304,4186,2951,169,684,12,189,1,21,1235
37147001305,4571,2744,234,1141,13,243,3,24,1827
37147001402,2530,1400,203,819,8,1,7,5,1130
37147001403,2959,1755,181,868,15,9,0,15,1204
37147001404,1773,566,104,1044,7,2,0,8,1207
37147001500,3088,1646,273,1052,5,9,1,3,1442
37147001601,4177,2842,324,792,23,41,1,13,1335
37147001602,4832,1920,242,2356,13,51,0,36,2912
37147001700,3909,2090,296,1270,10,108,0,11,1819
37147001800,5693,2629,416,2437,17,15,0,14,3064
37147001900,2725,1462,212,936,16,19,1,14,1263
37147002002,4667,2275,349,1883,21,6,2,9,2392
37147002003,4004,610,1107,2089,4,0,15,13,3394
37147002004,1799,570,583,554,9,4,0,10,1229
37149920101,3014,2494,150,235,13,13,1,0,520
37149920103,3013,2619,200,84,2,11,0,7,394
37149920104,3001,2603,191,60,4,19,3,4,398
37149920201,2665,2383,147,7,11,0,0,10,282
37149920202,2119,1846,119,45,9,0,1,10,273
37149920301,1089,968,73,8,2,3,0,0,121
37149920303,1775,1615,62,26,3,6,0,0,160
37149920304,2652,2188,84,224,7,8,2,10,464
37151030100,5043,2647,1301,814,27,54,0,8,2396
37151030201,3234,2042,748,256,16,50,0,7,1192
37151030202,4962,3078,1411,186,16,77,0,16,1884
37151030301,6559,3143,2455,610,28,124,0,15,3416
37151030302,3109,986,920,1016,11,17,3,24,2123
37151030400,4238,2019,1534,423,22,68,0,21,2219
37151030502,4388,3360,596,231,10,57,0,14,1028
37151030503,5838,5029,421,139,24,25,0,23,809
37151030504,5871,5432,119,62,34,19,0,16,439
37151030600,6668,5477,742,190,23,45,0,14,1191
37151030700,6138,5418,387,61,11,64,0,14,720
37151030803,3902,3309,316,125,5,7,0,3,593
37151030804,2538,2047,322,77,4,10,0,5,491
37151030805,4083,3257,441,209,11,15,0,7,826
37151030806,2809,1928,639,121,2,29,0,10,881
37151030900,3583,3079,168,178,10,4,1,13,504
37151031001,2881,1970,534,223,7,35,0,1,911
37151031002,4446,3206,510,510,23,13,0,38,1240
37151031101,3349,2874,256,43,9,5,1,23,475
37151031102,2397,1662,417,167,15,5,0,5,735
37151031200,5184,3544,716,638,48,24,2,17,1640
37151031303,4298,3845,158,49,36,55,0,10,453
37151031304,4713,4118,254,114,34,33,0,5,595
37151031305,3706,3010,244,242,28,31,0,13,696
37151031307,4203,3743,205,50,32,10,0,0,460
37151031308,2678,2335,154,49,21,14,0,9,343
37151031401,5434,4207,517,391,25,32,0,9,1227
37151031402,3971,2510,1062,213,8,35,0,3,1461
37151031501,6215,5453,286,142,24,65,0,17,762
37151031503,3026,2000,301,341,17,245,1,5,1026
37151031504,5368,4220,256,251,23,424,1,17,1148
37151031505,3453,3018,145,132,17,45,1,4,435
37151031601,4357,3377,370,256,33,191,0,22,980
37151031602,1529,1011,146,83,12,231,0,4,518
37153970100,3213,1623,288,1110,62,14,0,11,1590
37153970200,4319,2562,534,915,82,35,0,7,1757
37153970300,4486,2974,358,861,79,29,0,18,1512
37153970400,4088,2480,169,1063,65,82,0,15,1608
37153970500,2335,1130,91,983,41,18,0,14,1205
37153970600,3990,1527,328,1846,72,35,4,19,2463
37153970700,2789,1649,432,486,52,20,0,7,1140
37153970800,4981,2870,288,1379,132,53,3,33,2111
37153970900,5050,3456,306,814,145,36,0,12,1594
37153971000,3730,1370,145,1952,58,31,0,13,2360
37153971100,3965,1969,133,1361,206,7,0,18,1996
37155960101,3859,1222,1255,956,243,4,0,7,2637
37155960102,4594,1883,1033,899,586,15,7,14,2711
37155960202,4025,391,1130,365,1988,4,8,18,3634
37155960203,3204,1380,377,940,259,13,2,13,1824
37155960204,2057,548,486,531,400,6,3,0,1509
37155960301,3283,633,482,1447,553,2,1,24,2650
37155960302,2416,365,727,382,830,9,1,17,2051
37155960402,3342,256,388,251,2386,3,0,0,3086
37155960403,3029,205,88,162,2413,16,0,7,2824
37155960404,3205,114,45,60,2855,2,0,8,3091
37155960501,2924,107,59,114,2556,1,3,6,2817
37155960502,5701,1050,230,1300,2488,247,3,45,4651
37155960503,1783,135,40,92,1433,3,0,5,1648
37155960601,3996,317,254,330,2941,7,0,20,3679
37155960602,1272,131,69,200,813,0,0,0,1141
37155960701,4782,988,889,346,2374,28,0,10,3794
37155960702,2617,624,292,312,1240,18,2,12,1993
37155960801,3220,425,217,1796,638,15,0,10,2795
37155960802,1178,79,23,871,158,0,1,3,1099
37155960900,1874,955,179,434,164,59,2,0,919
37155961000,1803,704,176,642,170,19,0,10,1099
37155961100,1930,562,446,560,253,16,0,5,1368
37155961200,2767,1135,236,891,343,32,1,21,1632
37155961301,4322,2182,340,736,708,188,4,35,2140
37155961302,5025,1418,617,1913,720,89,18,26,3607
37155961400,3789,1798,566,676,642,9,0,7,1991
37155961500,5044,2549,278,769,1219,4,0,22,2495
37155961601,3402,1865,147,667,530,15,4,12,1537
37155961602,3098,1591,98,741,563,2,0,0,1507
37155961700,4322,1138,107,1982,933,9,0,13,3184
37155961801,4444,229,117,455,3500,5,0,11,4215
37155961802,4450,567,97,940,2646,21,0,12,3883
37155961900,4004,998,158,1539,1120,4,2,14,3006
37155962001,3040,352,47,1410,1119,14,1,0,2688
37155962002,2729,263,64,509,1752,18,0,4,2466
37157040101,3934,3118,164,492,10,19,3,11,816
37157040102,2454,1846,97,421,6,4,0,17,608
37157040200,3746,2227,353,949,17,3,1,17,1519
37157040300,3866,2534,225,862,6,89,1,13,1332
37157040400,5851,3795,389,1330,15,29,3,22,2056
37157040501,3534,2315,326,742,14,13,0,18,1219
37157040502,2811,1914,186,574,21,25,0,16,897
37157040601,3688,3041,190,348,5,6,0,14,647
37157040602,4386,3218,486,523,0,9,1,5,1168
37157040700,4149,3553,152,269,6,16,0,14,596
37157040800,1597,909,51,531,15,25,0,5,688
37157040900,2468,1919,145,286,3,7,0,9,549
37157041001,6437,5356,576,219,31,48,3,10,1081
37157041002,5903,5036,243,366,26,27,0,15,867
37157041100,6485,5175,197,845,18,24,0,13,1310
37157041200,4962,1741,351,2625,13,19,0,16,3221
37157041300,6374,3685,902,1565,19,5,1,24,2689
37157041400,3019,1340,360,1116,24,18,0,7,1679
37157041501,1338,1000,67,208,11,9,3,1,338
37157041502,6035,3741,260,1756,3,51,13,14,2294
37157041601,3323,2710,178,281,5,12,0,16,613
37157041602,4736,4045,188,303,14,35,0,10,691
37159050201,4152,2021,526,1394,7,52,0,15,2131
37159050202,5347,2505,602,1937,12,84,0,18,2842
37159050300,3609,1721,469,1201,15,33,12,20,1888
37159050400,3139,363,335,2294,11,15,1,15,2776
37159050500,3845,2482,183,984,5,25,2,38,1363
37159050700,3221,1633,346,1032,11,24,7,25,1588
37159050800,2870,791,242,1687,6,12,7,18,2079
37159050901,4169,3644,172,149,13,44,1,16,525
37159050903,6349,5350,325,336,24,31,0,31,999
37159050904,2597,2421,56,8,4,14,0,7,176
37159051001,7748,6800,340,200,25,35,3,34,948
37159051002,5980,4988,334,316,11,58,2,17,992
37159051101,7017,6117,371,193,18,48,2,7,900
37159051102,3824,2902,493,171,14,91,0,6,922
37159051201,6887,4097,1379,1033,11,75,1,19,2790
37159051202,3896,2375,801,490,14,53,2,3,1521
37159051204,4282,2077,1227,736,17,99,2,23,2205
37159051301,2848,2097,270,344,11,27,0,7,751
37159051302,5355,3591,506,874,31,135,1,10,1764
37159051303,5892,2870,500,2102,13,133,2,19,3022
37159051400,7583,5209,1280,676,26,58,5,21,2374
37159051501,4261,2133,1148,723,13,49,0,14,2128
37159051502,3156,2638,305,74,9,33,0,17,518
37159051600,7182,4842,867,1062,29,72,0,34,2340
37159051700,8170,6470,854,427,29,80,6,18,1700
37159051801,4577,3959,294,79,19,27,2,18,618
37159051802,4879,4110,409,112,10,18,9,17,769
37159051901,4861,3934,441,283,9,19,1,20,927
37159051903,3390,2484,318,406,9,8,3,8,906
37159051904,3207,2290,262,453,13,31,0,2,917
37159052000,2582,1221,285,954,5,22,0,18,1361
37161960101,1471,1372,30,12,8,8,0,4,99
37161960102,2210,2044,58,42,5,0,0,2,166
37161960103,2420,2204,43,61,1,14,0,17,216
37161960201,4184,3721,102,209,9,19,1,7,463
37161960202,1303,1139,34,79,2,2,1,6,164
37161960203,1330,1157,62,56,0,9,0,8,173
37161960301,1615,1364,49,138,1,5,1,14,251
37161960302,1405,1266,54,22,0,5,0,1,139
37161960400,3384,2856,122,210,5,30,0,7,528
37161960501,2600,2096,104,260,12,14,0,16,504
37161960502,2799,2097,182,329,5,28,1,19,702
37161960503,1699,1360,75,181,3,23,1,8,339
37161960600,4109,2709,154,978,21,18,8,19,1400
37161960700,4558,3122,352,818,10,34,4,17,1436
37161960800,4505,2635,501,1007,6,65,5,6,1870
37161960900,5056,3763,398,589,15,23,0,30,1293
37161961001,3890,3415,105,198,11,16,0,6,475
37161961002,3088,2847,61,83,3,0,0,1,241
37161961102,3132,2660,193,114,10,12,0,7,472
37161961103,2332,1827,199,192,6,2,0,7,505
37161961104,3008,2486,213,146,5,11,0,5,522
37161961200,4346,3886,195,112,14,5,1,3,460
37163970101,1734,724,404,525,18,5,0,10,1010
37163970102,4555,2099,1519,768,40,8,1,10,2456
37163970201,1154,717,220,167,12,4,2,0,437
37163970202,5143,2905,1323,569,189,14,0,11,2238
37163970302,4906,3210,846,597,72,6,1,18,1696
37163970303,2227,1313,545,257,30,2,0,14,914
37163970304,4071,3059,443,402,41,10,0,12,1012
37163970401,1833,1458,178,71,32,0,0,2,375
37163970402,2801,1416,275,932,37,13,0,7,1385
37163970501,1189,631,144,358,17,2,4,3,558
37163970502,4198,2107,786,1075,88,13,2,17,2091
37163970600,4640,1676,718,1979,99,40,2,10,2964
37163970701,1807,1129,269,288,10,28,2,8,678
37163970702,4624,1742,1052,1610,40,29,0,11,2882
37163970801,2073,706,338,826,95,13,2,6,1367
37163970802,4513,1861,1434,952,132,15,0,6,2652
37163970900,2976,1330,571,963,25,12,0,0,1646
37163971001,2471,968,870,560,8,0,0,10,1503
37163971002,1226,465,199,508,15,0,1,1,761
37163971003,895,213,115,537,2,2,1,0,682
37165010101,3529,2175,93,838,247,38,1,20,1354
37165010102,5031,2305,158,1858,346,104,3,19,2726
37165010200,3614,561,52,2603,220,12,0,16,3053
37165010300,4145,1175,148,2231,347,44,2,15,2970
37165010400,5288,1977,353,1817,870,41,1,13,3311
37165010501,2698,1324,50,870,267,16,3,6,1374
37165010502,3550,2043,127,630,505,9,0,7,1507
37165010601,3115,1073,78,1378,441,18,3,14,2042
37165010602,3204,1614,47,869,462,57,2,2,1590
37167930101,4251,3698,107,225,8,91,1,0,553
37167930102,3797,2891,73,555,12,116,0,15,906
37167930200,4945,3351,217,1027,27,116,1,5,1594
37167930300,3917,3102,177,314,0,154,0,12,815
37167930500,3478,2542,277,366,13,86,0,9,936
37167930700,4668,4269,99,29,8,100,0,4,399
37167930801,5839,4997,353,208,18,38,3,23,842
37167930802,4746,4116,415,38,18,11,2,4,630
37167930901,2590,2062,197,192,7,34,0,5,528
37167930902,3459,2951,260,99,13,23,0,2,508
37167931001,2347,2062,55,89,7,81,1,1,285
37167931002,3441,2811,97,317,17,48,0,9,630
37167931101,2019,1713,70,153,14,11,0,2,306
37167931102,3406,2475,166,624,17,26,0,4,931
37167931202,3159,2409,173,320,10,115,0,5,750
37167931203,2767,631,136,1835,12,28,0,9,2136
37167931204,3675,2565,214,609,9,62,1,22,1110
37169070101,3492,3066,113,176,16,3,2,3,426
37169070102,2633,2399,119,35,8,11,0,0,234
37169070200,3256,3065,100,27,7,4,0,0,191
37169070301,2315,2066,23,111,12,0,0,4,249
37169070302,2178,1969,77,56,6,5,0,5,209
37169070400,4959,4519,146,98,13,5,0,11,440
37169070503,5892,5307,201,98,15,57,2,17,585
37169070504,3290,2965,153,37,14,6,0,2,325
37169070505,3545,3189,131,65,10,28,1,9,356
37169070506,2804,2439,161,41,8,21,0,11,365
37169070600,4748,4450,76,52,14,10,0,3,298
37169070701,2852,2412,60,258,13,1,0,1,440
37169070702,2556,1763,96,565,4,7,6,11,793
37171930101,1818,1539,91,96,3,0,0,1,279
37171930102,4806,4151,388,75,5,7,0,12,655
37171930201,3125,2366,357,253,13,5,1,8,759
37171930202,3152,2586,402,45,4,27,0,0,566
37171930301,2086,1636,136,223,7,27,0,0,450
37171930302,3606,2816,405,236,3,32,0,12,790
37171930400,2521,1664,506,196,7,50,3,6,857
37171930501,2771,2298,325,61,1,19,0,10,473
37171930502,3516,2737,366,301,5,20,0,3,779
37171930600,3538,2868,412,126,10,25,0,8,670
37171930700,4090,3596,279,66,2,20,3,23,494
37171930802,3164,2853,180,27,0,4,2,7,311
37171930803,2321,2158,93,5,4,3,0,7,163
37171930804,2683,2148,411,33,3,3,0,1,535
37171930901,4438,3424,657,211,4,35,0,11,1014
37171930902,1618,1425,87,28,0,14,0,3,193
37171931001,2393,1792,516,22,9,0,0,2,601
37171931002,4938,3533,1149,99,14,38,0,1,1405
37171931003,2949,1806,994,51,8,7,2,8,1143
37171931101,2874,2443,304,38,6,2,0,4,431
37171931102,3503,3068,293,24,8,5,0,11,435
37171931103,1746,1593,54,34,4,2,0,1,153
37171931200,3703,3271,91,163,10,25,0,9,432
37173940100,4883,826,289,24,3416,15,4,3,4057
37173960200,2951,2443,122,55,131,13,4,8,508
37173960301,3192,2827,87,12,117,21,1,17,365
37173960302,3086,2442,94,11,366,4,1,15,644
37173980200,5,3,0,0,0,0,0,1,2
37175960100,4352,3524,419,159,20,27,3,10,828
37175960201,1868,1408,120,216,2,5,4,5,460
37175960202,2469,1927,152,244,6,15,5,10,542
37175960301,3892,3214,253,189,8,53,7,23,678
37175960302,3539,3119,116,87,21,21,2,22,420
37175960401,4355,3995,127,46,5,13,0,10,360
37175960403,2635,2462,46,20,3,12,0,10,173
37175960404,1941,1761,53,26,2,14,0,5,180
37175960501,2819,2600,101,3,7,7,0,6,219
37175960502,2661,2363,143,29,15,3,0,5,298
37175960601,1124,974,86,3,8,1,1,7,150
37175960602,1331,1195,82,5,5,2,0,2,136
37177960100,3245,1879,272,934,5,43,0,13,1366
37179020100,6928,6199,242,201,29,21,3,22,729
37179020203,3943,3107,279,276,5,117,1,13,836
37179020204,4117,3763,174,41,9,21,0,11,354
37179020205,3443,2681,278,253,19,54,0,17,762
37179020206,4017,3600,191,65,6,27,5,9,417
37179020305,7286,5315,602,799,23,173,0,44,1971
37179020307,6748,4376,1061,783,26,118,2,41,2372
37179020308,6326,4056,861,919,9,128,3,51,2270
37179020309,2343,1995,120,68,3,40,0,5,348
37179020310,6422,4642,574,644,18,199,9,63,1780
37179020312,4293,2668,683,556,20,161,2,40,1625
37179020313,2344,1705,244,182,19,54,0,26,639
37179020314,5841,3984,563,509,17,498,0,24,1857
37179020315,5250,4091,352,316,11,192,0,21,1159
37179020316,4968,3554,520,489,10,167,0,20,1414
37179020317,6772,4183,944,1007,5,277,3,62,2589
37179020318,3764,2798,416,246,12,77,0,24,966
37179020319,3419,2198,337,372,7,335,0,31,1221
37179020320,2956,1911,422,389,6,81,2,20,1045
37179020321,4723,2245,1680,539,12,64,2,19,2478
37179020401,6465,4124,1141,799,13,137,0,35,2341
37179020403,4555,2892,894,523,10,41,18,7,1663
37179020405,2007,1012,612,310,7,13,0,5,995
37179020406,4373,709,2046,1458,22,26,0,9,3664
37179020501,5258,2063,1551,1388,11,46,0,26,3195
37179020502,4085,1997,952,945,13,35,0,17,2088
37179020601,5064,1646,2067,1166,18,30,1,8,3418
37179020602,4702,1866,1580,1080,2,44,0,21,2836
37179020701,5994,2618,1311,1747,22,60,6,113,3376
37179020702,3966,2424,558,815,14,12,1,8,1542
37179020800,5072,2931,512,1435,19,21,0,7,2141
37179020901,5306,4098,540,369,30,17,0,20,1208
37179020902,5952,4976,409,276,33,32,1,28,976
37179021004,7062,5273,587,609,26,214,1,47,1789
37179021005,4891,3714,459,421,23,42,3,18,1177
37179021006,5541,4455,258,164,5,409,3,28,1086
37179021007,7126,4783,341,428,15,1287,3,28,2343
37179021009,4468,3069,258,417,4,547,0,12,1399
37179021012,5647,4582,365,231,6,207,0,16,1065
37179021013,9206,6437,984,947,21,351,3,39,2769
37179021014,2769,2126,181,309,1,16,0,1,643
37179021015,4819,4017,217,245,30,57,3,34,802
37179021016,5254,3398,355,344,8,912,8,28,1856
37179021017,5405,3833,413,397,7,493,3,17,1572
37179021018,4794,3451,258,309,4,595,3,10,1343
37179021019,5007,3930,214,167,1,454,0,21,1077
37179021020,5173,3710,334,390,7,528,1,28,1463
37179021021,2403,1908,170,157,3,86,0,5,495
37181960100,3925,1919,157,1737,4,19,0,12,2006
37181960200,4107,1748,190,2036,5,11,0,9,2359
37181960300,5124,2714,256,1960,14,32,2,9,2410
37181960400,4226,2132,186,1681,4,114,0,17,2094
37181960500,4650,836,241,3381,16,31,0,17,3814
37181960600,1375,287,223,815,8,1,0,6,1088
37181960700,3770,284,324,3069,10,3,0,2,3486
37181960800,1898,415,402,1010,7,5,0,7,1483
37181960901,2860,951,427,1401,4,4,0,10,1909
37181960902,1661,856,181,582,1,3,0,0,805
37181960903,3464,1155,646,1526,6,32,4,7,2309
37181961000,5518,2946,484,1883,12,29,3,14,2572
37183050100,5199,3637,320,768,6,225,2,17,1562
37183050300,3498,2676,181,389,9,104,0,15,822
37183050400,1655,1168,91,288,0,25,0,2,487
37183050500,3880,2593,278,794,5,41,3,18,1287
37183050600,3460,1475,225,1610,8,44,0,19,1985
37183050700,3073,933,197,1772,7,45,1,6,2140
37183050800,4086,1540,418,1931,49,20,1,26,2546
37183050900,2672,753,301,1478,6,46,1,8,1919
37183051000,2798,2058,210,290,9,62,0,9,740
37183051101,4099,2337,370,730,8,422,0,14,1762
37183051102,3940,2508,255,641,33,321,2,14,1432
37183051200,4466,3688,210,146,5,191,0,23,778
37183051400,5962,4931,264,361,10,180,4,24,1031
37183051501,3519,3185,87,71,2,69,0,9,334
37183051502,2695,2386,83,59,0,65,0,7,309
37183051600,4958,4549,174,49,8,36,0,18,409
37183051700,4044,3727,90,65,1,70,0,1,317
37183051800,5147,4480,214,199,7,62,0,10,667
37183051900,4911,1763,702,2188,5,43,4,10,3148
37183052001,3782,390,1235,1954,14,45,0,20,3392
37183052002,5085,451,1232,3241,15,37,0,14,4634
37183052101,8750,976,2301,5048,32,129,0,50,7774
37183052102,5966,383,1200,4045,15,92,0,54,5583
37183052303,3759,2389,225,656,7,284,0,14,1370
37183052304,2803,1586,192,721,8,124,2,28,1217
37183052305,3053,1831,183,402,11,511,4,9,1222
37183052306,1382,877,77,215,3,161,1,11,505
37183052307,4619,2530,364,909,6,506,2,39,2089
37183052401,6315,4464,381,821,13,340,9,33,1851
37183052404,4001,2421,340,360,9,672,0,31,1580
37183052407,4401,2485,552,881,18,221,4,36,1916
37183052408,3025,1382,441,790,7,221,5,32,1643
37183052409,4865,2043,712,492,10,1406,12,17,2822
37183052410,1790,953,220,402,2,82,0,21,837
37183052411,6285,2765,986,1702,11,370,2,159,3520
37183052504,7187,4970,586,1009,8,324,0,35,2217
37183052505,5050,3358,592,648,11,202,5,16,1692
37183052506,2488,1881,126,309,4,73,2,13,607
37183052507,2861,1638,376,624,13,55,3,10,1223
37183052508,3384,2569,164,383,5,142,0,14,815
37183052509,3989,2941,264,440,4,169,0,14,1048
37183052601,3386,3047,83,61,1,69,2,14,339
37183052602,5219,4342,236,321,4,137,0,38,877
37183052603,3613,3202,110,103,1,98,0,25,411
37183052701,6052,3179,1543,863,7,248,2,33,2873
37183052704,6809,912,2627,2760,17,271,4,27,5897
37183052705,5558,2719,1124,1109,7,303,4,55,2839
37183052706,4848,1290,1591,1590,19,174,6,22,3558
37183052707,6958,2246,1719,2195,17,488,3,32,4712
37183052801,6140,3795,558,1434,21,84,2,22,2345
37183052802,5972,2878,1158,1523,31,107,7,34,3094
37183052807,6737,2054,1133,3102,32,111,2,25,4683
37183052809,2772,1376,694,526,20,15,0,18,1396
37183052810,8391,1224,1622,4981,34,211,2,47,7167
37183052811,8517,824,1915,5199,20,213,6,60,7693
37183052812,4215,2615,348,1002,13,58,0,47,1600
37183052813,2939,1496,397,830,17,44,0,29,1443
37183052814,5061,2323,539,1786,17,138,8,24,2738
37183052815,4648,1479,949,1900,27,79,0,23,3169
37183052816,5842,481,1317,3768,13,79,4,52,5361
37183052901,2906,2142,403,233,2,14,1,7,764
37183052902,5824,3898,851,731,19,77,3,26,1926
37183052903,3257,2314,248,506,4,43,0,4,943
37183052905,3286,2375,314,383,6,29,0,15,911
37183052906,5131,3599,601,663,11,63,6,20,1532
37183053003,6105,4055,485,599,11,604,8,43,2050
37183053004,2938,2280,114,163,1,251,0,6,658
37183053005,4880,4162,191,83,7,216,1,36,718
37183053006,3126,2699,143,64,9,78,2,14,427
37183053007,3545,2645,195,134,18,371,2,26,900
37183053009,9254,4916,2471,1230,30,209,1,41,4338
37183053010,4665,3301,486,402,16,181,1,39,1364
37183053011,4224,2440,391,604,12,541,2,39,1784
37183053105,5462,3923,602,538,13,113,2,27,1539
37183053106,3999,2477,386,867,19,52,3,26,1522
37183053109,10138,7754,1083,637,37,155,13,47,2384
37183053110,6424,4157,906,841,23,166,3,47,2267
37183053111,6905,4398,1172,911,15,120,0,27,2507
37183053112,6549,4606,563,919,22,90,3,47,1943
37183053113,5592,3562,628,971,32,110,3,8,2030
37183053114,7140,5223,692,753,21,124,0,31,1917
37183053115,2747,1949,431,218,7,24,0,6,798
37183053202,4367,3635,203,282,6,83,3,24,732
37183053203,10600,7709,662,926,17,668,2,92,2891
37183053204,4982,3249,491,823,14,123,4,32,1733
37183053205,6082,4514,448,539,15,281,2,29,1568
37183053206,5759,3709,533,850,20,352,3,23,2050
37183053208,12130,9403,796,568,28,666,0,47,2727
37183053209,3023,2202,360,288,4,41,0,0,821
37183053210,5363,4127,451,286,6,230,0,31,1236
37183053211,8124,6468,631,437,11,220,3,35,1656
37183053405,5376,4132,220,243,13,517,0,28,1244
37183053408,4278,2331,175,99,5,1495,0,7,1947
37183053409,6807,4348,402,242,9,1470,0,13,2459
37183053410,6673,2931,275,326,12,2841,4,34,3742
37183053411,14610,5665,760,1090,33,6390,0,81,8945
37183053415,4917,3072,384,345,7,851,3,21,1845
37183053417,4634,2826,513,580,4,448,2,18,1808
37183053419,3010,2458,121,130,6,149,0,14,552
37183053421,5922,3816,519,547,10,735,4,27,2106
37183053422,2449,1881,145,100,4,189,0,18,568
37183053423,2172,1574,197,130,5,148,0,14,598
37183053424,4728,2864,301,250,8,1071,3,15,1864
37183053425,3140,1517,156,111,0,1259,1,14,1623
37183053426,7522,2637,366,246,11,3989,0,35,4885
37183053427,5698,3982,395,316,0,685,0,45,1716
37183053428,13307,8809,834,718,42,2097,4,75,4498
37183053429,3185,2358,243,153,6,262,0,24,827
37183053430,4201,2751,392,419,5,437,0,16,1450
37183053431,5562,3018,959,719,4,550,1,46,2544
37183053432,3173,2010,293,518,11,139,2,29,1163
37183053433,4434,3631,235,116,5,230,3,28,803
37183053434,4931,3355,614,492,6,273,2,17,1576
37183053435,3741,2778,247,154,14,336,0,13,963
37183053436,3255,2200,589,155,4,157,4,22,1055
37183053505,3791,2908,249,158,10,275,0,18,883
37183053506,5943,4558,439,392,15,274,0,43,1385
37183053507,3923,2592,500,447,10,217,2,23,1331
37183053509,5201,4142,226,118,8,481,0,19,1059
37183053512,7112,4567,442,658,9,1050,5,33,2545
37183053513,4461,2112,767,826,11,487,3,21,2349
37183053516,3543,2007,568,464,7,243,11,54,1536
37183053517,4663,1601,2147,461,14,221,1,47,3062
37183053518,3528,2831,266,135,0,122,4,10,697
37183053519,3954,2201,777,576,9,187,1,27,1753
37183053520,5857,2938,1083,1045,8,501,3,45,2919
37183053521,3638,2452,181,241,7,579,0,27,1186
37183053522,8495,3506,463,739,21,3447,0,50,4989
37183053523,5779,3229,394,388,18,1444,3,40,2550
37183053524,3778,2291,375,355,11,563,0,18,1487
37183053525,2898,1978,220,270,4,235,0,17,920
37183053603,4457,2260,187,175,11,1676,3,10,2197
37183053604,4336,2363,161,122,7,1483,8,37,1973
37183053608,7746,1987,318,636,23,4476,3,44,5759
37183053609,1653,642,165,231,2,558,0,2,1011
37183053611,6852,2180,306,610,16,3434,0,42,4672
37183053612,3664,898,185,321,6,2147,0,17,2766
37183053613,4419,2153,383,1095,2,555,0,23,2266
37183053614,2572,1593,109,288,10,435,0,13,979
37183053615,5038,2174,510,1602,7,430,1,31,2864
37183053616,5488,3286,356,376,12,1208,0,26,2202
37183053617,10385,4132,733,1143,18,3861,11,58,6253
37183053618,4931,1397,340,723,7,2312,3,17,3534
37183053619,501,190,51,76,0,155,0,9,311
37183053620,6758,2111,408,682,18,3254,4,49,4647
37183053711,5339,4037,340,525,6,181,0,17,1302
37183053712,2805,2322,107,170,3,92,3,18,483
37183053713,3799,2043,446,982,18,92,0,25,1756
37183053714,5297,3804,429,634,7,165,0,17,1493
37183053715,3489,2798,211,267,5,78,0,10,691
37183053716,4233,2691,330,913,8,90,1,27,1542
37183053717,4806,2358,407,1298,27,458,5,43,2448
37183053718,3458,2544,211,305,9,205,0,22,914
37183053719,4017,3079,278,239,5,206,2,17,938
37183053720,4360,3712,191,142,5,108,1,16,648
37183053721,3980,3227,178,152,16,224,2,8,753
37183053722,4958,4171,192,306,5,108,0,28,787
37183053723,3359,2469,276,320,3,146,3,12,890
37183053724,6316,3935,524,739,15,800,3,34,2381
37183053725,5663,3754,467,785,17,307,5,29,1909
37183053726,3366,1727,579,755,7,140,0,22,1639
37183053727,5204,3647,414,603,8,252,4,27,1557
37183053728,2722,1484,345,626,4,143,0,24,1238
37183053729,4285,3162,293,543,6,112,0,16,1123
37183053730,2412,1256,383,583,1,54,1,20,1156
37183053803,3917,3264,156,131,14,166,0,17,653
37183053804,3928,3218,180,251,3,124,0,14,710
37183053805,2007,1733,43,43,3,61,4,20,274
37183053806,3582,3130,118,109,2,105,0,10,452
37183053807,4146,3415,164,226,6,161,5,24,731
37183053808,5581,4684,146,250,5,250,0,14,897
37183053901,4583,3671,184,284,5,190,0,24,912
37183053902,6091,4974,333,373,19,147,1,15,1117
37183054001,5511,3268,575,1259,8,139,0,22,2243
37183054004,5286,2881,904,1104,13,122,0,46,2405
37183054006,3288,1701,385,789,1,256,3,7,1587
37183054007,4101,2671,345,780,10,77,0,21,1430
37183054008,6474,1024,1841,3015,21,304,0,44,5450
37183054011,2838,2397,119,157,9,52,0,8,441
37183054012,3734,2999,180,307,6,133,2,12,735
37183054015,4122,1259,770,1601,29,320,0,30,2863
37183054016,6058,4428,438,730,13,193,0,12,1630
37183054017,2813,1455,348,762,7,96,1,26,1358
37183054018,3741,1047,523,1621,14,353,5,22,2694
37183054019,5208,3960,322,468,3,183,2,10,1248
37183054020,4849,3492,342,684,4,102,0,14,1357
37183054021,3101,2554,151,128,1,101,1,5,547
37183054022,6181,1472,1902,2244,17,250,1,37,4709
37183054023,7951,2217,1093,3586,41,630,5,48,5734
37183054106,8332,1359,2596,3804,28,232,8,77,6973
37183054108,7771,2599,1803,2757,30,194,2,69,5172
37183054109,4824,2271,702,1579,37,43,1,17,2553
37183054111,2605,1363,459,618,13,51,0,10,1242
37183054112,3999,1260,928,1503,26,74,5,37,2739
37183054113,4887,1590,805,1980,27,247,3,42,3297
37183054114,7613,2884,1690,2454,22,233,4,48,4729
37183054115,9855,3863,1429,3736,32,327,8,52,5992
37183054116,6623,1972,2153,1812,18,408,7,49,4651
37183054117,6300,1702,1398,2161,19,722,2,58,4598
37183054118,5662,2353,570,2057,8,401,1,61,3309
37183054119,7087,2996,789,2664,19,297,3,54,4091
37183054120,1475,1075,110,165,6,43,0,4,400
37183054121,8953,4200,1200,2756,19,315,2,35,4753
37183054203,3818,3098,217,292,1,85,2,5,720
37183054204,4957,3502,411,643,9,118,1,20,1455
37183054206,6566,4770,542,765,6,168,6,27,1796
37183054212,6171,3642,557,1349,13,329,4,23,2529
37183054213,4462,2880,308,658,9,373,0,20,1582
37183054214,2122,1739,130,150,5,9,0,25,383
37183054215,4978,2739,454,1393,6,142,1,17,2239
37183054216,5706,3757,387,1091,4,215,1,19,1949
37183054217,4573,3136,295,687,8,223,0,25,1437
37183054218,8672,3980,1092,2511,30,596,9,47,4692
37183054219,4130,3137,334,321,7,100,3,24,993
37183054220,6573,3657,817,1411,18,333,4,27,2916
37183054221,7537,5194,620,1042,12,246,0,45,2343
37183054222,8084,5854,693,955,13,242,3,33,2230
37183054223,2723,1804,215,530,6,66,0,14,919
37183054224,4651,2718,336,1229,10,94,2,25,1933
37183054303,2783,1308,540,802,10,17,0,15,1475
37183054304,5628,3200,675,1426,18,53,0,42,2428
37183054305,3551,1616,505,1179,26,41,0,36,1935
37183054306,3635,1469,741,1244,7,14,0,35,2166
37183054402,8201,4715,1425,1554,32,107,10,29,3486
37183054403,4159,2010,1138,787,19,40,6,29,2149
37183054404,6927,3132,1236,2029,17,169,3,57,3795
37183054501,5763,2753,1227,1207,31,308,1,21,3010
37183054502,3898,1323,894,1510,7,27,0,37,2575
37183980100,2,0,0,0,0,0,0,0,2
37183980200,0,0,0,0,0,0,0,0,0
37185950101,2215,1772,47,305,12,5,0,5,443
37185950102,1316,881,27,340,11,6,0,17,435
37185950103,2426,496,59,965,790,14,0,2,1930
37185950201,3469,1369,118,1812,41,6,3,20,2100
37185950202,2227,661,86,1411,23,4,0,1,1566
37185950300,3726,960,190,2394,42,12,1,17,2766
37185950400,3263,1070,212,1822,34,15,0,3,2193
37187950100,4103,1993,202,1783,7,15,0,9,2110
37187950201,2653,933,34,1581,3,11,1,16,1720
37187950202,2951,1119,91,1679,1,7,1,11,1832
37187950300,1296,913,44,307,4,4,1,0,383
37189920100,4507,4155,131,30,5,22,1,6,352
37189920200,3843,3522,138,12,3,11,0,13,321
37189920300,2360,2076,132,20,6,14,0,8,284
37189920400,8327,7126,446,241,18,126,1,30,1201
37189920500,8429,4954,1052,1390,5,366,3,296,3475
37189920601,5143,4155,412,165,11,161,4,33,988
37189920602,2549,2227,140,59,6,43,2,9,322
37189920701,1982,1755,122,9,1,10,0,8,227
37189920702,2905,2633,126,16,6,35,0,4,272
37189920703,5895,4964,510,104,11,94,0,21,931
37189920800,2835,2638,68,13,2,23,0,4,197
37189920900,4610,4143,216,39,8,31,0,6,467
37189921000,701,638,28,3,0,2,0,0,63
37191000102,6602,4875,338,939,12,118,4,13,1727
37191000103,2353,1734,168,308,19,2,2,2,619
37191000104,5003,3556,392,810,17,21,2,15,1447
37191000200,3110,1894,279,840,6,4,0,6,1216
37191000302,5484,2507,493,2155,17,74,1,27,2977
37191000303,6762,4399,670,1262,26,88,7,38,2363
37191000304,5063,3622,390,783,9,46,0,18,1441
37191000401,5915,3857,720,1040,13,66,7,20,2058
37191000402,4160,1868,884,1074,10,90,0,23,2292
37191000500,2722,1566,495,336,10,93,6,5,1156
37191000601,4387,1182,1211,1791,10,20,0,20,3205
37191000603,4856,1909,1813,959,12,20,7,18,2947
37191000604,3223,1298,1676,149,9,11,3,9,1925
37191000700,2338,564,255,1448,5,8,0,5,1774
37191000800,2382,1201,422,673,9,8,0,12,1181
37191000901,4391,2369,705,1071,11,40,3,32,2022
37191000902,5212,2391,1101,1444,10,32,2,20,2821
37191001000,3766,3042,401,222,10,5,0,0,724
37191001102,3160,2278,180,489,20,57,0,15,882
37191001103,3717,2461,246,815,24,14,0,8,1256
37191001104,3467,2581,349,313,6,38,3,22,886
37191001200,3759,1522,243,1703,7,123,1,17,2237
37191001301,5758,2416,414,2338,8,266,9,44,3342
37191001302,3491,1631,292,1237,4,170,5,24,1860
37191001401,3538,1094,144,2109,19,35,3,8,2444
37191001402,2490,109,125,2152,5,14,1,0,2381
37191001500,2162,164,124,1768,0,9,1,0,1998
37191001800,2799,660,130,1870,16,14,1,4,2139
37191001900,3934,1158,187,2354,9,46,3,22,2776
37191002000,1329,291,80,877,2,10,0,7,1038
37193960101,3158,2916,124,21,2,4,0,14,242
37193960102,3437,3099,118,102,6,13,0,4,338
37193960200,3455,3225,95,33,5,5,0,12,230
37193960300,5978,5398,299,113,6,8,4,18,580
37193960401,3213,3036,68,5,1,7,0,0,177
37193960402,3639,3271,208,32,9,4,0,4,368
37193960500,3283,2365,457,310,0,16,1,13,918
37193960600,2575,1858,324,247,9,6,0,9,717
37193960700,3590,2765,583,126,3,24,0,5,825
37193960801,3972,3475,335,25,3,18,0,3,497
37193960802,4339,3958,208,39,4,18,0,6,381
37193960901,2377,2230,71,8,6,10,0,12,147
37193960902,2260,2109,43,50,0,7,0,0,151
37193961001,4749,3747,440,335,5,20,0,2,1002
37193961002,4969,4024,510,194,3,90,0,8,945
37193961100,4157,2744,430,746,12,64,0,9,1413
37193961201,3567,3299,135,51,5,7,0,2,268
37193961202,3251,2797,206,143,7,3,0,10,454
37195000100,2902,501,432,1827,16,8,2,10,2401
37195000200,1080,111,182,737,3,4,0,10,969
37195000300,2200,211,427,1490,2,1,2,8,1989
37195000401,4574,1558,409,2392,9,72,1,15,3016
37195000402,3586,1370,208,1738,6,128,3,17,2216
37195000501,3554,2834,129,411,9,22,0,17,720
37195000502,5045,2924,242,1540,10,127,0,8,2121
37195000601,3612,1027,324,2100,3,15,1,17,2585
37195000602,3982,2337,165,1195,3,150,0,10,1645
37195000701,2226,130,200,1832,0,6,0,3,2096
37195000702,2870,283,793,1707,11,2,1,1,2587
37195000801,1597,42,195,1309,5,1,0,18,1555
37195000802,3383,566,617,2068,7,6,0,30,2817
37195000900,3472,2471,341,545,16,3,0,8,1001
37195001000,1839,841,349,592,0,5,0,9,998
37195001100,1443,735,146,519,7,3,0,1,708
37195001200,3675,1808,643,1074,10,9,0,14,1867
37195001301,2719,1414,210,962,15,29,0,0,1305
37195001302,2602,1464,202,819,12,0,0,7,1138
37195001401,3380,2683,107,439,13,71,0,10,697
37195001402,6059,2282,722,2571,25,199,0,19,3777
37195001501,2337,1573,423,259,3,4,0,2,764
37195001502,3498,2326,576,487,5,22,0,9,1172
37195001600,3154,2040,424,545,19,6,0,7,1114
37195001700,3995,2575,558,684,30,7,0,7,1420
37197050101,5463,4704,446,114,4,20,0,9,759
37197050102,3990,3533,240,70,3,13,0,17,457
37197050200,4451,3683,418,170,8,11,0,8,768
37197050300,5732,4557,576,307,8,34,0,21,1175
37197050401,3158,2643,404,30,5,9,0,8,515
37197050402,3123,2261,727,53,8,5,0,4,862
37197050502,4267,3655,376,84,18,11,0,1,612
37197050503,3361,2581,569,84,5,22,0,10,780
37197050504,3669,2740,626,159,4,17,0,9,929
37199960101,3977,3632,180,4,4,5,0,12,345
37199960102,1969,1787,102,6,12,5,0,5,182
37199960200,4825,4310,295,55,14,11,0,10,515
37199960300,3118,2682,293,29,12,11,1,3,436
37199960400,4581,4214,146,10,15,8,0,10,367
38001965600,2200,2028,36,12,14,39,1,0,172
38003967900,1675,1601,10,1,11,0,0,1,74
38003968000,2581,2454,27,3,10,1,0,8,127
38003968200,2796,2437,92,105,37,30,2,5,359
38003968300,3801,3472,56,68,34,38,0,10,329
38005940100,2134,328,34,1,1716,0,0,1,1806
38005940200,1825,299,23,1,1448,7,0,0,1526
38005956700,2005,1905,32,0,26,0,0,0,100
38007963100,945,902,22,4,3,6,0,0,43
38009952300,2336,1884,89,28,147,29,1,9,452
38009952400,2318,2174,17,0,38,6,0,2,144
38009952500,1725,1630,35,3,12,7,0,2,95
38011965200,1718,1563,94,0,21,11,2,0,155
38011965300,1275,1197,35,0,13,6,1,0,78
38013953300,2201,2049,59,12,21,12,0,5,152
38015010100,3050,2448,138,92,202,41,5,6,602
38015010200,4651,3743,228,76,335,22,10,21,908
38015010300,5794,4656,260,282,272,77,18,8,1138
38015010400,3487,3044,98,112,89,27,6,7,443
38015010500,5494,4674,188,165,160,65,5,14,820
38015010600,4426,3766,117,72,272,17,10,9,660
38015010700,3999,3185,152,127,228,34,124,8,814
38015010800,3556,2714,235,60,352,10,1,12,842
38015010900,5026,4261,145,191,297,25,9,10,765
38015011001,7283,5967,387,255,280,145,20,7,1316
38015011002,7563,7004,135,25,154,42,1,11,559
38015011101,5630,4713,138,235,181,143,36,18,917
38015011103,2598,2070,70,145,142,29,40,6,528
38015011104,7123,6602,83,48,95,138,2,11,521
38015011105,6726,6182,109,68,84,77,4,11,544
38015011200,9237,7939,318,185,353,123,25,25,1298
38015011300,8273,7157,205,84,488,24,0,18,1116
38015011400,3115,2905,56,5,34,4,0,5,210
38015011500,1427,1319,22,0,35,0,0,3,108
38017000100,5184,4838,73,15,17,87,1,5,346
38017000203,2838,2394,93,92,58,71,1,5,444
38017000204,3351,2854,98,79,80,83,1,6,497
38017000300,5239,3996,358,399,35,321,1,0,1243
38017000400,3813,3309,166,62,38,80,2,3,504
38017000501,3413,2845,179,124,87,26,1,5,568
38017000502,3666,3021,144,160,60,126,2,8,645
38017000601,2336,1714,103,259,79,77,4,12,622
38017000602,2607,1999,113,163,119,65,2,7,608
38017000700,1855,1461,86,101,74,44,0,9,394
38017000801,3102,2570,104,93,101,45,0,4,532
38017000802,4887,3376,220,481,99,476,1,16,1511
38017000901,4816,4184,119,164,68,35,0,17,632
38017000903,3507,2514,164,536,46,60,0,10,993
38017000904,4126,3419,166,239,66,50,8,14,707
38017001003,3772,2892,165,287,87,165,0,7,880
38017001004,4256,3446,185,242,72,120,7,11,810
38017010106,4576,2362,291,1036,134,534,2,21,2214
38017010107,2639,1609,160,404,53,324,4,4,1030
38017010109,3789,2991,141,282,70,95,0,9,798
38017010110,2361,1961,64,131,22,76,1,6,400
38017010111,3581,2067,167,899,63,213,3,14,1514
38017010201,4673,4226,116,102,48,24,0,6,447
38017010205,3727,3391,73,32,14,109,0,7,336
38017010206,5797,4720,262,372,107,33,0,11,1077
38017010303,6530,5197,150,596,50,254,11,27,1333
38017010306,4028,3077,111,398,32,221,5,1,951
38017010307,1994,1811,29,26,6,55,2,2,183
38017010308,4888,3378,126,771,48,385,1,20,1510
38017040100,1902,1817,15,2,8,0,0,0,85
38017040200,2437,2313,25,8,18,2,0,2,124
38017040300,3370,3144,52,20,24,6,0,10,226
38017040501,7860,6144,385,621,57,314,2,23,1716
38017040502,8909,7257,327,598,112,213,2,23,1652
38017040503,3216,2985,61,25,34,3,0,17,231
38017040504,6393,5215,133,567,36,202,2,18,1178
38017040505,5780,4863,130,411,33,113,3,18,917
38017040506,3809,3181,95,279,33,88,6,10,628
38017040507,3683,3256,57,125,15,70,2,3,427
38017040508,5587,4679,158,196,27,267,0,15,908
38017040509,5625,4710,122,271,37,242,0,14,915
38017040600,3155,2991,62,6,12,6,1,4,164
38017040700,6341,4553,234,1040,52,238,1,15,1788
38017040800,5107,4712,100,47,36,16,0,20,395
38019950900,1883,1753,34,0,14,9,0,7,130
38019951100,1821,1732,11,2,14,7,0,8,89
38021973200,2268,2041,136,3,8,20,0,5,227
38021973300,1468,1388,31,5,1,0,0,6,80
38021973400,1263,1143,32,11,17,7,0,6,120
38023954500,2195,2024,53,23,17,11,4,3,171
38025962200,4095,3241,107,23,455,32,0,10,854
38027959200,2347,2102,77,5,60,0,0,0,245
38029966500,3301,3162,35,0,13,12,0,8,139
38031959600,3397,3199,66,7,18,13,0,6,198
38033962900,1736,1600,48,5,12,1,1,4,136
38035010100,3388,2654,203,114,174,28,0,4,734
38035010200,4248,3413,303,133,98,47,0,15,835
38035010301,1588,1269,87,61,16,111,6,4,319
38035010302,2396,1632,111,110,39,414,8,5,764
38035010400,5873,3979,403,457,282,384,3,13,1894
38035010600,2414,1795,185,93,129,18,2,15,619
38035010700,1879,1683,57,14,30,9,0,5,196
38035010801,6027,4866,198,230,142,331,2,7,1161
38035010804,4824,3694,243,423,87,169,1,15,1130
38035010805,2391,1654,146,238,74,177,0,10,737
38035010806,3023,2056,209,288,116,170,2,10,967
38035010900,2211,1940,90,15,46,11,0,15,271
38035011000,1846,1550,104,44,50,18,0,1,296
38035011100,6382,5834,124,51,27,123,0,12,548
38035011201,2742,2174,150,150,96,34,0,1,568
38035011202,5774,4719,213,279,65,243,7,12,1055
38035011400,2318,2118,66,5,16,7,0,5,200
38035011701,2350,2011,121,27,64,16,0,2,339
38035011702,5120,4555,151,77,38,77,3,11,565
38035011800,1712,1610,38,7,4,5,3,0,102
38035011900,2002,1197,323,170,6,73,15,5,805
38035012000,2662,2352,132,23,38,14,0,2,310
38037965900,2301,2169,26,10,32,11,0,0,132
38039968600,2306,2200,24,8,12,7,0,4,106
38041964700,1072,1027,11,0,8,1,2,0,45
38041964800,1417,1292,23,5,34,4,5,8,125
38043966800,2394,2271,52,3,11,1,5,0,123
38045972100,1404,1333,25,1,10,3,0,6,71
38045972200,2689,2564,63,5,10,4,4,4,125
38047972500,1876,1773,35,2,11,0,0,1,103
38049955600,2425,2252,67,7,15,7,2,0,173
38049955900,2920,2772,31,4,12,5,4,0,148
38051972900,2530,2375,53,7,5,23,0,8,155
38053940100,1878,87,85,9,1614,3,0,1,1791
38053962301,3573,2939,341,66,67,27,0,6,634
38053962302,1662,1456,83,6,22,9,0,14,206
38053962400,5654,4020,974,122,98,128,5,34,1634
38053962500,1937,1766,49,11,22,4,0,12,171
38055940100,1058,284,44,9,637,9,0,0,774
38055960800,4180,3899,54,11,37,10,6,13,281
38055961001,4533,4189,50,12,92,29,1,4,344
38057961600,2427,2239,54,7,41,14,0,10,188
38057961700,3145,2813,115,29,44,20,0,5,332
38057961800,2778,2519,49,6,108,9,1,3,259
38059020100,4904,4075,292,65,220,32,5,11,829
38059020200,8931,7704,406,130,287,57,18,15,1227
38059020301,7128,5802,326,200,442,38,3,18,1326
38059020302,3718,3312,96,21,102,27,6,9,406
38059020303,1734,1434,64,24,121,0,0,5,300
38059020400,3252,3071,50,6,53,8,2,1,181
38059020500,3624,3398,78,16,13,9,5,15,226
38061940300,1239,486,79,15,571,13,0,7,753
38061940400,3542,795,308,71,2060,57,0,4,2747
38061955200,5028,4258,381,27,106,35,3,23,770
38063959000,3015,2844,69,6,16,9,1,5,171
38065961200,1877,1755,28,3,23,5,3,1,122
38067950100,1191,1085,27,7,1,8,0,4,106
38067950200,1494,1296,26,4,98,2,0,0,198
38067950500,1448,1256,121,5,8,0,0,7,192
38067950600,2711,2459,69,11,26,17,0,11,252
38069956100,1469,1238,44,33,103,3,1,6,231
38069956200,2521,2373,28,3,43,14,4,4,148
38071957600,4393,3215,133,27,743,32,3,0,1178
38071957700,2875,2628,36,15,49,14,4,1,247
38071957800,4337,3511,105,31,435,26,3,7,826
38073968900,1821,1718,51,11,2,3,0,0,103
38073969000,1556,1498,11,7,11,4,0,1,58
38073969100,2326,2147,67,18,5,17,0,9,179
38075952900,2282,2146,37,5,14,0,0,2,136
38077970700,2185,2080,31,6,10,4,4,1,105
38077970800,2140,2020,54,3,15,10,0,0,120
38077970900,4264,3619,233,67,130,42,11,12,645
38077971000,3836,3213,149,64,171,60,4,4,623
38077971100,1240,1147,50,6,7,1,0,0,93
38077971400,2864,2624,57,9,100,6,0,6,240
38079941800,5113,195,45,10,4743,1,0,0,4918
38079951600,1407,671,31,0,548,20,2,3,736
38079951700,4121,627,37,3,3315,0,3,1,3494
38079951900,1546,805,24,0,604,2,3,4,741
38081974000,1513,1373,38,33,4,3,0,0,140
38081974200,2349,2197,53,15,4,10,0,0,152
38083960200,1265,1191,10,2,11,6,0,4,74
38085940800,1509,289,29,1,1124,0,0,0,1220
38085940900,2389,112,34,2,2157,2,0,0,2277
38087965000,706,679,8,0,2,0,0,0,27
38089963300,1631,1500,48,0,9,10,0,5,131
38089963400,5613,4748,326,143,83,75,6,11,865
38089963501,3579,3100,200,80,24,44,7,14,479
38089963502,5617,4247,575,375,59,106,16,21,1370
38089963600,2199,1808,163,89,24,22,2,10,391
38089963700,3926,3350,218,135,65,33,5,10,576
38089963800,5086,4067,555,137,76,36,8,11,1019
38089963900,3973,3653,122,65,20,12,5,5,320
38089964000,2022,1834,67,9,32,6,2,1,188
38091968700,1798,1721,36,3,7,0,0,0,77
38093967000,2701,2590,20,3,9,9,1,3,111
38093967200,2583,2476,29,6,8,5,0,5,107
38093967300,2881,2513,86,105,112,27,0,2,368
38093967401,1730,1356,113,126,28,20,0,4,374
38093967402,4125,3704,114,87,42,17,2,0,421
38093967500,3589,3291,91,42,36,31,1,1,298
38093967800,3984,3574,140,75,61,28,0,9,410
38095951500,2162,1984,34,2,71,10,1,4,178
38097970100,2358,2190,65,5,20,9,0,2,168
38097970200,2509,2258,90,39,16,5,2,4,251
38097970300,1433,1385,15,0,5,0,0,2,48
38097970400,1697,1478,127,4,19,4,2,2,219
38099957800,1516,1225,205,4,27,0,0,4,291
38099957900,1508,945,452,21,23,6,0,11,563
38099958000,2644,1977,462,30,48,25,0,3,667
38099958100,2174,1975,115,11,19,9,0,4,199
38099958200,1613,1512,50,1,12,2,0,9,101
38099958300,1108,1042,32,2,7,3,0,0,66
38101010100,2752,2085,138,129,130,43,3,19,667
38101010200,5734,4220,670,307,94,79,33,18,1514
38101010301,5651,4114,458,441,80,170,28,19,1537
38101010302,5987,4962,277,221,129,110,3,21,1025
38101010400,5628,4484,405,214,121,82,5,16,1144
38101010500,5397,4644,199,117,101,64,3,18,753
38101010601,4284,3480,204,198,102,125,5,4,804
38101010602,5924,4594,463,306,176,97,2,22,1330
38101010701,4235,3259,271,206,181,65,2,10,976
38101010702,3125,2284,221,125,199,15,0,6,841
38101010800,4916,4156,206,197,63,45,12,18,760
38101010901,2268,1509,316,111,13,61,14,24,759
38101010902,2749,1622,503,226,31,73,16,9,1127
38101011000,1984,1843,45,3,9,18,3,8,141
38101011200,3731,3436,81,18,29,7,0,12,295
38101011300,5554,4981,133,34,112,33,0,26,573
38103959800,1681,1582,13,8,17,10,0,0,99
38103960000,2301,2202,25,10,0,2,0,4,99
38105953400,3002,2510,316,38,19,22,0,16,492
38105953500,3806,2853,245,60,319,26,0,24,953
38105953600,3838,3330,128,27,87,17,1,16,508
38105953701,12559,8263,1793,1178,310,243,37,67,4296
38105953702,6337,4674,647,416,88,96,39,11,1663
38105953800,2415,1971,176,39,72,18,0,2,444
38105953900,3721,3156,184,102,64,45,8,5,565
38105954100,5272,4004,408,181,166,145,13,23,1268
39001770100,4742,4474,47,22,16,4,0,1,268
39001770200,4714,4494,40,6,1,5,0,3,220
39001770301,3988,3822,23,12,13,0,0,6,166
39001770302,3077,2942,21,15,1,10,0,5,135
39001770400,4685,4490,46,18,12,8,1,0,195
39001770500,3038,2885,6,4,21,4,0,17,153
39001770600,3233,3078,34,7,10,8,0,1,155
39003010100,4126,3715,100,98,4,34,2,33,411
39003010200,3812,3560,72,12,3,8,0,3,252
39003010300,1600,1505,32,7,1,2,1,2,95
39003010600,5128,4735,90,42,22,14,21,30,393
39003010801,4453,3970,117,137,0,27,1,22,483
39003010802,3602,3073,120,178,5,57,0,10,529
39003010900,4545,3369,187,665,12,77,1,13,1176
39003011000,5437,3632,230,1123,15,83,0,55,1805
39003011200,2843,1996,90,683,7,5,0,9,847
39003011301,4538,3950,148,122,15,95,2,17,588
39003011302,2771,2590,56,32,4,4,0,9,181
39003011400,3143,2997,40,13,1,3,0,6,146
39003011500,2757,2588,48,13,1,4,0,3,169
39003011600,2579,2334,46,65,2,2,0,12,245
39003011800,2298,1945,63,132,4,40,1,11,353
39003011900,3089,2769,77,83,20,25,0,11,320
39003012000,2593,2288,62,107,3,56,1,10,305
39003012100,3438,2958,78,127,0,102,0,21,480
39003012200,3338,1980,127,869,9,61,1,23,1358
39003012300,3893,2558,180,719,11,15,0,55,1335
39003012400,2466,1719,129,391,3,39,1,22,747
39003012600,1742,1284,84,242,4,7,0,13,458
39003012700,1481,781,29,495,2,6,0,22,700
39003012900,1668,807,71,601,8,8,0,27,861
39003013000,4005,2733,155,781,23,8,8,10,1272
39003013100,2343,1774,105,304,3,22,0,2,569
39003013200,1827,1148,87,420,5,5,2,13,679
39003013300,1352,637,80,510,8,3,0,4,715
39003013400,2124,1176,84,703,5,1,0,16,948
39003013600,1182,605,39,388,3,3,0,7,577
39003013700,1095,388,42,561,5,3,0,5,707
39003013800,2614,936,67,1394,6,0,0,36,1678
39003013900,3313,3031,147,25,4,13,0,3,282
39003014000,3316,3103,108,13,6,1,0,6,213
39003014100,1695,1057,82,420,9,2,0,0,638
39005970101,2375,2234,46,3,2,1,0,1,141
39005970102,6168,5790,61,21,11,22,5,10,378
39005970200,5803,5533,67,17,11,10,4,16,270
39005970300,3823,3563,63,28,7,11,4,0,260
39005970400,3614,3334,78,29,10,7,5,10,280
39005970500,2954,2592,87,48,2,60,5,6,362
39005970600,4433,4046,136,45,8,32,3,14,387
39005970700,5493,5135,48,49,0,88,2,4,358
39005970800,4148,3773,82,85,10,65,2,11,375
39005970900,5061,4860,77,12,1,7,1,9,201
39005971000,4750,4510,59,5,10,7,0,9,240
39005971100,3825,3578,58,41,10,12,2,13,247
39007000101,4653,3268,121,1085,0,12,0,7,1385
39007000102,3130,2827,90,35,10,14,0,6,303
39007000103,3527,3159,102,57,9,16,2,13,368
39007000200,4344,3921,107,47,0,39,1,6,423
39007000300,2093,1870,71,30,3,19,0,9,223
39007000400,1681,1392,93,61,3,0,0,5,289
39007000500,4108,3413,247,128,1,10,0,1,695
39007000601,2582,1889,278,211,5,16,0,5,693
39007000602,3294,2766,157,132,0,11,0,4,528
39007000603,4058,3166,434,175,3,17,1,11,892
39007000701,3036,1781,535,447,16,8,0,29,1255
39007000702,2836,2482,127,61,4,16,0,1,354
39007000703,3631,2293,561,407,12,5,0,25,1338
39007000704,3793,2990,330,171,22,17,0,32,803
39007000801,1346,1179,63,10,0,5,0,7,167
39007000802,4912,4202,333,50,10,32,1,3,710
39007000900,4477,3898,255,63,6,16,0,7,579
39007001001,5611,5211,88,66,1,17,0,10,400
39007001002,3397,3133,78,20,1,7,3,5,264
39007001101,1852,1729,33,13,10,1,0,4,123
39007001102,6139,5774,96,42,3,12,0,3,365
39007001201,3497,3224,58,38,9,7,0,9,273
39007001202,3327,3100,58,21,8,5,0,17,227
39007001301,3628,3401,33,33,5,12,0,3,227
39007001303,2835,2623,41,21,0,10,0,19,212
39007001304,979,920,10,8,1,2,2,10,59
39007001401,4119,3981,38,25,6,0,0,2,138
39007001402,4689,4472,52,35,6,12,2,7,217
39007990000,0,0,0,0,0,0,0,0,0
39009972600,4042,3840,16,38,4,1,0,8,202
39009972700,3633,3366,42,39,19,10,0,13,267
39009972800,3815,3410,60,172,11,12,0,10,405
39009972900,5776,4912,117,229,13,190,0,29,864
39009973000,3707,3137,99,105,10,163,0,13,570
39009973101,4316,3334,183,552,30,97,0,17,982
39009973200,4581,3924,103,156,7,184,0,20,657
39009973300,3926,3085,148,194,8,270,0,19,841
39009973400,3154,2801,82,32,12,62,0,19,353
39009973500,3351,2926,36,132,16,15,0,25,425
39009973600,3795,3582,36,28,16,3,0,7,213
39009973700,3971,3742,42,29,2,14,0,4,229
39009973800,4925,4673,36,25,13,15,0,27,252
39009973901,6193,4631,325,890,56,84,0,39,1562
39009973902,3246,2723,125,147,6,90,1,6,523
39011040100,3726,3517,49,8,10,10,3,2,209
39011040200,4241,4004,64,37,8,4,2,6,237
39011040300,3553,3198,119,18,11,22,3,6,355
39011040400,6882,6424,147,30,16,29,1,17,458
39011040500,5162,4942,28,19,5,43,1,6,220
39011040600,3749,3492,69,30,4,17,13,4,257
39011040900,3751,3520,75,21,2,48,1,1,231
39011041000,4011,3868,54,1,2,20,2,9,143
39011041100,4003,3806,49,27,4,7,0,8,197
39011041201,2057,1959,25,3,5,11,3,6,98
39011041202,5287,4913,102,37,9,31,11,6,374
39013010100,3733,3402,44,97,0,12,1,11,331
39013010200,3516,3124,32,124,4,15,0,7,392
39013010300,3401,3242,15,28,4,6,0,6,159
39013010600,3540,3342,25,24,4,3,0,8,198
39013010700,2687,2496,32,17,2,15,0,1,191
39013010802,2162,2075,10,3,5,0,0,0,87
39013010901,1733,1687,10,1,0,0,0,1,46
39013010902,4875,4613,39,39,6,16,0,9,262
39013011000,4770,4563,39,7,6,8,0,11,207
39013011200,3167,2983,55,4,3,2,0,15,184
39013011300,3696,3525,57,12,0,14,0,2,171
39013011400,4292,4017,29,42,5,9,0,6,275
39013011500,1435,1287,29,50,6,4,0,0,148
39013011600,1151,959,23,95,8,0,0,0,192
39013011700,1285,1064,28,77,0,0,0,7,221
39013011900,2786,2439,38,133,5,5,0,4,347
39013012000,2459,2077,33,133,9,5,0,5,382
39013012100,1128,965,15,56,2,0,0,10,163
39013012201,1810,1718,9,1,2,3,0,1,92
39013012202,4469,3264,95,986,9,25,6,5,1205
39013012300,4078,3752,75,56,3,57,4,8,326
39013012400,4324,3942,92,86,0,66,0,13,382
39015951201,4345,4072,40,12,7,4,2,10,273
39015951202,4818,4506,56,25,12,12,0,15,312
39015951301,5439,5100,83,25,6,16,0,27,339
39015951302,2668,2550,29,9,6,0,0,5,118
39015951400,4234,4022,32,12,6,6,0,8,212
39015951500,5567,5342,54,27,11,3,0,11,225
39015951600,3357,3119,66,33,8,8,0,7,238
39015951700,2380,2184,27,63,0,7,0,1,196
39015951800,5218,4801,56,68,8,23,0,13,417
39015951900,5650,5357,44,28,4,5,0,14,293
39017000100,4733,3766,332,295,7,73,1,18,967
39017000200,4253,3242,391,262,6,20,38,23,1011
39017000300,3574,1172,669,1383,16,18,69,18,2402
39017000400,4747,2083,1672,715,18,19,43,4,2664
39017000500,4520,2991,869,331,19,54,34,15,1529
39017000600,4680,3366,649,314,6,20,33,18,1314
39017001001,5907,4978,110,419,7,67,10,29,929
39017001002,5603,4807,187,321,14,59,0,12,796
39017001100,4287,3434,266,269,22,8,4,21,853
39017001300,4443,3857,111,214,8,34,2,14,586
39017010102,2965,2375,120,105,3,185,0,8,590
39017010103,5129,3874,180,248,11,557,3,13,1255
39017010104,5545,4595,227,263,6,267,0,16,950
39017010105,3560,2872,148,145,9,221,0,6,688
39017010106,3241,2479,145,151,6,306,0,6,762
39017010201,2451,1952,81,124,5,208,1,8,499
39017010202,5238,4455,71,144,6,317,1,19,783
39017010203,5345,5071,57,11,10,10,0,6,274
39017010301,4378,4122,41,21,5,17,0,8,256
39017010302,3523,3321,27,13,3,9,0,21,202
39017010500,2336,2071,53,76,5,0,0,14,265
39017010600,3249,3023,61,22,9,0,0,8,226
39017010800,6672,6261,76,31,11,14,0,20,411
39017010901,4882,3654,207,574,5,160,9,23,1228
39017010903,5563,3960,300,599,7,380,4,23,1603
39017010904,3812,2976,208,375,3,26,8,36,836
39017010906,7444,3479,1196,1947,10,491,16,43,3965
39017010907,2704,1921,110,301,5,241,0,10,783
39017010909,5165,2287,799,1366,6,463,13,29,2878
39017010910,4894,3616,184,616,13,293,4,15,1278
39017010911,4145,3322,123,302,7,189,1,7,823
39017010912,2318,1511,109,373,1,193,0,10,807
39017010913,3518,1569,345,1267,5,160,7,24,1949
39017011003,6405,5040,204,463,0,396,1,34,1365
39017011004,6442,3467,837,1543,10,231,6,44,2975
39017011005,7208,5312,249,920,10,396,11,20,1896
39017011006,5767,4558,204,498,9,269,4,27,1209
39017011109,4504,3421,237,378,7,226,8,18,1083
39017011110,5373,4592,148,188,7,207,11,18,781
39017011111,6690,5395,382,216,9,400,14,15,1295
39017011112,6670,4841,227,584,5,677,4,26,1829
39017011118,3487,2896,95,141,4,246,1,6,591
39017011120,8072,5940,613,696,17,392,0,41,2132
39017011122,5704,2953,295,893,6,1227,2,35,2751
39017011123,6042,2262,1574,1670,11,312,0,16,3780
39017011125,3744,2818,170,185,0,371,4,34,926
39017011126,5013,3059,364,565,2,738,3,15,1954
39017011127,4584,3420,195,332,5,406,2,17,1164
39017011128,2953,2129,93,222,0,348,2,18,824
39017011129,4396,3202,245,460,5,249,0,25,1194
39017011130,5398,3664,1022,198,2,261,28,29,1734
39017011131,3545,2952,99,168,1,169,0,28,593
39017011132,4400,3316,151,413,2,282,1,14,1084
39017011133,4450,3669,116,242,5,196,1,9,781
39017011134,8101,6244,349,609,3,507,2,17,1857
39017011135,7199,5215,764,519,12,372,0,15,1984
39017011136,5042,3733,210,382,1,471,0,31,1309
39017011137,3462,2713,113,255,3,213,1,25,749
39017011200,8868,7403,276,410,16,282,9,24,1465
39017011300,7038,5449,643,400,3,217,0,24,1589
39017011800,6411,5764,145,111,24,59,11,20,647
39017012100,3170,2861,137,21,4,7,0,2,309
39017012200,3462,2739,168,253,13,14,0,15,723
39017012300,2121,1828,57,102,5,3,0,8,293
39017012400,2439,2201,32,103,3,13,0,13,238
39017012500,5024,4097,170,413,8,67,1,28,927
39017012600,2439,2044,76,121,2,58,0,11,395
39017012700,3153,2533,161,213,1,19,0,14,620
39017013000,1555,635,186,623,9,3,3,10,920
39017013100,2182,871,308,812,2,0,0,15,1311
39017013200,3389,2280,322,445,6,7,17,24,1109
39017013300,2335,1956,116,122,1,10,0,8,379
39017013400,2237,1612,134,330,0,16,5,8,625
39017013500,2980,2169,431,199,9,18,0,9,811
39017013600,5239,3247,749,884,14,41,5,30,1992
39017013900,2805,2423,139,71,3,3,7,16,382
39017014000,2687,1400,488,600,6,8,0,15,1287
39017014100,2333,1680,198,303,4,5,0,11,653
39017014300,4736,4506,36,27,6,22,0,10,230
39017014400,1809,1195,200,287,5,15,4,3,614
39017014600,1178,823,140,143,3,13,3,7,355
39017014700,4059,3305,193,235,12,18,2,19,754
39017014800,6963,6028,249,206,8,22,1,33,935
39017014900,5265,4771,101,130,7,25,1,12,494
39017015000,7616,7160,104,60,6,22,1,9,456
39017015100,7389,6459,226,183,20,30,3,26,930
39019720100,3261,3123,21,9,15,4,0,9,138
39019720200,3361,3132,41,17,12,3,2,11,229
39019720300,4910,4559,59,58,10,7,1,15,351
39019720400,4042,3831,35,11,10,7,0,8,211
39019720500,5087,4812,100,11,17,22,0,5,275
39019720600,3150,3001,13,10,4,7,0,1,149
39019720700,2910,2746,30,6,5,2,0,7,164
39021010100,1872,1721,24,25,1,11,0,9,151
39021010200,6668,6175,110,36,21,25,1,39,493
39021010400,3893,3424,98,102,9,14,0,20,469
39021010500,3996,3524,79,121,14,10,3,10,472
39021010600,3714,3108,85,232,13,25,2,16,606
39021011001,2683,2528,42,15,0,13,0,3,155
39021011501,4350,4127,40,26,1,7,0,12,223
39021011504,5117,4671,95,85,7,16,1,21,446
39021011505,3262,3041,40,25,7,4,0,5,221
39021011506,3159,2995,35,16,6,0,0,4,164
39023000200,1489,514,96,728,4,4,6,11,975
39023000300,1317,826,83,279,5,0,2,3,491
39023000400,2194,1539,173,316,10,6,0,25,655
39023000500,1690,1343,81,108,8,0,0,5,347
39023000600,2685,1695,97,584,7,2,0,35,990
39023000700,1897,1244,95,337,16,28,0,13,653
39023000901,2179,1363,89,566,10,13,1,18,816
39023000902,1171,335,92,632,6,0,0,2,836
39023001000,1541,956,50,360,5,6,4,1,585
39023001101,1335,409,122,654,2,3,0,12,926
39023001102,2833,874,112,1624,3,8,0,20,1959
39023001200,4199,1943,332,1583,13,7,0,29,2256
39023001300,4029,3165,208,339,9,10,5,20,864
39023001400,3721,2705,275,433,8,27,5,17,1016
39023001500,4433,3622,178,317,7,24,6,17,811
39023001600,3813,3358,73,134,7,7,5,10,455
39023001700,2453,1848,112,272,8,20,0,30,605
39023001900,3018,2559,101,135,3,33,7,12,459
39023002000,2231,2045,32,35,14,18,3,6,186
39023002100,1655,1358,61,129,2,7,2,4,297
39023002200,4362,3906,70,129,16,34,1,10,456
39023002301,3143,2942,20,13,8,18,2,3,201
39023002403,4064,3415,104,300,5,39,4,10,649
39023002404,3328,2582,99,422,6,68,3,16,746
39023002501,2292,2008,37,151,4,38,4,6,284
39023002502,3180,2896,54,54,1,14,3,11,284
39023002601,3799,3570,70,16,1,19,1,0,229
39023002602,4169,3862,54,35,2,31,2,8,307
39023002605,3930,3554,76,92,21,35,1,18,376
39023002607,3567,3265,61,93,4,23,0,12,302
39023002608,4164,3835,50,97,7,17,1,14,329
39023002701,3096,2506,433,9,4,18,1,3,590
39023002702,2522,2165,230,11,8,8,2,1,357
39023002800,4591,4215,122,30,1,21,4,24,376
39023002901,3629,3096,303,37,9,13,4,2,533
39023002902,4410,3779,417,14,15,18,1,3,631
39023003001,3092,2785,71,47,7,31,1,24,307
39023003002,3669,3405,47,46,7,6,0,16,264
39023003101,2446,2228,52,28,1,19,1,7,218
39023003102,1742,1598,43,13,5,16,1,1,144
39023003200,2711,2462,41,48,1,12,3,8,249
39023003301,3652,3373,59,26,3,15,0,10,279
39023003302,2532,2373,16,28,3,7,3,7,159
39023003400,3213,2458,114,402,19,18,2,17,755
39023003700,4815,3815,208,368,9,137,0,17,1000
39025040101,5071,4744,38,20,17,9,0,9,327
39025040102,2655,2439,28,14,10,4,0,7,216
39025040202,2215,2038,29,2,3,6,0,4,177
39025040203,6230,5720,116,39,14,32,0,17,510
39025040205,3192,2861,114,34,5,32,1,7,331
39025040206,4463,4003,117,107,3,9,0,17,460
39025040301,3979,3625,116,17,0,57,0,16,354
39025040302,3900,3536,106,41,0,62,3,17,364
39025040303,7628,6842,219,94,16,173,0,19,786
39025040401,3349,3020,61,87,5,35,0,16,329
39025040403,2786,2343,82,133,6,22,4,16,443
39025040404,3974,3628,89,48,1,51,1,13,346
39025040405,3101,2754,100,40,1,77,2,10,347
39025040500,5082,4604,114,85,8,51,0,17,478
39025040600,7439,6785,146,90,6,106,3,19,654
39025040702,4351,3901,127,46,8,37,0,11,450
39025040703,3479,3174,74,42,3,44,8,11,305
39025040704,3949,3369,155,92,4,83,0,25,580
39025040800,5663,5299,87,22,8,14,0,3,364
39025040900,5682,5265,44,45,7,20,0,19,417
39025041001,5873,5324,120,93,12,32,2,16,549
39025041002,3092,2808,44,42,8,61,0,3,284
39025041101,3411,3035,80,97,2,27,1,10,376
39025041102,5352,4502,173,255,7,58,11,33,850
39025041104,3822,3415,121,71,9,55,1,3,407
39025041105,6110,5426,174,122,9,44,0,22,684
39025041201,4125,3638,146,82,3,58,3,17,487
39025041202,5024,4562,111,59,5,82,0,15,462
39025041303,5036,4481,121,92,12,102,0,9,555
39025041304,23,21,0,0,0,0,0,0,2
39025041305,5269,4613,165,138,4,145,2,15,656
39025041306,5438,4438,203,189,16,348,0,9,1000
39025041307,4904,4404,96,104,5,55,0,30,500
39025041403,4378,3849,171,69,8,49,0,4,529
39025041404,4834,4074,153,235,15,144,3,5,760
39025041405,5384,4775,216,92,11,34,0,22,609
39025041406,5230,4818,80,44,9,96,6,16,412
39025041503,4730,4191,132,81,10,42,1,5,539
39025041504,3967,3658,61,35,4,57,0,14,309
39025041505,3600,3315,63,45,2,37,0,13,285
39025041506,2799,2582,72,11,1,21,0,11,217
39025041600,5533,4974,162,67,22,15,3,12,559
39025041701,4308,3886,125,44,15,7,0,16,422
39025041702,3223,3046,30,13,6,1,0,9,177
39025041800,3637,3338,46,19,6,3,0,13,299
39025041900,5525,5205,66,3,7,21,2,5,320
39025042001,3412,3197,36,24,8,7,1,7,215
39025042002,2374,2224,27,21,4,4,0,4,150
39027964300,3701,3449,57,20,9,5,0,18,252
39027964400,5184,4946,62,14,11,1,1,9,238
39027964501,3358,2915,71,140,1,60,0,21,443
39027964502,2983,2633,76,63,7,28,0,5,350
39027964600,2891,2415,101,149,6,15,1,13,476
39027964700,5762,4887,147,344,32,48,0,31,875
39027964800,4874,4539,86,31,7,19,0,24,335
39027964900,5065,4729,42,17,7,15,2,17,336
39027965000,3929,3699,61,11,8,3,2,8,230
39027965100,4271,4035,62,30,8,11,0,19,236
39029950100,5504,5166,73,29,1,14,5,10,338
39029950200,4588,4321,83,18,4,23,1,9,267
39029950300,5055,4775,75,9,1,11,0,13,280
39029950400,4205,4049,25,8,2,19,1,2,156
39029950500,5965,5278,279,113,2,27,3,8,687
39029950600,4860,4276,271,24,14,35,0,16,584
39029950700,5174,4789,77,28,12,37,0,17,385
39029950800,4429,4183,58,13,5,7,0,14,246
39029950900,3655,3507,30,8,0,5,2,0,148
39029951000,5618,5389,56,9,4,10,0,9,229
39029951100,4502,4223,58,50,4,8,0,12,279
39029951200,4154,3915,30,37,6,7,0,9,239
39029951300,3593,3401,31,38,8,2,0,8,192
39029951401,2119,2019,25,1,3,0,0,14,100
39029951402,4997,3801,181,899,19,16,0,0,1196
39029951500,4627,4309,66,25,19,11,0,20,318
39029951600,5398,5060,50,15,7,44,0,9,338
39029951700,4776,4479,46,51,5,3,0,5,297
39029951800,2842,2392,20,202,5,3,0,9,450
39029951900,3334,3095,23,36,15,5,4,1,239
39029952000,2702,2414,61,84,5,15,0,4,288
39029952100,1382,1190,18,69,4,7,0,2,192
39029952200,1772,1427,20,163,5,1,0,16,345
39029952300,2703,2373,42,91,7,10,0,2,330
39029952400,3923,3635,54,62,4,25,0,8,288
39031960900,4681,4536,41,1,1,13,1,5,145
39031961000,4702,4467,52,56,1,3,3,3,235
39031961100,4317,4130,20,18,14,10,1,10,187
39031961200,3052,2937,29,2,2,8,0,3,115
39031961300,3866,3555,59,85,7,6,2,6,311
39031961400,3044,2782,38,65,13,26,0,3,262
39031961500,2495,2222,54,77,3,8,0,9,273
39031961600,2358,2250,18,25,0,7,0,0,108
39031961700,2905,2710,49,38,1,17,0,0,195
39031961800,5192,4993,41,22,15,0,0,8,199
39033974100,3394,3251,51,6,1,7,1,6,143
39033974200,4039,3889,46,10,1,7,1,4,150
39033974300,2791,2597,49,21,7,36,0,11,194
39033974400,3161,2947,36,35,2,6,2,0,214
39033974500,3872,3627,55,32,2,19,0,8,245
39033974600,2574,2426,35,26,2,15,1,2,148
39033974700,3913,3711,56,14,3,6,0,1,202
39033974800,2182,1999,15,50,0,8,0,6,183
39033974900,3263,3007,50,51,4,7,2,8,256
39033975000,3857,3663,64,18,3,5,0,7,194
39033975100,2931,2675,69,14,5,6,2,8,256
39033975200,2701,2527,51,3,1,3,0,5,174
39033975300,3347,3069,61,25,9,6,3,4,278
39035101101,1686,638,194,681,11,57,2,7,1048
39035101102,4338,3196,325,445,10,111,0,20,1142
39035101201,2678,1483,607,372,3,72,0,23,1195
39035101300,1638,893,168,422,0,75,0,10,745
39035101400,2211,971,575,451,6,106,0,6,1240
39035101501,2353,845,549,687,9,134,1,20,1508
39035101603,2395,845,653,670,2,71,0,16,1550
39035101700,2534,749,684,872,10,41,0,23,1785
39035101800,2667,1006,650,777,3,69,1,11,1661
39035101901,1530,640,397,381,5,28,0,16,890
39035102101,3334,1226,934,851,12,112,0,24,2108
39035102102,2665,1026,875,517,6,94,1,18,1639
39035102200,2817,1132,841,577,10,93,0,23,1685
39035102300,2269,725,849,483,15,30,0,33,1544
39035102401,2123,639,821,514,0,29,0,28,1484
39035102402,3214,1072,1134,717,16,63,5,29,2142
39035102700,4074,1487,1516,766,6,40,0,38,2587
39035102800,1728,485,730,389,1,24,1,2,1243
39035102900,1892,453,996,325,0,11,0,20,1439
39035103300,2760,1035,376,1182,2,50,1,14,1725
39035103500,1758,1194,297,161,13,21,0,9,564
39035103602,3999,2532,482,685,16,132,2,21,1467
39035103800,1672,750,552,239,5,52,0,8,922
39035104400,1310,835,227,167,3,25,0,4,475
39035104800,1620,727,504,263,10,27,2,15,893
39035105100,3584,1494,1389,477,22,24,0,35,2090
39035105300,3188,938,1529,556,18,20,0,24,2250
39035105400,3532,1341,1277,659,3,28,1,15,2191
39035105500,1746,637,583,389,4,12,0,9,1109
39035105602,1998,730,635,494,8,30,0,8,1268
39035105700,4385,2210,1032,875,12,28,3,30,2175
39035105900,2988,2109,467,208,3,37,0,17,879
39035106100,3659,2020,1040,342,16,64,0,13,1639
39035106200,3596,2265,805,277,11,45,3,18,1331
39035106500,2421,1587,508,146,3,30,0,15,834
39035106600,3319,2048,737,321,15,23,0,9,1271
39035106800,2804,1465,699,436,1,15,2,21,1339
39035106900,3623,2468,572,374,2,51,0,9,1155
39035107000,1658,1182,250,130,0,53,0,5,476
39035107101,3656,2314,220,921,1,130,0,5,1342
39035107701,5524,3558,314,1083,8,331,0,36,1966
39035107802,4158,1687,182,1428,6,660,0,37,2471
39035108201,1287,485,136,463,5,127,0,6,802
39035108301,1569,349,254,276,3,616,1,6,1220
39035108400,1094,242,156,169,0,491,0,3,852
39035108701,4549,283,266,3784,8,62,0,24,4266
39035109301,1089,74,118,858,0,7,0,2,1015
39035109701,2318,492,407,1357,1,5,3,4,1826
39035109801,2147,26,86,1973,0,1,2,6,2121
39035110901,2495,1135,262,937,4,4,0,19,1360
39035111202,1120,278,128,665,2,13,0,2,842
39035111401,1043,9,23,985,8,0,0,1,1034
39035111700,1041,69,55,858,1,4,0,11,972
39035112100,1649,84,116,1390,8,4,0,2,1565
39035112200,935,3,13,890,0,0,0,1,932
39035112301,1115,44,26,996,4,0,0,5,1071
39035114501,923,43,28,816,3,1,0,0,880
39035114600,828,256,38,517,0,3,0,2,572
39035114800,2144,29,42,2005,3,4,0,5,2115
39035115400,1957,632,170,989,7,8,0,29,1325
39035115700,1303,427,101,686,12,5,1,2,876
39035115800,2648,883,197,1431,0,3,1,17,1765
39035115900,3635,991,203,2265,7,7,0,33,2644
39035116300,1351,24,17,1278,0,0,0,2,1327
39035116400,2445,39,37,2293,1,10,0,9,2406
39035116500,1810,18,35,1703,7,3,2,0,1792
39035116600,1823,10,21,1762,6,1,0,3,1813
39035116700,1271,18,13,1206,2,3,0,5,1253
39035116800,2267,10,28,2171,7,0,0,3,2257
39035116900,1336,18,34,1246,2,0,0,0,1318
39035117101,2188,443,33,1626,1,6,0,9,1745
39035117102,996,28,19,914,0,0,0,5,968
39035117201,3113,431,30,2525,7,12,2,3,2682
39035117203,1757,271,48,1351,6,0,1,13,1486
39035117300,1852,105,26,1676,2,0,1,4,1747
39035117400,1270,165,27,1030,1,4,0,2,1105
39035117500,2462,199,54,2126,5,3,0,8,2263
39035117600,2956,632,105,2083,4,10,0,27,2324
39035117700,4736,1871,88,2563,7,20,5,17,2865
39035117800,1878,232,57,1499,1,8,2,9,1646
39035117900,2169,73,37,1971,5,1,0,15,2096
39035118101,1509,41,12,1385,2,8,2,12,1468
39035118200,1684,44,51,1536,5,2,0,15,1640
39035118301,2239,237,32,1804,0,44,0,12,2002
39035118602,1786,31,24,1650,19,3,0,5,1755
39035118800,3596,2058,180,365,5,844,1,12,1538
39035118900,1453,258,32,921,1,198,0,20,1195
39035119401,2021,396,61,1259,0,229,1,23,1625
39035119402,1554,48,24,1437,1,1,0,0,1506
39035119501,2485,914,79,1242,1,122,0,11,1571
39035119502,1819,288,57,1357,1,33,0,4,1531
39035119600,2136,36,38,2003,3,1,0,10,2100
39035119701,1830,31,26,1699,10,13,0,7,1799
39035119702,1710,30,34,1589,1,6,3,0,1680
39035119800,2491,36,28,2355,7,2,0,9,2455
39035119900,2043,41,11,1896,9,4,0,20,2002
39035120200,1869,10,19,1790,8,2,0,9,1859
39035120400,1975,58,34,1825,6,6,1,2,1917
39035120500,1834,30,33,1723,0,5,0,9,1804
39035120600,2113,15,32,2002,4,2,0,11,2098
39035120701,1326,10,28,1259,0,1,0,3,1316
39035120702,1644,6,22,1571,2,6,1,4,1638
39035120801,2090,24,24,1960,4,0,0,0,2066
39035120802,1838,22,30,1702,3,1,0,12,1816
39035121100,1799,36,25,1693,2,3,0,9,1763
39035121200,1390,22,29,1282,2,0,0,11,1368
39035121300,1769,47,33,1634,6,1,0,1,1722
39035121401,1452,26,14,1363,1,3,0,4,1426
39035121403,2456,47,33,2269,8,0,0,23,2409
39035121500,2634,28,39,2501,4,0,0,7,2606
39035121700,3613,18,47,3431,7,2,0,20,3595
39035121800,1662,18,27,1568,1,3,0,1,1644
39035121900,1261,27,12,1183,0,0,0,8,1234
39035122100,3005,26,22,2861,4,9,0,16,2979
39035122200,1722,16,32,1610,1,1,0,20,1706
39035122300,1717,10,24,1639,5,2,0,2,1707
39035123100,2555,2224,116,55,9,70,0,9,331
39035123200,2907,2403,172,118,1,89,1,15,504
39035123400,3511,3014,199,102,0,77,0,19,497
39035123501,3570,1933,770,522,6,105,0,42,1637
39035123502,2718,1216,391,488,11,424,4,8,1502
39035123601,2776,2273,204,135,8,31,0,9,503
39035123602,2981,2081,285,351,2,146,1,9,900
39035123603,3021,2338,264,224,5,67,0,23,683
39035123700,2561,1714,276,230,4,197,0,7,847
39035123800,2007,629,456,760,6,38,7,12,1378
39035123900,3323,1812,660,531,1,147,0,20,1511
39035124100,5302,2267,1456,1045,8,216,8,32,3035
39035124201,2501,1469,452,312,6,127,0,19,1032
39035124202,1866,954,324,303,4,172,0,5,912
39035124300,4312,1846,1042,1002,17,143,6,14,2466
39035124500,3608,1922,666,480,7,281,0,21,1686
39035124600,3963,2072,860,684,6,72,0,22,1891
39035126100,2882,113,156,2501,13,5,0,12,2769
39035127501,2743,150,88,2435,2,3,0,5,2593
39035130103,4913,4620,108,25,0,31,0,11,293
39035130104,4179,3937,90,9,1,44,1,3,242
39035130105,3549,3255,112,25,1,45,0,6,294
39035130106,3522,3207,126,36,0,42,0,6,315
39035131103,4812,3697,106,368,1,435,0,50,1115
39035131104,5206,3512,117,673,0,740,0,35,1694
39035131105,3968,2262,122,913,3,469,0,33,1706
39035132100,4757,1707,121,2694,8,30,7,16,3050
39035132200,2851,1345,121,1235,4,26,0,11,1506
39035132301,3617,1251,78,2090,6,40,0,11,2366
39035132302,1924,949,76,816,7,7,0,2,975
39035133103,3365,397,81,2712,10,37,0,8,2968
39035133104,2921,496,311,1955,1,33,4,12,2425
39035134100,1466,1001,87,267,5,23,2,7,465
39035134203,3700,2848,191,272,0,210,0,12,852
39035134204,4157,3511,148,257,4,40,0,6,646
39035134205,2546,2209,81,99,6,29,0,7,337
39035134206,2988,2620,98,82,5,34,0,0,368
39035134300,3688,3069,137,233,12,70,3,19,619
39035135103,2240,2021,51,16,3,57,0,9,219
39035135104,4288,3917,67,34,0,123,3,1,371
39035135105,5507,4899,122,52,2,248,0,12,608
39035135106,1600,1446,31,1,1,52,0,6,154
39035136101,6368,5476,261,162,5,259,0,22,892
39035136103,5720,4995,112,76,3,331,0,17,725
39035136104,3342,2516,185,261,0,176,0,15,826
39035136105,4506,4000,67,23,2,269,0,9,506
39035137101,2528,1334,461,453,9,148,0,20,1194
39035137102,4503,3111,722,319,9,131,0,27,1392
39035137103,4328,2933,611,216,5,372,0,11,1395
39035138105,1209,861,96,147,1,36,0,2,348
39035138106,3279,2621,193,230,0,39,0,13,658
39035138107,1997,1672,146,41,1,33,0,9,325
39035138108,3840,3256,211,82,4,81,1,9,584
39035138109,4153,3479,270,168,2,89,0,7,674
39035138110,4117,3443,232,104,5,169,0,15,674
39035140100,1501,163,33,1225,1,26,0,4,1338
39035140301,2140,61,29,1970,5,4,0,24,2079
39035140302,2476,633,48,1607,2,75,0,13,1843
39035140400,3145,870,90,1862,6,175,0,18,2275
39035140500,3345,838,71,2196,4,73,0,35,2507
39035140600,1162,501,41,517,1,29,0,7,661
39035140701,2469,752,93,1427,3,51,0,22,1717
39035140702,1661,467,60,1024,4,29,0,6,1194
39035140800,3866,2313,67,1035,7,260,1,56,1553
39035140900,2048,730,80,1098,7,12,0,41,1318
39035141000,1079,297,38,655,0,31,0,2,782
39035141100,4158,2426,211,636,2,655,3,33,1732
39035141200,3111,2209,121,345,0,243,0,9,902
39035141300,2790,1952,127,182,3,394,0,24,838
39035141400,2460,2012,172,126,0,53,0,4,448
39035141500,1583,1177,45,249,0,38,1,14,406
39035141601,1617,1241,69,163,1,48,0,10,376
39035141602,1526,527,49,842,2,26,0,17,999
39035141700,1455,1013,58,298,0,20,0,10,442
39035150100,1900,24,37,1744,0,0,2,8,1876
39035150300,1159,11,11,1100,1,6,0,2,1148
39035150400,1006,10,14,933,0,0,1,3,996
39035151200,1569,33,24,1454,3,0,1,6,1536
39035151300,1800,296,33,1368,4,16,1,9,1504
39035151500,1102,41,21,999,8,3,0,7,1061
39035151600,1270,92,27,1066,6,11,0,12,1178
39035151700,1019,54,19,898,5,4,0,4,965
39035151800,1214,13,20,1152,2,0,0,5,1201
39035152101,2426,1812,39,461,2,16,0,12,614
39035152102,4875,1490,95,3055,7,25,0,41,3385
39035152201,3340,794,91,2282,12,38,0,22,2546
39035152202,4424,1335,87,2787,11,30,1,27,3089
39035152301,2288,961,80,1098,0,33,0,28,1327
39035152302,4181,1884,124,2015,7,14,0,26,2297
39035152303,3931,1462,74,2193,6,27,0,24,2469
39035152400,1727,528,26,1055,4,32,2,8,1199
39035152501,3711,1142,66,2343,0,18,0,33,2569
39035152502,2577,740,71,1640,4,9,0,5,1837
39035152605,5726,1243,117,4048,14,32,2,33,4483
39035152701,2401,183,40,2084,2,0,0,2,2218
39035152702,2427,364,70,1889,1,18,0,13,2063
39035152703,1826,553,16,1171,2,12,1,7,1273
39035153103,2597,2295,112,34,0,45,3,8,302
39035153104,3011,2694,130,32,4,18,0,12,317
39035153105,3901,3254,197,159,0,90,0,31,647
39035153106,3872,3410,173,98,6,43,1,16,462
39035153107,3910,3485,119,123,4,84,1,7,425
39035154100,2274,725,97,1342,1,13,0,12,1549
39035154200,1601,481,39,1000,0,5,0,5,1120
39035154400,2901,970,120,1665,1,10,0,18,1931
39035154501,3792,1617,174,1798,8,69,0,6,2175
39035154502,3275,1272,164,1655,4,55,1,12,2003
39035154601,5126,2248,189,2414,4,67,0,11,2878
39035154603,3163,1323,130,1568,5,15,0,3,1840
39035154604,4253,1744,182,2096,13,30,2,13,2509
39035155101,5628,4759,94,157,3,492,0,4,869
39035155102,3091,2730,72,108,1,106,0,5,361
39035156101,1424,1327,34,8,7,13,0,2,97
39035156102,6160,5575,116,50,0,204,0,20,585
39035160100,1940,1778,62,18,0,22,0,0,162
39035160200,2289,1973,111,74,5,34,0,4,316
39035160300,1852,1646,66,25,3,14,3,11,206
39035160400,3535,3088,130,81,5,54,0,20,447
39035160500,3794,3256,220,152,5,49,0,11,538
39035160602,2944,2035,198,452,2,91,0,14,909
39035160603,1682,1207,102,261,2,31,0,14,475
39035160604,3431,2761,172,193,5,172,0,11,670
39035160900,3478,3056,146,91,5,34,0,4,422
39035161000,1718,1496,81,36,2,22,1,1,222
39035161100,3601,3195,130,80,0,31,2,19,406
39035161200,2901,2467,116,108,3,71,0,11,434
39035161300,2894,2488,128,95,6,54,1,6,406
39035161400,3270,2726,114,170,7,54,0,11,544
39035161500,3840,3179,198,150,2,116,3,24,661
39035161600,2040,1561,131,125,0,113,4,9,479
39035161900,2548,2210,113,102,2,34,2,6,338
39035170101,2935,1878,67,721,5,119,1,28,1057
39035170102,4793,3734,114,597,2,155,0,15,1059
39035170201,2480,2064,63,215,0,65,0,7,416
39035170202,3842,3000,104,528,1,91,0,22,842
39035171102,5126,588,120,4256,1,15,0,19,4538
39035171103,3917,582,101,3036,15,18,0,30,3335
39035171104,4636,422,102,3930,14,21,0,31,4214
39035171203,2730,832,89,1670,8,21,0,17,1898
39035171204,2124,455,48,1500,6,8,4,9,1669
39035171205,2664,595,87,1863,4,26,1,18,2069
39035171206,2504,848,106,1424,0,28,0,10,1656
39035172101,2716,2074,124,257,4,113,0,1,642
39035172102,3968,3046,127,395,5,209,0,3,922
39035172104,2030,856,34,414,3,637,1,18,1174
39035172105,3378,1880,96,904,4,382,0,15,1498
39035172201,3776,2979,110,309,8,203,0,18,797
39035172202,4483,2839,152,1127,6,216,0,17,1644
39035173103,2802,2350,137,68,8,142,3,5,452
39035173104,4763,4160,223,110,3,136,2,9,603
39035173105,2360,2119,85,24,4,67,0,0,241
39035173106,3699,2238,163,119,13,1044,0,18,1461
39035173107,2380,2164,81,27,1,21,1,7,216
39035174103,2956,2621,128,33,3,65,1,8,335
39035174104,2410,2135,119,31,3,41,0,6,275
39035174105,2990,2693,126,32,0,49,0,8,297
39035174106,3170,2697,142,88,3,107,3,14,473
39035174107,3632,3166,163,60,3,63,0,7,466
39035174203,2992,2693,98,49,2,67,0,12,299
39035174204,3784,3319,187,50,3,74,0,10,465
39035174205,4585,3581,248,305,4,235,0,30,1004
39035174206,2486,1809,207,180,4,112,4,9,677
39035174207,3437,2863,210,122,7,90,0,12,574
39035175105,4850,4426,92,29,6,142,0,4,424
39035175106,2931,2696,69,17,3,83,0,4,235
39035175107,3652,3274,82,44,0,164,0,6,378
39035175108,2665,2176,100,120,1,148,0,7,489
39035175109,2380,2161,72,24,3,49,0,6,219
39035175110,5138,4137,166,144,10,481,0,13,1001
39035175201,6395,5710,185,123,6,173,0,14,685
39035175202,3311,2972,83,43,2,92,0,13,339
39035176100,2109,1909,79,18,0,17,0,4,200
39035176200,5380,4720,211,123,4,86,0,26,660
39035177101,4357,2999,397,549,14,204,0,11,1358
39035177103,4006,3055,382,288,6,100,0,7,951
39035177104,3619,2909,329,157,5,20,1,5,710
39035177201,4016,3213,377,134,6,65,0,11,803
39035177202,3366,2738,292,112,11,43,0,7,628
39035177302,2543,2170,123,47,3,112,0,3,373
39035177303,5009,3984,477,179,13,118,0,19,1025
39035177304,3662,2509,343,407,33,175,3,18,1153
39035177403,3066,2585,209,91,2,40,0,6,481
39035177404,2867,2372,201,82,10,49,0,10,495
39035177405,4471,3759,330,111,2,70,0,19,712
39035177406,3990,3392,259,102,3,47,0,15,598
39035177501,4294,3632,287,62,0,120,1,16,662
39035177503,3510,3103,162,62,1,86,0,15,407
39035177504,4008,3581,189,42,2,57,0,10,427
39035177505,4395,4047,127,51,3,61,0,4,348
39035177604,1979,1721,119,32,5,28,0,2,258
39035177605,2710,2484,108,10,8,22,0,21,226
39035177606,3809,3164,185,170,2,185,0,12,645
39035177607,3778,3199,204,143,5,102,0,21,579
39035177608,5672,4363,404,393,6,270,3,25,1309
39035177609,2019,1806,60,47,0,53,0,0,213
39035178101,2758,2318,163,81,4,67,0,8,440
39035178102,4587,3345,318,401,1,313,2,12,1242
39035178201,3454,3004,157,129,1,47,0,19,450
39035178204,4862,3511,412,445,6,299,0,27,1351
39035178205,2235,1878,137,57,4,81,0,2,357
39035178206,2967,2590,159,70,6,8,0,6,377
39035179101,3816,2765,127,295,7,432,0,33,1051
39035179102,2980,2472,71,82,2,197,0,24,508
39035180102,4217,1576,124,2134,1,248,0,10,2641
39035180103,3609,1347,70,2026,6,55,0,19,2262
39035180104,2975,551,64,2201,0,40,1,18,2424
39035181100,7234,6655,189,50,5,122,3,14,579
39035181201,5851,5165,181,126,9,172,2,16,686
39035181203,3194,2949,105,29,3,23,0,11,245
39035181204,5476,4777,231,73,1,194,3,35,699
39035182103,2713,2325,100,89,1,116,0,11,388
39035182104,2683,2435,44,41,2,92,0,13,248
39035182105,3313,2949,116,53,1,68,1,11,364
39035182106,3011,2748,68,44,2,80,0,4,263
39035183100,2958,1634,104,673,3,396,3,17,1324
39035183200,2700,2104,102,179,1,140,0,11,596
39035183300,4686,3651,162,437,2,197,0,36,1035
39035183401,2262,1467,51,454,4,132,0,13,795
39035183402,1507,233,30,1164,1,26,0,7,1274
39035183501,3137,1621,97,1119,0,132,2,14,1516
39035183502,3749,2491,121,811,2,129,0,10,1258
39035183603,1415,55,20,1280,3,2,0,9,1360
39035183604,2576,545,88,1764,1,42,0,18,2031
39035183605,2867,1217,101,1318,0,65,0,33,1650
39035183606,1582,654,65,716,1,27,2,18,928
39035184103,4178,3257,84,296,1,369,1,17,921
39035184104,1887,1296,42,278,2,183,2,13,591
39035184105,4887,2597,161,685,8,1253,0,6,2290
39035184106,2369,1470,90,417,5,283,0,12,899
39035184108,7822,4956,171,830,8,1555,0,27,2866
39035185101,2755,353,56,2188,0,69,0,7,2402
39035185102,2685,952,82,1463,5,51,0,32,1733
39035185103,2333,913,95,1170,0,27,0,14,1420
39035185104,3773,1901,124,1533,5,85,0,12,1872
39035185201,1569,394,38,1053,4,19,0,16,1175
39035185202,4967,1438,218,3004,3,51,1,28,3529
39035185203,3801,2234,117,1185,1,76,4,43,1567
39035186103,5145,4426,124,91,5,359,0,10,719
39035186104,2618,2297,86,52,10,71,1,5,321
39035186105,3685,3314,119,71,4,49,1,10,371
39035186106,4836,3253,301,309,8,731,7,27,1583
39035186107,6561,5759,194,74,4,334,1,5,802
39035186201,5829,4928,253,167,3,268,4,25,901
39035186202,4606,3937,153,162,0,218,0,4,669
39035186203,3692,3236,136,62,4,139,0,11,456
39035186205,5187,4481,149,109,9,264,0,12,706
39035186206,4332,3469,130,90,3,475,0,25,863
39035187103,2777,1071,77,1428,0,62,0,26,1706
39035187104,3287,2282,130,631,1,97,4,16,1005
39035187105,3137,2389,129,477,5,63,0,15,748
39035187106,4713,3896,124,417,0,92,0,70,817
39035188103,3050,80,67,2779,3,3,1,22,2970
39035188106,2677,93,43,2474,2,4,0,16,2584
39035188107,2493,111,77,2175,12,37,0,12,2382
39035189105,4126,3564,143,86,3,173,0,21,562
39035189107,5139,4465,185,106,1,194,0,26,674
39035189108,5415,4641,167,87,2,320,6,20,774
39035189109,3568,3051,113,77,3,190,0,16,517
39035189110,4523,3617,219,202,3,292,2,22,906
39035189111,7600,6328,224,188,4,577,1,25,1272
39035189112,3857,3354,106,27,0,217,0,16,503
39035190502,2366,2272,26,16,0,9,0,7,94
39035190503,1680,1529,72,20,0,15,0,0,151
39035190505,6166,5242,266,137,3,237,1,11,924
39035190506,5387,4757,192,147,0,97,0,27,630
39035192300,1519,1351,65,25,4,36,0,1,168
39035192800,1430,1048,36,225,0,55,0,21,382
39035192900,1897,1773,32,8,0,24,1,9,124
39035194100,2033,1731,25,204,0,17,0,4,302
39035194300,3356,2865,78,181,1,115,0,17,491
39035194500,2264,1998,57,52,2,84,0,8,266
39035195600,4734,580,110,3812,5,34,0,21,4154
39035195700,4566,1479,88,2602,6,196,0,32,3087
39035195800,4016,3099,74,320,0,379,0,13,917
39035195900,4323,4010,101,53,6,26,0,12,313
39035196000,1720,495,34,1077,7,32,0,8,1225
39035196100,2435,1735,181,346,2,20,0,22,700
39035196200,3832,158,52,3441,8,10,0,16,3674
39035196300,4087,3518,128,125,0,167,0,5,569
39035196400,2643,502,570,1368,10,43,2,13,2141
39035196800,5095,2407,293,779,12,1335,2,37,2688
39035197000,3020,128,78,2702,7,12,0,25,2892
39035197100,4062,2715,93,766,0,293,0,12,1347
39035197200,2238,76,53,2038,4,4,0,6,2162
39035197300,3185,2042,266,461,3,223,0,16,1143
39035197400,3862,1953,1070,548,8,46,0,25,1909
39035197500,3863,2215,738,647,5,85,2,24,1648
39035197600,3360,937,1687,546,20,22,0,27,2423
39035197700,2711,1201,871,488,4,37,0,6,1510
39035197800,3094,2129,268,448,3,124,5,10,965
39035197900,1824,627,261,822,19,0,0,6,1197
39035198000,2338,465,249,1479,14,2,0,11,1873
39035198100,2066,615,179,1129,0,1,1,27,1451
39035198200,3396,122,75,3080,1,2,0,8,3274
39035198300,4165,155,65,3802,3,29,2,12,4010
39035198400,2933,101,99,2626,2,2,2,10,2832
39035198500,1701,24,22,1605,2,0,1,10,1677
39035198600,4129,255,156,3576,6,29,0,12,3874
39035198700,1945,83,37,1708,10,30,2,8,1862
39035198800,1858,37,74,1669,8,12,0,11,1821
39035198900,1689,380,157,1082,8,0,1,13,1309
39035199000,1289,55,54,1138,0,4,0,7,1234
39035199100,2153,66,30,1960,6,47,0,6,2087
39035199200,1628,15,55,1484,7,5,0,12,1613
39035199300,1753,56,24,1600,2,4,0,8,1697
39035980100,5,2,1,0,0,1,0,0,3
39035980200,0,0,0,0,0,0,0,0,0
39035980500,3,1,1,0,0,0,0,0,2
39035980900,0,0,0,0,0,0,0,0,0
39035981000,54,44,9,0,0,0,0,0,10
39035981100,0,0,0,0,0,0,0,0,0
39035990000,0,0,0,0,0,0,0,0,0
39037500100,4057,3911,90,5,2,1,0,10,146
39037510100,3954,3548,212,53,9,3,3,10,406
39037520100,3440,3300,45,12,0,4,10,7,140
39037530100,4491,4367,28,4,9,9,0,5,124
39037540100,3343,3164,42,12,5,10,1,9,179
39037550100,3494,3320,50,5,9,5,0,5,174
39037555001,2675,2504,61,15,4,23,0,3,171
39037555002,3795,3515,72,35,6,39,6,14,280
39037555101,3250,3017,67,39,11,13,0,12,233
39037555102,3715,3369,80,51,8,27,1,12,346
39037560101,3619,3472,27,10,6,4,0,4,147
39037560102,3184,3004,31,25,13,7,5,17,180
39037570101,2968,2840,18,20,5,23,0,2,128
39037570102,5896,5663,36,16,5,13,0,12,233
39039958100,4250,3877,235,18,12,12,3,2,373
39039958200,4543,4253,149,12,7,4,0,6,290
39039958300,4281,3796,297,19,12,11,1,7,485
39039958400,3869,3519,189,10,4,9,1,11,350
39039958500,4318,3352,588,176,4,49,1,18,966
39039958600,3630,2788,578,94,13,12,3,10,842
39039958700,4637,3637,735,105,5,16,5,13,1000
39039958800,3534,2522,735,97,5,11,1,16,1012
39039958900,5224,4532,444,67,17,9,0,5,692
39041010100,4839,4007,198,261,2,86,8,15,832
39041010200,5659,4787,292,162,5,75,1,23,872
39041010420,2824,2417,148,74,8,20,1,21,407
39041010421,2265,2040,57,59,0,37,5,4,225
39041010422,6199,5376,223,205,7,58,0,27,823
39041010520,7164,6096,245,312,11,89,5,21,1068
39041010530,3192,2394,307,233,5,23,1,12,798
39041011101,2689,2489,54,28,0,5,0,1,200
39041011102,5416,4991,108,29,2,48,0,23,425
39041011200,3264,2935,57,64,3,11,0,24,329
39041011411,3321,2877,84,69,5,138,0,8,444
39041011412,4769,3922,133,66,2,431,1,7,847
39041011421,7521,6211,201,104,10,756,0,22,1310
39041011423,7079,6098,160,82,2,483,4,32,981
39041011430,3016,2419,113,90,5,290,2,9,597
39041011431,1266,1172,31,5,3,14,4,8,94
39041011432,7545,6251,195,141,2,693,1,19,1294
39041011520,3962,3040,203,252,9,272,1,29,922
39041011530,4079,2658,127,269,4,824,4,17,1421
39041011540,7067,5477,163,292,9,836,0,22,1590
39041011561,7079,3778,366,583,24,1982,1,43,3301
39041011562,8697,5762,299,349,19,1855,1,60,2935
39041011563,6191,4107,157,244,6,1420,0,7,2084
39041011564,5203,4199,152,135,0,465,0,21,1004
39041011565,4519,3831,132,145,0,199,2,18,688
39041011604,9560,8227,321,240,14,282,3,38,1333
39041011710,6772,5730,174,336,12,255,0,31,1042
39041011740,5178,4356,109,280,2,256,0,17,822
39041011760,4881,4321,264,48,2,27,1,17,560
39041011762,5684,4744,140,339,9,233,1,18,940
39041011763,5157,4300,171,136,4,354,5,13,857
39041011764,2569,2305,37,73,3,35,2,19,264
39041011765,2439,2007,78,78,0,175,0,16,432
39041011766,4591,3800,123,313,7,141,0,14,791
39041011900,6557,5074,224,120,8,901,0,9,1483
39041012000,5851,5406,113,25,2,60,0,17,445
39041012100,9973,7516,249,243,13,1535,0,29,2457
39041012200,5125,4369,212,198,7,104,0,12,756
39041012300,4730,4355,64,32,5,22,1,12,375
39041012400,10232,5576,528,988,11,2668,5,68,4656
39043040100,5593,5110,218,21,3,23,0,12,483
39043040200,3901,3571,143,12,3,17,1,3,330
39043040300,5920,5462,188,14,7,16,0,9,458
39043040400,5921,5515,146,43,8,50,0,2,406
39043040500,4487,4036,156,64,6,22,3,2,451
39043040700,3805,2311,221,954,8,15,0,15,1494
39043040801,2585,1548,157,571,0,10,2,31,1037
39043040802,1624,1034,115,334,1,5,0,2,590
39043040900,3300,2448,149,440,8,11,0,25,852
39043041000,2850,1519,157,916,7,5,2,17,1331
39043041100,4052,2290,304,951,14,19,0,24,1762
39043041200,2472,1322,154,757,4,17,0,18,1150
39043041300,3585,2273,189,847,12,14,0,19,1312
39043041400,2866,2322,86,288,1,31,0,6,544
39043041600,5685,4978,198,184,14,72,0,18,707
39043041701,3519,3245,139,5,7,4,0,1,274
39043041702,2729,2464,88,60,7,7,0,4,265
39043041800,6103,5616,197,19,7,23,2,15,487
39043041900,4625,3997,125,175,4,113,0,9,628
39043990100,0,0,0,0,0,0,0,0,0
39045030100,3669,3444,54,21,6,7,1,9,225
39045030200,3004,2820,32,14,2,13,0,4,184
39045030300,3418,3171,74,22,0,11,0,10,247
39045030400,4796,4487,66,44,5,16,4,9,309
39045030601,7918,5529,350,1300,9,234,0,32,2389
39045030602,4044,2397,184,979,12,254,4,23,1647
39045030700,4209,3641,74,214,11,41,1,15,568
39045030800,5950,5528,91,58,4,20,0,16,422
39045030901,5146,4718,79,55,9,55,0,6,428
39045030902,3996,3786,44,12,0,14,1,1,210
39045031000,5646,5307,73,24,10,35,0,8,339
39045031100,6303,5901,56,27,24,4,0,20,402
39045031200,4905,4595,58,14,11,6,1,8,310
39045031300,3187,2861,56,72,13,19,0,11,326
39045031401,2594,2436,35,11,2,21,3,12,158
39045031402,4296,3917,74,88,3,26,0,14,379
39045031500,2984,2658,74,77,1,31,0,7,326
39045031600,6763,6197,121,96,12,40,0,11,566
39045031700,3920,3432,94,122,13,23,0,9,488
39045032000,3290,2933,83,98,10,7,0,16,357
39045032100,3371,3095,57,41,7,8,2,8,276
39045032200,3580,3185,87,79,7,9,2,19,395
39045032300,3998,3688,61,80,11,7,0,5,310
39045032501,3554,3328,50,23,2,12,0,16,226
39045032502,2902,2119,42,662,2,9,0,5,783
39045032601,3244,3061,27,9,8,2,0,13,183
39045032602,3562,3315,32,17,7,6,1,7,247
39045032701,4515,2407,199,1264,13,338,4,34,2108
39045032703,4021,1148,210,1913,9,503,0,13,2873
39045032704,4444,1447,481,1984,4,286,0,25,2997
39045032800,4235,3348,149,379,3,160,0,20,887
39045032901,6223,5051,164,529,17,144,0,34,1172
39045032902,5957,4611,178,698,6,212,3,6,1346
39045033000,5365,4048,132,715,19,111,1,29,1317
39045033101,4488,3361,162,585,9,122,3,12,1127
39045033102,5424,3694,218,976,6,257,0,28,1730
39047925800,3773,3415,135,40,4,10,1,4,358
39047925900,3497,3194,55,75,1,9,7,12,303
39047926000,4181,3843,102,62,8,20,0,7,338
39047926100,4769,4171,121,143,8,52,0,24,598
39047926200,4667,4199,106,99,8,40,1,23,468
39047926300,3594,3269,68,76,3,28,0,7,325
39047926400,4470,4169,94,26,11,12,2,11,301
39049000110,3489,3164,85,49,2,53,0,8,325
39049000120,3220,2927,66,38,4,57,0,11,293
39049000210,3049,2684,86,62,4,46,0,4,365
39049000220,4186,3750,104,62,0,76,0,13,436
39049000310,3377,2067,201,778,15,90,3,30,1310
39049000320,2505,1766,159,343,7,38,0,22,739
39049000330,2427,1351,266,606,8,41,3,16,1076
39049000410,2439,2126,76,29,10,48,0,11,313
39049000420,3316,2940,81,51,4,54,1,26,376
39049000500,4187,3342,164,113,0,389,0,14,845
39049000600,3839,3086,191,183,6,120,2,20,753
39049000710,3339,1649,339,1059,9,40,4,30,1690
39049000720,2583,541,235,1615,3,14,1,15,2042
39049000730,3629,298,257,2826,11,4,1,19,3331
39049000810,2747,1476,274,711,10,30,0,19,1271
39049000820,3193,1277,280,1355,4,38,3,17,1916
39049000910,3693,821,317,2261,5,12,0,30,2872
39049000920,2209,398,271,1406,7,11,1,16,1811
39049001000,5613,4313,293,358,4,319,3,24,1300
39049001110,3751,2556,161,125,4,766,2,8,1195
39049001121,12131,10744,361,694,0,222,45,40,1387
39049001122,3268,2473,130,211,2,337,5,12,795
39049001200,5201,3962,351,230,2,410,0,33,1239
39049001301,2903,2022,189,382,1,148,0,7,881
39049001302,3039,2453,168,148,0,146,3,12,586
39049001400,1531,216,123,1088,7,1,0,22,1315
39049001500,2092,137,106,1721,5,5,0,6,1955
39049001600,2399,1244,166,753,6,76,0,9,1155
39049001700,3994,2379,390,567,5,378,0,17,1615
39049001810,4324,2912,302,284,2,585,2,15,1412
39049001820,2478,1938,156,123,2,140,0,16,540
39049001901,4059,3070,213,205,0,368,0,18,989
39049001902,4063,3415,157,120,0,165,1,33,648
39049002000,3259,2666,133,228,6,99,0,11,593
39049002100,2456,2032,106,69,4,136,0,14,424
39049002200,4279,3338,198,383,3,171,3,16,941
39049002300,1503,333,64,1008,5,17,1,7,1170
39049002510,3144,409,468,2056,3,15,5,34,2735
39049002520,2784,877,102,1576,3,34,1,45,1907
39049002600,3920,794,847,2088,22,15,0,3,3126
39049002710,1908,411,120,1242,10,16,2,21,1497
39049002730,2183,379,234,1416,13,15,2,15,1804
39049002740,2447,1750,102,458,4,19,0,12,697
39049002750,2554,476,421,1454,2,20,0,31,2078
39049002760,3331,1756,185,1163,3,22,3,31,1575
39049002770,2300,368,365,1373,5,25,1,25,1932
39049002780,2353,1320,80,845,0,22,0,5,1033
39049002800,2461,505,100,1655,11,9,0,21,1956
39049002900,2887,333,142,2204,5,33,4,8,2554
39049003000,4189,3100,197,394,17,277,2,19,1089
39049003200,3500,2808,238,152,2,146,0,20,692
39049003600,2039,721,101,1018,10,32,0,21,1318
39049003700,3389,1446,163,1486,21,37,0,34,1943
39049003800,2105,1234,92,632,0,24,2,24,871
39049004001,1253,862,53,192,1,55,0,19,391
39049004002,4245,2602,222,946,8,290,1,24,1643
39049004200,1107,639,56,308,4,32,0,3,468
39049004301,3532,2895,141,125,1,251,1,10,637
39049004302,1740,941,196,422,9,17,1,10,799
39049004500,5048,2946,601,1033,20,57,2,29,2102
39049004610,3298,2623,246,205,5,23,0,25,675
39049004620,2609,1400,403,531,4,35,7,32,1209
39049004700,5138,2158,1015,1493,15,82,1,28,2980
39049004810,2929,1930,350,383,5,53,0,21,999
39049004820,2685,1442,405,545,4,73,0,15,1243
39049004900,5686,2962,813,1414,21,82,0,23,2724
39049005001,1647,1058,77,349,7,11,0,15,589
39049005002,3095,1791,212,829,19,18,2,18,1304
39049005100,2548,837,131,1437,5,8,0,19,1711
39049005200,3125,2658,108,114,2,96,0,22,467
39049005300,2676,957,113,1394,6,35,3,13,1719
39049005410,1418,261,71,983,0,16,0,14,1157
39049005420,2082,308,88,1536,14,8,0,18,1774
39049005500,4062,663,184,2928,9,21,0,28,3399
39049005610,1646,645,74,768,4,17,2,11,1001
39049005620,2422,1185,127,895,9,29,3,19,1237
39049005700,3715,3248,142,105,4,91,0,10,467
39049005810,2719,2322,100,123,2,41,2,14,397
39049005820,2127,1718,71,200,7,19,0,16,409
39049005900,2365,630,80,1449,30,24,5,16,1735
39049006000,2224,1149,88,769,12,20,0,19,1075
39049006100,2534,1467,116,792,12,12,0,8,1067
39049006236,6192,5102,122,54,13,643,0,19,1090
39049006237,5953,4484,338,232,8,614,0,39,1469
39049006238,1892,1475,93,61,0,162,0,12,417
39049006239,6516,3259,264,336,14,2375,0,20,3257
39049006240,5998,4350,459,244,5,705,1,17,1648
39049006241,9531,5885,357,428,22,2458,2,36,3646
39049006301,3155,2208,288,206,4,248,0,17,947
39049006302,4613,2811,503,299,12,793,3,27,1802
39049006310,4857,4203,110,49,5,264,0,29,654
39049006321,4436,3795,90,53,1,333,0,5,641
39049006323,3570,2985,84,50,0,270,0,16,585
39049006330,4941,4271,174,36,5,219,3,15,670
39049006340,3392,2726,72,39,2,408,3,5,666
39049006351,4116,3117,220,337,2,250,0,11,999
39049006352,3290,1939,229,263,5,687,0,20,1351
39049006353,4806,3029,314,436,11,729,2,17,1777
39049006372,7614,4425,784,825,9,1054,0,69,3189
39049006384,6276,4607,401,367,9,475,2,29,1669
39049006386,6014,3992,418,346,8,945,5,30,2022
39049006387,6512,4623,536,482,5,509,0,27,1889
39049006391,5664,4804,112,95,1,372,1,11,860
39049006392,4644,3971,125,74,4,289,1,16,673
39049006393,5343,4147,264,223,8,439,9,32,1196
39049006394,2753,2201,123,121,1,127,0,21,552
39049006395,3713,2378,210,251,4,653,0,24,1335
39049006396,5472,3779,292,373,17,737,1,29,1693
39049006397,6680,4295,922,551,4,411,10,48,2385
39049006398,3592,2387,78,108,2,869,4,10,1205
39049006410,2943,2558,81,22,6,120,0,18,385
39049006430,4946,4073,129,49,3,501,2,6,873
39049006500,3827,3502,70,25,0,97,0,8,325
39049006600,4204,3779,74,35,0,105,0,13,425
39049006710,2894,2480,79,108,4,61,0,6,414
39049006721,3763,3423,54,66,3,88,0,12,340
39049006722,2953,2404,94,213,1,68,0,18,549
39049006810,2354,2111,67,24,0,32,1,23,243
39049006821,3619,2513,135,679,4,71,1,22,1106
39049006822,1907,1664,67,38,6,34,0,4,243
39049006910,1698,1539,24,6,2,42,0,1,159
39049006921,3861,2013,339,1085,13,143,1,31,1848
39049006923,3957,1725,344,1237,9,402,0,10,2232
39049006924,4245,1570,285,1680,6,450,0,33,2675
39049006931,6882,1732,963,3522,14,365,0,50,5150
39049006932,7121,1829,875,3359,20,684,1,50,5292
39049006933,7124,773,653,3532,6,1902,5,39,6351
39049006943,4677,2026,466,1738,8,140,1,34,2651
39049006944,4332,2489,279,1173,12,104,1,59,1843
39049006945,6102,1378,867,3371,19,78,0,80,4724
39049006950,2797,2557,46,30,4,67,1,4,240
39049006991,4576,3798,144,290,1,103,0,22,778
39049006992,4443,1007,701,2178,6,369,0,16,3436
39049007010,3995,2835,131,823,8,54,0,4,1160
39049007020,6547,5674,206,212,3,88,2,34,873
39049007041,2744,2044,123,193,6,248,1,13,700
39049007043,5558,3277,659,804,15,363,0,69,2281
39049007044,5888,3543,343,673,20,1010,1,29,2345
39049007047,3760,2426,339,553,6,224,1,29,1334
39049007048,6388,3881,500,803,8,769,7,43,2507
39049007101,3239,2342,156,440,4,72,0,10,897
39049007102,3392,2917,73,177,7,68,0,14,475
39049007103,3286,2093,147,637,8,256,0,11,1193
39049007112,6625,2387,475,2753,3,677,3,33,4238
39049007113,5194,1992,385,1998,6,516,1,31,3202
39049007114,5130,2515,292,1768,3,184,0,76,2615
39049007115,6053,2024,490,3012,8,222,0,43,4029
39049007120,5451,3792,283,840,10,147,2,34,1659
39049007193,6563,5786,152,186,15,105,1,25,777
39049007198,2875,2030,118,451,0,107,0,6,845
39049007199,6263,3154,345,1995,6,355,0,47,3109
39049007202,3645,1649,208,1319,6,234,1,22,1996
39049007205,6540,4869,304,693,8,329,0,42,1671
39049007209,9770,6049,453,1476,16,1261,3,47,3721
39049007211,4549,3656,121,209,2,338,1,16,893
39049007212,5388,4168,213,344,5,343,5,26,1220
39049007213,5398,4075,147,266,2,591,0,27,1323
39049007214,3877,2686,170,641,2,194,0,16,1191
39049007215,5550,4177,217,667,16,206,0,44,1373
39049007301,5986,2672,284,1723,11,908,4,47,3314
39049007302,4862,2512,196,1207,4,653,4,39,2350
39049007303,6632,3828,211,1824,6,464,2,10,2804
39049007305,4480,3348,154,600,7,150,5,27,1132
39049007306,4526,3717,111,369,7,152,0,3,809
39049007394,3499,2828,105,244,0,133,5,16,671
39049007397,3537,1258,239,1451,6,369,0,17,2279
39049007398,8249,3826,359,2236,4,1374,4,33,4423
39049007424,6240,3650,335,1457,10,390,0,57,2590
39049007425,2712,2069,93,318,0,33,2,21,643
39049007426,3357,2669,121,355,6,48,6,9,688
39049007427,6714,4610,244,1228,21,191,0,28,2104
39049007492,6421,4534,231,956,8,345,2,36,1887
39049007494,4404,2853,153,909,10,197,2,5,1551
39049007511,1872,118,76,1571,3,7,1,8,1754
39049007512,4295,384,203,3446,3,18,2,53,3911
39049007520,3242,562,257,2209,6,14,1,37,2680
39049007531,3065,589,470,1690,3,199,0,15,2476
39049007532,2633,192,203,1974,0,176,1,7,2441
39049007533,1933,198,273,1267,4,123,0,4,1735
39049007534,3884,398,302,3024,15,36,3,17,3486
39049007550,2983,895,95,1788,6,72,0,27,2088
39049007552,3998,261,109,3122,3,374,0,17,3737
39049007553,5731,772,307,3940,7,442,4,73,4959
39049007710,4629,1660,631,2005,6,70,0,20,2969
39049007721,6485,1184,938,3362,3,715,0,18,5301
39049007722,3673,1572,613,1091,3,155,0,20,2101
39049007730,3221,1597,225,911,1,272,0,26,1624
39049007740,1743,1238,78,254,5,79,0,22,505
39049007811,3621,2978,156,123,3,183,0,11,643
39049007812,4931,3507,179,385,12,619,2,13,1424
39049007820,3784,1991,225,283,7,1141,0,20,1793
39049007830,3691,2466,173,185,2,676,2,17,1225
39049007922,6201,5073,323,260,7,291,0,46,1128
39049007931,4305,3515,246,145,12,97,1,16,790
39049007941,3258,2463,220,173,2,225,0,7,795
39049007955,3364,2756,211,96,1,122,0,14,608
39049007956,4747,3638,304,210,11,313,0,24,1109
39049007957,4940,4237,196,105,11,179,2,14,703
39049007958,3330,2935,70,29,0,172,0,2,395
39049007959,1962,1490,198,95,3,40,2,17,472
39049007960,4926,3439,343,550,3,296,0,17,1487
39049007961,4974,3961,127,127,0,518,0,30,1013
39049007962,5249,4155,204,383,2,194,1,25,1094
39049007963,3065,2664,97,46,1,117,3,15,401
39049007964,6496,5128,349,264,16,435,0,23,1368
39049007965,3863,2490,501,311,13,294,0,27,1373
39049007966,5332,3120,701,809,6,341,1,43,2212
39049008001,3350,2893,124,42,6,129,0,10,457
39049008002,3487,2936,214,73,3,78,0,13,551
39049008110,4245,2966,525,418,5,59,1,24,1279
39049008120,4101,2261,1121,375,9,94,0,32,1840
39049008132,7202,4543,991,870,15,358,1,41,2659
39049008163,3622,1505,1092,731,3,77,0,19,2117
39049008164,4573,2402,768,1028,11,125,0,33,2171
39049008165,2544,1842,291,161,9,99,2,11,702
39049008166,5601,3984,419,407,6,498,3,33,1617
39049008167,4078,2403,495,748,2,109,0,16,1675
39049008168,3517,2048,380,791,3,94,0,12,1469
39049008169,5235,3150,971,533,8,262,6,19,2085
39049008170,5083,3840,405,385,3,150,0,14,1243
39049008171,3505,2095,447,623,0,135,2,17,1410
39049008172,5597,3577,598,848,5,293,3,17,2020
39049008210,2321,1191,660,258,14,51,7,13,1130
39049008230,3178,379,676,1948,0,28,0,21,2799
39049008241,2559,1394,479,455,6,35,0,20,1165
39049008242,6316,4313,665,563,22,443,0,18,2003
39049008311,4686,2344,698,1240,6,79,3,21,2342
39049008312,5027,2118,1145,1284,7,143,2,17,2909
39049008321,2530,1680,284,248,1,140,0,11,850
39049008322,4837,3238,418,728,7,141,0,14,1599
39049008330,1847,1406,160,136,4,9,0,8,441
39049008340,6354,3811,555,1413,18,176,4,26,2543
39049008350,7668,2717,1380,3038,4,164,6,45,4951
39049008360,6690,4458,671,861,13,250,5,30,2232
39049008380,5128,3493,373,830,9,152,0,20,1635
39049008381,4426,3585,315,184,9,89,2,18,841
39049008382,3715,2773,242,369,6,91,4,19,942
39049008400,3161,2875,55,42,0,58,1,21,286
39049008500,5702,4957,224,93,4,180,3,31,745
39049008710,2593,371,124,1888,10,50,1,17,2222
39049008720,3507,1012,534,1555,17,171,0,27,2495
39049008730,1987,440,194,1246,7,22,1,15,1547
39049008811,1774,1283,106,239,8,9,2,7,491
39049008812,3393,820,266,2022,12,32,0,25,2573
39049008813,2447,421,159,1677,3,21,6,5,2026
39049008821,2597,2207,102,119,9,14,1,6,390
39049008822,4134,2539,260,1002,8,56,0,33,1595
39049008825,6468,5057,252,666,29,77,1,38,1411
39049008900,5240,4243,201,416,3,106,3,30,997
39049009000,3644,3103,72,163,3,92,2,22,541
39049009100,5044,4268,169,253,0,98,1,18,776
39049009220,2613,1303,467,645,8,36,0,26,1310
39049009230,5631,1933,718,2468,18,105,0,33,3698
39049009240,2052,1227,375,324,4,2,2,5,825
39049009250,2103,996,372,574,4,29,4,22,1107
39049009251,1169,191,130,743,2,9,1,1,978
39049009252,2927,823,269,1651,9,55,1,15,2104
39049009311,3325,786,320,1975,12,34,2,25,2539
39049009312,3552,795,559,1904,5,40,0,36,2757
39049009321,2457,542,436,1324,6,65,0,6,1915
39049009322,3751,943,567,1906,0,98,0,26,2808
39049009323,3828,576,559,2462,6,33,0,30,3252
39049009325,4746,632,448,3332,20,55,3,26,4114
39049009326,1686,191,224,1149,2,11,0,5,1495
39049009332,3321,622,137,2333,5,27,0,30,2699
39049009334,3160,401,233,2236,9,112,0,24,2759
39049009336,2085,764,115,1051,0,61,0,5,1321
39049009337,4416,455,304,3350,2,40,5,36,3961
39049009340,3513,1099,447,1688,6,52,3,16,2414
39049009350,3046,890,284,1649,3,31,0,28,2156
39049009361,5429,2492,217,2359,8,58,3,33,2937
39049009372,4613,1164,299,2803,13,70,0,33,3449
39049009373,6184,1323,401,3951,9,102,0,15,4861
39049009381,6424,2781,289,2276,9,695,1,42,3643
39049009382,3002,2063,190,398,2,157,1,26,939
39049009383,2636,1476,142,689,13,152,0,20,1160
39049009384,2916,1541,169,777,2,228,1,37,1375
39049009385,3907,2366,189,1019,3,140,1,16,1541
39049009386,3279,687,292,1946,4,119,0,31,2592
39049009390,7155,3457,518,1735,2,1067,0,44,3698
39049009391,5068,1684,401,2436,9,139,2,36,3384
39049009392,3750,919,232,2270,2,86,0,23,2831
39049009393,3742,448,275,2711,5,98,0,11,3294
39049009394,2014,1277,81,508,3,47,0,6,737
39049009395,4895,2802,187,1315,13,318,0,34,2093
39049009396,2825,443,167,1970,6,42,0,18,2382
39049009397,2977,898,155,1732,3,38,0,11,2079
39049009401,4626,2302,247,1596,10,121,3,49,2324
39049009403,3629,1563,187,1356,13,251,2,11,2066
39049009404,2764,2284,98,174,7,35,0,3,480
39049009405,4143,3407,96,354,6,68,0,12,736
39049009410,2810,1471,170,907,4,41,6,24,1339
39049009420,6093,3280,324,1938,24,108,9,50,2813
39049009440,5054,3575,256,769,9,115,1,48,1479
39049009495,5258,3041,408,1319,15,151,1,27,2217
39049009497,2000,1713,70,68,1,27,0,11,287
39049009498,3827,1439,179,1892,9,77,0,32,2388
39049009520,4614,3655,209,362,11,82,3,18,959
39049009590,5323,4444,201,350,14,60,0,8,879
39049009600,4250,3101,217,651,0,41,2,27,1149
39049009711,4436,3743,223,199,12,27,0,23,693
39049009712,2593,2301,64,47,0,16,0,23,292
39049009751,6537,5739,161,203,2,117,3,15,798
39049009752,7528,5832,338,590,10,255,1,30,1696
39049009753,5947,5397,124,75,4,77,0,24,550
39049009754,3989,3508,119,95,1,62,0,19,481
39049009755,7213,6091,216,306,9,265,0,17,1122
39049009756,2244,1746,210,136,0,27,0,9,498
39049009757,4669,3975,178,162,14,47,0,14,694
39049009801,3288,2959,72,43,12,32,0,10,329
39049009802,3521,3219,129,13,3,14,1,9,302
39049009900,1970,476,398,942,1,50,0,16,1494
39049010000,5858,4069,316,915,8,164,1,37,1789
39049010100,1487,637,56,623,9,88,0,6,850
39049010201,4049,1815,181,1731,8,79,1,26,2234
39049010202,5534,2765,264,1735,5,368,3,44,2769
39049010203,4486,1892,216,2008,2,86,1,26,2594
39049010204,6684,2338,412,3296,19,160,1,54,4346
39049010300,2665,1734,211,409,3,62,4,11,931
39049010401,2641,1746,89,28,0,658,0,4,895
39049010402,5411,3738,127,80,6,1250,1,16,1673
39049010501,5037,3501,148,62,2,1092,4,31,1536
39049010502,3411,2536,129,68,0,528,0,5,875
39049010601,5364,4069,237,241,3,536,1,23,1295
39049010602,7124,5617,312,350,11,503,4,10,1507
39049010700,1420,1030,78,172,0,58,0,7,390
39049010900,4983,2852,295,1017,1,564,0,42,2131
39049980000,5,2,3,0,0,0,0,0,3
39051040100,3322,3045,148,13,4,5,0,8,277
39051040200,4560,4125,195,55,4,7,0,18,435
39051040300,4668,4293,158,17,11,5,1,13,375
39051040400,3679,3150,312,9,11,11,0,1,529
39051040500,4856,4391,259,10,4,7,0,16,465
39051040600,4324,3841,297,10,6,16,0,23,483
39051040701,2873,2241,465,25,5,16,2,3,632
39051040702,4992,3888,837,34,8,38,3,10,1104
39051040800,4778,4215,408,22,5,25,0,5,563
39051040900,4661,3779,712,30,2,22,0,23,882
39053953500,4498,4152,29,104,2,11,0,12,346
39053953600,4000,3725,26,71,9,6,2,14,275
39053953700,4137,3869,52,65,16,9,3,2,268
39053953800,3953,3736,25,29,7,10,0,1,217
39053953901,4084,3756,30,93,3,47,0,9,328
39053953902,2632,2481,22,15,4,12,0,11,151
39053954000,3509,3086,44,150,9,35,0,20,423
39053954100,2407,2150,34,70,5,18,0,10,257
39055310100,2144,2026,21,2,1,0,0,3,118
39055310200,1938,1813,27,19,1,9,1,5,125
39055310600,6017,5612,140,32,2,41,0,19,405
39055310700,3940,3720,61,23,0,19,0,18,220
39055310800,7087,6553,146,90,2,57,0,23,534
39055310900,3103,2803,100,35,3,14,0,13,300
39055311000,3657,3559,21,21,3,4,1,0,98
39055311300,4379,4118,68,29,2,9,0,7,261
39055311400,5244,4850,101,81,1,19,0,21,394
39055311500,5540,5128,107,40,0,63,0,22,412
39055311600,3972,3712,82,13,0,58,3,4,260
39055311700,5608,4891,134,339,0,71,0,12,717
39055311800,7285,6726,127,109,3,73,0,15,559
39055311900,6574,6053,160,67,2,68,0,15,521
39055312000,2778,2674,25,6,3,16,0,0,104
39055312100,4446,4353,27,2,0,12,0,1,93
39055312201,5504,5084,114,57,3,53,1,7,420
39055312202,4232,3988,53,18,1,31,0,7,244
39055312203,4676,4386,59,28,5,18,0,12,290
39055312300,4644,4346,71,57,3,31,2,12,298
39055312400,2629,2563,20,7,1,0,0,4,66
39057200101,2528,1991,85,225,6,66,7,7,537
39057200103,3794,2679,140,562,10,136,5,31,1115
39057200104,5048,3275,193,832,6,455,5,35,1773
39057200300,3796,3021,161,253,9,40,5,21,775
39057200400,2122,1690,68,151,2,29,0,18,432
39057200500,4850,3962,187,236,10,70,6,33,888
39057200600,3667,2990,120,185,8,97,5,11,677
39057200700,4287,3157,167,523,16,49,7,37,1130
39057200901,4152,3174,185,348,9,177,1,15,978
39057200902,3535,3115,85,87,6,61,2,4,420
39057210101,3769,2402,229,312,3,591,2,27,1367
39057210102,2061,1644,89,58,6,132,2,6,417
39057210201,4532,3985,133,78,9,88,0,29,547
39057210202,3652,3062,158,109,7,129,4,8,590
39057210300,3705,3320,81,50,2,89,0,18,385
39057210401,5226,4239,203,214,6,295,8,10,987
39057210402,5260,4434,169,149,6,237,0,18,826
39057210500,6292,5345,179,105,11,363,0,21,947
39057210602,5186,4542,160,64,4,137,1,8,644
39057210603,7946,6286,324,247,7,525,3,67,1660
39057210604,5552,4086,211,329,6,654,0,34,1466
39057210605,3009,2598,98,46,9,125,0,2,411
39057220101,4104,3541,117,75,0,158,0,21,563
39057220102,4716,4213,126,37,4,86,0,38,503
39057220201,4474,3659,173,235,14,141,1,17,815
39057220202,4079,3616,99,89,1,92,0,5,463
39057230100,2473,2302,23,15,8,10,2,8,171
39057240100,2802,2319,79,211,8,8,0,8,483
39057240200,4614,3813,91,332,13,45,4,18,801
39057240302,3948,3254,53,354,12,22,0,19,694
39057240303,4333,3411,111,412,13,28,3,16,922
39057240304,4275,3436,156,327,6,36,0,24,839
39057240500,4478,3703,78,434,15,29,0,12,775
39057240600,5186,1954,81,2763,32,10,2,103,3232
39057240700,2604,2274,52,77,8,16,0,14,330
39057255000,3566,2770,161,312,17,41,3,25,796
39057260100,6717,6054,95,137,3,137,0,44,663
39057270100,3732,3450,45,52,4,21,2,16,282
39057280101,2639,2463,33,21,7,18,0,8,176
39057280102,2304,2150,24,12,1,8,0,9,154
39057280200,1367,1181,30,47,6,10,2,10,186
39057280300,1586,1043,164,180,0,55,5,1,543
39059977100,4376,4223,34,8,4,10,0,4,153
39059977200,4610,4382,29,21,9,16,1,2,228
39059977300,3252,2930,40,92,10,22,2,12,322
39059977400,3629,3276,43,155,9,27,3,11,353
39059977500,3327,2998,58,73,19,8,0,5,329
39059977600,2919,2631,49,76,12,9,0,5,288
39059977700,3795,3563,48,28,5,17,1,10,232
39059977800,3880,3674,38,13,8,9,0,12,206
39059977900,4330,3982,64,32,8,15,0,0,348
39059978000,4320,4058,41,22,3,16,0,4,262
39061000200,1156,90,12,994,1,0,0,7,1066
39061000700,3433,2112,146,851,3,191,3,21,1321
39061000900,1660,837,51,674,4,28,0,7,823
39061001000,1688,1030,65,440,1,51,0,9,658
39061001100,1088,586,20,425,3,15,0,0,502
39061001600,1059,381,33,586,0,7,1,4,678
39061001700,1215,369,46,715,0,21,0,2,846
39061001800,1427,945,59,313,0,30,0,5,482
39061001900,2044,1301,73,520,0,53,0,6,743
39061002000,1503,1064,49,240,3,51,0,15,439
39061002200,2256,665,97,1248,1,94,5,21,1591
39061002300,1387,580,75,606,6,65,1,17,807
39061002500,3836,2634,194,593,3,239,0,10,1202
39061002600,3437,2476,189,467,2,138,2,18,961
39061002700,1651,1167,78,219,3,85,1,15,484
39061002800,1234,726,33,387,0,21,0,11,508
39061002901,2744,2002,97,346,0,187,1,13,742
39061002902,2799,1383,70,629,8,528,1,36,1416
39061003000,5918,4176,102,908,0,566,0,9,1742
39061003200,1426,866,40,181,0,235,1,3,560
39061003300,2947,2060,66,463,3,277,1,0,887
39061003600,1054,64,23,930,0,3,0,2,990
39061003700,1601,344,25,1133,5,14,3,9,1257
39061003800,2032,231,57,1640,3,9,2,7,1801
39061003900,1684,225,47,1319,7,10,0,6,1459
39061004000,2141,697,84,1209,0,30,0,6,1444
39061004100,1618,979,44,455,1,62,0,14,639
39061004200,1947,1317,63,393,2,49,7,15,630
39061004602,5056,4047,147,469,7,88,3,24,1009
39061004603,3048,2648,64,170,5,17,1,1,400
39061004604,3561,2702,131,458,4,72,0,10,859
39061004605,2622,2087,77,262,3,80,2,17,535
39061004703,3850,3355,100,136,0,95,1,14,495
39061004800,3551,3221,117,33,0,53,0,12,330
39061004900,6644,5621,192,282,4,256,2,40,1023
39061005000,5029,4284,189,202,5,143,1,26,745
39061005100,2520,2190,125,52,0,63,0,17,330
39061005200,3563,3060,106,158,0,89,1,13,503
39061005301,3349,2702,140,244,2,117,1,12,647
39061005302,3319,2726,91,268,4,110,0,9,593
39061005500,4110,1626,148,2006,7,103,6,22,2484
39061005600,5339,3262,157,1568,3,60,3,29,2077
39061005701,3174,2129,125,743,5,42,0,11,1045
39061005702,4513,2491,296,1347,2,112,0,23,2022
39061005800,5166,1603,232,3003,18,46,0,31,3563
39061005900,1208,717,42,356,3,27,8,7,491
39061006000,5806,2384,562,2421,14,133,12,23,3422
39061006100,2781,1024,878,683,11,45,3,10,1757
39061006300,3865,221,172,3303,0,36,0,14,3644
39061006400,3137,211,47,2755,5,5,2,7,2926
39061006501,2947,1977,152,589,2,69,1,22,970
39061006502,3512,1236,84,1892,9,61,0,28,2276
39061006600,2052,420,65,1454,5,22,0,15,1632
39061006800,4046,364,91,3358,4,24,0,27,3682
39061006900,2598,171,81,2189,9,27,0,17,2427
39061007000,2499,1337,106,615,5,319,1,15,1162
39061007100,3695,2557,132,395,4,405,0,16,1138
39061007200,2214,1297,101,323,4,346,2,22,917
39061007300,1916,699,111,958,5,21,0,15,1217
39061007400,1954,1357,81,341,1,41,3,15,597
39061007500,2032,1334,51,451,2,35,0,19,698
39061007700,2667,160,58,2276,9,3,0,19,2507
39061008000,5684,455,287,4493,23,40,0,34,5229
39061008100,2791,408,77,2196,1,20,0,21,2383
39061008201,4159,1371,106,2475,1,35,0,24,2788
39061008202,3349,1018,157,1983,3,18,0,18,2331
39061008300,4779,1511,131,2665,7,236,0,23,3268
39061008400,2286,1023,35,1132,2,14,2,12,1263
39061008501,3790,643,287,2644,8,38,0,15,3147
39061008502,1918,83,123,1585,6,3,0,4,1835
39061008601,1951,296,79,1478,7,4,2,16,1655
39061008800,3157,367,267,2365,5,18,2,41,2790
39061009200,4464,1176,1401,1653,15,16,0,22,3288
39061009300,2412,907,376,953,4,12,0,20,1505
39061009400,1651,487,304,759,4,4,0,14,1164
39061009500,2569,880,673,881,9,12,2,11,1689
39061009600,4145,2309,274,1243,8,49,0,14,1836
39061009700,5168,2282,763,1687,20,38,3,49,2886
39061009800,2285,753,201,1185,1,10,0,21,1532
39061009901,4552,3025,245,982,4,20,0,19,1527
39061009902,3490,2094,274,897,7,25,1,10,1396
39061010002,6030,948,212,4432,10,89,2,55,5082
39061010003,4935,1318,323,3024,8,59,4,20,3617
39061010004,4705,922,252,3252,10,55,0,19,3783
39061010005,1546,685,58,675,4,8,0,11,861
39061010100,4834,2141,148,2208,6,57,2,45,2693
39061010201,5923,3186,365,2021,10,58,2,36,2737
39061010202,2531,1354,59,948,0,32,2,25,1177
39061010300,1256,869,31,254,2,6,7,4,387
39061010400,1257,922,45,178,2,21,0,2,335
39061010500,1434,1204,35,99,0,3,0,8,230
39061010600,1391,1225,25,54,4,5,0,7,166
39061010700,1735,1103,96,408,2,4,0,10,632
39061010900,2784,1114,162,1331,3,26,0,22,1670
39061011000,2768,286,50,2307,11,6,0,6,2482
39061011100,3454,1345,69,1830,4,33,0,11,2109
39061020401,5174,4660,87,87,23,27,0,20,514
39061020403,5994,5693,30,29,5,30,0,12,301
39061020404,4807,4575,50,35,3,25,2,1,232
39061020501,3053,2585,43,274,1,31,0,14,468
39061020502,4687,4164,74,247,2,45,2,16,523
39061020504,3358,2324,104,596,7,122,3,10,1034
39061020505,4633,2547,191,1365,22,235,20,9,2086
39061020601,6237,5728,96,169,3,56,1,16,509
39061020603,5727,5059,94,224,3,136,4,14,668
39061020604,2671,2414,47,106,0,26,0,6,257
39061020701,7107,5542,161,829,17,184,3,30,1565
39061020705,3335,1905,162,897,11,153,1,11,1430
39061020707,4982,4567,60,126,0,84,0,20,415
39061020741,3435,1615,238,1241,5,67,13,48,1820
39061020742,4213,2121,268,1385,21,113,0,25,2092
39061020762,3178,1799,113,884,2,184,2,20,1379
39061020763,2341,1660,44,339,5,212,0,9,681
39061020764,4975,2932,141,1097,9,524,0,31,2043
39061020802,4978,4269,74,343,2,70,0,19,709
39061020811,5876,4118,113,1154,5,227,5,14,1758
39061020812,4454,3902,53,281,2,55,2,11,552
39061020901,3623,2741,130,555,6,15,6,19,882
39061020902,5614,3860,109,1292,9,39,4,21,1754
39061021001,3134,2693,94,155,7,18,1,11,441
39061021002,3805,3454,76,87,0,49,0,15,351
39061021003,3160,2825,57,65,1,21,0,14,335
39061021101,4962,4677,58,56,13,33,0,10,285
39061021102,6449,6139,56,46,0,33,2,16,310
39061021201,2153,2026,23,17,0,24,1,8,127
39061021202,5363,4588,112,362,10,62,3,13,775
39061021302,5672,5385,28,63,7,29,1,7,287
39061021303,4723,4326,62,106,6,66,1,7,397
39061021304,5026,4434,88,235,5,31,0,42,592
39061021401,5242,4458,84,347,18,53,6,13,784
39061021421,4149,3634,75,139,5,81,0,13,515
39061021422,2988,2383,81,312,2,58,0,12,605
39061021501,4911,2005,373,2017,2,220,0,46,2906
39061021504,6386,1395,1022,3140,16,525,13,44,4991
39061021505,3196,708,453,1759,1,105,15,9,2488
39061021506,3506,563,564,2054,0,130,0,24,2943
39061021508,6026,3225,259,1982,13,197,3,44,2801
39061021509,6831,2983,354,2870,20,172,19,55,3848
39061021571,3591,1111,232,1844,2,174,11,25,2480
39061021572,5893,991,519,3551,11,529,21,43,4902
39061021602,3100,510,81,2356,3,35,0,17,2590
39061021603,3767,1736,111,1617,7,83,2,23,2031
39061021604,3727,1162,121,2176,14,36,6,19,2565
39061021701,2891,1454,171,1077,8,25,0,29,1437
39061021702,4370,1650,74,2376,5,19,0,34,2720
39061021801,6270,1971,167,3744,11,57,4,33,4299
39061021802,3411,1177,81,1889,10,11,4,24,2234
39061021900,1330,353,50,846,3,4,0,13,977
39061022000,3957,2861,198,588,7,34,0,15,1096
39061022101,4462,2901,131,1158,6,69,0,38,1561
39061022102,7029,3385,198,2490,22,527,1,63,3644
39061022200,4389,2710,224,1165,4,52,0,12,1679
39061022301,5838,2332,1924,1152,4,162,4,44,3506
39061022302,5710,4183,550,321,3,247,175,30,1527
39061022400,2298,1821,77,278,3,35,0,12,477
39061022500,4603,1381,266,2588,1,163,0,28,3222
39061022601,6140,5067,135,442,0,178,2,47,1073
39061022602,2748,1930,95,483,5,55,0,22,818
39061022700,3144,92,94,2810,1,6,0,14,3052
39061023001,4939,2596,571,719,13,734,24,16,2343
39061023002,5045,4049,184,406,9,135,1,28,996
39061023100,2669,2239,36,186,0,101,0,12,430
39061023201,2933,2295,68,391,6,31,0,10,638
39061023210,5372,4169,163,504,4,266,2,24,1203
39061023222,3213,2441,103,376,6,90,8,9,772
39061023300,4148,3430,88,269,4,154,0,30,718
39061023400,3814,1098,130,2368,0,30,0,30,2716
39061023501,4691,3355,147,136,11,853,0,14,1336
39061023521,2582,1656,97,375,0,283,2,16,926
39061023522,6500,5035,268,345,3,524,0,25,1465
39061023600,4134,3530,130,185,6,70,14,19,604
39061023701,2723,2283,42,175,2,83,0,12,440
39061023702,2605,2194,118,116,0,39,4,8,411
39061023800,5222,2517,239,2074,11,81,4,23,2705
39061023901,4902,3402,200,300,6,808,2,15,1500
39061023902,5011,4375,123,106,3,221,0,8,636
39061024001,5241,3825,209,483,1,475,2,35,1416
39061024002,3058,2575,88,103,0,205,0,8,483
39061024100,7391,6431,312,101,0,222,1,18,960
39061024200,2938,2195,95,455,2,81,0,6,743
39061024301,4147,2201,270,349,4,1027,5,11,1946
39061024303,7164,6160,254,228,10,168,1,19,1004
39061024322,8197,6637,286,183,0,749,0,20,1560
39061024323,3352,2600,148,108,1,345,2,13,752
39061024324,4675,3746,168,124,3,378,5,20,929
39061024401,4716,3963,109,203,9,220,0,33,753
39061024402,3240,2706,101,42,2,255,0,11,534
39061024700,1768,1561,61,37,4,27,0,2,207
39061024800,3646,3293,86,39,2,82,0,8,353
39061024901,1066,922,57,6,1,13,0,10,144
39061024903,4578,4170,107,21,0,68,0,12,408
39061024904,3528,3088,88,78,5,102,0,25,440
39061025001,6253,5640,136,148,10,105,0,8,613
39061025002,7258,6522,191,116,6,81,0,24,736
39061025101,5026,4503,109,54,1,149,0,12,523
39061025102,7542,6697,204,108,8,191,3,24,845
39061025103,6743,5951,199,94,11,219,6,22,792
39061025200,4313,3173,291,586,6,44,0,29,1140
39061025300,2580,1885,201,333,9,11,0,7,695
39061025401,1535,1240,83,96,2,27,0,8,295
39061025402,2955,2520,137,111,1,57,2,5,435
39061025500,4087,2818,270,775,5,19,5,14,1269
39061025600,3573,2878,128,314,4,75,3,12,695
39061025700,2087,1172,176,564,9,8,2,9,915
39061025800,4070,2855,88,816,14,37,4,29,1215
39061026001,5049,4783,82,12,5,29,0,13,266
39061026002,8422,7709,170,106,12,58,2,18,713
39061026102,2905,2695,58,14,4,9,1,3,210
39061026103,4146,3785,76,50,11,24,0,13,361
39061026104,3910,3642,61,26,8,21,2,9,268
39061026200,2255,1957,122,35,5,1,4,6,298
39061026300,1070,429,65,511,6,0,0,8,641
39061026400,2508,413,56,1911,2,30,0,13,2095
39061026500,3196,1927,155,773,3,182,5,15,1269
39061026600,1476,1240,32,132,0,19,0,1,236
39061026700,1645,321,34,1206,0,10,0,9,1324
39061026800,1578,1361,63,49,2,36,0,6,217
39061026900,2366,336,56,1814,0,5,1,9,2030
39061027000,2649,290,41,2175,6,14,5,20,2359
39061027100,4271,500,67,3491,7,35,8,18,3771
39061027200,2181,705,107,1274,0,5,0,12,1476
39061027300,2773,2514,78,61,1,28,1,3,259
39061027400,4337,2296,174,1499,19,32,0,36,2041
39061027500,2924,2642,69,45,0,52,2,6,282
39061027600,2325,1356,117,517,5,202,3,23,969
39061027700,4110,2546,129,1118,13,59,6,22,1564
39063000100,4122,3430,359,112,0,36,0,19,692
39063000200,6476,5929,160,48,8,159,3,24,547
39063000301,1303,1209,32,6,0,3,0,9,94
39063000302,7013,6345,390,34,7,67,1,5,668
39063000400,7632,6641,389,140,11,193,1,22,991
39063000500,4933,3988,449,160,2,108,2,18,945
39063000600,6533,5246,515,221,11,266,0,33,1287
39063000700,6301,5508,282,101,3,196,4,6,793
39063000800,3546,2958,253,94,4,53,1,10,588
39063000901,1983,1595,203,54,3,28,2,5,388
39063000902,3401,2776,222,156,10,69,0,10,625
39063001000,6413,5469,433,96,4,123,2,16,944
39063001100,4141,3573,266,51,10,74,3,15,568
39063001200,5732,5424,98,21,4,3,5,13,308
39063001300,5391,5016,147,69,2,15,2,15,375
39065000100,3173,2998,76,17,0,3,1,6,175
39065000200,4577,4145,136,59,9,20,1,7,432
39065000300,3620,3418,79,13,11,7,1,4,202
39065000401,1794,1592,82,43,3,18,0,9,202
39065000402,4215,3739,122,67,5,76,0,14,476
39065000500,4162,3927,56,22,7,11,1,11,235
39065000600,3857,3557,89,23,5,10,4,10,300
39065000700,5298,5013,57,12,8,24,0,8,285
39067975600,3409,3173,44,20,2,12,1,9,236
39067975700,3539,3367,24,5,11,3,0,0,172
39067975800,2246,2160,13,0,0,4,2,0,86
39067975900,2053,1948,12,0,0,6,3,0,105
39067976000,3236,2777,37,209,1,15,0,9,459
39069000100,4673,4327,140,15,5,15,0,9,346
39069000200,3755,3484,180,12,12,8,0,8,271
39069000300,5208,4562,440,58,4,30,0,7,646
39069000400,3410,2789,435,28,10,37,1,4,621
39069000500,3256,2967,186,6,7,10,0,8,289
39069000600,3388,2888,390,11,8,14,0,2,500
39069000700,3972,3446,416,25,3,11,3,5,526
39071954400,3981,3692,25,76,8,12,1,4,289
39071954500,3932,3707,40,25,8,2,2,6,225
39071954600,5816,5470,61,46,11,10,0,23,346
39071954700,6222,5941,48,21,11,1,0,12,281
39071954800,4261,3841,66,113,29,30,3,15,420
39071954900,3648,3225,42,185,6,31,1,12,423
39071955001,1706,1626,15,4,2,1,0,5,80
39071955002,2620,2393,16,19,14,4,1,2,227
39071955101,3230,3067,49,10,4,9,0,6,163
39071955102,2970,2832,37,7,10,1,0,10,138
39071955200,4931,4698,25,12,6,9,0,1,233
39073964900,4338,4151,32,8,7,12,0,10,187
39073965000,3629,3463,16,9,0,4,0,4,166
39073965100,3925,3716,22,16,7,6,0,12,209
39073965200,4329,4048,32,39,8,20,0,12,281
39073965300,3851,3598,48,26,1,7,0,6,253
39073965400,4480,4198,54,22,15,17,0,9,282
39073965500,3498,3328,28,19,7,5,0,0,170
39075976301,4994,4924,51,1,2,3,0,0,70
39075976302,6090,5997,42,12,0,4,0,3,93
39075976401,2484,2447,20,1,2,0,0,0,37
39075976402,2804,2703,35,10,2,6,2,0,101
39075976403,3703,3601,16,41,2,4,0,0,102
39075976500,5413,5148,78,14,4,13,2,15,265
39075976600,4363,4130,56,10,6,5,0,10,233
39075976700,4473,4166,102,27,10,27,0,11,307
39075976801,5156,5070,57,0,0,2,0,0,86
39075976802,4743,4689,17,3,5,0,1,2,54
39077915400,5141,4748,158,10,3,13,0,11,393
39077915500,6111,5303,353,116,11,43,0,14,808
39077915600,5053,4472,258,64,12,32,2,7,581
39077915700,4272,3381,591,82,19,16,0,9,891
39077915800,4519,3795,387,73,6,34,1,15,724
39077915900,4010,3807,69,4,4,9,1,5,203
39077916000,4002,3570,198,32,2,2,1,4,432
39077916100,3447,3236,86,7,2,4,0,6,211
39077916200,4568,3336,998,64,14,10,2,3,1232
39077916300,3465,2695,611,30,8,18,0,6,770
39077916400,4962,4594,192,13,17,23,4,3,368
39077916500,4702,4383,104,18,29,6,0,7,319
39077916600,4313,3922,79,49,12,6,1,16,391
39079957200,4821,4518,64,12,6,9,0,2,303
39079957300,3504,3332,17,1,14,9,0,4,172
39079957400,5435,5077,46,64,25,12,0,0,358
39079957500,5794,5389,75,37,13,49,1,27,405
39079957600,2725,2545,36,19,7,9,0,7,180
39079957700,5406,5175,35,17,11,8,0,5,231
39079957800,4968,4799,33,8,12,5,0,5,169
39081000200,3453,2378,120,721,16,36,0,35,1075
39081000400,2581,1609,120,550,3,11,0,30,972
39081000600,2490,2138,51,191,6,17,2,3,352
39081001000,2451,2123,64,115,2,57,3,1,328
39081001200,5096,4440,92,294,7,35,0,7,656
39081001300,1221,1001,29,112,1,0,0,2,220
39081001400,3915,3160,128,325,3,36,2,1,755
39081011000,1555,1475,24,1,0,0,0,7,80
39081011100,2660,2531,25,3,6,4,0,0,129
39081011200,2053,1831,16,47,8,3,4,9,222
39081011300,2597,2387,32,32,0,22,2,0,210
39081011401,3958,3731,27,36,10,16,1,3,227
39081011402,3781,3540,41,26,6,8,2,9,241
39081011500,4769,4444,38,30,6,15,3,7,325
39081011700,4277,3812,41,165,3,29,2,11,465
39081011800,3457,2985,72,138,8,9,2,72,472
39081011900,3107,2892,42,27,4,1,0,5,215
39081012000,2803,2514,37,66,7,5,2,11,289
39081012100,2560,2393,19,11,4,5,0,2,167
39081012200,1982,1885,15,10,1,0,1,10,97
39081012300,2077,1903,26,28,4,6,2,7,174
39081012400,2406,1373,100,691,4,23,1,12,1033
39083006700,5209,4951,50,19,7,11,0,3,258
39083006801,5737,5337,75,49,5,21,0,15,400
39083006802,5051,4820,57,17,2,21,3,20,231
39083006900,6260,5930,67,15,10,11,6,31,330
39083007000,3170,2956,39,33,10,12,1,4,214
39083007100,3618,3263,83,42,13,5,0,11,355
39083007200,5329,4831,94,96,15,40,2,8,498
39083007301,3447,2852,210,100,6,131,1,84,595
39083007302,3407,3140,93,48,10,37,0,2,267
39083007400,5709,5437,63,26,8,6,2,13,272
39083007500,4331,3935,155,54,14,13,1,16,396
39083007600,4775,4343,133,38,15,39,0,5,432
39083007701,3283,3094,33,17,0,6,1,4,189
39083007702,3395,3169,44,11,3,12,0,21,226
39085200100,2002,1479,51,368,3,17,0,2,523
39085200200,2564,2207,61,116,1,23,1,2,357
39085200300,3038,2706,83,80,0,28,1,0,332
39085200400,3414,2965,84,191,5,28,0,6,449
39085200500,3186,2842,86,92,1,31,3,0,344
39085200600,3345,2964,85,142,1,28,0,14,381
39085200700,3751,3109,81,344,2,31,0,19,642
39085200800,3599,3057,79,257,15,40,0,8,542
39085200900,1957,1601,44,202,0,11,0,18,356
39085201000,5068,3185,86,1432,5,157,2,8,1883
39085201101,1981,745,59,744,5,347,0,5,1236
39085201102,2970,2752,44,43,3,39,0,1,218
39085201200,3531,2935,80,311,2,94,1,7,596
39085201300,3871,3402,56,224,3,80,3,4,469
39085201400,3830,3521,102,48,5,25,0,9,309
39085201500,2651,2312,73,98,8,53,2,19,339
39085201600,4023,3467,54,284,0,98,1,10,556
39085201700,6053,4714,166,710,4,115,7,13,1339
39085201800,3657,3350,68,68,6,29,0,6,307
39085201900,2698,2431,29,82,3,19,0,9,267
39085202000,5550,4963,126,139,9,65,1,16,587
39085202100,2180,1748,51,222,5,16,0,8,432
39085202400,2871,2631,45,14,1,26,0,9,240
39085202500,4260,3668,130,152,3,81,3,8,592
39085202600,3679,3322,95,50,5,18,0,7,357
39085202700,6399,5942,94,64,4,83,0,9,457
39085202800,5926,5396,110,96,9,90,0,18,530
39085202901,4795,4434,102,29,2,62,0,9,361
39085202902,1641,1514,25,27,3,10,0,2,127
39085203000,6477,5954,112,71,4,92,0,17,523
39085203200,3453,2972,100,141,3,103,0,13,481
39085203400,4363,3952,115,54,3,62,0,7,411
39085203500,6709,6151,134,80,2,127,0,12,558
39085203700,3215,2994,49,16,5,46,1,1,221
39085204000,3108,2753,123,89,3,17,2,11,355
39085204200,4332,1604,1820,612,5,12,2,24,2728
39085204303,2660,2062,141,208,0,105,0,28,598
39085204304,6572,3827,1317,970,15,80,3,20,2745
39085204400,3114,1724,936,268,4,11,0,27,1390
39085204500,3622,1711,1222,493,5,27,0,9,1911
39085204700,4705,3804,496,161,0,59,3,11,901
39085204800,5424,4767,292,95,1,24,0,10,657
39085204900,5728,5065,247,91,12,44,1,9,663
39085205001,5964,5432,114,99,1,99,0,30,532
39085205002,5851,5288,179,92,7,53,0,32,563
39085205100,7439,6943,132,42,0,128,0,16,496
39085205200,3128,2958,34,12,2,2,0,6,170
39085205300,2484,2283,64,21,0,16,0,5,201
39085205400,1601,1450,50,9,0,16,0,8,151
39085205701,4777,4180,257,41,6,48,0,3,597
39085205702,2668,2416,69,19,0,21,0,1,252
39085205800,1259,1155,41,0,3,7,0,2,104
39085206100,3436,3068,103,47,6,23,1,8,368
39085206200,1500,1285,85,35,3,10,0,3,215
39085206300,4777,4078,402,59,4,29,0,11,699
39085206400,4957,4647,86,25,2,47,0,15,310
39085206500,4008,3556,109,78,0,137,0,9,452
39085206600,4430,3922,75,149,13,35,0,1,508
39085206700,6352,5706,209,72,14,31,0,9,646
39085990000,0,0,0,0,0,0,0,0,0
39087050100,2522,2283,15,85,9,4,0,15,239
39087050200,2216,2036,24,48,6,11,0,8,180
39087050300,2168,1812,37,191,11,15,0,19,356
39087050400,3003,2815,20,54,1,15,0,5,188
39087050501,3002,2902,10,6,5,0,0,5,100
39087050502,3168,3030,42,4,5,3,0,4,138
39087050600,1227,1175,5,12,9,0,0,2,52
39087050700,3223,3080,40,19,4,1,0,1,143
39087050800,3528,3346,26,28,2,2,1,8,182
39087050900,2133,2003,12,12,4,3,1,6,130
39087051001,4542,4028,66,184,9,16,0,11,514
39087051002,4085,3860,26,53,12,5,0,3,225
39087051101,3685,3417,46,40,5,10,1,9,268
39087051102,2561,2200,50,189,3,2,0,4,361
39087051200,4861,4495,74,52,8,16,0,24,366
39087051300,3537,3325,36,38,5,19,2,2,212
39087051401,5293,4951,46,67,17,46,0,7,342
39087051402,3486,3258,43,18,19,51,2,2,228
39089750700,3306,2899,71,110,15,18,0,16,407
39089751000,2539,2242,36,98,4,12,0,11,297
39089751300,3593,3120,91,126,10,7,3,20,473
39089751600,3726,3276,93,98,0,51,1,9,450
39089751900,4419,3874,73,130,8,23,0,22,545
39089752200,4743,4171,72,117,14,25,0,22,572
39089752500,4151,3441,94,292,14,9,3,16,710
39089752801,4184,3784,65,82,6,45,3,13,400
39089752802,2843,2638,58,40,0,10,0,15,205
39089753100,5153,4526,120,159,11,29,7,12,627
39089753301,3362,2965,42,118,4,19,0,23,397
39089753302,4826,4277,106,83,23,104,0,3,549
39089753600,1969,1746,57,40,3,6,1,4,223
39089753900,5081,4665,106,89,6,44,4,8,416
39089754102,2538,2385,28,43,0,11,0,6,153
39089754103,2213,2028,28,38,0,30,1,5,185
39089754104,5691,5096,103,171,16,40,0,22,595
39089754400,6057,5726,57,21,18,16,8,13,331
39089754700,6500,6102,82,28,8,17,0,7,398
39089755000,6937,6413,83,37,7,33,0,39,524
39089755301,3626,3288,102,28,8,40,0,14,338
39089755302,4270,3852,160,20,11,32,2,10,418
39089755601,2621,2409,47,23,5,18,3,6,212
39089755602,2478,2261,92,6,4,4,0,3,217
39089755901,5178,3685,182,521,22,539,0,11,1493
39089755902,2647,1951,127,262,10,172,2,8,696
39089756201,2862,1736,149,705,11,86,0,27,1126
39089756203,3147,1310,97,1054,5,514,0,19,1837
39089756204,5877,2851,231,1135,16,1283,0,43,3026
39089756500,4961,4162,119,193,9,195,2,31,799
39089756801,3719,3029,91,211,15,151,0,9,690
39089756802,1830,1552,35,41,1,113,0,11,278
39089756803,4360,3758,96,135,9,178,0,9,602
39089757100,4216,3807,81,84,15,41,0,16,409
39089757401,5123,4084,165,212,8,402,1,17,1039
39089757402,2509,2089,54,122,1,126,0,14,420
39089757701,3171,2627,130,64,0,174,2,70,544
39089757702,4678,3813,202,97,7,262,0,97,865
39089758300,2518,2368,27,14,5,9,0,4,150
39089758601,2727,2511,43,22,5,7,0,1,216
39089758602,4583,4298,45,21,17,17,0,22,285
39089758901,3077,2926,20,12,4,10,0,7,151
39089758902,3278,3079,26,14,8,4,0,5,199
39089759000,3438,2922,81,182,7,6,1,9,516
39089759101,4665,4317,66,24,12,25,0,15,348
39089759102,3129,2876,55,20,4,42,1,23,253
39091003800,3827,3606,29,7,13,20,0,12,221
39091003900,4519,4226,66,19,1,23,0,17,293
39091004000,2590,2476,31,12,5,10,0,8,114
39091004100,2780,2560,45,6,3,14,1,14,220
39091004200,1787,1614,47,13,5,15,1,7,173
39091004300,5484,5205,43,17,2,15,1,17,279
39091004400,5542,4543,226,232,14,115,4,40,999
39091004500,4302,3640,141,163,9,32,2,22,662
39091004600,5440,4687,252,145,15,53,0,26,753
39091004700,5415,5050,83,26,16,13,1,5,365
39091004800,4464,4142,41,33,0,17,1,13,322
39093010200,4228,3835,154,41,4,28,6,17,393
39093010300,5570,4987,235,42,7,96,2,5,583
39093010400,4081,3425,207,119,8,151,6,12,656
39093013101,5392,4754,188,45,4,230,0,6,638
39093013102,5010,4534,151,29,3,152,0,8,476
39093013201,8214,7083,348,127,4,335,1,39,1131
39093013202,6231,4778,510,410,11,267,0,13,1453
39093021100,3207,2692,245,64,5,39,0,11,515
39093021200,5750,4863,419,107,12,46,0,11,887
39093022100,1889,1444,261,78,0,10,0,2,445
39093022200,2474,1525,493,263,5,12,2,20,949
39093022400,3889,1944,912,732,15,13,1,14,1945
39093022500,1633,1041,351,159,0,6,1,1,592
39093022601,2765,1485,648,460,7,11,0,15,1280
39093022800,4654,1241,1651,1430,4,12,0,13,3413
39093023000,5375,2918,1202,859,23,13,0,12,2457
39093023100,3240,652,1841,601,0,0,0,28,2588
39093023200,2905,954,1142,633,7,7,0,17,1951
39093023300,2359,784,872,530,6,3,0,7,1575
39093023400,2248,1289,590,273,0,4,1,5,959
39093023500,2304,1229,676,279,2,9,0,7,1075
39093023600,2813,969,1366,333,8,5,1,12,1844
39093023900,1459,782,406,188,7,4,0,4,677
39093024000,2114,1098,612,300,4,5,0,6,1016
39093024100,3096,1939,690,314,6,9,0,9,1157
39093024200,4418,2342,1168,639,9,42,0,16,2076
39093028100,4135,3460,239,145,4,118,0,17,675
39093030101,2783,2552,95,8,4,4,0,2,231
39093030102,4005,3639,152,23,3,10,2,10,366
39093050100,2829,2419,234,31,4,20,0,15,410
39093050200,3792,3262,257,38,4,71,0,3,530
39093050301,4746,4172,305,62,4,30,1,9,574
39093050302,3807,3375,243,38,6,23,1,7,432
39093050400,2225,1996,119,23,4,7,1,11,229
39093057100,3607,3259,123,68,9,3,0,2,348
39093060100,4260,2938,230,631,17,80,0,52,1322
39093060200,5116,3899,261,485,5,139,2,21,1217
39093070101,3556,2963,258,139,6,40,0,17,593
39093070102,5220,3800,383,564,10,65,0,36,1420
39093070200,2006,1536,184,141,4,15,0,11,470
39093070300,3336,2394,279,381,7,31,0,25,942
39093070400,4466,2658,380,1033,4,26,0,15,1808
39093070500,2852,1767,265,532,7,11,0,28,1085
39093070600,4393,3515,256,310,1,54,0,12,878
39093070700,2120,1647,136,148,0,20,0,0,473
39093070901,1874,734,432,558,9,2,0,10,1140
39093070902,3733,2614,292,576,8,23,4,9,1119
39093071100,4345,3493,259,292,8,25,0,13,852
39093071201,4314,3101,324,485,8,33,0,12,1213
39093071202,3990,3229,232,283,10,41,0,16,761
39093071300,4627,3680,309,280,14,19,0,17,947
39093071400,3122,1354,402,1082,5,2,2,13,1768
39093071500,1770,1482,93,113,12,6,0,7,288
39093077100,3501,3191,105,30,7,25,0,6,310
39093080101,2154,1939,73,13,6,19,1,4,215
39093080103,4295,3772,222,75,2,46,1,7,523
39093080104,3463,3042,174,38,7,24,0,2,421
39093080500,9133,7879,478,180,5,223,1,36,1254
39093080600,5450,4890,211,74,0,51,0,11,560
39093080701,5044,4448,196,114,4,101,4,25,596
39093080702,5741,5021,260,140,7,97,0,19,720
39093090100,3775,3423,148,12,9,39,0,24,352
39093090200,3636,3371,92,5,8,18,2,12,265
39093091100,3565,3116,163,70,1,42,0,27,449
39093091200,3986,3011,98,724,2,9,0,7,975
39093092100,2394,2190,90,12,7,5,0,0,204
39093093100,3052,2839,84,11,4,13,0,7,213
39093094101,4727,4330,132,23,9,16,0,11,397
39093094102,3677,3368,122,27,3,19,0,8,309
39093095100,7672,6291,238,850,17,17,3,11,1381
39093096100,6140,5615,177,70,15,13,0,12,525
39093097100,3008,2798,52,24,0,3,2,9,210
39093097201,4032,3012,519,263,0,57,0,4,1020
39093097202,5871,3805,1131,588,14,60,1,13,2066
39093097300,2903,977,964,774,2,5,0,11,1926
39093097401,5540,5055,142,36,2,124,0,14,485
39093097402,5787,5240,182,38,7,91,1,11,547
39093097500,6809,3250,2518,625,17,21,0,13,3559
39093097600,3262,2122,266,640,9,4,0,16,1140
39093990200,0,0,0,0,0,0,0,0,0
39095000201,2482,1394,230,683,9,8,2,19,1088
39095000202,1850,1092,204,401,6,14,0,10,758
39095000301,2629,1496,292,625,5,12,0,25,1133
39095000302,2475,1418,224,684,4,8,0,12,1057
39095000400,3720,2062,389,928,8,15,0,17,1658
39095000601,3441,1653,295,1202,9,17,0,17,1788
39095000602,984,484,86,331,2,4,0,7,500
39095000701,2058,937,201,718,10,5,0,16,1121
39095000702,2146,1064,223,721,3,6,0,12,1082
39095000703,776,360,52,304,2,5,0,12,416
39095000800,1278,137,51,1006,0,0,2,9,1141
39095000900,2014,606,207,1053,8,9,0,2,1408
39095001001,1459,366,153,860,3,4,0,2,1093
39095001002,1832,488,176,1060,0,0,0,1,1344
39095001100,2110,451,244,1280,7,7,0,7,1659
39095001201,2247,1554,215,332,6,10,0,9,693
39095001202,2825,987,246,1438,5,0,0,15,1838
39095001301,2692,2188,93,217,3,86,2,8,504
39095001302,2107,940,147,713,2,164,0,8,1167
39095001303,3128,1268,206,1416,7,44,5,15,1860
39095001400,1414,176,28,1074,5,8,0,30,1238
39095001500,1243,142,62,970,1,1,3,10,1101
39095001601,1623,282,80,1181,0,4,0,8,1341
39095001602,1163,377,47,660,3,6,0,12,786
39095001700,1162,260,208,619,4,3,0,0,902
39095001800,1988,538,390,936,0,6,0,11,1450
39095001900,1272,187,237,758,3,5,0,19,1085
39095002000,1507,897,252,216,8,16,0,1,610
39095002100,2682,1222,130,1160,9,11,1,8,1460
39095002401,3402,1242,180,1659,6,116,0,16,2160
39095002402,1394,82,35,1205,5,12,0,5,1312
39095002500,1450,67,42,1213,6,0,0,18,1383
39095002600,1047,48,46,904,0,0,1,4,999
39095002700,876,342,46,424,7,13,0,11,534
39095002800,1587,711,119,683,3,23,0,10,876
39095002900,1875,350,224,1166,7,3,0,6,1525
39095003000,1778,712,270,656,9,6,0,16,1066
39095003100,1009,105,20,823,7,2,0,12,904
39095003200,1034,34,48,902,2,0,0,12,1000
39095003300,1114,44,16,974,0,0,0,8,1070
39095003500,1108,58,26,954,3,1,0,3,1050
39095003600,1048,87,38,873,1,2,1,0,961
39095003901,2886,1528,401,714,9,11,0,30,1358
39095003902,1957,1035,266,513,3,1,2,12,922
39095004000,1746,688,368,567,6,0,0,11,1058
39095004200,1483,604,425,329,5,3,1,9,879
39095004401,1395,641,186,422,7,22,0,9,754
39095004402,1944,776,243,755,5,32,1,8,1168
39095004501,2526,1867,261,198,4,23,2,16,659
39095004503,2529,2045,198,163,4,12,0,7,484
39095004504,3413,2884,220,162,0,19,0,7,529
39095004600,2169,1355,369,303,6,6,1,26,814
39095004701,2974,1760,535,431,8,25,1,19,1214
39095004702,3502,1996,600,638,8,13,0,12,1506
39095004800,2585,1383,483,492,1,2,0,13,1202
39095004900,2632,1655,447,345,6,14,1,12,977
39095005000,1751,1188,299,131,1,8,0,1,563
39095005101,2669,1111,380,934,8,8,0,13,1558
39095005102,1349,747,301,185,4,6,0,7,602
39095005200,3110,2144,605,179,8,18,0,7,966
39095005300,1866,978,543,204,5,2,0,6,888
39095005400,2561,1194,613,519,12,4,0,6,1367
39095005501,2938,2554,186,35,8,7,0,15,384
39095005502,3045,2575,258,56,18,5,0,8,470
39095005503,2267,1954,138,81,0,7,0,3,313
39095005601,4312,3581,302,194,9,10,0,1,731
39095005602,947,705,117,33,1,5,0,7,242
39095005701,3415,2248,239,663,14,24,0,9,1167
39095005703,2524,1748,253,352,6,5,1,12,776
39095005704,2950,2180,204,378,6,4,0,15,770
39095005705,2000,1338,151,336,0,17,3,10,662
39095005801,3576,2568,278,453,14,33,2,9,1008
39095005803,2017,1653,132,74,0,15,0,16,364
39095005804,2838,2008,246,372,10,19,0,10,830
39095005901,2649,2243,147,72,0,11,1,16,406
39095005902,4356,3294,303,423,8,33,1,23,1062
39095006000,2398,1902,105,221,2,33,0,8,496
39095006100,3148,2482,219,229,4,23,0,10,666
39095006200,2423,1765,229,262,3,14,0,18,658
39095006300,3141,2064,296,543,6,27,0,10,1077
39095006400,2483,1905,151,268,2,11,0,12,578
39095006500,2232,1290,132,626,4,56,0,4,942
39095006600,2160,448,102,1411,5,29,0,6,1712
39095006700,2242,866,138,953,10,136,1,23,1376
39095006801,3007,1158,249,1313,6,38,0,29,1849
39095006802,2339,1031,121,868,3,207,0,12,1308
39095006900,2593,1999,188,273,8,24,0,8,594
39095007002,2020,1820,85,17,1,21,0,12,200
39095007003,1901,1640,107,36,0,19,2,8,261
39095007004,2077,1849,92,25,0,11,0,10,228
39095007102,3634,3252,172,28,5,29,0,22,382
39095007103,2763,2404,127,84,4,51,0,5,359
39095007104,1488,1196,74,111,1,35,0,3,292
39095007202,3655,2439,223,785,6,43,0,16,1216
39095007204,4542,2868,275,1009,6,98,0,27,1674
39095007206,2114,1595,137,254,3,29,4,18,519
39095007207,2047,1520,117,297,0,22,3,5,527
39095007208,2786,1555,148,829,2,102,0,10,1231
39095007209,2425,834,156,1265,10,19,0,11,1591
39095007302,3279,1370,188,1469,13,33,1,30,1909
39095007304,2650,1484,162,775,2,52,0,11,1166
39095007305,2271,1604,167,314,7,30,0,21,667
39095007306,3675,1249,219,1927,21,47,0,9,2426
39095007307,1318,403,56,756,3,11,0,14,915
39095007401,2574,1082,131,1138,5,94,0,5,1492
39095007402,3128,890,148,1879,11,34,1,11,2238
39095007501,1778,744,59,579,0,256,4,24,1034
39095007502,1899,1151,96,533,4,30,0,19,748
39095007600,4860,3838,155,157,3,472,0,37,1022
39095007700,3370,2701,167,330,4,69,0,18,669
39095007801,1955,1660,123,32,6,15,0,4,295
39095007802,1826,1372,104,245,7,21,0,5,454
39095007901,2162,1872,113,43,4,8,0,11,290
39095007903,3011,2410,165,188,10,25,0,18,601
39095007904,2557,2065,173,154,2,21,0,14,492
39095008000,4146,3551,188,187,5,51,0,16,595
39095008100,3801,3181,200,148,0,65,1,3,620
39095008204,2343,2117,96,40,4,23,1,4,226
39095008205,2358,2130,83,25,2,29,0,5,228
39095008206,3851,3413,112,48,4,143,0,5,438
39095008207,1861,1622,89,61,0,14,1,5,239
39095008208,2729,2172,96,145,0,205,2,6,557
39095008209,2944,2512,104,105,4,75,0,11,432
39095008210,1944,1607,109,112,4,29,1,1,337
39095008302,1654,1425,69,81,1,25,0,4,229
39095008303,3459,2758,141,319,5,77,0,8,701
39095008304,2834,2386,105,149,5,109,0,7,448
39095008401,2813,1970,116,515,4,62,0,11,843
39095008402,1930,1610,124,71,1,31,2,14,320
39095008501,2611,1637,123,641,2,37,0,6,974
39095008502,1474,1032,61,199,6,76,0,6,442
39095008601,2565,1575,163,662,4,18,0,13,990
39095008602,2502,1721,187,391,3,41,0,15,781
39095008701,3354,2209,221,657,4,51,8,6,1145
39095008702,2447,1548,239,448,9,8,0,10,899
39095008703,2371,1642,159,384,5,99,0,7,729
39095008801,3804,2958,277,299,0,85,0,21,846
39095008802,3645,2981,146,287,3,71,0,17,664
39095008903,4789,4353,171,26,7,26,0,25,436
39095008904,1562,1432,34,30,0,3,1,2,130
39095008905,4072,3756,130,31,4,35,0,5,316
39095008906,2592,2322,105,15,0,33,0,19,270
39095009001,4811,4241,151,90,2,138,2,13,570
39095009002,5627,4840,205,210,3,192,0,13,787
39095009003,4402,3928,158,75,1,96,0,13,474
39095009101,4546,3657,175,289,1,232,0,15,889
39095009103,2794,2195,165,227,2,95,0,4,599
39095009104,2792,2262,165,188,7,19,0,8,530
39095009203,3757,3007,136,120,5,319,0,20,750
39095009204,5995,5171,183,104,2,326,0,13,824
39095009205,4695,3740,152,346,2,291,0,28,955
39095009206,2955,2456,132,118,2,116,0,18,499
39095009300,1575,1501,31,4,3,2,1,0,74
39095009400,2472,1771,132,411,2,10,0,8,701
39095009500,2830,2498,139,38,7,6,0,8,332
39095009600,3378,3106,128,11,8,15,0,8,272
39095009700,2895,2591,176,9,0,8,0,21,304
39095009800,4468,3962,266,25,6,29,3,15,506
39095009901,3455,3031,169,88,2,34,3,17,424
39095009902,1096,947,79,13,0,4,2,9,149
39095010001,3871,3124,463,76,6,26,1,7,747
39095010002,3164,2517,368,101,1,38,1,10,647
39095010100,3985,3268,417,95,10,24,0,2,717
39095010200,3053,1966,231,674,12,17,0,9,1087
39095010300,1524,617,546,283,8,4,1,3,907
39095010400,4112,2722,470,675,30,126,31,11,1390
39095010500,2820,427,162,2017,21,10,1,22,2393
39095010600,1911,585,76,1121,3,16,2,13,1326
39095990000,0,0,0,0,0,0,0,0,0
39097040101,2334,1949,271,18,8,4,0,12,385
39097040102,5103,4702,93,24,7,46,0,31,401
39097040201,2902,2699,30,11,2,17,0,16,203
39097040202,2581,2315,117,16,5,10,0,1,266
39097040400,2666,2458,42,14,2,8,0,11,208
39097040500,4546,4218,98,37,1,25,0,13,328
39097040600,5660,4898,149,209,3,103,0,21,762
39097040700,3006,2437,100,265,5,12,1,16,569
39097041000,4828,2696,141,1953,14,8,0,0,2132
39097041100,4743,4361,58,100,1,11,3,27,382
39097041200,3272,3027,83,11,5,9,0,13,245
39097041300,2183,2001,81,6,6,0,0,15,182
39099800501,2116,238,619,1175,0,6,1,16,1878
39099800502,959,344,34,575,0,0,0,0,615
39099800600,1194,100,382,654,8,1,2,0,1094
39099801000,1467,446,258,666,1,1,4,20,1021
39099801100,2335,799,324,1090,9,4,0,9,1536
39099801200,1477,619,221,532,1,6,0,14,858
39099801300,2141,1274,198,500,1,11,4,7,867
39099801400,2104,1626,119,241,3,9,0,16,478
39099801500,1818,848,172,675,10,8,0,2,970
39099801600,2336,490,297,1345,4,1,0,8,1846
39099801700,928,256,145,464,11,2,4,5,672
39099802100,892,160,122,581,0,3,0,4,732
39099802300,787,33,92,603,7,5,0,2,754
39099802400,2531,366,214,1758,8,7,0,10,2165
39099802500,1312,278,83,880,1,4,0,6,1034
39099802600,1604,1070,100,310,3,5,1,10,534
39099802701,3232,2579,163,378,2,8,0,8,653
39099802702,2818,2190,169,338,2,5,0,12,628
39099802800,2665,1738,201,542,5,8,5,20,927
39099802900,2233,1215,223,644,4,6,2,15,1018
39099803000,1875,1124,164,451,0,0,0,6,751
39099804000,2080,1151,118,647,11,50,0,12,929
39099804100,1300,392,106,728,3,10,0,8,908
39099804200,1934,657,118,1009,7,45,0,4,1277
39099804300,900,292,101,443,6,4,0,7,608
39099810100,4213,2640,772,609,10,8,0,12,1573
39099810200,1974,868,517,478,2,7,0,4,1106
39099810300,1665,473,446,659,0,0,2,3,1192
39099810600,2784,2076,267,194,5,15,4,16,708
39099810700,5233,4639,230,139,6,29,1,3,594
39099810800,2046,1742,89,121,4,6,0,1,304
39099810900,2021,1800,103,57,7,0,0,5,221
39099811001,4002,3725,147,9,7,19,1,1,277
39099811002,7506,7031,217,29,3,76,0,10,475
39099811100,996,906,31,4,3,0,0,3,90
39099811200,2393,2262,49,12,0,14,0,4,131
39099811301,4199,3222,272,452,11,30,0,12,977
39099811302,2139,1736,120,173,0,38,1,1,403
39099811400,3218,2030,229,707,1,64,0,20,1188
39099811500,5824,4988,254,278,4,84,2,6,836
39099811600,3479,2909,169,207,4,68,0,10,570
39099811700,2622,2166,107,183,4,44,2,6,456
39099811800,1647,1284,88,160,3,30,1,12,363
39099811901,4289,3632,194,269,0,38,0,13,657
39099811902,3292,2928,110,61,5,123,4,4,364
39099812001,5622,4733,273,266,5,137,1,15,889
39099812002,3882,3382,99,170,5,76,0,8,500
39099812101,6143,5446,162,139,4,248,0,20,697
39099812102,4231,3922,92,11,5,51,0,17,309
39099812200,6570,5966,186,45,0,163,0,14,604
39099812301,3888,3117,144,432,0,12,3,12,771
39099812302,6482,5308,271,578,4,25,0,15,1174
39099812400,2742,2194,125,258,9,8,0,2,548
39099812500,4952,4459,135,149,6,29,1,6,493
39099812601,4745,3421,269,780,15,62,1,11,1324
39099812602,5222,4429,202,330,6,23,0,19,793
39099812604,4884,4335,121,204,2,30,5,25,549
39099812605,3134,2902,73,71,0,4,4,1,232
39099812700,2124,2020,32,6,2,5,0,7,104
39099812800,3565,3321,47,15,5,14,0,0,244
39099812900,4101,3888,65,3,0,3,0,4,213
39099813000,4117,3829,59,26,2,7,0,12,288
39099813200,4171,4003,37,12,4,9,1,5,168
39099813300,3101,2902,47,7,11,15,0,19,199
39099813400,3420,3236,59,17,1,15,1,7,184
39099813501,3537,3312,37,67,5,14,0,6,225
39099813502,4058,3835,61,10,1,24,0,5,223
39099813601,5839,5450,136,38,6,23,0,6,389
39099813602,2468,2312,52,9,6,5,0,9,156
39099813700,3506,971,879,1541,6,5,0,13,2535
39099813800,3024,613,436,1852,3,17,0,8,2411
39099813900,1571,155,185,1146,0,3,1,6,1416
39099814000,2910,923,278,1525,13,19,0,44,1987
39099814100,2303,1117,228,814,13,0,0,11,1186
39099814200,1722,247,149,1219,7,4,0,14,1475
39101000100,1153,971,48,56,4,3,1,1,182
39101000200,2958,2432,132,210,5,0,0,10,526
39101000300,2118,1887,60,59,6,6,0,5,231
39101000400,3674,3250,130,85,5,9,0,6,424
39101000501,2644,2203,111,134,26,9,2,5,441
39101000502,2600,2242,83,135,11,5,1,7,358
39101000600,4648,4166,117,136,9,75,1,2,482
39101000700,2675,2326,82,104,2,5,1,19,349
39101000800,2400,2061,70,144,4,10,0,4,339
39101000900,4254,3420,219,335,14,18,1,12,834
39101001000,3155,2824,101,77,8,44,0,12,331
39101001100,2403,2047,79,125,1,8,0,10,356
39101010100,5294,4825,106,73,5,50,5,22,469
39101010201,5222,4827,88,54,10,12,0,10,395
39101010202,4975,2512,220,2209,9,13,1,3,2463
39101010300,4902,4586,134,13,14,3,0,9,316
39101010400,4949,4492,129,92,7,60,0,12,457
39101010500,5335,5043,47,10,0,28,2,18,292
39103400100,8025,7489,147,33,6,114,0,23,536
39103402000,5750,5417,94,21,0,36,0,14,333
39103403001,3215,3015,63,13,1,1,0,8,200
39103403002,3450,3178,76,21,5,24,0,6,272
39103404000,4338,3977,97,15,5,97,1,20,361
39103405000,4556,4196,81,17,3,59,0,23,360
39103406000,7046,6509,132,31,3,106,2,9,537
39103407000,7621,6947,166,71,9,108,1,32,674
39103408001,2741,2401,85,115,5,20,1,11,340
39103408002,1953,1793,42,21,1,28,0,13,160
39103408003,3190,2761,190,38,3,60,0,17,429
39103408101,3625,2915,157,305,10,23,0,22,710
39103408102,4024,3612,122,66,5,51,0,13,412
39103408201,4534,3938,140,154,4,41,4,20,596
39103408202,5646,5029,150,142,7,54,0,20,617
39103408301,3568,3149,118,50,0,131,0,13,419
39103408303,3528,3197,74,79,2,10,0,25,331
39103408304,3666,3308,87,41,0,40,1,20,358
39103408305,2894,2604,73,49,2,38,1,12,290
39103409001,2213,2074,29,2,1,4,0,5,139
39103409002,4591,4211,122,22,0,23,0,17,380
39103410000,4102,3903,68,17,8,0,0,1,199
39103411001,1606,1483,25,2,3,10,0,5,123
39103411002,2857,2645,46,22,2,26,0,1,212
39103412000,4271,3991,59,21,9,14,3,8,280
39103413000,5527,5212,83,14,7,29,0,12,315
39103415100,5169,4627,175,56,4,133,2,17,542
39103415200,4042,3705,124,18,0,35,0,17,337
39103415300,4749,4233,163,55,4,64,0,16,516
39103415400,4411,3950,157,64,10,45,0,3,461
39103415801,5433,4760,210,65,10,131,0,9,673
39103415802,2152,1971,55,10,3,36,0,9,181
39103416000,5464,4920,158,84,0,79,0,20,544
39103416100,4719,4309,107,35,7,57,1,23,410
39103416200,4534,3946,163,110,4,80,0,48,588
39103416300,2626,2354,92,64,0,31,0,0,272
39103416400,3323,2909,121,65,4,72,0,8,414
39103417001,4509,4116,89,43,11,30,0,6,393
39103417002,4076,3735,86,16,5,62,0,3,341
39103417100,6972,6404,125,92,2,85,6,19,568
39103417200,7159,6552,133,72,17,63,5,17,607
39103417300,4595,4198,108,61,10,34,0,4,397
39105964100,4064,3919,19,14,4,4,0,11,145
39105964200,4418,4241,25,18,10,6,0,14,177
39105964300,4517,4305,39,14,13,1,0,9,212
39105964400,3087,2877,25,74,12,1,0,5,210
39105964500,2793,2644,31,20,4,5,0,3,149
39105964600,3331,3194,33,8,6,5,0,1,137
39107967200,3662,3412,75,8,7,8,46,7,250
39107967300,4383,4205,68,8,0,4,6,13,178
39107967400,4857,4239,169,63,9,25,189,15,618
39107967500,5650,5149,155,34,9,78,102,10,501
39107967600,2929,2497,119,37,8,34,119,6,432
39107967700,6453,6129,119,19,18,9,76,8,324
39107967800,2185,2100,35,3,2,5,1,2,85
39107967900,7333,7131,100,10,1,10,21,13,202
39107968000,5076,4890,88,9,9,16,4,4,186
39109300100,4751,4219,127,113,4,37,4,8,532
39109315001,4148,3818,67,58,2,32,0,21,330
39109315002,4403,3922,89,104,7,36,2,38,481
39109315100,5763,4897,114,281,6,34,2,28,866
39109315300,4936,4271,125,190,6,11,0,16,665
39109320100,3597,3439,21,14,11,6,0,19,158
39109325000,2798,2621,35,17,2,7,0,15,177
39109330100,3516,3306,46,23,5,8,2,33,210
39109340100,4713,4516,48,16,4,11,0,21,197
39109345000,4893,4562,48,25,13,15,0,11,331
39109350101,5050,4695,66,21,10,57,0,28,355
39109350102,3376,3049,65,32,6,61,0,26,327
39109355001,6051,5513,168,73,6,62,1,6,538
39109355002,1637,1500,39,12,2,8,0,11,137
39109365001,3715,2934,84,176,2,344,1,16,781
39109365002,5352,4565,156,216,11,147,1,13,787
39109365101,4049,3660,71,101,5,37,0,6,389
39109365102,5064,4502,102,149,1,28,3,23,562
39109365200,3586,3105,95,101,10,18,0,17,481
39109365301,6066,5011,186,335,13,181,0,39,1055
39109365302,6024,5417,110,72,4,169,0,22,607
39109380100,10409,8798,292,420,15,328,3,47,1611
39109390100,4877,4644,45,10,7,7,2,19,233
39111966600,3156,3062,7,6,0,0,0,0,94
39111966700,3587,3480,12,2,0,6,2,3,107
39111966800,3726,3542,33,9,6,15,0,11,184
39111966900,2916,2825,15,2,6,0,1,5,91
39113000100,3005,275,75,2556,7,4,0,14,2730
39113000200,2175,237,32,1785,10,0,0,9,1938
39113000300,2076,139,35,1805,0,0,0,11,1937
39113000400,3783,273,114,3197,10,4,4,33,3510
39113000500,4088,720,86,3042,7,12,0,35,3368
39113000600,1678,163,32,1401,6,5,1,9,1515
39113000700,2071,174,62,1698,1,5,0,10,1897
39113000801,3935,735,155,2818,7,14,0,35,3200
39113000802,2130,366,78,1516,6,15,0,13,1764
39113000900,2870,762,84,1777,11,13,4,18,2108
39113001000,1358,190,34,1042,0,5,0,13,1168
39113001100,4124,1058,150,2590,1,13,4,37,3066
39113001200,1021,303,26,597,5,6,0,13,718
39113001501,4179,2600,154,1093,10,130,0,23,1579
39113001600,1874,1310,74,341,0,2,0,18,564
39113001700,775,511,59,160,4,2,0,4,264
39113001801,2449,1198,185,878,9,8,0,10,1251
39113001802,3741,2466,557,397,9,73,1,37,1275
39113001900,4079,2735,501,546,6,41,1,21,1344
39113002000,2920,1638,507,607,7,12,0,28,1282
39113002200,2988,1534,479,712,20,11,1,11,1454
39113002300,2949,1853,518,374,8,20,2,27,1096
39113002400,2712,1835,433,269,6,15,3,7,877
39113002500,5485,3781,554,724,20,49,0,25,1704
39113002600,5807,4329,459,477,10,117,6,52,1478
39113002700,1997,1673,51,108,6,26,1,11,324
39113002800,2246,1909,99,83,7,25,0,8,337
39113002900,4030,3481,130,144,9,24,3,19,549
39113003000,2827,2250,156,204,9,24,5,13,577
39113003100,2791,2294,60,231,8,37,0,13,497
39113003201,3823,2578,149,517,5,353,2,23,1245
39113003300,5076,3533,487,556,6,138,2,34,1543
39113003402,3683,3094,159,193,3,107,2,8,589
39113003403,3325,2814,149,181,3,64,5,4,511
39113003404,1987,1477,120,214,6,27,0,17,510
39113003500,1935,108,38,1691,9,0,0,10,1827
39113003800,2481,112,36,2206,3,5,0,17,2369
39113003900,1952,61,21,1774,4,3,0,23,1891
39113004100,2079,55,43,1914,13,2,0,6,2024
39113004200,1996,105,34,1778,0,3,0,8,1891
39113004300,1959,110,30,1705,8,0,5,18,1849
39113004400,2120,98,48,1885,2,2,0,13,2022
39113004600,1464,377,156,862,2,3,0,6,1087
39113010100,2218,1931,73,24,0,62,0,22,287
39113010200,7354,6335,291,86,8,259,2,26,1019
39113020100,2944,2423,93,185,1,65,3,14,521
39113020200,3000,2519,107,157,2,27,0,9,481
39113020300,2653,2369,72,75,1,37,0,7,284
39113020400,6814,5360,393,475,13,248,1,16,1454
39113020500,1532,1255,42,127,0,22,0,2,277
39113020601,1889,1646,68,60,3,21,5,9,243
39113020602,1689,1542,28,27,0,21,0,9,147
39113020700,3167,2708,109,76,3,90,0,12,459
39113020800,2466,2174,77,65,4,38,3,11,292
39113020900,2713,2244,86,162,1,37,3,9,469
39113021000,1802,1512,80,77,1,12,0,9,290
39113021100,3247,2569,122,268,12,96,3,8,678
39113021200,1778,1456,45,79,0,85,1,18,322
39113021301,2862,2488,101,45,1,11,4,18,374
39113021302,2067,1726,102,56,1,39,6,4,341
39113021400,2581,2188,113,37,1,64,1,15,393
39113021501,2981,2414,104,193,11,46,14,22,567
39113021502,1656,1321,51,160,6,18,1,1,335
39113021601,2082,1763,72,109,8,23,0,11,319
39113021602,3640,3156,121,112,12,77,0,18,484
39113021700,2534,2021,85,215,0,62,0,7,513
39113021800,2286,1522,62,415,1,85,0,20,764
39113021900,2261,1895,88,125,0,34,0,10,366
39113030100,4704,3176,326,735,10,181,2,21,1528
39113030200,2536,1939,115,313,10,19,2,14,597
39113040101,1925,1705,53,29,1,33,4,15,220
39113040102,2215,1915,62,50,3,90,1,3,300
39113040103,2966,2419,283,54,4,130,3,12,547
39113040201,2927,2594,63,55,3,82,0,11,333
39113040203,2646,2184,109,131,3,135,0,20,462
39113040204,4726,3889,178,282,2,148,0,12,837
39113040302,5595,4413,181,606,8,113,3,27,1182
39113040303,5526,4824,185,145,3,141,0,3,702
39113040305,3571,2740,93,127,10,388,1,10,831
39113040306,5709,4721,157,246,7,300,0,29,988
39113040401,5327,4282,178,400,10,223,0,35,1045
39113040403,4201,3298,159,231,1,314,0,12,903
39113040405,6334,4396,296,513,10,785,1,30,1938
39113040406,7996,5952,182,335,18,1192,0,18,2044
39113050101,4338,3183,239,541,8,154,0,18,1155
39113050104,2510,2032,77,173,8,76,3,11,478
39113050105,4936,3627,227,654,7,204,1,19,1309
39113050106,6119,4623,259,525,15,377,4,27,1496
39113050107,3384,2048,152,489,8,512,0,11,1336
39113050301,3407,2878,169,163,9,35,1,5,529
39113050302,5273,4549,188,252,5,56,1,10,724
39113050303,3950,2471,282,834,5,112,5,25,1479
39113050401,5184,4515,129,223,11,61,0,23,669
39113050402,2012,1812,57,43,2,0,1,3,200
39113050502,2864,2451,53,71,2,101,3,16,413
39113050503,6384,5652,141,233,3,58,1,17,732
39113050504,6581,5152,350,607,10,139,3,31,1429
39113050600,5362,4785,120,195,5,15,4,16,577
39113060100,1236,533,50,574,0,2,1,8,703
39113060200,1434,714,85,540,2,2,1,9,720
39113060300,3718,827,112,2625,5,13,0,27,2891
39113070101,3687,1564,77,1851,7,20,1,18,2123
39113070102,3433,687,68,2532,4,16,5,18,2746
39113070201,1415,717,39,559,0,4,0,9,698
39113070202,1813,215,32,1487,0,1,0,7,1598
39113070300,2748,521,47,2034,5,5,2,12,2227
39113070400,2617,617,48,1798,10,9,1,16,2000
39113070500,4091,537,77,3260,0,15,1,20,3554
39113070600,1184,124,23,974,0,5,0,9,1060
39113070700,3189,485,47,2512,1,7,0,14,2704
39113080100,5864,1369,151,4006,14,26,6,41,4495
39113080200,2716,1392,66,1095,9,17,3,16,1324
39113080300,2206,452,52,1599,1,7,0,17,1754
39113080400,3152,1004,84,1882,6,10,2,29,2148
39113080500,6237,3707,213,1808,14,75,6,50,2530
39113080600,1205,1061,31,48,1,4,0,7,144
39113080700,2051,1857,58,34,5,8,0,1,194
39113090302,6336,4533,218,702,16,384,2,35,1803
39113090303,3687,2361,201,633,3,244,0,27,1326
39113090304,6593,4784,296,798,14,207,3,37,1809
39113090600,3149,2453,125,282,15,43,1,14,696
39113090700,1438,1141,132,56,4,19,2,1,297
39113090800,1308,1107,40,49,6,14,0,4,201
39113090900,3544,3062,90,156,4,60,2,4,482
39113091000,2635,2203,104,119,8,36,0,11,432
39113091100,2682,1560,353,380,12,114,4,11,1122
39113100101,6390,4174,250,1347,6,181,2,40,2216
39113100102,5903,4059,188,1104,6,178,3,31,1844
39113100201,4736,3110,213,905,12,110,8,21,1626
39113100202,2524,1676,67,494,10,88,1,19,848
39113100203,4660,3353,171,693,22,89,3,21,1307
39113100301,4347,3156,237,529,9,125,1,31,1191
39113100302,3308,2400,171,404,8,89,0,17,908
39113100400,5268,3884,189,667,5,139,12,44,1384
39113110100,1575,1422,41,39,3,7,0,0,153
39113110201,4682,4009,71,226,4,135,0,32,673
39113110202,3335,2281,94,680,2,72,3,11,1054
39113115002,3994,3559,57,153,7,29,4,11,435
39113115011,5587,4768,140,296,8,68,0,7,819
39113115012,5339,4279,108,535,12,128,0,10,1060
39113120101,5187,3660,109,1033,2,77,0,31,1527
39113120102,4728,2956,104,1254,9,117,0,8,1772
39113120103,3272,2012,67,973,4,25,0,33,1260
39113125000,6472,5592,153,318,13,61,0,12,880
39113125102,6317,4721,148,983,11,94,0,42,1596
39113125103,2750,2092,24,449,0,62,1,6,658
39113125104,4319,3177,64,767,6,96,0,21,1142
39113130101,2335,2114,98,20,3,2,0,2,221
39113130102,6564,6131,83,48,9,74,4,14,433
39113140100,5848,5462,56,51,11,28,3,14,386
39113150100,6076,5682,58,24,3,20,0,30,394
39113160100,1947,1855,18,11,4,6,0,7,92
39113165000,6800,6311,118,112,2,30,1,14,489
39113165100,2597,200,49,2195,6,14,9,2,2397
39113165200,1614,638,57,802,0,31,3,10,976
39113980000,0,0,0,0,0,0,0,0,0
39115968800,3028,2834,22,21,3,6,1,14,194
39115968900,3685,3336,37,101,4,9,0,10,349
39115969000,3909,3664,43,55,5,4,0,13,245
39115969100,3180,2691,25,219,8,5,1,12,489
39117965000,4270,4034,55,16,5,16,1,9,236
39117965100,4910,4674,48,29,7,3,0,11,236
39117965201,4955,4537,153,35,10,16,7,14,418
39117965202,1903,1774,15,10,3,9,0,0,129
39117965300,6281,5906,90,24,12,1,0,10,375
39117965401,2444,2297,24,7,5,11,0,24,147
39117965402,3626,3422,59,6,0,14,0,16,204
39117965501,3459,3245,60,18,10,9,0,7,214
39117965502,3102,2884,76,8,4,11,0,2,218
39119911000,4785,4567,34,36,5,7,0,12,218
39119911100,6350,5822,73,61,9,39,1,20,528
39119911201,2763,2574,29,9,13,9,0,11,189
39119911202,4106,3813,45,57,7,27,0,12,293
39119911300,5881,5485,57,58,5,9,0,17,396
39119911400,3498,2665,49,378,5,1,0,30,833
39119911500,5060,4410,83,216,2,34,0,8,650
39119911601,2439,2209,18,64,4,32,0,7,230
39119911602,4198,3761,55,134,3,74,0,13,437
39119911700,3359,2902,28,202,4,22,0,21,457
39119911800,3152,2496,57,279,9,16,0,35,656
39119911900,2851,2433,47,133,17,5,1,14,418
39119912000,3143,2676,56,172,3,8,0,21,467
39119912100,3475,2522,68,445,11,6,2,46,953
39119912200,3436,2587,74,346,17,2,0,39,849
39119912300,4157,3822,28,97,2,8,0,13,335
39119912400,4276,3999,31,55,9,9,0,9,277
39119912500,4557,4304,32,23,9,2,3,14,253
39119912600,3283,3129,16,21,0,14,0,6,154
39119912700,5543,5109,64,126,2,18,1,20,434
39119912800,6098,5662,111,73,2,42,0,10,436
39121968300,3960,3838,22,4,9,3,0,0,122
39121968401,4201,4022,35,5,13,14,0,3,179
39121968402,2990,2106,99,743,8,4,0,3,884
39121968500,2964,2874,17,0,1,1,0,5,90
39123050100,813,780,6,4,0,1,0,5,33
39123050201,2024,1918,30,10,1,17,0,6,106
39123050202,1687,1623,30,4,2,7,0,3,64
39123050301,2761,2603,80,13,4,8,0,0,158
39123050302,2163,2053,54,7,3,10,0,3,110
39123050500,2997,2541,203,88,2,19,0,6,456
39123050600,3179,2531,362,99,4,15,2,8,648
39123050700,3462,3138,192,13,0,1,0,9,324
39123050800,3966,3689,134,16,3,12,3,10,277
39123050900,5359,4845,274,19,11,14,1,13,514
39123051000,4825,4260,336,13,4,24,0,19,565
39123051100,3773,3437,168,17,8,15,0,8,336
39123051201,1109,982,82,12,0,8,0,0,127
39123051202,1729,1574,82,17,5,2,0,2,155
39123051203,517,462,26,3,0,4,0,0,55
39125960100,2997,2724,169,21,7,7,0,3,273
39125960200,4206,3836,164,21,4,5,3,10,370
39125960300,4049,3734,168,31,11,4,0,9,315
39125960400,4043,3411,378,62,8,9,2,29,632
39125960500,3511,3267,131,4,11,5,0,10,244
39127965801,3793,3568,25,10,11,10,0,20,225
39127965802,3928,3738,28,10,10,3,0,11,190
39127965901,3394,3252,25,3,2,6,0,10,142
39127965902,3523,3371,31,14,6,10,0,3,152
39127966000,4944,4683,25,13,18,3,0,11,261
39127966100,4280,4097,29,7,11,0,0,14,183
39127966200,5772,5433,54,23,15,18,0,5,339
39127966301,3178,3012,20,5,18,14,0,7,166
39127966302,2596,2441,15,5,3,3,0,4,155
39129020100,1864,1660,32,63,3,5,3,6,204
39129020200,2525,2258,75,47,8,6,0,10,267
39129020310,4860,4382,59,79,14,40,0,9,478
39129020320,3857,3497,59,122,9,22,0,7,360
39129020400,2787,2525,61,48,4,31,0,6,262
39129021101,4674,4418,48,17,7,9,0,8,256
39129021102,3556,3305,44,44,5,16,2,19,251
39129021201,5041,4579,84,81,8,21,0,5,462
39129021202,3233,2945,59,22,11,14,2,8,288
39129021300,3494,2043,51,1391,8,0,1,0,1451
39129021401,3213,2949,45,20,5,18,0,15,264
39129021403,6330,5606,153,136,15,85,2,15,724
39129021404,1888,1775,13,1,1,6,0,13,113
39129021500,3161,2964,31,17,9,8,0,11,197
39129021600,3293,3037,49,26,8,3,0,4,256
39129021700,4763,4473,40,29,16,12,1,17,290
39131952200,5324,4955,30,64,19,6,0,17,369
39131952300,5151,4840,57,40,26,5,0,6,311
39131952400,3265,3044,37,39,7,28,4,3,221
39131952500,3572,3334,28,18,19,7,2,5,238
39131952601,3489,3308,17,10,11,12,0,0,181
39131952602,2153,2050,20,6,8,5,0,6,103
39131952700,4134,3939,30,13,20,7,0,7,195
39133600102,3392,2986,84,162,1,14,0,27,406
39133600103,5550,5184,45,26,0,21,1,23,366
39133600200,5577,5170,91,31,2,16,0,26,407
39133600302,7383,6694,152,128,3,203,4,8,689
39133600303,5444,4487,119,282,3,317,2,39,957
39133600304,4412,3848,121,118,2,155,0,8,564
39133600401,6887,5174,216,911,4,279,6,42,1713
39133600402,5505,4579,137,353,9,191,3,9,926
39133600403,5085,4223,132,343,3,80,3,21,862
39133600500,5245,4819,70,109,6,16,0,8,426
39133600602,2649,2471,40,15,5,10,0,5,178
39133600603,3450,3048,59,126,8,8,0,9,402
39133600703,1735,1564,34,11,5,3,0,8,171
39133600704,1648,1535,20,4,5,5,3,10,113
39133600705,2351,2222,24,22,0,3,0,5,129
39133600706,2780,2618,35,5,8,15,0,5,162
39133600800,3235,2756,68,186,16,26,0,25,479
39133600901,3859,3062,98,396,14,12,0,10,797
39133600902,5694,4681,99,534,12,19,0,28,1013
39133601000,2459,1902,47,316,10,15,0,13,557
39133601100,5056,4646,94,54,5,9,2,11,410
39133601200,4536,3480,150,383,4,226,0,10,1056
39133601300,6318,5018,146,644,16,128,0,27,1300
39133601400,4269,3316,138,412,6,93,0,11,953
39133601501,2122,1697,109,105,0,90,0,1,425
39133601502,7391,5189,303,999,44,549,6,15,2202
39133601503,4839,3796,163,347,5,297,3,31,1043
39133601600,4069,3605,61,43,3,113,3,28,464
39133601702,5779,5148,95,187,0,58,2,19,631
39133601703,3561,2868,113,233,6,154,0,8,693
39133601704,3246,2738,65,221,2,46,0,7,508
39133601801,4060,3650,74,105,2,34,0,4,410
39133601802,4542,4061,52,75,6,150,0,18,481
39133601901,2564,2379,29,8,5,12,0,0,185
39133601902,2838,2623,59,16,0,5,0,8,215
39133602000,5276,4942,80,10,9,16,0,16,334
39133602101,3723,3528,45,8,2,4,0,11,195
39133602102,3262,3067,38,6,2,8,0,4,195
39135400100,3226,3010,60,22,9,10,0,11,216
39135410100,2084,1970,24,3,4,15,2,6,114
39135420100,4305,4106,29,10,3,17,0,7,199
39135430100,2669,2541,26,9,9,0,2,8,128
39135440100,3730,3542,21,10,8,10,0,16,188
39135450100,2161,2051,11,16,9,20,0,9,110
39135455001,2273,2109,22,16,6,5,0,14,164
39135455002,5750,5293,80,46,8,55,0,11,457
39135460100,2840,2701,20,15,8,11,0,2,139
39135470101,3573,3350,41,18,5,9,0,4,223
39135470102,4167,3994,27,8,8,3,0,7,173
39135480100,4221,4033,25,9,7,7,0,3,188
39137030100,4496,3406,979,16,6,8,0,16,1090
39137030200,5619,5307,167,14,3,5,0,2,312
39137030301,3592,3080,402,23,2,14,0,6,512
39137030302,4442,4031,291,20,3,16,0,6,411
39137030400,3466,3269,115,9,5,1,0,7,197
39137030500,3794,3549,159,6,2,3,1,7,245
39137030600,4126,3983,69,5,2,8,0,16,143
39137030700,4916,4802,47,7,2,6,2,1,114
39139000400,2549,1844,82,415,0,14,0,17,705
39139000500,3706,2423,129,786,16,8,3,38,1283
39139000600,3056,1656,105,974,16,6,4,19,1400
39139000700,2776,1247,72,1208,4,11,3,23,1529
39139000800,2584,2007,42,295,12,20,0,20,577
39139000900,4665,4145,91,141,14,10,1,12,520
39139001000,5630,4192,149,878,8,30,7,35,1438
39139001100,2699,2218,77,301,2,9,0,5,481
39139001200,3880,3233,74,357,0,22,3,21,647
39139001300,3159,2457,82,403,9,16,0,11,702
39139001400,2298,1666,78,376,2,22,1,17,632
39139001500,1904,1737,29,38,6,11,0,3,167
39139001600,1712,1478,46,96,0,1,3,8,234
39139001700,5017,2185,183,2620,15,9,0,2,2832
39139001800,3710,3321,54,149,3,11,3,18,389
39139001900,6106,5467,108,210,2,24,2,15,639
39139002000,5730,5380,52,35,10,15,3,22,350
39139002101,5444,4674,105,325,11,104,7,14,770
39139002102,4822,4348,94,122,4,54,3,12,474
39139002200,7119,6533,116,101,10,61,4,18,586
39139002300,6351,5757,110,166,10,57,0,31,594
39139002400,5891,5002,150,237,6,186,0,25,889
39139002500,4354,4087,92,19,10,8,2,3,267
39139002600,4652,4336,105,28,3,16,1,9,316
39139002700,5583,5281,93,68,0,28,0,3,302
39139002800,3580,3378,74,11,1,8,0,13,202
39139002900,4356,4169,57,18,4,7,3,5,187
39139003001,5357,5063,55,22,4,9,3,14,294
39139003002,3997,3771,39,17,5,10,2,18,226
39139003100,2249,1176,72,800,5,4,0,22,1073
39141955500,6158,5839,39,35,7,27,1,7,319
39141955603,4046,3728,34,48,15,7,1,13,318
39141955604,6967,4670,159,1999,7,18,0,2,2297
39141955700,5647,5285,44,57,11,3,1,15,362
39141955801,4322,3936,73,87,14,17,0,11,386
39141955802,3893,3449,64,109,15,20,3,14,444
39141955900,4288,3664,54,220,7,60,1,12,624
39141956000,5550,4805,82,301,12,59,2,16,745
39141956100,3535,2913,72,291,15,13,0,21,622
39141956200,2305,1959,36,148,8,13,1,7,346
39141956300,3078,2609,56,143,19,60,0,13,469
39141956400,3354,2865,50,171,9,9,4,14,489
39141956500,3806,3207,72,244,11,2,0,10,599
39141956600,5136,4788,60,21,4,30,0,7,348
39141956700,4796,4467,40,55,9,3,2,6,329
39141956800,5896,5500,68,46,10,18,2,13,396
39141956900,4316,4021,28,30,16,10,2,15,295
39143960800,3397,2893,325,56,4,16,0,5,504
39143960900,3292,2937,204,28,3,16,0,4,355
39143961000,4043,3555,320,8,3,12,0,13,488
39143961100,3866,3427,317,10,4,4,0,1,439
39143961200,3844,3512,181,10,4,8,0,9,332
39143961300,4421,3562,472,173,6,26,0,8,859
39143961400,2595,1761,419,198,4,12,0,19,834
39143961500,3987,2610,735,364,5,14,3,20,1377
39143961600,3030,2115,519,234,5,16,1,12,915
39143961700,3229,2132,662,236,6,8,1,11,1097
39143961800,4286,2990,671,343,3,14,0,12,1296
39143961900,3288,2833,289,32,1,6,1,6,455
39143962000,6306,5444,530,41,7,21,1,18,862
39143962100,5010,4612,181,11,8,12,0,10,398
39143962200,4302,3836,230,18,12,17,0,11,466
39145002100,4789,4496,44,7,13,12,1,10,293
39145002200,4513,3583,42,746,14,8,1,7,930
39145002300,4763,4524,25,12,22,10,1,20,239
39145002400,5225,4931,53,14,21,10,0,11,294
39145002500,2843,2696,18,4,7,8,0,4,147
39145002600,3822,3603,32,10,21,6,0,12,219
39145002700,4869,4638,43,3,7,15,0,3,231
39145002800,4443,4113,40,123,19,12,0,2,330
39145002901,3675,3413,58,27,7,18,2,3,262
39145002902,2545,2376,50,16,6,14,0,1,169
39145003000,3504,3279,62,20,5,6,2,12,225
39145003100,3053,2844,47,36,9,6,0,6,209
39145003200,1734,1576,32,48,8,0,1,4,158
39145003300,2243,1967,31,135,3,8,0,13,276
39145003400,3528,3045,116,129,12,20,0,17,483
39145003500,2087,1820,52,78,9,5,0,7,267
39145003600,2368,1954,95,172,27,18,0,25,414
39145003700,2557,1927,61,368,12,32,1,23,630
39145003800,4423,4107,62,78,5,51,0,15,316
39145003900,2996,2819,54,6,15,2,0,9,177
39145004000,4028,3820,35,6,12,13,0,6,208
39147962500,3724,3505,74,11,4,7,3,9,219
39147962600,3867,3554,169,4,3,3,1,10,313
39147962700,3439,3101,198,18,8,15,0,7,338
39147962800,3444,2525,531,161,3,16,0,12,919
39147962900,3890,2838,485,277,9,16,3,26,1052
39147963000,3214,2472,337,197,4,13,1,15,742
39147963100,4378,4146,101,8,6,6,1,5,232
39147963200,4187,3777,139,39,4,46,0,9,410
39147963300,4055,3446,155,246,10,49,1,10,609
39147963400,4253,3796,144,78,0,29,16,13,457
39147963500,3638,3138,184,114,5,26,3,23,500
39147963600,4206,3777,136,94,6,60,1,7,429
39147963700,4949,4510,167,59,2,73,6,5,439
39147963800,3825,3628,79,8,2,0,0,7,197
39149971400,4169,4001,51,1,2,4,2,13,168
39149971500,5078,4856,48,25,7,28,0,11,222
39149971600,5072,4982,25,7,0,7,0,2,90
39149971700,4265,4030,54,37,4,34,0,22,235
39149971800,5428,4395,158,313,4,160,9,49,1033
39149971900,4111,3567,102,138,12,39,7,21,544
39149972000,3684,3108,115,106,19,19,0,19,576
39149972100,5581,5025,97,90,8,128,7,17,556
39149972200,5141,4718,77,88,19,18,1,10,423
39149972300,5701,5385,60,34,6,13,3,24,316
39151700100,1326,797,43,381,3,9,1,9,529
39151700200,5542,3152,427,1356,37,16,0,83,2390
39151700300,2550,1374,163,742,10,3,0,26,1176
39151700400,4652,2888,206,1131,7,15,0,59,1764
39151700500,2968,1341,178,1127,11,4,0,40,1627
39151700600,2871,1772,158,608,9,16,10,15,1099
39151700701,2594,2083,86,302,6,11,0,10,511
39151700702,3752,2806,160,504,10,43,0,20,946
39151700800,3720,2199,296,801,10,10,0,33,1521
39151701000,3604,2152,232,818,10,11,11,33,1452
39151701100,3278,2280,150,494,5,28,5,32,998
39151701200,3728,2545,118,688,14,5,4,20,1183
39151701300,3870,2472,191,792,7,6,0,30,1398
39151701500,2761,1715,141,613,7,4,0,34,1046
39151701700,2744,1420,328,707,22,3,0,18,1324
39151701800,2311,832,99,1133,11,0,1,17,1479
39151702100,3094,1011,110,1711,12,5,0,33,2083
39151702300,3586,1239,194,1787,2,2,0,33,2347
39151702500,2884,2207,67,326,5,5,2,20,677
39151710200,4179,3112,103,544,4,9,6,40,1067
39151710300,3528,2938,87,222,1,17,4,18,590
39151710400,1012,652,42,219,5,1,0,4,360
39151710500,4193,2951,101,687,12,18,0,38,1242
39151710600,4927,4433,98,131,5,31,3,18,494
39151710700,3586,3096,97,184,2,43,1,10,490
39151710800,5072,4552,82,202,1,15,0,17,520
39151710900,4277,4002,68,30,12,24,3,13,275
39151711001,4086,3735,81,28,18,28,0,4,351
39151711002,4096,3797,73,23,8,14,1,17,299
39151711111,4859,4552,95,25,6,7,0,6,307
39151711112,5275,4918,100,29,8,47,1,12,357
39151711121,6302,5816,113,64,3,44,0,21,486
39151711122,5706,5042,143,141,3,107,0,13,664
39151711202,4284,4056,42,16,9,18,1,13,228
39151711211,6779,6267,117,51,10,39,4,23,512
39151711212,2485,2349,35,19,0,7,0,2,136
39151711312,7332,6523,155,148,5,231,0,24,809
39151711321,3834,3330,121,125,0,103,0,14,504
39151711322,3549,2847,100,285,0,146,0,7,702
39151711323,4571,4018,103,40,13,164,0,9,553
39151711324,4721,4116,102,83,9,201,3,8,605
39151711402,6756,5792,185,239,5,201,1,20,964
39151711411,4211,3802,103,46,3,118,3,6,409
39151711412,4748,4247,103,136,5,40,0,6,501
39151711501,3912,3425,90,133,2,90,0,10,487
39151711502,3463,2922,88,261,1,47,0,13,541
39151711600,5809,4885,138,434,3,22,6,21,924
39151711700,5477,4373,181,471,23,27,1,40,1104
39151711800,4988,4227,143,308,2,50,1,25,761
39151711900,5005,4408,147,153,12,87,0,22,597
39151712000,4498,3869,278,83,4,39,2,1,629
39151712102,8627,7507,220,402,16,59,0,37,1120
39151712112,1904,1693,33,66,0,30,0,5,211
39151712113,1351,1176,17,44,6,23,0,2,175
39151712114,4827,4249,104,116,8,114,0,16,578
39151712201,6448,5420,207,443,11,84,0,57,1028
39151712202,5666,4918,112,347,9,54,0,9,748
39151712300,5907,4799,124,564,7,35,1,25,1108
39151712400,6514,5134,153,738,25,33,0,33,1380
39151712500,2115,1981,43,12,1,13,0,1,134
39151712601,2538,2345,48,9,11,18,2,6,193
39151712602,5129,4818,87,13,2,13,0,18,311
39151712700,5111,4842,67,33,1,16,0,6,269
39151712800,4493,4197,70,45,6,11,1,7,296
39151712900,4031,3747,52,16,17,11,2,10,284
39151713000,3848,3582,49,46,5,5,0,15,266
39151713100,5611,4786,93,375,20,13,0,15,825
39151713201,6844,6103,103,246,33,21,0,32,741
39151713202,2028,1856,29,43,11,3,0,2,172
39151713300,4418,3883,101,188,5,11,0,26,535
39151713401,5155,4497,160,166,10,15,2,20,658
39151713402,4258,3742,104,131,6,11,0,13,516
39151713501,5597,4732,146,267,8,184,3,12,865
39151713502,5732,5039,152,233,7,17,2,23,693
39151713600,2499,2155,78,122,3,7,0,2,344
39151713700,2437,1981,96,157,2,5,0,24,456
39151713900,1855,1560,76,88,8,6,0,7,295
39151714000,3982,3607,79,53,8,16,0,19,375
39151714100,3149,2688,85,156,10,7,3,24,461
39151714200,2712,1363,178,881,2,6,3,18,1349
39151714302,3865,3242,94,269,8,17,0,10,623
39151714400,3888,3019,276,375,14,16,0,11,869
39151714600,4527,4229,52,91,4,13,0,4,298
39151714701,6254,5853,80,49,2,8,1,16,401
39151714702,2461,2326,31,11,1,4,0,3,135
39151714801,6547,6222,63,23,7,11,2,13,325
39151714802,3029,2846,43,14,0,15,0,7,183
39151714901,3818,3558,33,19,9,6,0,15,260
39151714902,3561,3281,39,56,16,6,0,12,280
39151715000,2762,2222,78,235,10,7,0,16,540
39153501100,1730,611,60,833,4,144,2,9,1119
39153501700,1146,681,59,301,6,25,0,13,465
39153501800,881,60,36,719,0,8,0,7,821
39153501900,2245,412,113,1507,3,93,2,7,1833
39153502101,3356,1184,174,606,4,1200,0,18,2172
39153502102,4808,1976,140,830,16,1589,2,32,2832
39153502200,6294,2516,267,1126,10,2086,4,22,3778
39153502300,5206,2393,190,2056,6,132,1,41,2813
39153502500,1027,532,43,339,2,17,0,11,495
39153502600,2977,1814,81,756,14,46,1,9,1163
39153502700,6421,4721,90,1035,13,158,9,39,1700
39153502800,4071,3124,101,496,5,53,4,22,947
39153503100,1530,658,44,640,2,66,0,17,872
39153503200,1473,333,61,915,10,46,1,4,1140
39153503300,5396,2341,188,2070,7,349,14,27,3055
39153503400,1319,169,72,980,0,8,0,18,1150
39153503500,3483,1129,87,1910,9,85,1,23,2354
39153503600,4152,3316,96,346,8,81,1,15,836
39153503701,5539,4721,100,335,6,80,0,14,818
39153503702,5482,4817,97,218,11,42,4,20,665
39153503800,3783,1919,99,1477,2,36,4,10,1864
39153504100,929,593,32,231,7,5,0,0,336
39153504200,1577,821,82,462,11,73,0,14,756
39153504400,1219,464,44,611,0,16,1,2,755
39153504500,1669,832,65,530,0,75,0,9,837
39153504600,3257,1378,118,1380,7,118,4,17,1879
39153504700,4334,2648,129,1033,7,147,1,35,1686
39153504800,4675,3506,118,577,8,155,2,16,1169
39153505200,1247,406,51,663,5,21,0,2,841
39153505300,1487,429,63,816,5,39,0,9,1058
39153505400,3614,2221,88,991,14,25,0,8,1393
39153505500,2560,1638,57,616,6,10,0,7,922
39153505600,1134,545,41,462,1,4,0,2,589
39153505700,2673,1741,79,654,4,11,1,13,932
39153505800,4579,3540,101,589,10,17,0,15,1039
39153505900,2376,1883,22,270,6,16,0,21,493
39153506100,5221,3077,144,1647,3,82,3,15,2144
39153506200,3679,723,70,2689,0,29,0,29,2956
39153506400,2801,1736,106,741,7,28,0,16,1065
39153506500,2596,378,85,1980,0,5,0,22,2218
39153506600,2195,1158,58,845,0,25,0,5,1037
39153506700,1598,124,53,1344,2,3,0,13,1474
39153506800,2196,802,52,1167,8,60,0,13,1394
39153507101,5003,2942,159,1541,7,56,0,27,2061
39153507102,2795,2269,64,273,1,61,2,5,526
39153507201,2497,1344,74,863,4,61,0,13,1153
39153507202,3436,2847,66,325,3,51,0,22,589
39153507203,4478,3381,147,621,9,66,0,29,1097
39153507300,3107,2475,93,331,4,44,0,25,632
39153507400,928,395,39,410,0,32,0,4,533
39153507501,2056,1208,84,584,0,61,0,4,848
39153507502,4479,1193,619,1700,11,632,0,41,3286
39153507600,4506,2521,221,560,6,977,0,23,1985
39153508000,5345,3984,191,767,8,86,2,22,1361
39153508301,1368,655,58,547,9,23,0,9,713
39153508399,4351,1442,88,2523,17,24,5,46,2909
39153508600,2816,300,81,2257,7,19,1,28,2516
39153508800,5362,417,79,4653,7,23,0,31,4945
39153508900,4291,2818,148,820,5,382,3,13,1473
39153509000,1388,647,94,522,9,10,0,12,741
39153510100,2711,2175,54,228,9,3,2,11,536
39153510200,3992,3441,106,161,10,26,3,5,551
39153510301,5110,3490,102,1143,7,44,4,34,1620
39153510302,5702,5045,105,266,10,25,1,14,657
39153510400,3715,3358,51,64,9,14,4,3,357
39153510500,4065,3655,63,123,14,13,0,6,410
39153520103,2051,1504,40,226,6,163,2,11,547
39153520104,4392,3560,98,304,8,207,2,15,832
39153520105,4196,3488,75,162,4,280,1,14,708
39153520106,2707,2084,59,182,6,254,0,10,623
39153520201,2669,2416,60,44,0,49,0,10,253
39153520202,4667,3956,103,165,14,206,2,14,711
39153520301,3385,2926,81,134,9,67,0,10,459
39153520302,3486,3054,64,57,10,139,0,15,432
39153520400,4505,4000,105,98,4,117,3,12,505
39153520500,4362,3778,98,93,5,162,0,26,584
39153520600,3663,3032,75,96,2,312,0,13,631
39153530101,7358,4920,176,973,1,982,3,25,2438
39153530103,4700,3412,111,755,6,236,0,18,1288
39153530104,7599,5424,158,1215,2,491,1,22,2175
39153530105,2814,1597,72,910,0,97,6,5,1217
39153530108,4805,3109,77,904,5,498,2,24,1696
39153530401,3330,2935,73,67,0,86,0,6,395
39153530402,3606,2955,103,235,2,129,0,9,651
39153530501,5134,4539,108,143,5,115,1,15,595
39153530502,3245,2847,71,73,0,125,1,2,398
39153530603,4617,3821,113,285,5,201,2,14,796
39153530604,3385,3069,58,86,1,53,0,7,316
39153530605,5607,4816,130,191,3,238,0,4,791
39153530606,5559,5001,104,144,0,102,0,10,558
39153530700,2516,2310,48,31,0,49,0,11,206
39153530800,6655,5861,116,143,9,228,2,25,794
39153530901,4699,3587,104,543,1,206,1,5,1112
39153530902,6476,5754,89,181,4,159,0,15,722
39153530903,5328,4816,71,77,6,123,3,18,512
39153531001,3767,3384,79,68,3,34,0,11,383
39153531002,5414,4800,75,140,13,77,1,34,614
39153531101,2840,2530,49,39,16,24,0,10,310
39153531102,4216,3873,52,37,7,67,1,4,343
39153531103,2976,2576,74,116,2,48,0,13,400
39153531405,4642,3998,105,178,6,132,3,7,644
39153531406,5368,4740,124,128,1,132,0,19,628
39153531407,2914,2678,50,35,2,45,1,7,236
39153531501,4222,3796,57,108,15,47,1,12,426
39153531502,4367,3936,66,89,2,79,1,9,431
39153531601,4205,3934,52,42,5,18,2,8,271
39153531602,3097,2906,33,12,5,5,0,6,191
39153531701,3986,3650,43,49,3,16,1,24,336
39153531702,4124,3840,38,18,13,18,1,15,284
39153531801,4772,4225,83,165,12,55,1,20,547
39153531802,4429,3871,73,186,15,88,0,12,558
39153532001,3707,3408,46,33,5,16,0,20,299
39153532003,4178,3904,48,36,0,23,0,13,274
39153532004,3782,3354,63,139,9,72,0,8,428
39153532202,6608,5022,200,836,6,241,0,20,1586
39153532301,5879,5236,121,75,0,212,1,15,643
39153532302,5866,5128,114,208,2,178,0,22,738
39153532501,3242,2984,42,53,0,74,0,4,258
39153532502,3195,2830,51,59,2,105,0,10,365
39153532600,2803,2519,53,51,2,44,3,9,284
39153532701,8077,5739,144,1354,9,491,3,21,2338
39153532702,3541,2713,105,324,1,236,2,6,828
39153532703,5599,4639,109,479,4,179,0,14,960
39153532705,7119,6086,138,518,7,160,0,16,1033
39153532706,3726,3328,91,129,9,53,1,2,398
39153532708,5323,4473,77,432,1,155,0,22,850
39153532901,1577,1435,19,23,2,21,0,6,142
39153532902,10091,7969,253,801,21,581,0,40,2122
39153532999,5962,5288,94,175,0,105,0,17,674
39153533000,1614,1485,24,26,0,8,0,2,129
39153533101,4873,4328,126,38,3,187,0,4,545
39153533102,2394,2205,57,9,0,42,0,9,189
39153533200,5847,5061,137,102,2,315,0,22,786
39153533400,5973,4176,161,1096,10,155,0,46,1797
39153533501,9186,6661,300,613,12,1201,0,36,2525
39153533502,3972,3509,58,176,11,69,3,4,463
39153534000,7304,6353,175,102,4,417,2,17,951
39153534100,2699,2323,65,33,2,166,0,7,376
39155920300,2805,2165,67,358,11,16,2,15,640
39155920400,2422,1674,79,416,4,1,0,8,748
39155920700,4434,2373,115,1711,6,4,0,7,2061
39155920800,2030,1394,68,371,1,5,0,32,636
39155920900,3564,1659,81,1575,3,15,0,17,1905
39155921000,5341,3325,101,1504,8,20,2,17,2016
39155921100,3443,2377,114,614,7,15,1,31,1066
39155921200,1883,1326,49,359,4,0,0,9,557
39155921300,2343,2033,60,148,2,23,0,7,310
39155921400,3310,2906,74,228,3,18,0,0,404
39155921500,5774,4626,136,580,6,52,2,17,1148
39155921600,3772,2484,77,922,10,23,1,10,1288
39155930101,2783,2608,33,7,8,12,0,2,175
39155930102,2340,2241,29,6,4,2,0,4,99
39155930200,2541,2356,29,8,1,15,0,9,185
39155930300,3269,3090,27,14,8,7,0,3,179
39155930400,3953,3700,37,33,0,1,0,12,253
39155930500,6397,6222,29,39,3,0,1,1,175
39155930600,3731,3488,39,24,3,12,0,9,243
39155930700,4122,3828,60,29,5,19,0,6,294
39155930800,4869,4543,57,43,4,11,0,21,326
39155930900,7086,6584,137,94,5,51,0,18,502
39155931000,6024,5573,74,68,5,46,0,20,451
39155931100,2293,2164,26,9,2,1,2,12,129
39155931200,3978,3697,53,57,0,24,0,6,281
39155931300,3970,3734,50,33,1,5,3,2,236
39155931400,4477,3931,56,221,5,12,0,9,546
39155931500,3869,3629,79,30,2,3,0,0,240
39155931601,4338,3998,81,104,6,24,1,0,340
39155931602,2890,2631,73,78,3,12,0,9,259
39155931700,1872,1605,32,97,0,9,0,15,267
39155931900,6001,3502,291,1776,8,64,0,37,2499
39155932000,5945,4990,157,485,4,66,1,11,955
39155932200,2780,2326,62,213,4,14,0,1,454
39155932300,5681,4996,174,271,10,23,0,18,685
39155932500,3172,2919,58,53,3,10,0,4,253
39155932600,3403,2955,63,155,2,12,0,14,448
39155932701,5605,4920,146,247,8,54,0,6,685
39155932702,2580,2272,81,71,2,14,0,6,308
39155932801,2669,2317,44,131,5,24,0,13,352
39155932802,3396,2866,79,127,5,13,1,22,530
39155932900,2556,2237,44,135,0,77,0,11,319
39155933001,5852,5287,117,144,10,113,1,11,565
39155933002,4209,3748,61,144,5,63,2,7,461
39155933100,2255,2059,32,17,6,3,0,3,196
39155933301,2754,2421,73,63,3,17,0,2,333
39155933302,4408,4061,101,89,0,7,0,0,347
39155933400,3332,3026,55,102,8,18,0,7,306
39155933500,3854,3557,69,39,3,1,0,20,297
39155933600,4754,4419,54,37,5,13,0,6,335
39155933700,2477,2231,45,71,1,10,0,18,246
39155933800,2439,1578,83,559,9,18,4,19,861
39155933900,1859,1489,95,144,10,4,0,6,370
39155934000,4073,1487,173,2087,8,3,2,39,2586
39157020100,5133,4820,136,13,2,16,0,7,313
39157020200,4134,3902,47,10,1,9,2,16,232
39157020300,3397,3183,57,31,3,8,0,1,214
39157020400,5474,5106,62,16,7,11,1,16,368
39157020500,5647,5330,152,21,5,14,4,5,317
39157020600,5219,4844,169,30,5,40,2,10,375
39157020700,6285,5158,809,74,12,24,10,1,1127
39157020801,3403,2362,813,51,7,24,0,10,1041
39157020802,2720,2251,321,27,8,12,0,4,469
39157020900,4184,3725,212,47,6,22,1,7,459
39157021000,4625,4226,130,33,7,15,0,11,399
39157021100,2832,2203,466,49,9,6,1,6,629
39157021200,2695,2537,37,27,3,3,0,0,158
39157021300,5086,4885,81,12,3,14,0,9,201
39157021400,2494,2361,61,18,1,5,0,6,133
39157021501,3485,3245,78,20,6,43,1,10,240
39157021502,2127,2029,13,10,0,2,0,6,98
39157021503,2358,2273,19,3,1,0,0,3,85
39157021600,4574,4268,65,56,7,6,5,6,306
39157021700,5263,4898,74,65,6,12,0,10,365
39157021800,2697,2558,22,7,5,1,0,3,139
39157021900,2524,2383,34,5,2,3,0,10,141
39157022001,3568,3311,60,43,8,12,2,0,257
39157022002,3339,3121,44,29,3,4,0,12,218
39159050100,3769,3529,70,11,5,20,0,7,240
39159050200,4875,4558,74,22,4,17,0,13,317
39159050301,4034,3735,72,15,2,33,0,13,299
39159050303,8423,7217,234,165,17,370,0,27,1206
39159050304,2557,2404,34,11,9,6,0,7,153
39159050401,5477,4642,98,556,8,62,0,13,835
39159050402,3630,3140,183,85,0,53,0,6,490
39159050501,4613,4059,149,74,7,122,0,22,554
39159050502,2249,1981,94,29,5,26,0,6,268
39159050601,10920,7057,300,198,16,2890,0,33,3863
39159050602,4012,3286,117,76,9,376,0,17,726
39159050701,4848,4533,50,22,3,57,0,24,315
39159050702,3377,3146,59,11,8,11,0,13,231
39161020100,4285,4070,83,19,4,15,0,12,215
39161020200,4514,4178,157,18,1,9,0,11,336
39161020300,2672,2545,59,4,3,5,0,3,127
39161020400,2841,2674,72,10,3,2,1,11,167
39161020500,3127,2887,98,15,5,8,0,1,240
39161020600,1615,1343,108,54,4,4,0,8,272
39161020700,1747,1520,104,34,4,8,0,2,227
39161020800,4514,4000,240,54,11,19,0,25,514
39161020900,3616,3250,176,49,2,18,12,6,366
39163953000,4799,4559,42,17,1,11,0,5,240
39163953100,5204,4986,27,10,14,9,0,6,218
39163953200,2797,2668,15,16,4,2,0,3,129
39165030101,4210,3955,56,34,0,8,0,3,255
39165030102,4671,4386,53,43,13,21,0,2,285
39165030200,1278,1199,24,17,0,3,0,0,79
39165030501,3850,3400,84,106,0,54,0,22,450
39165030503,5682,5067,143,99,13,93,0,31,615
39165030504,5179,4577,123,124,5,139,0,20,602
39165030600,3796,3439,77,83,8,25,0,13,357
39165030700,7449,6344,249,368,11,115,5,25,1105
39165030800,7020,6368,203,65,3,92,0,20,652
39165030901,8624,7178,232,271,5,513,0,19,1446
39165030902,8886,7726,254,173,10,328,3,13,1160
39165031001,6483,6075,116,24,3,24,0,8,408
39165031002,2162,2020,36,6,3,7,0,3,142
39165031100,3947,3660,47,24,17,8,0,6,287
39165031200,8353,7504,209,115,6,87,2,39,849
39165031300,4909,4358,139,85,21,64,0,19,551
39165031400,5094,4287,278,230,5,46,0,4,807
39165031500,5450,4645,369,149,8,42,0,8,805
39165031601,1681,1448,49,81,0,22,1,10,233
39165031602,6166,5317,185,237,3,185,4,9,849
39165031603,3412,3127,94,21,0,31,0,8,285
39165031700,3193,1195,69,1916,4,1,0,3,1998
39165031904,6926,4962,373,305,8,877,61,26,1964
39165031905,6318,4336,331,370,17,969,0,12,1982
39165031906,4351,3041,189,140,4,801,1,27,1310
39165031907,11864,8055,441,452,16,2389,2,41,3809
39165031908,5820,3593,206,180,4,1574,19,20,2227
39165032003,7490,6102,292,158,1,640,1,25,1388
39165032004,6113,4280,196,237,7,1143,16,14,1833
39165032006,4072,3208,160,125,6,393,3,15,864
39165032008,3765,2376,184,166,0,874,2,17,1389
39165032009,8087,4000,295,422,12,2998,3,39,4087
39165032010,3377,2977,126,25,0,57,4,13,400
39165032011,3502,2438,164,126,2,583,3,17,1064
39165032100,9917,7437,344,293,16,1372,5,49,2480
39165032202,6479,5894,172,83,3,67,2,11,585
39165032203,8425,7518,270,192,9,179,5,10,907
39165032204,4881,4287,173,126,0,96,1,5,594
39165032205,8835,7727,257,206,10,218,9,26,1108
39165032206,3001,2612,113,48,1,54,0,10,389
39165032300,5215,4788,128,43,9,17,0,21,427
39165032400,4929,4634,86,16,4,21,5,10,295
39165032501,3411,3106,62,65,8,24,0,3,305
39165032502,4064,3581,87,126,13,24,1,8,483
39167020101,3925,3567,35,81,10,24,0,12,358
39167020102,2277,2079,21,24,6,18,3,8,198
39167020201,3671,3423,68,26,2,13,0,20,248
39167020202,3333,3146,24,31,2,13,0,0,187
39167020300,3623,3449,25,10,4,7,0,10,174
39167020400,2017,1860,39,25,1,12,0,1,157
39167020500,2249,1981,59,64,5,48,0,35,268
39167020800,3512,3105,84,44,15,37,0,10,407
39167020900,2544,2309,43,23,4,46,3,5,235
39167021000,3669,3355,70,46,9,10,0,6,314
39167021100,4004,3786,49,31,10,26,1,8,218
39167021201,3086,3000,8,6,6,4,1,2,86
39167021202,2077,2008,6,0,2,0,0,15,69
39167021300,4749,4510,41,4,23,10,0,11,239
39167021400,3981,3779,47,18,5,25,0,0,202
39167021500,1464,1394,17,7,2,2,0,2,70
39167021600,3603,3463,31,7,3,1,0,3,140
39167021700,5987,5449,50,153,5,13,0,10,538
39169000100,3524,2929,137,180,0,30,2,8,595
39169000200,3288,2939,72,45,4,90,0,15,349
39169000300,2683,2321,76,99,9,61,1,8,362
39169000500,3907,3301,117,171,8,59,0,13,606
39169000600,5632,5059,122,141,8,30,0,18,573
39169000700,7066,6289,190,127,8,148,0,20,777
39169000800,7209,6306,238,196,4,140,2,28,903
39169000900,4089,3833,62,29,3,25,6,9,256
39169001000,3077,2514,221,127,4,75,0,10,563
39169001100,1394,1301,28,20,4,14,0,2,93
39169001200,1283,944,135,99,4,11,1,7,339
39169001300,3989,3332,207,165,6,62,2,21,657
39169001400,3010,2800,58,18,4,10,2,4,210
39169001700,8000,7871,76,0,0,3,2,3,129
39169001800,4235,4083,51,11,6,7,0,6,152
39169001900,3165,3016,36,6,6,4,0,10,149
39169002000,3069,2904,35,10,3,10,2,10,165
39169002100,2933,2792,30,22,2,5,0,0,141
39169002200,3847,3578,68,11,10,5,1,7,269
39169002300,3038,2906,26,10,5,9,1,5,132
39169002400,3913,3645,61,28,6,13,0,6,268
39169002500,2482,2363,37,2,0,5,3,2,119
39169002901,3415,3205,49,23,2,5,0,3,210
39169002902,5106,4758,64,17,13,22,2,18,348
39169003000,2212,2059,38,12,4,0,0,13,153
39169003100,2258,2124,52,11,3,10,0,5,134
39169003200,3994,3662,173,35,1,29,0,11,332
39169003300,3193,3084,34,21,1,9,0,2,109
39169003400,3064,2756,81,24,7,9,0,5,308
39169003500,3455,3236,57,15,4,25,0,5,219
39169003700,3936,3785,81,1,2,2,4,8,151
39169980000,1428,1235,43,79,1,23,1,1,193
39171950100,4668,4252,244,11,5,9,0,9,416
39171950200,3868,3639,86,11,5,8,0,12,229
39171950300,4278,3883,182,21,8,40,0,14,395
39171950400,4578,4254,157,12,6,14,0,9,324
39171950500,4154,3510,345,204,4,11,0,4,644
39171950600,4867,4196,375,33,10,41,0,20,671
39171950700,4299,3850,231,20,11,47,0,9,449
39171950800,3648,3387,120,6,4,18,0,14,261
39171950900,2742,2512,122,5,2,10,0,1,230
39173020100,5160,4274,475,55,7,64,0,13,886
39173020200,2942,2564,167,42,2,22,0,1,378
39173020300,4930,4294,272,87,6,61,0,16,636
39173020401,5678,4937,268,120,5,88,0,9,741
39173020402,6550,5343,340,180,8,432,0,18,1207
39173020500,2263,2063,84,4,4,20,0,12,200
39173020601,4120,3419,403,45,4,80,0,9,701
39173020602,8808,7359,429,153,7,548,0,22,1449
39173020701,3441,2624,275,171,3,205,1,13,817
39173020702,4003,3497,165,67,8,44,0,11,506
39173020800,3854,3390,235,53,4,4,0,7,464
39173020901,4859,4175,365,58,3,25,0,18,684
39173020902,2447,2125,167,36,0,8,0,17,322
39173021000,4097,3720,203,22,3,10,0,7,377
39173021100,3874,3536,182,18,0,13,0,6,338
39173021200,7787,6729,365,101,3,304,0,15,1058
39173021300,3450,3157,162,16,2,4,0,5,293
39173021400,3053,2642,249,25,8,5,0,4,411
39173021500,2404,2129,161,12,5,2,0,5,275
39173021601,5334,4741,225,74,1,118,0,8,593
39173021602,2384,1914,192,104,7,44,3,11,470
39173021701,3200,2545,211,143,5,111,1,4,655
39173021702,4807,3731,372,292,6,161,0,5,1076
39173021800,5592,4434,230,590,3,83,1,15,1158
39173021901,3729,3240,236,56,8,65,0,16,489
39173021902,5084,3868,480,330,14,159,0,23,1216
39173022100,4157,3755,211,20,10,10,0,10,402
39173022200,2660,2197,224,92,3,16,0,13,463
39173022300,3758,3423,199,7,3,9,3,0,335
39173022400,3536,3116,267,20,15,4,0,6,420
39173022500,4287,3552,466,96,7,31,0,11,735
39175938000,4222,4028,89,13,3,7,1,8,194
39175938100,4407,4134,83,15,5,43,0,3,273
39175938200,3514,3339,73,12,7,3,0,12,175
39175938300,3584,3237,216,15,2,22,0,8,347
39175938400,3191,2968,115,9,0,7,2,0,223
39175938500,2982,2814,65,13,4,3,0,14,168
40001376600,2331,1300,120,10,616,29,0,8,1031
40001376700,4654,2304,169,4,1424,73,4,4,2350
40001376800,3848,1334,147,13,1915,6,3,0,2514
40001376900,4305,1147,585,9,2103,33,3,0,3158
40001377000,4357,1379,231,4,2182,21,2,0,2978
40003955600,1445,1275,70,5,17,0,0,0,170
40003955700,1342,1156,71,0,29,3,0,4,186
40003956000,2912,2271,138,224,148,4,0,3,641
40005587600,1773,1063,62,162,305,4,2,6,710
40005587700,4133,2503,200,260,611,41,2,32,1630
40005587800,3981,2799,126,14,651,4,0,11,1182
40005587900,4256,2938,160,129,625,0,0,9,1318
40007951600,2591,1586,877,0,15,4,3,3,1005
40007951700,1063,956,47,0,5,4,0,0,107
40007951800,1395,955,380,3,9,3,3,0,440
40009966100,7393,5264,1137,167,248,63,5,17,2129
40009966200,7078,5471,892,128,174,41,3,14,1607
40009966500,1670,1396,124,6,42,4,0,0,274
40009966800,6269,4395,531,818,306,20,4,7,1874
40011958600,1400,1123,170,8,23,5,3,4,277
40011958700,1488,1132,108,6,138,11,0,2,356
40011958800,1135,986,55,0,30,0,0,0,149
40011958900,3030,1743,517,214,294,10,1,6,1287
40011959000,1682,1264,135,20,165,0,1,0,418
40013795600,2479,1667,125,8,453,2,3,2,812
40013795700,3527,2498,141,14,533,9,0,9,1029
40013795900,1607,1175,62,27,208,0,3,5,432
40013796002,5305,3338,362,50,925,35,0,3,1967
40013796003,4525,3015,327,20,648,7,3,9,1510
40013796004,1684,1207,78,6,217,11,0,1,477
40013796101,5419,3535,358,97,724,56,0,5,1884
40013796102,4827,3074,467,52,616,109,2,19,1753
40013796200,4397,2720,338,171,590,29,0,3,1677
40013796300,1836,1089,178,50,256,4,1,3,747
40013796400,2550,1259,424,80,445,8,0,2,1291
40013796500,2539,1584,268,14,394,8,0,2,955
40013796600,5372,3915,300,126,565,7,2,10,1457
40015161601,5284,2291,2271,252,280,21,0,1,2993
40015161602,2162,1673,160,23,180,0,1,3,489
40015161700,1625,1232,265,5,24,0,0,2,393
40015161800,2626,1622,301,11,516,0,2,1,1004
40015161900,1400,964,74,20,218,2,2,5,436
40015162000,2801,1896,141,11,489,3,0,2,905
40015162101,3000,1027,327,82,1222,14,1,5,1973
40015162102,3337,761,497,214,1520,15,0,0,2576
40015162200,2201,1263,148,14,595,4,4,4,938
40015162300,2509,1851,151,14,276,4,3,6,658
40017300100,2422,1846,140,13,200,9,2,11,576
40017300201,6406,5084,508,44,203,24,0,11,1322
40017300202,4347,3186,487,65,279,8,4,4,1161
40017300300,3286,1895,747,70,331,14,0,7,1391
40017300400,1183,435,262,226,173,2,3,1,748
40017300500,2958,1831,467,89,323,13,0,3,1127
40017300600,3385,2309,375,56,263,19,2,11,1076
40017300701,1848,1163,219,69,221,7,3,3,685
40017300702,5034,3332,543,518,337,23,1,4,1702
40017300802,3606,2768,236,92,122,15,0,22,838
40017300803,3313,2736,194,20,64,45,1,0,577
40017300804,3769,2516,438,253,87,93,4,15,1253
40017300805,7091,5163,553,286,259,163,4,32,1928
40017300806,4604,3069,450,442,92,177,0,8,1535
40017300901,6764,4729,654,257,217,263,3,2,2035
40017300902,2423,1748,229,51,91,35,3,14,675
40017300904,5945,3362,1588,238,185,77,4,17,2583
40017300905,5998,4357,418,218,202,322,3,18,1641
40017301001,1061,704,121,56,25,52,4,2,357
40017301003,7086,4989,769,200,216,226,4,33,2097
40017301006,3313,2082,380,91,141,312,7,19,1231
40017301010,3624,2232,552,179,111,196,5,10,1392
40017301011,5883,4046,695,152,203,221,12,22,1837
40017301012,2674,1558,211,103,87,457,11,7,1116
40017301013,6444,4092,624,311,160,705,1,22,2352
40017301014,5218,3259,534,313,143,434,5,30,1959
40017301015,2227,1403,268,146,62,156,3,7,824
40017301100,6059,4591,521,94,224,164,0,14,1468
40017301201,3766,2825,311,95,161,16,1,14,941
40017301202,2460,1950,162,38,86,16,2,7,510
40017301301,2830,2043,287,72,111,91,0,13,787
40017301302,5444,4178,428,113,141,156,2,17,1266
40017301406,5268,3863,559,67,196,69,2,20,1405
40017301407,6348,4898,528,62,221,65,2,16,1450
40017301408,2055,1676,109,14,68,15,0,10,379
40017301409,2763,1956,289,46,111,11,12,13,807
40017301410,5500,4024,521,148,196,111,4,19,1476
40019892100,2712,1673,88,366,179,3,0,136,1039
40019892200,1276,986,38,14,128,4,0,7,290
40019892301,1471,1131,74,2,104,4,0,4,340
40019892302,1100,839,39,18,93,3,0,4,261
40019892400,3176,2556,79,11,257,0,0,7,620
40019892501,4774,3275,251,88,487,91,2,37,1499
40019892502,5360,3961,243,61,476,89,2,51,1399
40019892601,2824,1673,346,198,228,23,2,31,1151
40019892602,3619,2280,225,269,274,163,4,56,1339
40019892700,4857,3489,212,77,478,26,1,108,1368
40019892801,2376,1026,334,408,221,5,14,45,1350
40019892802,2272,898,279,467,271,0,2,74,1374
40019892900,2164,1282,287,161,211,14,3,9,882
40019893001,4133,2689,390,216,340,73,5,29,1444
40019893002,3126,1974,284,197,232,79,2,13,1152
40019893100,2763,1495,453,271,224,10,7,44,1268
40021977600,5307,2373,179,16,2001,24,2,25,2934
40021977701,2854,1523,81,39,767,2,5,5,1331
40021977702,3448,1637,145,3,1146,13,1,7,1811
40021977801,2472,877,205,42,973,0,1,0,1595
40021977802,4353,1742,445,21,1435,73,2,8,2611
40021977901,3356,1358,286,32,1070,52,1,7,1998
40021977902,3564,1499,319,79,1121,30,1,46,2065
40021978000,4273,1447,764,65,1391,17,3,17,2826
40021978100,5860,2482,444,133,1869,68,3,14,3378
40021978201,2702,1045,149,2,1095,9,2,7,1657
40021978202,2822,1473,81,18,843,9,0,0,1349
40021978301,3116,1476,183,41,979,6,0,1,1640
40021978302,2951,1299,156,28,1055,5,0,2,1652
40023966900,2541,1786,49,52,328,5,0,18,755
40023967000,2952,1843,88,153,617,1,0,4,1109
40023967100,3726,1989,237,463,553,18,1,25,1737
40023967200,2115,828,89,599,338,1,2,5,1287
40023967300,2870,1668,132,104,666,4,1,5,1202
40025950100,1077,879,162,0,0,0,0,2,198
40025950300,1219,768,401,1,4,0,0,5,451
40027200100,338,232,33,20,19,5,0,3,106
40027200200,1724,1134,198,73,101,15,0,4,590
40027200300,3512,2133,655,122,161,42,4,6,1379
40027200400,1795,1175,294,28,79,11,0,11,620
40027200500,3573,2644,252,56,144,80,3,67,929
40027200602,3302,2130,369,153,139,155,3,22,1172
40027200603,2996,1597,343,328,145,175,5,12,1399
40027200604,3191,1981,307,297,124,91,2,5,1210
40027200700,245,156,17,33,20,2,0,2,89
40027200800,7444,4889,582,511,351,193,8,26,2555
40027200900,4069,2763,449,114,228,73,6,22,1306
40027201000,5895,3718,826,339,263,85,0,17,2177
40027201102,2871,2249,152,70,97,68,0,12,622
40027201103,3643,2535,307,141,154,181,1,9,1108
40027201104,2110,1510,139,116,84,40,0,3,600
40027201201,2258,1560,161,98,66,157,3,12,698
40027201202,6015,4180,785,68,106,44,1,751,1835
40027201204,3850,2302,343,375,136,418,1,34,1548
40027201205,4705,2885,439,412,201,277,12,12,1820
40027201302,3988,2204,514,327,144,382,3,18,1784
40027201303,4941,2971,540,419,159,291,3,38,1970
40027201403,6463,4566,504,257,250,131,5,13,1897
40027201404,4215,2813,329,292,150,134,5,20,1402
40027201405,6593,4396,525,377,268,324,2,33,2197
40027201505,5791,4318,384,181,202,195,10,18,1473
40027201508,3052,1973,460,120,128,89,0,3,1079
40027201509,5428,3663,477,278,201,218,6,11,1765
40027201511,2801,1924,147,113,86,189,7,13,877
40027201512,3724,2674,243,160,148,189,0,11,1050
40027201513,2981,2133,140,35,98,268,0,18,848
40027201514,5334,3736,304,140,187,422,0,25,1598
40027201602,2920,1845,406,110,152,31,0,14,1075
40027201603,3845,2419,529,244,138,40,3,15,1426
40027201604,3910,2318,610,225,170,98,1,12,1592
40027201607,6721,4136,729,305,257,623,5,15,2585
40027201609,5027,3069,319,221,108,864,2,19,1958
40027201610,4338,2730,363,145,120,570,3,10,1608
40027201611,2264,1513,269,127,73,84,1,2,751
40027201612,5340,3588,574,283,203,202,7,18,1752
40027201700,5060,3468,530,111,159,257,5,6,1592
40027201801,4409,2838,324,155,107,682,2,11,1571
40027201802,3789,2622,362,133,105,246,3,12,1167
40027201902,4660,2502,884,358,156,295,12,7,2158
40027201903,3098,1507,609,223,94,410,0,8,1591
40027201904,5376,2703,844,434,157,735,4,32,2673
40027202002,4309,2683,690,278,145,114,6,21,1626
40027202004,3893,2578,457,201,155,77,0,12,1315
40027202005,6564,3631,1186,459,269,255,7,27,2933
40027202006,3433,1738,670,440,161,106,15,14,1695
40027202007,4954,2899,744,455,135,139,15,34,2055
40027202008,5105,3401,499,316,212,195,2,20,1704
40027202102,2543,1787,252,160,82,15,5,4,756
40027202104,2433,1635,265,135,92,50,0,10,798
40027202105,4473,3004,554,249,138,72,0,21,1469
40027202106,6264,4110,639,275,232,227,6,58,2154
40027202107,3335,2222,293,211,123,139,0,14,1113
40027202201,4806,3333,542,201,157,111,6,16,1473
40027202203,5945,3853,601,418,232,154,3,27,2092
40027202205,8093,5166,822,405,304,468,6,24,2927
40027202207,646,428,65,10,26,48,1,1,218
40027202208,2754,1761,285,166,87,143,4,16,993
40027202301,6821,5037,476,191,284,122,1,22,1784
40027202302,6621,4956,422,74,496,37,5,18,1665
40027202403,5637,4358,363,64,314,52,6,5,1279
40027202404,4307,3325,281,28,263,7,4,18,982
40027202405,6617,4722,350,571,488,11,0,8,1895
40027202406,3294,2303,231,51,326,13,5,4,991
40027202407,3207,2383,232,37,218,19,0,3,824
40027202501,4666,3577,253,26,279,25,1,17,1089
40027202502,2663,2061,159,34,119,15,0,13,602
40027202600,2541,1732,411,31,158,2,1,7,809
40029388100,3564,2236,152,21,712,10,0,40,1328
40029388200,1702,1135,46,2,297,5,0,8,567
40031000100,3601,1650,517,779,255,53,20,2,1951
40031000200,2224,954,403,475,107,35,20,17,1270
40031000300,5101,2338,751,1093,203,143,39,30,2763
40031000402,3841,1870,500,749,116,175,48,21,1971
40031000403,4637,2494,511,769,109,279,20,20,2143
40031000404,3857,1684,540,912,155,94,44,21,2173
40031000405,1957,890,305,426,71,84,17,4,1067
40031000503,3549,1608,560,775,90,92,25,29,1941
40031000504,3689,1871,543,610,146,110,29,19,1818
40031000505,3831,1555,626,862,249,109,32,18,2276
40031000506,4075,1816,568,959,142,204,33,21,2259
40031000600,2409,1378,319,278,102,60,27,15,1031
40031000700,2486,1221,443,342,119,87,27,1,1265
40031000800,2169,1020,361,428,125,29,25,11,1149
40031000900,1842,1104,226,165,102,25,5,9,738
40031001000,1744,898,291,236,67,35,5,7,846
40031001100,1544,775,253,253,79,15,11,4,769
40031001400,1109,520,161,212,112,19,0,2,589
40031001500,2298,1064,414,431,146,15,3,5,1234
40031001600,1605,451,230,656,132,13,5,12,1154
40031001700,1873,1033,333,187,140,14,2,3,840
40031001901,1578,772,242,299,69,19,3,11,806
40031001902,1424,425,192,613,61,12,0,6,999
40031002001,5802,3041,717,964,183,257,54,18,2761
40031002003,2055,1670,123,52,60,14,0,5,385
40031002004,3894,2054,554,566,204,68,49,0,1840
40031002005,5735,2977,730,1212,379,96,30,11,2758
40031002101,4082,2623,589,172,211,80,21,22,1459
40031002102,4489,3539,240,44,280,16,4,48,950
40031002201,2935,1927,281,91,341,29,10,10,1008
40031002202,3969,2881,257,95,332,49,18,20,1088
40031002301,6374,4141,681,485,386,84,24,35,2233
40031002302,4939,3039,454,138,772,21,9,11,1900
40031002401,295,160,57,51,0,8,0,2,135
40031002403,2142,1002,430,498,15,111,16,0,1140
40031002405,2786,1525,534,362,22,133,31,14,1261
40031002406,6587,3474,1264,1011,77,227,78,31,3113
40031002500,2598,1021,445,621,222,80,19,11,1577
40033871100,3545,2562,204,12,400,24,8,8,983
40033871200,1982,1536,157,56,81,4,1,1,446
40035373100,2989,1982,77,12,571,5,0,18,1007
40035373200,2490,1503,50,12,597,12,0,0,987
40035373300,3733,2055,152,246,745,10,0,10,1678
40035373400,2695,1526,107,87,471,22,1,3,1169
40035373500,2200,1372,41,11,449,26,0,0,828
40037020101,2333,1740,157,36,143,26,1,2,593
40037020102,1508,1012,144,32,136,6,0,0,496
40037020103,2940,2290,121,41,198,19,1,8,650
40037020602,3417,2333,173,76,343,18,10,7,1084
40037020603,3412,2223,229,60,448,7,0,17,1189
40037020604,3218,2198,151,50,374,15,2,8,1020
40037020702,3582,2610,110,31,439,5,2,3,972
40037020704,1421,1198,31,10,92,3,6,2,223
40037020705,2846,2223,84,21,224,20,1,10,623
40037020706,5498,4173,192,26,335,20,4,5,1325
40037020707,2291,1705,92,7,267,6,0,6,586
40037020800,3057,2452,74,46,240,5,2,3,605
40037020900,2998,2124,124,58,260,17,5,1,874
40037021000,3681,2388,168,275,431,16,1,12,1293
40037021101,2949,2226,71,99,281,3,2,0,723
40037021102,3603,2678,108,49,388,12,0,10,925
40037021201,1899,1416,98,2,157,7,3,4,483
40037021202,3829,2524,225,269,374,9,0,0,1305
40037021300,2274,1508,191,50,253,7,1,6,766
40037021401,2120,1607,86,23,174,20,0,9,513
40037021402,4413,2947,256,120,503,15,15,8,1466
40037021500,5791,4034,353,50,717,24,4,12,1757
40037021600,2674,1919,174,21,225,10,7,8,755
40039950800,3390,1196,1410,260,255,14,0,16,2194
40039960401,3885,2570,723,84,299,33,0,15,1315
40039960402,3406,1736,1146,63,203,47,0,3,1670
40039960600,5504,3436,1001,243,320,105,1,15,2068
40039960701,5983,4414,593,101,358,81,0,8,1569
40039960702,3075,2479,308,21,113,13,0,0,596
40039961000,3270,2652,203,11,154,1,0,0,618
40041375601,3331,2239,173,5,517,16,1,3,1092
40041375602,3108,2325,89,2,372,3,0,3,783
40041375701,4394,3300,133,12,478,23,13,10,1094
40041375702,3852,2505,288,23,572,29,10,7,1347
40041375803,1996,1460,48,4,276,8,0,3,536
40041375804,1039,776,11,2,161,5,0,0,263
40041375805,2032,1543,60,14,215,5,1,0,489
40041375806,1405,1062,37,12,141,1,2,4,343
40041375901,2835,1706,79,1,638,48,0,12,1129
40041375902,1070,721,25,2,160,7,0,1,349
40041376000,5345,2435,269,15,1857,132,0,16,2910
40041376100,4429,1697,150,11,1904,97,2,17,2732
40041976200,5561,3250,259,13,1200,97,7,9,2311
40043959100,1795,1393,112,0,184,2,0,3,402
40043959200,1530,1317,96,7,37,2,2,1,213
40043959300,1159,1013,52,0,26,0,0,0,146
40045952600,2677,2212,277,7,53,7,0,1,465
40045952800,1072,936,63,9,4,2,0,2,136
40047000101,2500,1548,493,84,58,8,107,13,952
40047000102,3244,1856,724,67,81,30,205,4,1388
40047000200,2740,2075,297,36,58,27,29,12,665
40047000601,2722,1923,303,61,62,35,103,3,799
40047000602,3610,1885,584,292,84,25,477,12,1725
40047000701,3189,1324,1163,94,59,14,365,4,1865
40047000702,3081,1335,1035,147,62,15,287,4,1746
40047001100,3574,3108,147,13,67,11,2,5,466
40047001200,3885,3240,260,16,91,18,3,4,645
40047001301,5189,4079,419,124,97,149,27,14,1110
40047001302,3838,3174,229,46,70,60,16,17,664
40047001401,3670,2519,460,84,93,33,170,18,1151
40047001402,4701,3435,485,127,77,99,192,9,1266
40047001500,6471,3770,1448,209,165,17,447,12,2701
40047001602,4628,3159,421,144,77,58,390,15,1469
40047001603,3093,2365,269,62,56,50,77,1,728
40047001604,2711,2144,245,55,50,36,23,3,567
40049681100,3050,2208,99,15,368,21,0,4,842
40049681200,3389,2396,405,32,282,18,3,5,993
40049681300,2802,1873,416,122,169,17,1,5,929
40049681400,4658,2867,781,148,359,30,0,9,1791
40049681500,2294,1499,199,138,191,0,1,9,795
40049681600,1839,1451,85,4,144,4,3,0,388
40049681700,1648,1293,73,2,145,0,0,3,355
40049681800,2968,2209,275,16,213,22,0,1,759
40049681900,3008,2404,119,68,195,6,0,3,604
40051000100,942,687,75,23,62,5,2,0,255
40051000400,3123,2173,300,101,219,6,1,3,950
40051000501,3414,2376,365,142,161,23,1,7,1038
40051000502,3607,2729,256,118,189,21,2,4,878
40051000600,4985,3872,324,81,261,21,8,8,1113
40051000701,3370,2673,114,10,187,6,3,5,697
40051000702,3206,2572,189,14,219,0,2,6,634
40051000801,3298,2649,170,16,161,7,0,7,649
40051000802,4876,3899,213,21,210,12,2,17,977
40051000901,2348,1892,150,5,86,0,0,9,456
40051000902,6316,4981,319,24,352,29,10,18,1335
40051000904,3898,3056,227,17,212,28,0,9,842
40051000905,3996,3278,149,22,184,10,3,11,718
40051000906,3514,2709,284,16,169,19,3,3,805
40051001000,3902,2296,385,671,225,13,1,5,1606
40053956400,1443,1255,52,16,22,2,4,8,188
40053956500,2726,2377,132,28,57,10,4,7,349
40055967100,2119,1509,156,228,120,2,0,6,610
40055967200,3372,2487,509,124,47,5,1,9,885
40057967800,2488,1403,740,149,53,7,0,0,1085
40059952100,1460,1092,291,0,6,0,0,1,368
40059952200,1812,1283,442,4,18,0,0,1,529
40061279100,1871,1267,59,1,402,2,2,7,604
40061279200,4097,2707,295,17,709,10,0,4,1390
40061279300,3335,2233,95,43,602,9,2,11,1102
40061279400,2258,1490,80,3,440,0,3,4,768
40063484600,2469,1264,89,66,754,2,8,9,1205
40063484700,2291,1569,115,14,345,4,0,4,722
40063484800,3759,1963,257,572,685,6,2,8,1796
40063484900,2511,1584,184,67,414,13,0,7,927
40063485000,2337,1693,110,9,315,13,4,10,644
40065968100,2449,2011,235,13,60,9,3,3,438
40065968200,1531,1116,268,19,47,0,1,1,415
40065968300,1582,1133,309,21,42,8,3,3,449
40065968400,5882,4173,847,250,92,110,13,14,1709
40065968500,4613,2937,718,354,51,142,25,20,1676
40065968600,3761,1385,1735,346,50,20,18,3,2376
40065968700,1531,567,611,235,16,7,1,2,964
40065968800,3436,1561,1214,376,24,24,13,11,1875
40067371600,1585,1213,56,2,112,13,2,3,372
40067371700,1289,940,220,1,39,2,2,4,349
40067371800,2463,1840,308,24,107,15,1,8,623
40069660198,2906,2024,137,20,451,3,0,4,882
40069660201,3408,2035,244,199,506,43,5,3,1373
40069660202,1631,1071,70,7,323,3,0,5,560
40069660300,2327,1605,130,10,302,3,0,45,722
40071000100,5801,3651,473,206,706,37,143,11,2150
40071000201,3030,2095,286,62,240,15,39,6,935
40071000202,4928,3486,425,96,357,56,5,4,1442
40071000300,4395,3429,252,62,231,56,0,11,966
40071000400,1967,1109,293,137,239,10,7,5,858
40071000500,3974,2333,652,179,370,7,66,4,1641
40071000600,3703,2635,125,9,657,6,0,10,1068
40071001100,3781,2691,317,39,445,14,7,5,1090
40071001200,4559,3419,223,30,467,13,2,1,1140
40071001301,3575,2724,326,11,222,21,4,12,851
40071001302,3987,3156,280,25,193,18,1,6,831
40073958100,4390,2694,1372,44,87,11,0,4,1696
40073958200,2109,1647,281,14,56,5,0,2,462
40073958300,5914,4314,932,95,184,27,0,17,1600
40073958400,2771,2330,170,17,90,2,0,3,441
40075963600,1402,997,68,7,226,4,2,2,405
40075963700,3828,2583,547,220,176,35,1,9,1245
40075964200,3279,2569,338,87,102,8,0,6,710
40077087100,2056,1289,43,4,544,7,0,7,767
40077087200,4876,3098,232,32,910,41,4,8,1778
40077087300,2512,1431,69,6,762,19,1,1,1081
40079040102,4632,3356,184,107,479,33,1,0,1276
40079040198,1930,1442,72,15,159,5,1,4,488
40079040299,3533,2462,113,94,484,29,0,3,1071
40079040301,5545,3953,204,29,794,34,2,10,1592
40079040302,3482,2576,98,9,455,14,0,1,906
40079040303,3471,2247,103,259,483,26,0,2,1224
40079040401,5483,3440,640,48,720,72,8,2,2043
40079040402,3722,2277,564,53,448,10,9,11,1445
40079040500,5108,3511,184,10,867,22,4,7,1597
40079040601,3333,1902,796,0,341,17,3,5,1431
40079040602,5096,3138,566,204,789,21,4,3,1958
40079040700,2794,1616,49,13,871,9,0,2,1178
40081961100,4647,3524,157,84,353,32,0,13,1123
40081961200,3889,3103,109,19,269,5,0,13,786
40081961300,4263,3449,184,55,208,13,1,8,814
40081961401,3002,2409,88,36,231,8,6,3,593
40081961402,4726,3581,202,42,395,21,0,13,1145
40081961500,5172,4091,164,106,370,12,1,15,1081
40081961600,2884,2285,96,36,162,2,0,2,599
40081961700,4875,3704,137,214,294,21,5,11,1171
40083600101,2360,1717,148,208,69,14,0,1,643
40083600200,2975,2061,220,336,86,9,0,17,914
40083600300,2386,1786,141,172,62,14,0,24,600
40083600401,6015,4398,816,76,180,34,6,47,1617
40083600402,3243,2426,329,74,85,23,6,16,817
40083600501,3778,2920,211,130,139,15,0,12,858
40083600502,5924,4531,508,113,215,17,2,25,1393
40083600600,4215,2196,200,1318,160,19,10,20,2019
40083600700,4376,3576,164,75,178,18,0,4,800
40083600801,5582,4141,629,133,156,52,2,17,1441
40083600802,4415,3444,288,74,140,30,5,32,971
40083600903,1830,1413,122,25,64,7,0,12,417
40083601000,2456,1451,227,467,79,8,0,11,1005
40085094100,3096,1517,1067,120,186,12,0,9,1579
40085094200,5027,3736,514,52,314,52,0,37,1291
40085094300,2023,1553,104,24,113,8,0,17,470
40087400103,5572,4280,395,40,320,31,5,11,1292
40087400104,5465,4306,304,44,240,14,4,11,1159
40087400105,4063,3031,267,22,240,26,2,6,1032
40087400106,5559,4200,395,71,337,23,2,18,1359
40087400201,3861,2840,310,25,324,19,5,10,1021
40087400203,4925,3638,453,21,304,6,10,17,1287
40087400204,5410,3836,558,52,373,51,3,17,1574
40087400300,5624,3673,965,60,413,38,4,10,1951
40087400400,1183,897,52,11,102,1,1,0,286
40089098200,2349,1511,45,1,581,1,0,0,838
40089098300,1489,870,49,41,379,1,0,3,619
40089098400,3935,2661,100,156,477,18,0,18,1274
40089098501,3610,2396,178,50,572,16,0,0,1214
40089098502,1924,1374,65,44,220,6,1,1,550
40089098600,5588,2877,540,329,853,35,316,3,2711
40089098700,3921,1709,298,1173,358,7,14,6,2212
40089098800,5689,3201,540,548,618,28,129,5,2488
40089098900,2309,1560,79,196,232,12,0,4,749
40091779601,1646,1304,17,9,166,9,0,2,342
40091779602,2766,1791,73,70,520,7,0,4,975
40091779700,3249,1978,120,125,591,29,0,24,1271
40091779900,2803,1692,64,107,637,10,2,1,1111
40091780100,2048,1354,45,28,381,2,1,8,694
40091780200,3182,2093,86,178,480,7,0,5,1089
40091780301,1258,998,41,5,118,2,1,0,260
40091780302,1989,1434,45,25,270,2,0,12,555
40093955100,3067,2360,540,6,36,20,0,6,707
40093955200,1718,1543,67,1,27,1,0,2,175
40093955300,2997,2576,177,8,68,19,0,1,421
40095094698,3365,2237,408,11,380,4,2,32,1128
40095094700,4787,2089,1854,128,335,29,1,7,2698
40095094803,2182,1726,63,14,187,6,0,3,456
40095094804,1194,850,79,4,170,0,0,4,344
40095094805,1990,1438,124,4,207,0,0,32,552
40095094806,1794,1409,77,8,134,5,1,7,385
40097040100,4486,2623,296,42,785,32,3,3,1863
40097040200,5132,3171,294,43,793,63,8,10,1961
40097040300,4180,2557,148,5,751,7,2,0,1623
40097040400,5351,3445,175,23,896,17,2,14,1906
40097040501,2899,1644,58,12,773,12,1,2,1255
40097040502,3814,2040,76,11,1123,24,2,4,1774
40097040600,3783,1914,70,7,1201,9,0,6,1869
40097040700,3313,2075,81,24,702,11,2,3,1238
40097040801,3294,2212,110,8,608,13,5,5,1082
40097040802,2794,1835,67,5,463,4,2,3,959
40099790600,2041,1450,108,6,298,0,2,1,591
40099790701,3791,2566,227,74,532,17,3,5,1225
40099790702,1701,1230,55,16,238,4,0,4,471
40099790801,3656,2359,332,45,512,10,14,3,1297
40099790802,2715,1841,204,12,356,14,0,3,874
40101000100,4565,1980,283,1016,629,50,3,17,2585
40101000200,1485,519,69,539,162,2,1,0,966
40101000300,2935,1096,226,959,276,12,0,7,1839
40101000400,1604,616,133,526,129,14,4,2,988
40101000600,3674,1840,251,337,729,24,4,14,1834
40101000700,4599,1939,1073,377,667,11,0,10,2660
40101000801,5421,3030,312,398,890,80,5,10,2391
40101000802,2296,1248,93,153,431,40,2,4,1048
40101000901,3488,1899,196,123,685,82,4,9,1589
40101000902,4476,2282,609,284,760,19,1,11,2194
40101001000,1610,689,114,357,184,18,0,1,921
40101001100,2776,1647,61,133,667,11,0,4,1129
40101001200,4504,2613,214,672,703,39,4,4,1891
40101001301,2974,1716,195,161,514,43,1,4,1258
40101001302,3324,1849,123,37,869,16,1,16,1475
40101001401,3938,2109,197,72,911,10,3,23,1829
40101001402,3127,1871,83,12,758,12,0,2,1256
40101001501,3531,2131,91,79,808,10,0,12,1400
40101001502,2189,1372,27,5,537,13,3,7,817
40101001600,3823,2411,149,305,438,6,3,8,1412
40103956600,2970,1909,121,19,610,4,0,6,1061
40103956900,3352,2658,156,64,143,23,0,5,694
40103957000,1647,1324,76,42,46,13,0,4,323
40103957100,2955,2523,67,20,154,7,0,15,432
40105172100,1921,1297,57,15,213,0,1,1,624
40105172200,1416,884,28,17,246,0,1,0,532
40105172300,1810,1219,28,4,322,0,1,0,591
40105172400,4173,2412,128,68,781,5,2,7,1761
40107080600,2755,1766,57,36,639,7,0,1,989
40107080700,3125,2002,124,468,316,15,0,15,1123
40107080900,3449,1771,114,81,1026,10,0,14,1678
40107081000,1981,1051,47,109,578,0,0,3,930
40109100100,3040,1710,448,239,70,349,3,5,1330
40109100201,1570,1041,146,86,41,98,7,4,529
40109100202,1639,776,380,180,71,94,0,14,863
40109100203,2538,1192,687,214,91,140,1,10,1346
40109100300,2681,2046,178,80,52,64,0,8,635
40109100400,1955,134,132,1534,25,4,0,5,1821
40109100500,1898,252,143,1256,26,69,4,5,1646
40109100800,2260,1027,447,283,66,248,0,5,1233
40109100900,1532,1014,213,61,37,56,0,0,518
40109101000,2892,1304,513,276,69,486,3,100,1588
40109101100,832,534,92,61,31,31,1,9,298
40109101200,1107,718,81,93,27,70,2,10,389
40109101300,2886,219,221,2154,48,2,0,28,2667
40109101400,1055,130,90,731,23,6,0,0,925
40109101500,1912,688,83,836,41,110,0,22,1224
40109101800,1499,1108,110,44,29,48,8,5,391
40109101900,2623,1667,409,145,60,109,3,14,956
40109102000,2798,1543,635,215,100,94,0,21,1255
40109102100,2112,1063,702,86,64,50,0,6,1049
40109102200,2693,895,1360,132,86,74,2,0,1798
40109102300,3166,1239,1361,199,72,62,9,9,1927
40109102400,2906,861,1482,185,98,97,2,11,2045
40109102500,1594,1057,121,155,45,88,0,6,537
40109103200,2633,1300,309,706,76,106,0,7,1333
40109103300,1445,341,818,162,28,22,0,1,1104
40109103900,3788,604,2508,334,132,47,2,3,3184
40109104100,3001,646,1643,359,108,22,12,17,2355
40109104200,2209,253,1800,46,57,18,0,2,1956
40109104300,3266,456,2576,73,82,4,1,4,2810
40109104400,3491,412,2796,126,65,12,1,4,3079
40109104500,3333,460,2630,75,94,12,5,1,2873
40109104600,985,168,729,22,21,10,0,3,817
40109104700,1198,349,602,120,70,2,0,5,849
40109104800,3323,601,2428,105,67,7,0,12,2722
40109104900,3734,683,2676,150,106,6,2,14,3051
40109105000,2269,361,1717,62,48,17,1,5,1908
40109105101,2347,1249,191,425,69,241,3,11,1098
40109105201,1576,106,93,1224,11,8,0,2,1470
40109105202,1194,67,54,1001,2,4,0,1,1127
40109105300,3223,786,1812,231,158,32,1,17,2437
40109105400,2021,505,1268,90,65,19,2,0,1516
40109105500,3060,543,2065,202,120,14,1,7,2517
40109105600,4731,842,3159,312,200,19,2,15,3889
40109105903,2804,1193,811,376,94,96,8,15,1611
40109105904,4027,1397,1583,424,115,180,0,27,2630
40109105905,2978,1174,1118,316,94,70,4,22,1804
40109105906,2938,1223,1226,142,88,63,2,8,1715
40109105907,4607,1290,2492,311,127,149,0,18,3317
40109106000,2281,643,136,1305,23,28,0,5,1638
40109106100,3214,604,188,2130,93,8,1,12,2610
40109106200,1462,167,64,1099,14,3,0,3,1295
40109106301,3512,611,780,1739,46,15,7,20,2901
40109106302,4589,838,985,2223,73,106,0,41,3751
40109106303,3530,1490,959,604,76,55,0,12,2040
40109106401,2167,1858,65,4,58,49,0,6,309
40109106402,2127,1673,136,47,53,48,4,10,454
40109106403,4818,3486,397,206,105,87,1,23,1332
40109106501,2872,2135,182,176,44,102,0,4,737
40109106502,3850,2062,541,496,87,330,0,12,1788
40109106503,1758,1280,131,119,30,77,0,3,478
40109106601,3148,1698,518,373,80,173,3,4,1450
40109106602,2575,1368,448,316,71,123,6,28,1207
40109106606,1983,1222,302,113,48,125,3,6,761
40109106607,3384,1755,559,477,54,248,2,7,1629
40109106608,3189,2257,235,271,63,123,0,13,932
40109106609,1033,708,127,45,27,28,1,5,325
40109106610,1235,763,125,124,25,83,0,13,472
40109106611,2583,1133,334,644,68,133,1,4,1450
40109106702,4006,1750,1380,368,109,65,0,13,2256
40109106704,2434,1510,437,151,82,34,2,14,924
40109106705,2677,1439,374,303,75,250,0,12,1238
40109106706,3635,1817,584,724,94,93,2,19,1818
40109106708,3203,1714,299,332,44,603,1,6,1489
40109106709,2480,675,414,1050,71,59,6,19,1805
40109106710,4258,1742,701,1141,91,122,11,30,2516
40109106801,1774,1137,337,70,61,17,0,0,637
40109106802,2001,1237,434,93,36,23,2,9,764
40109106803,3261,1699,988,232,90,37,7,17,1562
40109106804,3848,1633,1358,381,95,55,0,8,2215
40109106902,2492,1197,771,238,76,18,4,9,1295
40109106903,6139,3794,1125,495,131,111,1,17,2345
40109106906,3283,1252,1235,335,60,219,0,8,2031
40109106907,2106,909,638,291,57,62,1,2,1197
40109106909,1790,895,437,205,63,25,5,2,895
40109106910,2663,1323,605,372,56,67,0,22,1340
40109106911,1893,943,550,124,49,79,2,15,950
40109106912,3198,1113,635,993,102,99,2,3,2085
40109106913,4556,1448,1364,1141,136,135,3,22,3108
40109106914,4311,1564,1592,681,117,42,8,24,2747
40109106916,2481,666,1092,370,87,26,13,9,1815
40109106917,3359,656,1548,791,50,91,12,18,2703
40109107001,5918,1360,3746,260,205,39,17,9,4558
40109107002,2108,809,999,101,67,34,2,13,1299
40109107101,1243,369,317,495,50,5,2,0,874
40109107103,2031,490,1199,145,93,9,0,3,1541
40109107104,2880,825,1411,326,131,28,1,3,2055
40109107206,4555,1815,1589,455,137,157,70,17,2740
40109107207,2191,1027,493,263,95,98,59,15,1164
40109107212,5979,2582,1509,693,274,229,55,36,3397
40109107213,4913,1543,2186,603,194,60,18,13,3370
40109107214,3184,1014,1694,129,115,55,1,15,2170
40109107215,4293,1085,2596,251,120,19,0,13,3208
40109107216,3096,797,1759,223,139,15,0,11,2299
40109107217,2134,446,1425,64,63,16,0,3,1688
40109107218,3107,740,1923,217,61,40,12,14,2367
40109107219,3257,646,2222,94,120,28,12,10,2611
40109107220,3840,840,2318,297,132,35,23,17,3000
40109107221,2395,742,1296,163,59,29,1,7,1653
40109107222,1869,534,930,233,62,27,5,1,1335
40109107223,2867,742,1687,222,95,20,0,9,2125
40109107224,3676,1710,1167,247,154,80,20,7,1966
40109107225,2976,794,1620,289,114,19,0,8,2182
40109107226,3178,963,1387,440,109,88,4,24,2215
40109107302,2979,866,1327,195,163,194,9,5,2113
40109107303,1544,863,408,74,76,18,0,4,681
40109107305,1312,430,396,331,52,1,0,0,882
40109107306,3739,1226,1132,888,139,41,2,18,2513
40109107401,5990,1722,954,2451,166,145,9,28,4268
40109107404,3376,1274,279,1233,67,207,15,16,2102
40109107405,4997,2306,607,1075,136,351,25,30,2691
40109107406,7600,3554,952,1751,153,427,39,39,4046
40109107407,553,370,60,28,18,6,0,1,183
40109107601,2148,1087,203,463,81,67,6,4,1061
40109107604,2025,1157,243,232,110,27,10,13,868
40109107605,2150,1292,188,284,100,23,5,8,858
40109107608,3991,2299,400,568,176,64,4,12,1692
40109107703,3645,2321,285,466,131,64,1,17,1324
40109107704,1657,854,226,242,81,38,9,1,803
40109107705,1998,1230,183,254,69,30,2,4,768
40109107706,2770,1477,297,524,129,38,8,20,1293
40109107707,1282,790,137,141,54,10,3,2,492
40109107801,3603,1360,495,1212,90,37,23,5,2243
40109107804,2395,1395,272,284,130,34,1,9,1000
40109107805,2580,1178,347,685,71,25,2,8,1402
40109107806,4101,2218,414,834,135,62,5,19,1883
40109107807,2866,1473,305,553,111,114,14,9,1393
40109107808,1932,902,251,446,71,81,4,5,1030
40109107809,1734,875,312,284,69,6,2,14,859
40109107810,2660,1451,374,381,134,22,0,5,1209
40109107900,1608,176,72,1189,24,11,0,11,1432
40109108003,3765,1045,197,1946,111,28,12,22,2720
40109108005,2449,779,230,1148,72,13,0,9,1670
40109108006,4039,2090,224,994,110,139,4,30,1949
40109108007,3330,1985,266,590,113,55,2,16,1345
40109108008,4277,1765,409,1415,128,60,7,15,2512
40109108009,3003,1260,250,1026,88,34,0,21,1743
40109108010,3127,1341,378,1006,101,11,19,23,1786
40109108011,3959,816,370,2339,122,25,8,23,3143
40109108101,4298,3268,205,199,113,142,1,17,1030
40109108106,6494,5205,286,128,117,276,2,20,1289
40109108107,3416,2850,119,53,60,94,1,15,566
40109108109,5852,4752,258,89,86,189,2,30,1100
40109108110,4343,3297,242,198,127,171,5,12,1046
40109108113,5001,3434,587,240,135,173,9,12,1567
40109108114,4837,3362,333,309,92,259,11,11,1475
40109108201,3763,2714,264,230,117,84,4,14,1049
40109108203,3247,2010,486,303,117,37,9,9,1237
40109108204,2916,1379,627,565,67,36,0,14,1537
40109108207,1031,553,86,174,41,72,1,3,478
40109108208,3836,2158,272,664,96,188,9,19,1678
40109108215,4741,3351,324,422,82,115,15,27,1390
40109108216,3158,2093,201,358,64,144,5,6,1065
40109108217,4073,2803,321,370,108,83,8,10,1270
40109108222,1899,1573,102,19,46,22,0,5,326
40109108223,5227,4258,207,95,110,166,2,14,969
40109108224,3500,2731,175,131,77,130,1,0,769
40109108225,3252,2420,231,173,63,101,1,4,832
40109108226,2549,1270,283,513,47,188,0,16,1279
40109108227,2272,1505,128,225,36,167,1,20,767
40109108228,1988,1527,124,48,37,97,2,0,461
40109108229,3417,2377,258,230,70,132,5,7,1040
40109108230,2478,1468,184,393,44,113,6,5,1010
40109108231,2350,1880,103,40,16,81,2,8,470
40109108232,3228,2653,128,70,73,43,1,5,575
40109108233,4320,2628,393,431,85,398,6,24,1692
40109108234,5086,3458,313,360,95,395,3,25,1628
40109108235,2620,1528,238,256,57,291,0,18,1092
40109108236,2023,1233,137,276,41,147,2,0,790
40109108237,3156,1953,202,298,57,372,2,9,1203
40109108238,2176,1363,152,349,62,65,0,4,813
40109108301,2162,598,167,1109,44,43,4,18,1564
40109108302,5293,3157,416,990,94,126,3,16,2136
40109108304,4894,3575,324,279,155,89,7,18,1319
40109108307,4811,1948,378,1780,95,110,10,29,2863
40109108309,2278,367,344,1307,41,26,4,11,1911
40109108310,3026,960,324,1361,39,80,8,14,2066
40109108314,2911,1192,319,940,37,139,13,0,1719
40109108317,3910,2500,273,368,68,333,13,11,1410
40109108318,5748,3307,368,666,103,817,5,41,2441
40109108319,3947,2329,336,543,62,303,14,29,1618
40109108320,3492,2736,193,188,73,43,4,11,756
40109108321,1500,521,99,697,29,27,1,2,979
40109108322,4147,1460,411,1733,83,79,21,9,2687
40109108323,4272,2298,377,892,85,247,7,18,1974
40109108324,1987,1494,85,95,29,105,2,4,493
40109108325,5623,3063,485,909,120,545,13,21,2560
40109108326,3149,1808,306,585,53,167,4,17,1341
40109108402,1373,1074,67,43,27,36,0,11,299
40109108403,1946,1397,138,118,55,47,4,6,549
40109108404,3430,2271,244,507,85,92,0,12,1159
40109108506,3333,2410,187,300,64,58,0,11,923
40109108507,1227,973,45,62,23,37,0,0,254
40109108508,1817,1075,153,270,35,87,1,11,742
40109108513,3699,2199,370,579,93,102,4,20,1500
40109108514,4972,2363,468,1395,104,134,17,18,2609
40109108515,5029,3352,377,624,109,187,4,21,1677
40109108520,2048,1566,80,148,46,30,2,2,482
40109108521,1408,548,196,390,28,102,0,2,860
40109108523,6118,3362,477,1074,120,437,0,28,2756
40109108524,5056,3133,300,498,120,573,3,28,1923
40109108525,2135,1134,253,352,32,181,3,18,1001
40109108526,4986,2522,641,1003,107,252,5,19,2464
40109108527,5716,3318,458,1017,109,281,3,23,2398
40109108528,2285,1351,113,434,71,157,0,15,934
40109108529,2781,2014,122,192,48,192,0,11,767
40109108530,3963,2215,293,701,90,254,17,25,1748
40109108531,5237,3669,369,196,119,447,1,15,1568
40109108532,1493,1165,68,55,32,48,2,0,328
40109108533,1676,1313,108,16,38,31,0,7,363
40109108534,5155,3196,363,528,76,517,17,16,1959
40109108535,11132,7335,816,766,200,1034,10,48,3797
40109108536,4907,3298,292,484,76,413,0,11,1609
40109108537,3412,2534,195,292,63,66,0,9,878
40109108538,2656,1718,174,324,55,182,3,4,938
40109108603,5155,3091,885,240,156,291,5,20,2064
40109108604,4966,2605,1245,301,172,253,0,13,2361
40109108701,2625,1842,196,176,97,50,4,17,783
40109108706,2894,1964,185,278,115,57,0,9,930
40109108707,4377,2758,313,577,127,135,6,10,1619
40109108708,4431,3437,233,60,230,39,0,8,994
40109108709,3510,2749,166,50,157,26,0,8,761
40109108710,3925,2729,266,227,185,56,1,16,1196
40109108711,3275,2587,146,71,150,26,1,20,688
40109108712,2388,1704,220,104,82,36,0,13,684
40109108713,3882,2917,209,121,173,55,3,18,965
40109108802,5208,3859,308,167,252,51,0,40,1349
40109108803,940,64,96,668,16,2,0,5,876
40109108804,2981,1735,195,648,105,10,6,9,1246
40109108805,3590,2283,245,526,153,15,5,7,1307
40109108806,1787,1299,64,142,78,26,0,1,488
40109108807,1414,944,95,172,55,15,4,2,470
40109108900,3712,2418,253,480,140,18,6,8,1294
40109109001,2138,1561,158,85,100,2,2,5,577
40109109003,4696,3627,214,46,252,37,3,7,1069
40109109004,3642,2753,206,81,226,32,3,13,889
40109109202,2908,2160,199,112,135,13,2,16,748
40109109203,4017,3115,247,173,67,101,0,10,902
40109109204,2440,2004,120,29,62,40,0,11,436
40109109205,2713,2041,146,55,79,120,0,9,672
40109109300,2047,1384,209,130,63,85,0,8,663
40109109400,1775,1302,99,94,43,97,0,4,473
40109109500,3337,417,287,2286,64,24,0,9,2920
40109109600,793,471,85,55,13,112,1,14,322
40109109700,2418,1328,183,453,39,185,6,2,1090
40109109800,686,202,346,67,45,0,2,3,484
40109109900,1564,841,219,294,97,21,2,6,723
40109110000,1552,507,717,114,118,8,5,2,1045
40109980001,61,27,8,1,0,2,1,0,34
40109980002,0,0,0,0,0,0,0,0,0
40109980003,42,8,4,30,0,0,0,0,34
40109980004,14,9,3,1,0,0,0,0,5
40109980005,1,0,1,0,0,0,0,0,1
40109980006,44,25,4,11,4,0,0,0,19
40109980007,192,133,11,17,1,12,0,4,59
40109980008,6,4,0,2,0,0,0,0,2
40109980009,58,19,7,21,1,1,0,0,39
40111000100,2546,749,106,915,444,11,1,1,1797
40111000200,2655,1290,85,376,539,5,1,17,1365
40111000300,2738,1509,254,224,450,33,0,9,1229
40111000400,4456,2403,198,397,743,33,1,10,2053
40111000500,3624,2402,106,234,457,13,0,0,1222
40111000601,3015,1946,259,17,430,15,0,4,1069
40111000602,4086,2667,221,256,455,9,0,9,1419
40111000700,3558,2211,142,122,619,4,2,12,1347
40111000800,2809,1789,50,130,474,1,1,8,1020
40111000901,2919,1899,96,32,526,18,6,7,1020
40111000902,4300,2734,191,39,810,18,10,5,1566
40113940001,5393,3164,235,484,970,9,0,3,2229
40113940003,4406,2982,175,16,668,11,8,9,1424
40113940004,2356,1611,63,6,367,9,0,0,745
40113940005,4075,2688,251,290,350,8,0,7,1387
40113940006,5403,682,280,3806,145,5,4,13,4721
40113940007,4480,3441,156,38,372,24,0,18,1039
40113940008,2858,1966,66,5,446,6,2,2,892
40113940009,3521,2555,93,9,421,18,0,13,966
40113940011,1220,901,23,5,84,5,0,0,319
40113940012,2014,997,56,31,701,4,1,0,1017
40113940013,2195,1089,135,57,630,2,0,2,1106
40113940014,3914,2639,185,35,594,25,4,14,1275
40113940015,3983,2728,154,14,657,2,0,15,1255
40115574100,3855,2403,97,19,952,19,3,1,1452
40115574200,2766,1474,587,12,427,4,2,3,1292
40115574300,2806,1749,170,27,462,23,105,3,1057
40115574400,2475,1586,164,31,347,10,52,4,889
40115574500,2033,1297,130,30,318,3,38,14,736
40115574600,4327,2643,229,130,711,21,15,7,1684
40115574700,4654,2993,104,14,932,39,5,9,1661
40115574800,3953,2550,88,21,660,25,6,8,1403
40115574900,3416,2155,139,3,754,10,5,1,1261
40117957100,3715,2855,121,27,334,19,0,6,860
40117957200,4223,3230,138,10,368,10,0,8,993
40117957300,3066,2383,94,8,282,16,0,18,683
40117957400,2380,1851,51,0,251,4,0,7,529
40117957500,2169,1211,63,28,692,0,0,3,958
40119010101,5146,3737,302,230,192,125,4,13,1409
40119010102,4955,3182,407,401,206,224,6,14,1773
40119010201,3017,2149,197,85,114,120,0,13,868
40119010202,2440,1475,296,173,105,142,0,11,965
40119010300,3997,3173,231,56,132,87,2,26,824
40119010400,5087,2787,483,353,270,765,3,15,2300
40119010501,721,486,65,21,24,50,1,4,235
40119010502,812,492,71,39,34,101,1,4,320
40119010503,2417,1597,267,69,50,178,2,19,820
40119010600,5078,3569,409,186,216,97,9,12,1509
40119010700,2799,1974,218,188,95,19,2,12,825
40119010800,2174,1621,135,80,99,25,0,12,553
40119010901,2950,2364,102,88,42,164,0,2,586
40119010902,6880,4960,454,188,190,390,6,25,1920
40119011001,3517,2760,233,26,159,51,4,13,757
40119011002,3200,2578,150,28,107,43,5,19,622
40119011101,5507,4280,262,42,216,28,4,26,1227
40119011103,2890,2341,97,30,134,7,1,13,549
40119011104,3789,2939,176,67,251,8,3,11,850
40119011200,2177,1739,81,8,130,2,0,2,438
40119011301,3438,2657,175,36,275,6,0,16,781
40119011302,3771,2844,223,78,228,18,0,11,927
40119011400,4884,3222,339,651,344,12,0,3,1662
40121485601,1049,794,48,1,73,0,0,1,255
40121485602,1550,1161,29,9,180,3,0,0,389
40121485700,2224,1461,81,9,426,4,0,3,763
40121485800,4125,2957,116,21,574,35,8,6,1168
40121485900,2215,1541,75,0,327,6,1,1,674
40121486000,4826,3269,223,62,667,25,0,13,1557
40121486100,4637,2801,360,205,626,30,4,11,1836
40121486200,3594,2104,288,122,552,26,3,2,1490
40121486300,1417,665,125,427,186,1,2,4,752
40121486400,2473,1399,250,63,382,11,9,6,1074
40121486500,5929,3874,404,223,670,79,7,7,2055
40121486600,3012,2087,84,29,419,32,0,0,925
40121486700,4817,3085,131,52,918,28,1,8,1732
40121486800,1905,1190,52,4,388,0,0,0,715
40123088600,5205,3213,195,56,1059,16,0,3,1992
40123088700,2349,1549,81,33,415,4,2,2,800
40123088801,4728,3067,224,87,691,54,0,16,1661
40123088802,3251,1655,192,162,652,36,5,24,1596
40123088900,3620,1878,297,163,629,134,0,23,1742
40123089000,4255,2507,223,33,911,21,1,2,1748
40123089100,2308,1103,237,96,416,18,0,0,1205
40123089200,1405,762,149,60,261,17,1,5,643
40123089300,4031,2297,306,144,641,58,2,2,1734
40123089598,5006,3331,226,23,875,11,2,20,1675
40123089600,1907,1341,78,4,292,3,0,1,566
40125500200,2993,1657,282,241,465,9,1,8,1336
40125500301,3424,1937,194,134,715,13,5,16,1487
40125500302,2696,1532,272,81,533,14,0,7,1164
40125500400,3386,2219,218,151,431,12,0,5,1167
40125500500,4582,2779,478,309,515,53,6,3,1803
40125500600,3400,2358,190,95,361,21,1,6,1042
40125500700,3645,2092,380,235,520,71,0,7,1553
40125500800,4279,3247,165,74,292,94,1,5,1032
40125500901,5050,3507,229,112,578,28,3,10,1543
40125500902,2538,1855,136,35,267,9,2,3,683
40125501003,4776,3646,194,24,382,21,1,21,1130
40125501004,4060,3018,185,56,341,20,3,10,1042
40125501005,6009,4093,347,273,751,37,1,8,1916
40125501006,3375,2376,206,71,363,35,2,7,999
40125501101,5923,3851,276,158,931,27,7,18,2072
40125501103,1547,1157,93,6,113,7,0,1,390
40125501104,4380,3099,206,86,447,10,0,10,1281
40125501105,1994,1414,68,30,215,1,0,7,580
40125501201,1681,1266,57,14,179,6,2,15,415
40125501300,2716,2055,112,9,294,7,4,4,661
40127097600,2627,1820,56,13,527,10,0,12,807
40127097701,2714,1799,108,32,459,24,0,6,915
40127097702,2900,2075,122,15,395,17,0,2,825
40127097800,2571,1688,90,6,449,1,0,3,883
40129960000,3442,2860,256,5,106,5,1,1,582
40131050101,4998,2806,502,91,716,67,1,67,2192
40131050103,2482,1543,199,34,342,25,0,4,939
40131050104,2148,1242,122,75,339,13,1,12,906
40131050105,5383,3565,294,151,619,42,4,30,1818
40131050201,2614,1634,135,17,403,14,0,1,980
40131050202,2972,1751,170,81,518,14,2,9,1221
40131050203,1507,1034,66,9,201,2,1,1,473
40131050301,2501,1631,93,8,403,19,0,6,870
40131050302,2634,1692,138,5,460,7,3,3,942
40131050303,3084,1972,126,7,463,38,5,15,1112
40131050304,3305,2303,135,18,406,28,1,10,1002
40131050403,5489,3696,320,64,437,279,3,17,1793
40131050404,7678,5089,659,192,565,308,5,14,2589
40131050405,4221,3125,177,43,302,103,6,8,1096
40131050406,3645,2761,145,52,236,88,0,16,884
40131050407,2338,1394,240,27,276,78,0,5,944
40131050408,2902,1749,173,43,464,38,0,4,1153
40131050409,1887,1166,288,9,180,8,3,3,721
40131050501,3258,2232,111,14,458,87,0,9,1026
40131050502,3391,2352,120,23,422,42,1,0,1039
40131050601,3934,2519,335,29,501,29,1,14,1415
40131050602,3638,2459,149,18,454,46,0,4,1179
40131050603,2450,1691,70,21,264,24,0,8,759
40131050604,3996,2722,164,20,505,31,0,10,1274
40131050701,2107,1197,34,10,487,2,0,0,910
40131050702,3010,1896,62,10,649,30,0,5,1114
40131050801,4531,3047,136,16,585,176,2,7,1484
40131050802,3137,2119,94,16,454,38,0,4,1018
40133583100,1594,1112,40,57,201,11,0,3,482
40133583200,3198,2183,123,43,552,0,0,12,1015
40133583300,2466,1638,168,40,305,19,4,43,828
40133583400,4266,2356,301,125,867,14,3,2,1910
40133583500,1938,1107,84,79,395,7,0,5,831
40133583600,3832,1826,185,465,832,8,0,7,2006
40133583700,2008,1394,92,19,293,4,1,6,614
40133583800,2632,1519,110,29,659,6,0,6,1113
40133583900,1622,974,73,63,307,3,0,5,648
40135030101,4077,2138,98,14,1260,33,0,10,1939
40135030103,2437,1395,146,165,326,19,0,9,1042
40135030105,4359,2714,224,17,835,27,1,17,1645
40135030106,2322,1447,68,61,435,12,2,3,875
40135030201,2277,1436,46,9,546,10,4,5,841
40135030202,5026,2601,160,103,1431,35,1,12,2425
40135030301,2099,1133,148,34,507,24,0,10,966
40135030303,3474,1835,296,72,782,27,1,9,1639
40135030304,3232,1809,148,12,761,19,1,11,1423
40135030401,3630,2250,115,38,742,20,2,13,1380
40135030403,3374,2059,140,24,644,29,2,5,1315
40135030404,2974,1680,137,36,685,33,0,6,1294
40137000101,5573,4177,397,105,251,83,0,21,1396
40137000102,3121,2390,223,62,145,21,0,8,731
40137000200,3866,3026,277,44,107,33,0,17,840
40137000300,2137,1467,310,47,77,4,6,6,670
40137000400,5221,3476,840,136,250,40,4,35,1745
40137000600,2987,1780,492,321,104,13,2,9,1207
40137000800,5006,4161,223,30,240,12,1,14,845
40137000901,4619,3754,235,20,191,21,0,11,865
40137000902,3328,2676,139,10,208,12,0,12,652
40137001000,1979,1496,80,4,140,4,0,3,483
40137001100,5011,3980,236,20,321,1,0,7,1031
40139950600,3601,1951,1455,14,30,11,0,4,1650
40139950700,2755,1570,943,91,44,17,0,0,1185
40139950800,5708,1392,3539,452,28,78,0,36,4316
40139950901,2280,258,1645,164,2,156,0,16,2022
40139950902,5590,2234,2723,249,44,184,0,12,3356
40139951000,1450,858,518,5,14,2,0,0,592
40141070100,928,654,168,41,16,3,0,5,274
40141070200,1051,667,227,73,18,3,0,0,384
40141070300,2253,1238,655,166,87,6,0,16,1015
40141070400,1413,612,578,119,30,13,0,3,801
40141070500,1323,811,295,75,40,1,0,1,512
40143000200,1380,91,170,1002,12,11,0,14,1289
40143000300,3986,730,1742,1060,138,0,10,11,3256
40143000400,4340,935,2221,628,248,5,22,8,3405
40143000500,2331,188,209,1594,68,14,2,4,2143
40143000800,1342,266,73,817,37,5,0,6,1076
40143000900,1205,391,97,470,66,10,11,5,814
40143001000,1366,139,40,1026,23,11,0,12,1227
40143001200,1730,334,962,215,81,45,0,0,1396
40143001300,2172,590,1178,144,106,24,2,3,1582
40143001400,5409,1438,2700,479,300,71,32,25,3971
40143001500,4241,1700,1540,347,272,8,24,12,2541
40143001600,5424,1531,2648,548,285,24,0,19,3893
40143001700,2521,1530,364,182,146,12,9,13,991
40143001800,1918,1128,292,100,138,22,3,2,790
40143001900,1600,1043,177,85,98,23,2,10,557
40143002000,1792,992,383,100,78,54,0,7,800
40143002100,3130,1729,437,369,118,193,3,16,1401
40143002301,2356,1096,706,186,129,16,4,2,1260
40143002500,4984,2916,501,876,251,116,2,12,2068
40143002700,2836,1529,442,276,239,27,0,13,1307
40143002900,2689,1732,142,204,205,16,4,4,957
40143003000,1818,1105,192,101,163,3,6,4,713
40143003100,2468,1789,147,132,108,51,0,11,679
40143003200,1479,1126,65,40,64,9,1,6,353
40143003300,1978,1494,90,31,69,46,2,6,484
40143003400,2309,1444,220,193,147,28,2,17,865
40143003500,2044,1462,138,44,120,27,1,0,582
40143003600,2041,1575,109,18,95,20,0,9,466
40143003700,2527,1834,159,56,109,25,1,12,693
40143003800,1854,1148,194,101,146,31,0,1,706
40143003900,4040,2711,345,211,225,48,11,28,1329
40143004000,4209,2992,260,183,231,38,0,15,1217
40143004101,2292,1893,50,10,81,38,7,3,399
40143004200,2879,2339,99,34,91,40,0,4,540
40143004301,2214,1891,91,11,64,23,0,3,323
40143004302,3414,2829,133,32,109,50,0,5,585
40143004400,2102,1570,116,65,86,36,0,12,532
40143004500,2524,2076,100,30,93,39,1,16,448
40143004600,3190,1091,359,888,191,50,189,9,2099
40143004700,1962,1243,173,71,205,28,1,6,719
40143004800,4384,2688,520,195,403,26,10,11,1696
40143004900,1666,897,195,197,140,9,11,13,769
40143005001,1899,1312,160,68,128,24,0,9,587
40143005002,3475,2339,250,234,241,67,6,14,1136
40143005100,1952,1463,105,72,60,38,4,7,489
40143005200,2984,2035,219,176,162,79,2,12,949
40143005300,4618,3047,504,272,236,60,0,7,1571
40143005401,3520,2283,232,24,419,126,0,10,1237
40143005403,4143,2787,207,34,479,54,0,15,1356
40143005404,4835,3156,307,58,503,198,1,20,1679
40143005500,3564,2539,153,20,435,4,0,4,1025
40143005600,2479,1609,130,19,371,26,2,7,870
40143005700,2229,248,300,1408,90,27,0,0,1981
40143005801,4114,2546,474,91,333,103,10,10,1568
40143005805,7369,4744,840,288,481,149,24,22,2625
40143005808,4154,2790,240,184,279,206,0,8,1364
40143005809,8362,5766,610,347,470,239,13,34,2596
40143005810,3660,2334,332,108,292,87,1,21,1326
40143005811,4668,3044,399,204,301,144,3,20,1624
40143005812,3439,2489,217,149,237,52,0,10,950
40143005813,2946,1856,267,147,215,125,2,0,1090
40143005900,2693,843,1051,321,151,91,12,0,1850
40143006000,5167,1464,2368,609,299,14,0,26,3703
40143006200,2687,253,199,1860,73,0,37,12,2434
40143006506,2391,1739,101,51,203,15,0,5,652
40143006507,1698,1160,106,95,115,0,0,4,538
40143006600,2694,1825,177,15,307,10,1,11,869
40143006701,3089,1296,320,646,282,117,11,8,1793
40143006703,4587,2869,461,219,324,198,0,27,1718
40143006708,9430,6807,495,192,461,447,3,34,2623
40143006709,8244,5141,641,259,413,898,2,15,3103
40143006710,4533,2553,233,143,221,979,3,10,1980
40143006711,3450,1896,294,197,211,461,3,5,1554
40143006712,1877,1368,93,57,48,143,0,5,509
40143006713,2488,1666,181,179,131,97,0,12,822
40143006801,3106,1307,351,887,134,31,16,9,1799
40143006803,3068,1538,329,668,159,24,4,18,1530
40143006804,2708,1302,485,488,142,48,0,10,1406
40143006901,4144,3005,223,217,182,125,3,19,1139
40143006902,1559,1194,96,45,58,12,0,8,365
40143006903,3790,2404,436,260,150,63,4,27,1386
40143006905,4543,1590,1162,1008,195,109,1,31,2953
40143006906,1956,782,553,227,98,69,0,11,1174
40143006907,3126,1438,556,468,122,188,4,14,1688
40143007000,2835,1551,277,466,148,46,1,8,1284
40143007101,3608,1615,783,630,205,41,3,7,1993
40143007102,2493,906,674,453,118,55,21,29,1587
40143007200,4093,1740,1248,366,271,19,3,15,2353
40143007304,3588,1256,1239,519,181,81,8,13,2332
40143007306,6037,1321,3040,846,227,218,4,32,4716
40143007308,3360,1898,562,133,260,162,0,11,1462
40143007309,1657,620,631,146,84,62,0,10,1037
40143007310,3961,1109,1844,347,141,193,36,6,2852
40143007311,2885,850,1119,368,142,199,19,0,2035
40143007312,4980,1502,1885,807,215,157,14,26,3478
40143007313,2565,710,1083,327,77,86,28,15,1855
40143007314,3758,1267,1304,542,161,94,26,18,2491
40143007402,2689,1842,209,88,193,26,0,8,847
40143007408,1304,848,132,96,93,11,0,7,456
40143007409,4302,1989,1026,418,164,368,0,5,2313
40143007410,2954,1096,641,573,132,187,2,12,1858
40143007411,3791,1779,610,611,157,303,1,18,2012
40143007412,3748,2167,372,210,122,550,3,8,1581
40143007413,3926,2515,398,233,156,225,2,8,1411
40143007414,2763,1624,321,291,119,77,1,9,1139
40143007415,1711,1049,179,79,122,59,0,8,662
40143007416,1657,1146,172,52,73,63,1,7,511
40143007417,1357,839,132,64,59,76,6,3,518
40143007503,2628,1756,304,103,151,24,0,9,872
40143007507,3806,2424,400,176,231,146,0,19,1382
40143007510,5463,3497,555,329,291,142,18,33,1966
40143007511,3308,2114,320,156,203,78,1,3,1194
40143007512,4445,3046,364,223,211,102,2,13,1399
40143007518,3642,2077,321,159,132,628,3,25,1565
40143007519,3698,2296,346,208,164,318,0,6,1402
40143007520,4347,3160,227,73,233,222,0,21,1187
40143007522,2456,1603,219,157,177,32,0,6,853
40143007523,2622,1905,160,47,154,36,2,4,717
40143007525,1931,1278,202,62,131,28,0,3,653
40143007526,1982,1342,168,93,80,77,1,9,640
40143007527,1291,870,104,61,66,49,2,6,421
40143007528,2134,1291,221,137,61,231,0,2,843
40143007529,4068,2780,310,173,224,130,0,14,1288
40143007530,2560,1682,203,107,107,172,0,15,878
40143007531,3859,2802,214,138,165,191,1,10,1057
40143007532,3556,2533,251,101,164,70,2,10,1023
40143007533,2772,2051,205,67,144,24,0,16,721
40143007534,2740,1903,147,123,149,36,2,1,837
40143007535,2609,1802,171,106,127,57,2,5,807
40143007536,2864,2079,184,91,104,53,3,12,785
40143007608,2425,802,333,821,133,62,19,9,1623
40143007611,1252,853,55,132,70,33,0,7,399
40143007612,3867,2302,459,502,94,289,6,29,1565
40143007613,3260,2268,223,256,114,82,0,15,992
40143007614,2479,1804,189,117,85,51,0,9,675
40143007615,2332,1625,166,226,58,50,3,12,707
40143007616,3478,2371,283,222,154,85,2,13,1107
40143007617,3899,1853,723,649,150,143,6,22,2046
40143007619,3945,2543,508,196,173,94,0,16,1402
40143007629,3728,2367,362,263,153,276,0,11,1361
40143007630,4983,2852,544,421,180,482,0,11,2131
40143007631,3240,2471,172,91,110,86,2,20,769
40143007632,3027,2137,180,205,88,147,6,8,890
40143007633,2754,1961,206,99,118,111,0,20,793
40143007634,3881,2503,510,282,156,127,5,12,1378
40143007636,4313,3170,289,84,203,192,1,11,1143
40143007638,4713,3617,162,58,159,305,0,11,1096
40143007639,4902,3232,417,330,176,182,0,9,1670
40143007641,4584,1397,529,925,217,1126,4,17,3187
40143007642,1996,762,217,363,66,420,9,13,1234
40143007643,1071,500,82,289,51,19,0,4,571
40143007644,3608,1441,490,1052,139,108,3,8,2167
40143007645,4003,2099,423,424,141,515,2,34,1904
40143007646,3058,1376,359,608,109,299,0,10,1682
40143007647,2784,1883,224,167,110,103,1,4,901
40143007648,2723,1564,319,336,113,84,4,10,1159
40143007649,2233,1585,109,129,67,140,0,3,648
40143007650,3082,1321,586,364,149,392,6,8,1761
40143007651,2718,2094,150,23,162,28,0,18,624
40143007652,3539,2652,139,68,99,271,4,18,887
40143007653,2042,1691,61,22,68,64,3,4,351
40143007654,3714,2850,108,35,118,193,0,24,864
40143007655,3321,2074,519,78,214,94,2,6,1247
40143007656,3642,2423,268,71,177,257,0,15,1219
40143007703,2872,1975,142,58,309,3,1,5,897
40143007704,4425,2231,269,146,597,631,3,8,2194
40143007705,2579,1595,157,94,319,37,0,0,984
40143007706,3212,1988,226,104,395,89,11,14,1224
40143007707,3420,2122,392,81,353,39,5,10,1298
40143007801,3187,1990,356,66,317,14,4,10,1197
40143007803,4388,3037,369,94,266,117,0,4,1351
40143007804,2704,1949,134,62,207,1,0,5,755
40143007900,4649,460,397,3152,209,7,5,27,4189
40143008001,1975,599,320,743,92,4,42,1,1376
40143008002,2724,312,146,1929,65,3,6,0,2412
40143008200,2488,669,1196,275,122,65,3,4,1819
40143008300,1416,564,481,167,73,19,0,9,852
40143008400,3477,1967,553,285,178,123,3,16,1510
40143008501,2772,1270,653,387,125,94,0,5,1502
40143008502,4854,2525,1005,422,280,161,2,10,2329
40143008600,3823,1922,525,559,213,193,7,13,1901
40143008700,3216,2341,202,250,114,32,0,15,875
40143008800,2045,1216,223,114,193,11,1,12,829
40143008900,3579,1083,1586,379,167,52,4,20,2496
40143009006,7010,1771,3468,798,186,289,5,19,5239
40143009008,3836,861,1885,601,112,31,4,29,2975
40143009010,3930,1036,1538,588,116,353,0,9,2894
40143009011,2235,567,913,419,110,64,11,6,1668
40143009012,3211,556,2098,279,74,60,0,7,2655
40143009013,2272,947,652,248,110,110,1,6,1325
40143009014,1924,667,725,215,71,91,7,3,1257
40143009015,4268,2481,561,228,200,296,2,11,1787
40143009016,3695,2632,218,161,173,173,4,6,1063
40143009017,2417,795,625,357,80,393,2,1,1622
40143009018,1982,1309,122,96,51,259,0,6,673
40143009019,3808,2190,467,315,198,248,9,21,1618
40143009020,2963,1845,356,194,146,90,5,7,1118
40143009021,2675,1593,358,203,118,95,2,17,1082
40143009101,2495,620,340,1093,114,22,3,21,1875
40143009104,2440,1229,425,315,162,45,0,3,1211
40143009200,3530,2495,219,77,250,20,0,12,1035
40143009300,3821,2664,230,59,350,17,0,10,1157
40143009401,4959,3588,251,86,431,16,1,7,1371
40143009403,3566,2516,151,47,370,14,4,13,1050
40143009404,2464,1792,125,32,189,9,7,12,672
40143009500,5140,3690,238,59,504,13,0,13,1450
40143011300,2735,995,1048,281,176,5,11,13,1740
40143011400,3115,234,227,2236,75,5,7,9,2881
40145030101,4346,2743,144,164,698,11,0,5,1603
40145030102,4020,2387,126,362,599,17,2,13,1633
40145030201,2724,1939,70,5,396,5,0,7,785
40145030202,3080,1991,57,49,558,17,2,5,1089
40145030300,1634,1112,75,52,168,10,0,2,522
40145030402,4445,3155,265,43,377,97,0,0,1290
40145030403,1913,1112,296,31,219,17,2,1,801
40145030406,5238,3087,686,304,301,270,3,15,2151
40145030407,4080,2314,580,288,236,209,4,18,1766
40145030408,2663,1601,290,97,227,187,0,12,1062
40145030502,2731,1907,177,69,199,30,0,4,824
40145030505,1746,1273,102,17,116,42,0,9,473
40145030506,2019,1380,191,76,104,26,0,0,639
40145030507,2548,1173,887,86,134,21,0,10,1375
40145030508,2161,1577,126,40,130,39,1,4,584
40145030509,5548,3814,452,168,362,80,0,15,1734
40145030510,2913,1915,245,59,241,80,0,10,998
40145030511,2962,2110,204,53,211,40,1,6,852
40145030512,4571,3195,240,66,366,72,3,14,1376
40145030601,5349,3621,225,117,639,32,8,18,1728
40145030603,3172,2048,167,61,424,33,1,15,1124
40145030604,2730,1806,119,123,294,13,0,12,924
40145030605,1698,1075,101,48,187,7,2,14,623
40145030798,3059,1848,112,219,490,6,0,5,1211
40145030800,3631,2551,200,41,397,44,0,11,1080
40147000100,1831,1046,146,131,234,6,1,5,785
40147000200,1857,1015,158,154,249,10,0,1,842
40147000300,2391,1550,210,106,214,40,0,8,841
40147000400,4599,3011,463,84,487,82,0,12,1588
40147000500,6311,4027,561,164,547,204,2,3,2284
40147000601,5173,3626,290,125,386,177,0,14,1547
40147000602,3137,2112,224,85,220,176,0,1,1025
40147000700,6375,4784,302,108,359,153,0,24,1591
40147000800,3494,2318,238,95,282,25,3,21,1176
40147000900,2081,1207,186,164,213,27,2,2,874
40147001000,2096,1534,59,3,289,1,0,3,562
40147001100,5025,3473,240,75,622,4,2,6,1552
40147001200,2286,1672,84,4,227,12,0,10,614
40147001300,5799,3833,199,24,865,57,0,11,1966
40149964900,3776,2990,355,41,110,14,0,10,786
40149965000,1989,1556,259,6,47,3,0,2,433
40149965100,3409,2878,224,13,84,0,0,4,531
40149965400,1750,1394,142,17,62,5,0,1,356
40151954201,2540,2111,172,20,47,38,1,5,429
40151954202,1677,1305,158,82,57,13,0,0,372
40151954300,2822,2232,202,122,108,22,0,7,590
40151954400,1585,1377,81,4,28,1,0,3,208
40153953100,2059,1764,146,4,38,1,0,6,295
40153953200,4867,3798,407,265,196,10,0,20,1069
40153953300,4114,2871,877,26,101,14,0,12,1243
40153953400,3426,2367,765,27,88,29,0,2,1059
40153953500,6004,4626,811,29,120,72,0,17,1378
41001950100,2844,2552,116,0,38,0,4,33,292
41001950200,3191,2738,170,10,27,17,0,19,453
41001950300,2745,2390,138,8,28,9,4,10,355
41001950400,3088,2758,132,6,40,23,2,7,330
41001950500,2749,2380,185,38,28,14,4,19,369
41001950600,2051,1846,68,8,11,1,1,10,205
41003000101,4344,3161,591,44,35,125,29,24,1183
41003000102,3409,2308,490,50,21,207,13,31,1101
41003000202,5256,4233,295,45,13,328,10,23,1023
41003000401,2968,2340,196,28,12,169,2,23,628
41003000402,5069,3716,322,47,15,651,12,31,1353
41003000500,3416,2881,178,14,12,132,11,15,535
41003000600,5215,3776,710,67,31,236,33,25,1439
41003000900,5997,4483,411,60,20,576,8,29,1514
41003001001,4064,2534,875,68,30,264,8,33,1530
41003001002,3243,2407,330,27,10,276,10,6,836
41003001101,3868,2613,376,52,33,495,15,35,1255
41003001102,4558,3254,358,48,33,519,14,17,1304
41003010101,4015,3418,261,11,24,66,11,15,597
41003010102,7258,6006,484,80,40,212,10,37,1252
41003010200,4340,3625,278,22,25,72,9,30,715
41003010300,3243,2864,132,2,18,23,0,15,379
41003010400,3959,3274,372,7,31,27,4,12,685
41003010601,3074,2011,335,54,30,399,11,26,1063
41003010602,3767,2690,390,56,15,413,21,22,1077
41003010702,4221,3019,358,67,1,519,25,41,1202
41003010800,3859,3057,403,28,39,49,5,17,802
41003010900,6041,4539,379,61,40,617,15,31,1502
41005020101,2581,2019,132,27,3,231,0,18,562
41005020102,2466,2000,149,12,11,141,2,5,466
41005020201,4135,3477,226,31,7,147,6,14,658
41005020202,2505,2082,108,9,2,168,7,19,423
41005020302,3974,2979,235,44,12,392,7,18,995
41005020303,5388,3996,373,65,12,528,12,32,1392
41005020304,5755,3947,355,50,6,995,7,42,1808
41005020401,5632,4450,363,35,13,329,4,29,1182
41005020403,3927,3178,169,26,8,257,6,10,749
41005020404,3940,3273,208,23,4,178,6,12,667
41005020503,2674,2284,116,11,0,106,2,20,390
41005020504,6695,5563,299,38,13,310,7,36,1132
41005020505,3186,2731,111,12,12,140,0,23,455
41005020506,3419,2777,242,33,9,149,1,14,642
41005020507,4166,3147,220,49,17,382,11,31,1019
41005020601,3242,2684,209,24,13,91,4,13,558
41005020602,5444,4335,350,47,10,293,7,19,1109
41005020700,4116,3453,229,33,6,118,7,15,663
41005020800,4355,3503,335,78,32,99,10,19,852
41005020900,3893,3112,312,56,16,75,11,40,781
41005021000,4642,3630,431,50,35,112,10,44,1012
41005021100,5276,4123,501,71,35,136,38,24,1153
41005021200,3889,3081,349,60,21,86,13,16,808
41005021300,6128,4731,680,79,32,126,14,26,1397
41005021400,5126,4076,466,75,37,125,16,24,1050
41005021500,5196,4154,347,83,24,228,11,34,1042
41005021601,5983,3822,1280,101,78,229,19,46,2161
41005021602,5039,3411,845,174,26,205,18,17,1628
41005021700,6322,5026,598,82,29,144,23,25,1296
41005021801,5775,4757,366,59,14,175,7,33,1018
41005021802,4347,3192,574,84,32,114,15,26,1155
41005021900,3463,2638,406,44,22,45,14,17,825
41005022000,6921,5665,546,57,50,156,24,34,1256
41005022101,6683,5066,805,96,75,194,23,24,1617
41005022105,6416,4324,695,118,34,799,19,23,2092
41005022107,4193,2665,706,123,23,250,40,30,1528
41005022108,3168,1870,924,53,32,54,9,17,1298
41005022109,3526,2205,273,39,11,755,9,8,1321
41005022110,4847,2977,438,69,16,1050,19,9,1870
41005022201,5680,3021,1418,268,52,401,131,36,2659
41005022205,4152,2861,328,74,10,621,17,37,1291
41005022206,6830,4452,438,140,44,1303,20,41,2378
41005022207,6414,4230,375,90,17,1267,22,20,2184
41005022208,9406,6033,623,181,33,1905,13,52,3373
41005022301,4953,4081,391,51,27,91,18,26,872
41005022302,6072,4991,475,53,53,138,9,34,1081
41005022400,4180,3480,241,33,30,50,12,24,700
41005022501,3286,2693,281,8,14,47,6,14,593
41005022502,4527,3552,502,54,28,51,8,24,975
41005022602,4635,3831,307,25,11,111,3,27,804
41005022603,4074,3048,535,31,16,90,7,19,1026
41005022605,7772,6063,846,97,61,169,20,42,1709
41005022606,6010,4974,399,35,35,164,16,39,1036
41005022702,7223,5886,348,48,17,401,10,45,1337
41005022707,8186,6190,806,97,33,508,14,37,1996
41005022708,4281,2987,830,59,25,102,16,24,1294
41005022710,2899,2014,503,28,12,130,32,9,885
41005022800,4051,3570,212,17,20,64,2,20,481
41005022901,4541,3584,581,18,30,67,9,13,957
41005022904,3850,2602,905,11,18,41,3,43,1248
41005022905,4448,3476,617,15,23,67,3,6,972
41005022906,3008,2251,570,8,20,27,2,14,757
41005022907,4144,2334,1472,30,26,38,6,15,1810
41005023001,3555,3105,167,21,25,49,0,12,450
41005023002,3770,3197,272,17,12,43,2,32,573
41005023100,6431,5566,293,28,30,133,0,46,865
41005023201,4904,3910,353,41,20,308,13,15,994
41005023202,8054,6108,720,95,42,490,32,60,1946
41005023300,5294,4439,370,22,30,115,0,20,855
41005023401,4914,3912,616,11,38,78,2,9,1002
41005023403,6462,5275,533,66,55,119,17,20,1187
41005023404,6967,5857,527,22,64,67,13,16,1110
41005023500,6050,4903,640,22,41,89,3,40,1147
41005023600,3963,3467,185,11,24,63,0,20,496
41005023700,4997,4379,232,17,41,52,3,16,618
41005023800,6578,5277,774,12,55,75,2,47,1301
41005023901,6003,4593,951,37,37,62,13,29,1410
41005023902,5690,4413,796,10,31,46,20,32,1277
41005024000,2821,2482,97,9,16,7,8,30,339
41005024100,5093,4451,227,6,45,39,4,27,642
41005024200,7428,6310,483,47,46,91,10,23,1118
41005024302,5256,4366,434,19,28,36,9,32,890
41005024303,3164,2677,265,12,20,15,4,26,487
41005024304,2251,1964,110,2,19,20,4,16,287
41005024401,3504,2425,575,44,15,140,23,13,1079
41005024402,5115,3630,724,73,27,350,17,10,1485
41005980000,82,48,24,1,1,7,0,0,34
41007950100,3454,2618,444,13,42,72,9,30,836
41007950200,3805,3248,246,13,18,61,5,23,557
41007950300,3072,2360,404,23,39,25,16,19,712
41007950400,3759,3307,153,14,34,30,9,11,452
41007950500,5451,4377,469,34,52,83,22,35,1074
41007950600,3393,2816,272,10,38,44,1,20,577
41007950700,2602,2156,251,13,26,22,5,0,446
41007950900,4861,3606,815,62,40,64,6,25,1255
41007951100,4841,3965,466,33,24,82,5,31,876
41007951200,3212,2759,229,5,18,30,11,21,453
41007951300,2622,2314,99,4,13,39,2,16,308
41007990000,0,0,0,0,0,0,0,0,0
41009970201,3505,2969,180,17,42,34,10,17,536
41009970202,2857,2473,144,9,41,23,0,12,384
41009970300,4380,3780,206,26,61,23,6,11,600
41009970400,2491,2137,108,3,38,24,0,13,354
41009970500,6802,5835,356,29,58,95,6,29,967
41009970600,6473,5509,313,39,60,65,13,53,964
41009970700,4204,3398,361,27,60,41,15,34,806
41009970800,7285,5941,508,57,89,78,21,52,1344
41009970900,5221,4382,303,36,41,70,22,11,839
41009971000,5518,4515,401,36,80,87,18,20,1003
41009971100,3853,3289,190,21,48,21,6,15,564
41011000101,1825,1584,84,2,27,2,2,8,241
41011000102,1899,1689,44,0,28,18,0,5,210
41011000103,2438,2139,78,14,51,31,1,13,299
41011000200,2433,2139,50,9,48,19,7,6,294
41011000300,3406,2715,265,24,69,46,4,24,691
41011000401,2889,2269,230,17,75,75,17,6,620
41011000402,4043,3334,254,15,58,119,17,13,709
41011000502,2977,2383,204,15,71,36,2,28,594
41011000503,2803,2139,313,7,48,57,4,16,664
41011000505,4099,3288,399,22,78,54,15,11,811
41011000506,2091,1533,170,17,169,22,6,18,558
41011000600,2670,2174,187,13,39,38,10,17,496
41011000701,4608,3662,396,31,102,64,11,21,946
41011000702,2722,2128,254,17,53,11,7,30,594
41011000800,3067,2580,171,2,61,25,2,7,487
41011000901,3893,3288,276,15,47,12,3,18,605
41011000902,3684,3112,215,5,54,14,0,18,572
41011001001,3680,3164,210,11,32,39,1,17,516
41011001002,3794,3260,202,15,43,21,4,18,534
41011001101,2356,1991,89,2,76,6,5,12,365
41011001102,3552,2967,201,6,91,19,2,10,585
41011990101,0,0,0,0,0,0,0,0,0
41013950101,3198,2730,202,8,48,18,2,8,468
41013950102,5205,4351,482,17,35,27,10,29,854
41013950200,4855,4068,420,7,65,15,4,10,787
41013950301,3520,2982,137,15,30,21,5,16,538
41013950302,3231,2564,398,21,40,14,0,21,667
41013950401,2332,2064,60,2,30,13,2,9,268
41013950402,2397,2115,104,8,14,6,0,9,282
41015950100,3296,2914,114,8,41,21,6,33,382
41015950201,3513,2975,211,10,81,28,6,8,538
41015950202,1923,1707,64,5,23,15,0,2,216
41015950301,4650,3749,405,17,124,38,6,26,901
41015950302,5145,4084,457,21,103,75,6,39,1061
41015950401,2925,2329,288,8,58,19,1,15,596
41015950402,1994,1670,135,8,31,18,0,2,324
41015990101,0,0,0,0,0,0,0,0,0
41017000100,2119,1880,82,14,3,18,4,6,239
41017000201,3330,2788,170,9,31,53,7,22,542
41017000202,2618,2319,103,4,19,10,5,6,299
41017000301,4679,4083,205,9,38,23,7,37,596
41017000302,4960,4241,226,12,68,26,2,23,719
41017000401,5464,4553,456,20,41,38,2,37,911
41017000403,1816,1689,61,5,0,14,0,5,127
41017000404,1893,1650,88,6,13,21,0,6,243
41017000501,3057,2758,90,7,12,28,5,14,299
41017000502,4187,3610,240,13,18,23,3,26,577
41017000601,1766,1553,90,3,17,13,1,10,213
41017000602,2656,2395,102,5,18,9,2,19,261
41017000603,3867,3521,118,9,20,28,5,31,346
41017000701,4385,3368,662,24,35,28,10,17,1017
41017000702,4636,4009,247,11,40,17,3,34,627
41017000800,7251,5787,879,23,49,71,8,34,1464
41017000901,4425,3272,728,40,29,88,5,7,1153
41017000902,3173,2467,402,12,32,22,14,10,706
41017001002,2616,2295,162,4,6,15,3,27,321
41017001003,6075,4881,729,28,36,70,9,18,1194
41017001004,7026,5264,1210,40,51,70,8,19,1762
41017001005,4432,3850,297,9,27,44,5,18,582
41017001101,8047,6510,703,67,35,151,8,35,1537
41017001102,6385,5597,360,21,32,75,7,20,788
41017001200,8671,7252,700,34,39,99,7,50,1419
41017001301,5861,5162,234,24,14,105,2,26,699
41017001302,8429,7384,399,30,13,150,14,30,1045
41017001401,5699,5056,238,14,21,65,7,33,643
41017001402,1308,1150,47,3,6,12,3,3,158
41017001501,3915,3015,540,24,26,59,14,23,900
41017001502,2234,1913,122,9,8,28,2,21,321
41017001601,4715,3592,677,25,27,59,21,32,1123
41017001602,1965,1611,186,3,6,21,2,7,354
41017001701,5594,4563,556,7,37,74,8,28,1031
41017001702,3487,2836,300,15,29,39,2,40,651
41017001801,4463,3538,511,35,23,82,10,33,925
41017001802,4450,3489,570,19,24,45,9,29,961
41017001901,1873,1664,59,7,10,22,1,5,209
41017001903,6277,5091,577,33,34,136,8,31,1186
41017001904,4677,3793,544,19,22,64,1,39,884
41017002001,1132,972,80,2,11,13,1,0,160
41017002002,9331,7150,1318,34,54,190,0,42,2181
41017002101,4668,3518,739,23,26,37,15,27,1150
41017002102,2388,2138,94,3,7,35,2,13,250
41017002103,6253,5368,336,28,32,131,6,35,885
41019010000,2320,1991,154,7,24,16,3,14,329
41019020000,3970,3385,231,4,38,41,11,39,585
41019030000,4047,3423,184,13,60,19,1,26,624
41019040000,2744,2342,118,2,36,29,2,17,402
41019050001,5005,4268,263,15,76,38,2,34,737
41019050003,3709,2933,382,5,64,24,5,13,776
41019050004,3487,2969,224,14,44,25,0,5,518
41019060000,3625,3183,158,11,40,45,0,23,442
41019070000,5550,4835,236,22,49,47,10,26,715
41019080001,3170,2672,202,10,23,70,0,24,498
41019080002,4896,4106,265,30,58,122,7,10,790
41019090001,4849,4074,303,13,66,88,15,10,775
41019090002,1084,971,42,2,11,11,4,3,113
41019100000,3103,2570,145,6,48,14,2,16,533
41019110000,3089,2656,116,0,36,17,6,33,433
41019120001,2795,2259,241,14,39,61,11,8,536
41019120002,4871,3921,444,32,97,62,10,17,950
41019130001,2457,2028,237,13,34,14,2,13,429
41019130002,3055,2542,200,17,46,16,3,25,513
41019140000,5627,4661,386,24,73,61,9,21,966
41019150001,4350,3655,293,8,46,29,2,18,695
41019150002,3066,2482,215,18,46,40,10,2,584
41019160001,3011,2566,175,6,36,39,1,20,445
41019160002,4930,4191,261,30,89,43,3,14,739
41019170000,3857,3375,123,11,55,13,4,9,482
41019180000,4730,3951,248,9,100,43,8,13,779
41019190000,4589,3786,279,13,155,25,12,27,803
41019200000,4902,4101,275,26,126,92,4,32,801
41019210000,4313,3629,254,8,79,41,4,20,684
41019990000,0,0,0,0,0,0,0,0,0
41021960100,1995,1747,107,3,29,6,9,3,248
41023960100,2050,1810,97,2,18,3,1,3,240
41023960201,1561,1427,52,1,4,0,3,0,134
41023960202,3622,3193,134,7,36,20,6,16,429
41025960101,2469,2122,148,0,55,8,0,0,347
41025960102,2861,2336,166,5,153,23,0,18,525
41025960200,2165,1977,80,0,11,5,0,3,188
41027950100,4449,2796,1291,5,53,51,9,16,1653
41027950201,3862,2732,793,8,13,64,7,39,1130
41027950202,3825,2796,679,8,24,79,4,18,1029
41027950301,3597,2270,975,14,22,102,4,10,1327
41027950302,2725,1978,537,5,8,43,0,16,747
41027950400,5519,2363,2873,7,29,42,9,20,3156
41029000100,2063,1261,529,38,29,63,4,14,802
41029000201,3765,2328,990,70,44,34,19,17,1437
41029000202,3810,2337,1100,63,36,20,19,17,1473
41029000203,4101,2697,1024,50,47,13,7,10,1404
41029000300,6076,3770,1590,46,71,88,65,35,2306
41029000403,4112,3311,350,37,24,96,13,20,801
41029000404,5023,4133,363,36,26,136,11,19,890
41029000405,4533,3059,757,64,36,93,85,28,1474
41029000406,4686,3333,730,27,42,99,45,21,1353
41029000501,2918,2162,437,28,20,32,3,35,756
41029000502,5678,4000,890,66,50,120,68,40,1678
41029000603,4063,3350,308,18,12,141,3,19,713
41029000604,3955,3170,384,21,24,58,21,21,785
41029000605,3865,2978,491,30,26,110,22,21,887
41029000606,2255,1896,155,9,7,88,1,4,359
41029000701,5171,3519,1173,17,33,59,12,26,1652
41029000702,5810,4437,837,30,48,74,18,36,1373
41029000800,7284,5093,1461,72,64,92,59,21,2191
41029000901,3431,2738,377,14,25,59,5,22,693
41029000902,6333,5138,621,39,33,113,19,28,1195
41029001001,6779,5274,870,37,61,91,13,36,1505
41029001002,4383,3285,653,25,41,37,22,21,1098
41029001100,5860,4497,733,28,68,74,25,24,1363
41029001200,4669,3457,693,34,30,118,28,11,1212
41029001301,5163,3364,1321,39,41,54,19,22,1799
41029001303,5791,3072,2244,26,37,36,22,33,2719
41029001304,5592,4290,686,23,30,170,9,32,1302
41029001401,5595,4533,559,32,48,50,14,36,1062
41029001402,1556,1290,125,3,12,7,0,11,266
41029001403,4617,3795,399,31,44,46,5,31,822
41029001500,5027,4412,268,11,27,41,0,28,615
41029001601,4587,3083,1091,48,32,54,7,17,1504
41029001602,6295,4644,1106,53,36,51,11,26,1651
41029001701,3254,2312,695,7,17,42,10,34,942
41029001702,4133,3266,453,21,36,61,6,39,867
41029001801,4258,3327,427,58,30,80,9,57,931
41029001802,4099,3451,229,23,23,89,6,22,648
41029001900,3320,2341,428,57,34,102,40,133,979
41029002000,2095,1693,150,27,5,38,2,14,402
41029002100,3470,2905,189,34,19,78,6,38,565
41029002200,4784,4064,242,39,16,87,2,46,720
41029002300,1737,1481,88,1,10,13,2,28,256
41029002400,2134,1689,206,13,13,42,4,17,445
41029002500,2716,2316,150,8,21,32,0,31,400
41029002600,2817,2436,116,7,31,3,5,55,381
41029002701,3510,3011,193,1,40,21,0,27,499
41029002702,3964,3405,218,12,49,26,7,52,559
41029002800,4965,4248,251,14,67,32,5,29,717
41029002901,3949,3324,275,31,41,29,10,13,625
41029002902,4021,3524,198,16,24,38,5,22,497
41029003001,4140,3437,269,30,46,21,11,24,703
41029003002,5047,4296,307,10,49,42,4,33,751
41031940000,2622,36,208,7,2254,1,3,2,2586
41031960100,2482,1904,326,83,70,5,7,5,578
41031960201,3688,1736,1543,12,209,14,0,10,1952
41031960202,6282,3936,1605,16,315,67,4,25,2346
41031960301,4560,4074,189,7,42,15,0,15,486
41031960303,564,504,20,0,9,4,0,3,60
41031960304,2435,1604,604,4,46,14,0,4,831
41031960305,1869,1211,507,5,36,11,4,2,658
41033360100,1910,1639,115,3,12,18,3,9,271
41033360300,5673,4912,313,8,50,33,6,20,761
41033360400,4616,3922,288,17,26,66,5,20,694
41033360500,6068,4824,619,41,64,85,11,29,1244
41033360601,2897,2341,241,19,44,44,8,11,556
41033360602,3992,3327,298,14,22,55,0,15,665
41033360701,4474,3486,485,33,63,45,11,29,988
41033360703,3002,2463,298,28,12,30,2,6,539
41033360704,3300,2619,318,13,35,41,7,17,681
41033360800,5265,4492,299,15,30,52,16,34,773
41033360900,2531,2228,118,7,23,23,1,12,303
41033361000,5094,4374,286,7,41,28,5,27,720
41033361101,5728,4597,640,16,80,78,5,37,1131
41033361102,4123,3343,354,24,32,30,7,25,780
41033361201,4029,3116,466,11,45,35,9,50,913
41033361202,3632,2913,305,14,50,41,18,12,719
41033361301,4226,3606,273,10,20,36,4,25,620
41033361302,3405,2806,307,15,61,27,0,16,599
41033361400,2811,2361,185,17,38,13,0,23,450
41033361500,2647,2206,187,13,26,23,3,17,441
41033361601,4917,3962,426,20,50,46,2,35,955
41033361602,3750,3193,216,23,59,21,0,24,557
41035970100,3301,2870,137,6,36,9,2,10,431
41035970201,2012,1622,114,23,104,17,0,13,390
41035970202,3005,1981,141,5,637,22,6,17,1024
41035970300,3304,2818,174,7,64,37,1,19,486
41035970400,1474,1130,212,6,18,8,9,14,344
41035970500,1608,1326,129,5,34,3,4,11,282
41035970600,1472,920,472,2,23,2,2,6,552
41035970700,2069,1360,574,4,14,10,5,21,709
41035970800,2383,1930,224,2,42,22,6,16,453
41035970901,2466,2080,150,9,35,25,0,14,386
41035970902,2478,1919,247,20,85,26,0,5,559
41035971000,2746,2354,132,13,34,22,2,9,392
41035971100,5850,4367,752,49,133,117,8,23,1483
41035971200,2547,1828,403,28,101,19,2,6,719
41035971300,5901,4481,752,51,155,40,10,18,1420
41035971400,5857,4296,845,43,168,64,4,21,1561
41035971500,4309,2917,813,38,170,34,7,22,1392
41035971600,3180,1930,813,52,151,31,1,6,1250
41035971700,2956,1954,559,50,99,35,6,22,1002
41035971800,2365,1740,249,20,104,51,5,31,625
41035971900,3479,2503,424,40,173,48,5,35,976
41035972000,4651,3593,456,24,113,112,19,57,1058
41037960100,2761,2341,140,0,29,11,6,24,420
41037960200,5399,4167,662,49,85,41,4,18,1232
41039000100,5232,4519,282,12,48,39,0,35,713
41039000200,5129,4476,206,14,46,34,6,46,653
41039000300,2807,2348,170,7,35,32,5,26,459
41039000402,3206,2764,187,16,17,30,1,35,442
41039000403,6165,5001,583,40,50,66,7,29,1164
41039000404,4010,3285,371,28,28,33,4,24,725
41039000500,2244,1919,96,3,22,15,1,11,325
41039000702,2751,2322,124,7,39,30,8,21,429
41039000705,3993,3311,307,15,47,59,9,19,682
41039000706,2990,2629,150,6,20,36,4,12,361
41039000707,4224,3687,191,23,29,46,4,24,537
41039000708,2372,2038,90,7,31,15,2,15,334
41039000800,1598,1366,50,5,16,9,4,17,232
41039000902,4623,4041,215,10,44,25,2,15,582
41039000903,5568,4579,381,49,51,55,9,27,989
41039000904,3506,2936,277,13,22,26,6,12,570
41039001001,2618,2266,128,2,20,19,1,11,352
41039001002,4148,3483,233,36,24,43,1,45,665
41039001101,6250,5080,533,25,35,91,9,35,1170
41039001102,4044,3453,258,7,48,22,1,25,591
41039001201,4189,3347,425,16,46,33,7,23,842
41039001202,4362,3503,388,11,37,53,12,19,859
41039001301,3475,2885,281,15,39,24,2,16,590
41039001302,5295,4341,456,19,63,45,4,36,954
41039001400,2509,2095,112,0,20,20,6,16,414
41039001500,4570,3768,274,67,67,26,5,30,802
41039001600,5485,4641,311,24,79,23,6,36,844
41039001700,5569,4855,271,16,67,46,2,28,714
41039001801,5783,4688,448,30,59,98,14,38,1095
41039001803,4404,3608,355,37,40,35,15,21,796
41039001804,3687,3065,286,18,32,39,8,9,622
41039001902,6626,4654,1143,86,83,88,43,43,1972
41039001903,3038,2245,482,34,23,16,6,9,793
41039001904,5477,3769,1081,32,75,89,19,30,1708
41039002001,3235,2633,316,21,36,50,6,10,602
41039002002,5166,4014,618,49,45,100,17,23,1152
41039002101,2995,2166,444,23,44,68,10,32,829
41039002103,4115,2868,676,95,50,78,29,13,1247
41039002104,2497,1821,338,48,30,30,42,8,676
41039002201,3966,3269,221,66,16,160,11,13,697
41039002203,4598,3525,382,106,12,203,29,27,1073
41039002204,3230,2525,227,55,16,230,6,22,705
41039002301,4372,3350,528,42,53,86,6,30,1022
41039002302,4593,3729,359,27,31,61,15,29,864
41039002401,4146,3375,269,41,33,137,7,37,771
41039002403,4329,3578,279,36,34,118,20,22,751
41039002404,4083,3253,381,35,30,59,13,23,830
41039002501,5040,3608,829,87,54,79,20,10,1432
41039002504,3118,1946,742,47,26,79,6,24,1172
41039002505,4498,3320,666,42,41,58,16,40,1178
41039002506,4438,3358,422,80,20,211,15,15,1080
41039002600,6766,4808,1088,101,81,131,27,43,1958
41039002700,4292,3223,569,46,32,66,4,24,1069
41039002800,4744,3502,688,48,42,65,12,37,1242
41039002902,4106,3167,408,36,34,81,10,34,939
41039002903,3000,2420,188,36,24,127,3,12,580
41039002904,4218,3296,312,70,26,197,15,19,922
41039003000,4546,3700,342,46,14,158,11,18,846
41039003101,6118,4721,545,77,43,259,23,37,1397
41039003103,2708,2136,215,28,25,67,13,8,572
41039003104,5214,3339,679,181,48,517,25,27,1875
41039003201,3254,2291,581,51,35,34,5,26,963
41039003202,4021,3001,550,56,35,76,5,21,1020
41039003301,3352,2316,627,38,38,47,12,15,1036
41039003302,3422,2656,411,43,25,35,9,18,766
41039003400,4798,3540,770,63,40,48,4,32,1258
41039003500,4476,3516,495,21,37,67,13,17,960
41039003600,4218,3086,402,49,46,251,4,24,1132
41039003700,7138,4927,731,135,19,648,31,39,2211
41039003801,3039,2177,353,66,11,162,20,11,862
41039003802,4392,2917,484,122,14,461,20,28,1475
41039003900,4237,3019,413,170,54,293,9,30,1218
41039004000,2584,1989,284,48,30,42,3,16,595
41039004100,4073,3261,354,40,18,69,8,51,812
41039004200,3309,2384,497,69,41,45,4,37,925
41039004300,9742,7107,1435,168,142,133,34,42,2635
41039004403,5189,3569,818,126,71,101,29,36,1620
41039004404,3399,2719,219,53,15,120,8,22,680
41039004405,4914,3809,333,59,31,287,3,29,1105
41039004406,3251,2141,598,56,40,168,17,10,1110
41039004407,3654,2647,445,76,36,64,20,29,1007
41039004501,2625,2077,223,34,18,56,3,20,548
41039004502,3284,2443,370,87,31,58,8,52,841
41039004600,2816,2287,215,30,16,45,1,30,529
41039004700,3600,2889,259,46,15,127,6,33,711
41039004800,4932,3495,471,105,24,416,14,40,1437
41039004900,4326,3454,320,53,13,138,1,33,872
41039005000,5439,4379,349,64,47,174,7,33,1060
41039005100,3287,2586,257,35,16,85,2,42,701
41039005200,2289,1928,118,9,7,80,1,6,361
41039005300,2550,2024,184,35,12,37,2,36,526
41039005400,5283,4256,338,46,36,202,0,44,1027
41039990000,0,0,0,0,0,0,0,0,0
41041950100,3450,2839,254,0,107,20,0,7,611
41041950303,1837,1483,149,16,29,56,3,10,354
41041950304,3667,2699,493,24,118,61,10,14,968
41041950401,2436,1763,377,11,53,60,5,19,673
41041950402,2199,1736,257,14,40,33,3,12,463
41041950601,2662,2292,102,8,49,26,9,14,370
41041950602,2464,2086,148,15,34,36,6,9,378
41041950800,3401,2692,361,20,20,46,5,18,709
41041950900,3432,2295,789,4,65,73,16,24,1137
41041951000,2169,1339,578,17,36,49,12,12,830
41041951100,1594,1216,219,6,23,33,4,10,378
41041951200,2166,1858,143,3,13,22,5,19,308
41041951300,2652,2187,163,4,59,20,0,10,465
41041951400,3044,2480,177,5,101,15,0,22,564
41041951500,2953,2569,87,8,26,24,1,22,384
41041951600,3830,3194,189,12,64,32,8,14,636
41041951700,2475,2072,172,5,25,33,0,22,403
41041951800,3964,2698,193,17,659,7,6,18,1266
41041990100,0,0,0,0,0,0,0,0,0
41043020101,6162,5108,544,12,36,71,14,29,1054
41043020102,3054,2312,417,27,27,48,6,7,742
41043020103,2726,2035,405,32,21,67,2,7,691
41043020200,1932,1545,200,0,18,47,3,12,387
41043020300,7447,5926,702,44,49,144,23,47,1521
41043020400,4713,3442,777,51,47,54,11,50,1271
41043020500,4205,2972,874,27,39,59,12,14,1233
41043020601,3970,3252,338,23,41,64,18,22,718
41043020602,5033,3660,823,36,39,125,20,26,1373
41043020700,5777,4309,927,43,88,64,10,13,1468
41043020801,2799,1982,524,21,34,23,9,13,817
41043020802,6217,4242,1335,61,87,57,26,38,1975
41043030100,6496,5665,347,20,63,42,5,38,831
41043030201,3501,2996,236,10,36,9,2,20,505
41043030202,3433,2993,180,8,37,25,3,7,440
41043030300,2505,2232,79,8,18,12,2,15,273
41043030401,6799,5852,322,20,103,33,9,43,947
41043030403,3258,2720,191,5,46,26,7,10,538
41043030404,4233,3620,218,14,35,30,2,27,613
41043030500,4374,3860,139,19,34,43,3,44,514
41043030600,7001,5823,642,14,54,36,17,25,1178
41043030700,4204,3484,352,11,30,44,2,26,720
41043030801,5120,4162,452,33,62,78,18,18,958
41043030802,3775,3208,252,23,33,17,4,5,567
41043030903,7226,6056,499,27,72,80,26,36,1170
41043030904,4639,3836,336,18,37,83,6,13,803
41043030905,3716,3127,231,9,51,33,5,25,589
41043030906,4295,3699,229,7,46,20,15,28,596
41045940000,0,0,0,0,0,0,0,0,0
41045970200,4979,2946,1666,22,37,97,6,23,2033
41045970300,4318,2479,1486,26,52,79,5,24,1839
41045970400,5208,2015,2820,99,42,40,6,19,3193
41045970500,5212,2323,2630,12,26,38,0,20,2889
41045970600,4444,3516,692,8,24,35,10,15,928
41045970700,1740,1377,258,0,6,23,0,9,363
41045970900,5670,4319,768,280,108,73,13,5,1351
41047000200,4595,3293,710,47,48,151,27,24,1302
41047000300,4993,2985,1465,62,38,51,72,34,2008
41047000400,4808,2503,1749,68,92,51,123,8,2305
41047000501,3878,1544,1927,40,27,95,60,20,2334
41047000502,5926,2181,3112,84,41,82,133,21,3745
41047000600,5260,3679,977,93,68,55,34,44,1581
41047000702,5457,3216,1458,383,101,105,34,23,2241
41047000703,2460,1113,1111,42,33,41,25,12,1347
41047000900,5584,3518,1380,68,77,100,89,36,2066
41047001000,4425,2475,1262,71,66,68,146,25,1950
41047001100,5060,3744,728,53,53,83,27,30,1316
41047001200,3700,2788,435,58,37,84,31,16,912
41047001300,4310,3374,454,58,36,80,24,22,936
41047001401,6495,4482,1239,62,71,191,49,25,2013
41047001402,5960,4180,1215,43,62,74,64,23,1780
41047001501,4658,3480,685,34,37,81,21,20,1178
41047001502,6110,3592,1853,66,76,72,89,45,2518
41047001503,5279,2962,1753,51,59,59,93,25,2317
41047001601,8107,4157,2852,129,71,417,95,24,3950
41047001603,7269,3492,2870,50,81,359,49,49,3777
41047001605,4874,1330,2951,109,41,71,189,18,3544
41047001606,5738,1867,3178,79,65,132,203,10,3871
41047001607,4577,1454,2211,93,32,110,437,14,3123
41047001608,4897,2166,2135,32,41,210,79,18,2731
41047001701,6588,2771,2935,97,60,150,258,25,3817
41047001702,5684,2285,2700,56,43,263,117,13,3399
41047001703,4675,2703,1563,39,42,95,50,30,1972
41047001801,7073,3363,2919,81,79,118,140,62,3710
41047001802,9033,4333,3632,143,108,225,167,62,4700
41047001803,5436,3629,1153,236,80,101,35,13,1807
41047002001,5476,3941,718,67,34,308,40,29,1535
41047002002,5566,4147,621,60,53,291,56,16,1419
41047002101,2455,1804,381,31,18,49,9,6,651
41047002102,6420,4821,786,112,83,146,61,42,1599
41047002201,2136,1722,218,15,5,36,11,11,414
41047002202,6713,5160,743,79,44,161,35,30,1553
41047002301,4380,3249,528,57,46,143,40,13,1131
41047002303,8334,6143,1032,74,71,276,155,35,2191
41047002304,6799,5132,665,97,37,360,38,39,1667
41047002400,4281,3461,312,39,21,170,10,33,820
41047002502,6284,3524,2216,32,36,164,21,25,2760
41047002503,5429,3886,967,28,41,129,36,39,1543
41047002504,4296,3200,523,72,40,162,23,14,1096
41047002600,2084,1709,274,6,7,20,1,21,375
41047002701,6195,5108,531,17,53,108,8,34,1087
41047002702,3619,3032,254,10,24,79,12,18,587
41047002800,4471,3528,403,34,55,118,6,36,943
41047010100,1506,1033,393,1,7,4,1,9,473
41047010201,2718,2040,472,12,26,26,0,2,678
41047010202,7972,4833,2690,29,46,59,10,20,3139
41047010303,4972,2081,2624,27,18,41,2,25,2891
41047010304,6893,1428,5207,26,14,56,7,29,5465
41047010305,4576,1338,2962,62,29,26,14,40,3238
41047010307,6213,3811,2021,30,21,102,0,19,2402
41047010308,4261,1520,2503,16,18,62,9,13,2741
41047010309,5770,1500,4091,9,15,28,17,10,4270
41047010400,4975,3262,1410,28,24,36,7,31,1713
41047010501,6067,5215,446,10,37,48,1,29,852
41047010502,6683,5234,916,36,52,33,6,30,1449
41047010503,4302,3470,495,26,36,14,6,18,832
41047010600,2661,2274,149,2,36,17,1,36,387
41047010701,8447,6198,1455,55,94,73,16,41,2249
41047010702,7452,6308,572,23,52,58,14,41,1144
41047010801,6171,4892,702,12,90,43,19,37,1279
41047010802,6434,4987,848,26,76,50,17,39,1447
41049970101,4924,1505,3240,20,21,4,1,19,3419
41049970102,4097,2380,1461,9,49,13,4,18,1717
41049970200,3165,2715,287,8,12,12,0,7,450
41051000101,3278,2747,172,39,12,88,0,22,531
41051000102,3996,3307,238,16,11,134,3,27,689
41051000201,3461,2726,232,40,18,146,8,31,735
41051000202,3456,2694,242,76,5,129,15,14,762
41051000301,5443,3929,426,117,19,485,14,22,1514
41051000302,7191,5984,318,40,14,280,3,38,1207
41051000401,3746,2966,210,35,7,226,7,24,780
41051000402,3906,2924,313,40,14,254,13,26,982
41051000501,4134,3011,354,102,11,287,16,36,1123
41051000502,4597,2997,519,128,24,560,33,22,1600
41051000601,5843,2874,1071,320,91,979,47,30,2969
41051000602,5756,2865,945,326,60,1077,73,22,2891
41051000701,4811,3185,457,212,30,518,16,51,1626
41051000702,5243,3428,496,175,46,683,20,28,1815
41051000801,5004,3838,407,75,13,283,8,34,1166
41051000802,5005,3646,511,98,43,324,14,31,1359
41051000901,4382,3466,285,53,5,241,0,22,916
41051000902,4910,3314,445,231,28,413,20,37,1596
41051001000,5669,4388,419,101,32,243,5,49,1281
41051001101,3262,2311,339,125,30,141,6,34,951
41051001102,1610,1210,135,19,10,95,2,10,400
41051001202,3342,2687,200,35,6,171,2,31,655
41051001203,2365,1863,204,36,9,63,1,13,502
41051001204,3052,2334,274,58,7,118,3,15,718
41051001301,4099,3251,304,64,6,156,1,43,848
41051001302,3376,2652,221,27,3,179,0,25,724
41051001400,5666,4355,448,104,15,282,13,61,1311
41051001500,3684,3026,199,29,2,142,2,22,658
41051001601,6234,4604,468,165,14,480,34,52,1630
41051001602,4616,2672,556,247,23,724,55,31,1944
41051001702,3969,2373,459,307,31,439,10,24,1596
41051001703,3952,2685,371,141,25,336,11,36,1267
41051001704,2677,1915,222,119,16,187,10,6,762
41051001801,4326,3144,363,255,26,209,0,26,1182
41051001802,3533,2751,247,49,19,137,2,38,782
41051001900,5123,4147,286,46,17,200,4,37,976
41051002001,2557,2007,214,42,17,93,0,7,550
41051002002,3692,2804,344,104,24,132,6,32,888
41051002101,1414,949,145,79,17,103,9,12,465
41051002102,2909,2170,261,100,16,138,10,18,739
41051002203,4931,3087,454,756,33,195,12,25,1844
41051002303,4074,2581,430,380,54,277,18,47,1493
41051002401,2794,2096,173,175,2,102,4,18,698
41051002402,3830,2905,308,180,27,135,4,17,925
41051002501,4672,3906,233,75,5,126,4,19,766
41051002502,4614,3462,363,163,24,197,3,29,1152
41051002600,2916,2351,169,42,4,85,0,13,565
41051002701,3286,2759,157,24,4,128,0,11,527
41051002702,3281,2438,245,103,35,181,5,22,843
41051002801,2991,2348,146,56,9,216,10,11,643
41051002802,3087,2406,208,50,7,170,2,8,681
41051002901,4687,3558,357,145,24,280,9,33,1129
41051002902,5684,4071,475,270,49,405,11,27,1613
41051002903,5303,3079,529,489,65,633,54,36,2224
41051003000,5038,3946,294,194,24,177,5,31,1092
41051003100,4940,3868,336,162,22,181,8,32,1072
41051003200,4252,3194,259,285,20,138,8,48,1058
41051003301,3340,2007,430,518,22,83,7,25,1333
41051003302,3109,2008,271,459,15,84,14,14,1101
41051003401,3657,2140,354,703,13,115,16,41,1517
41051003402,4120,2522,449,606,21,173,24,16,1598
41051003501,3877,2683,388,311,35,125,15,35,1194
41051003502,2763,2035,268,140,7,111,0,22,728
41051003601,4819,2960,490,804,29,110,14,38,1859
41051003602,6284,3980,604,951,31,191,27,19,2304
41051003603,1591,1091,84,234,11,57,2,11,500
41051003701,4332,2668,528,607,18,124,26,41,1664
41051003702,2358,1653,161,270,10,59,1,25,705
41051003801,3355,2274,342,256,18,134,46,24,1081
41051003802,3363,2346,326,182,30,137,19,25,1017
41051003803,4385,3060,405,312,16,184,28,24,1325
41051003902,3297,2500,247,110,20,101,29,34,797
41051003903,3409,1850,600,486,35,104,48,12,1559
41051003904,4075,2665,521,300,33,158,45,25,1410
41051004002,6745,4597,704,143,47,585,73,24,2148
41051004003,7781,3490,1876,1295,50,339,125,41,4291
41051004102,5288,3568,735,196,36,190,58,53,1720
41051004103,4308,2337,1042,296,37,222,55,26,1971
41051004104,3080,1507,933,298,23,56,16,5,1573
41051004200,4201,2954,473,212,42,116,20,51,1247
41051004300,1176,958,94,13,9,40,0,6,218
41051004500,3229,2469,226,71,15,181,5,25,760
41051004601,3473,2841,182,30,7,197,0,22,632
41051004602,2189,1776,115,27,2,101,1,13,413
41051004700,4346,3384,327,74,21,212,7,34,962
41051004800,3070,2296,272,94,18,154,15,17,774
41051004901,3074,2164,252,68,4,378,4,19,910
41051004902,2441,1806,248,89,18,94,3,17,635
41051005001,3473,2488,302,104,12,331,8,25,985
41051005002,1365,946,144,30,13,112,3,7,419
41051005101,4433,3010,397,243,43,374,6,24,1423
41051005102,3113,2281,214,96,28,281,4,15,832
41051005103,3920,2597,476,282,108,86,23,34,1323
41051005201,2180,1439,257,135,30,122,0,16,741
41051005202,2937,2130,296,74,11,202,7,26,807
41051005500,3038,1979,289,149,26,350,7,21,1059
41051005601,2904,1937,214,96,25,384,2,33,967
41051005602,2370,1447,323,103,11,270,17,66,923
41051005701,461,334,31,17,3,31,0,0,127
41051005702,3790,2568,289,107,21,487,13,9,1222
41051005800,5204,4046,326,61,14,400,8,37,1158
41051005901,2221,1609,212,70,13,126,10,19,612
41051005902,4168,2883,238,117,200,480,5,22,1285
41051005903,3278,2514,248,56,15,173,9,26,764
41051006001,1466,1155,104,19,4,66,0,4,311
41051006002,2322,1864,151,44,0,88,2,21,458
41051006100,2500,2043,145,14,15,92,5,12,457
41051006200,3187,2620,173,41,11,75,7,20,567
41051006300,5616,4423,377,83,25,261,2,32,1193
41051006402,6237,5045,362,48,18,311,7,26,1192
41051006403,4114,2710,313,388,35,228,60,17,1404
41051006404,3524,2741,216,72,21,208,7,22,783
41051006501,6262,4903,389,153,17,288,8,50,1359
41051006502,4419,3383,378,113,17,161,11,31,1036
41051006601,2752,2269,130,24,5,104,1,13,483
41051006602,5551,4096,478,221,38,199,24,56,1455
41051006701,3164,2513,199,67,7,134,5,12,651
41051006702,3298,2585,191,94,13,136,2,34,713
41051006801,2373,1835,129,56,10,125,6,14,538
41051006802,3656,2921,239,33,11,157,2,40,735
41051006900,2966,2353,165,42,5,159,2,11,613
41051007001,5521,3530,304,67,1,1173,7,33,1991
41051007002,2857,2181,154,24,11,271,4,31,676
41051007100,2771,2293,178,8,24,68,8,18,478
41051007201,3029,2073,577,85,24,74,13,10,956
41051007202,3727,1998,729,429,33,216,53,31,1729
41051007300,1781,1145,253,247,38,24,16,2,636
41051007400,3822,1625,1159,595,45,108,30,34,2197
41051007500,5140,3007,793,559,45,338,13,33,2133
41051007600,3462,1639,1110,260,15,192,30,23,1823
41051007700,1949,1174,321,118,7,179,19,8,775
41051007800,1959,1182,291,134,12,183,37,8,777
41051007900,4617,2344,770,587,42,470,59,25,2273
41051008001,3455,2108,417,240,21,365,14,24,1347
41051008002,2970,1845,280,187,19,359,22,27,1125
41051008100,8087,4239,1218,938,90,898,150,41,3848
41051008201,3405,2110,385,204,18,499,21,7,1295
41051008203,5608,3493,735,453,47,452,21,33,2115
41051008204,2604,1142,736,179,35,386,24,10,1462
41051008301,4399,1557,471,504,31,1489,62,31,2842
41051008302,4621,2354,812,221,32,811,79,26,2267
41051008400,4854,2455,736,474,33,826,48,27,2399
41051008500,4629,2475,776,247,54,784,37,8,2154
41051008600,4357,2245,752,258,50,671,37,29,2112
41051008700,4916,3321,551,123,26,478,19,40,1595
41051008800,4204,2836,571,73,26,376,13,16,1368
41051008902,4166,2500,652,215,38,442,27,26,1666
41051008903,5024,2997,494,155,16,1084,19,22,2027
41051008904,5006,3086,596,407,48,511,39,21,1920
41051009001,5642,2691,1019,367,32,1110,113,23,2951
41051009002,5121,2145,1085,532,50,889,105,20,2976
41051009101,5977,2787,1228,535,51,881,104,25,3190
41051009102,7003,3840,933,429,40,1215,101,25,3163
41051009202,5459,2720,913,589,41,795,66,22,2739
41051009203,4044,2085,883,198,36,519,62,6,1959
41051009204,4763,2309,790,588,71,634,81,32,2454
41051009301,6285,2865,1569,761,57,470,105,24,3420
41051009302,4743,2622,539,532,49,611,51,35,2121
41051009400,6970,4509,779,404,38,729,76,28,2461
41051009501,5137,2279,653,937,30,798,89,32,2858
41051009502,4271,2171,641,596,30,486,35,19,2100
41051009603,3743,2047,912,226,18,232,80,20,1696
41051009604,5444,2344,1721,547,36,385,85,36,3100
41051009605,5710,2557,1081,771,28,753,171,36,3153
41051009606,5671,2252,1759,585,63,547,107,32,3419
41051009701,5745,3048,1077,441,53,663,92,22,2697
41051009703,4979,2541,972,375,25,716,92,13,2438
41051009704,3855,1938,1090,150,34,352,95,25,1917
41051009801,4633,1997,1662,400,41,204,19,34,2636
41051009803,7087,4157,1426,277,53,635,51,26,2930
41051009804,3496,1996,618,213,24,364,34,18,1500
41051009903,7482,5196,514,196,23,1109,22,31,2286
41051009904,3844,2450,663,161,51,175,34,26,1394
41051009905,3410,2271,526,122,21,150,27,20,1139
41051009906,3650,2695,436,136,23,149,1,22,955
41051009907,5627,3923,978,117,32,196,15,20,1704
41051010001,6110,3609,1502,294,54,185,82,21,2501
41051010002,5584,3525,977,205,39,407,36,27,2059
41051010101,5429,3284,1172,267,52,216,78,21,2145
41051010102,4549,2848,823,224,39,239,48,15,1701
41051010200,7130,3840,1810,350,56,576,50,32,3290
41051010303,5717,3670,1056,156,38,332,58,25,2047
41051010304,5140,2239,2108,188,52,212,56,13,2901
41051010305,4105,3128,534,62,26,104,17,15,977
41051010306,5038,3414,726,120,23,366,27,29,1624
41051010402,6298,4955,514,84,49,234,14,22,1343
41051010405,6188,3841,1279,235,57,209,69,33,2347
41051010407,6060,4102,1025,171,75,166,34,31,1958
41051010408,6665,4101,1674,156,53,265,35,25,2564
41051010410,4807,2878,1098,207,52,157,68,33,1929
41051010411,3276,2182,677,88,17,100,25,5,1094
41051010412,3402,2669,353,40,15,112,15,11,733
41051010413,5227,3657,800,137,28,198,14,26,1570
41051010500,3947,3439,176,17,10,52,12,9,508
41051010601,1718,1158,153,97,20,144,4,18,560
41051010602,1786,1154,202,187,26,88,3,12,632
41051980000,55,31,8,1,1,7,3,1,24
41053005100,2234,1368,624,26,37,19,15,9,866
41053005203,6406,4695,851,115,49,234,30,26,1711
41053005204,3813,2808,520,55,49,133,21,16,1005
41053005205,8747,6491,1145,79,76,304,52,51,2256
41053005206,2629,1628,626,63,43,66,32,9,1001
41053005301,8524,6666,902,59,56,260,41,52,1858
41053005302,2109,1729,175,1,17,35,1,24,380
41053020202,7477,6133,597,30,154,66,7,37,1344
41053020203,3051,2474,266,14,50,27,5,14,577
41053020204,5010,4187,323,8,92,42,7,33,823
41053020303,4728,3317,828,44,48,123,31,14,1411
41053020304,8074,5573,1552,94,80,185,65,33,2501
41053020305,8792,4819,3247,52,55,65,26,22,3973
41053020306,1988,1669,186,0,14,15,0,10,319
41053020400,6608,4969,414,25,658,35,6,39,1639
41053020500,7243,6193,474,17,101,93,5,23,1050
41055950100,1870,1610,119,0,19,7,0,3,260
41057960101,2193,1884,127,10,10,40,6,12,309
41057960102,1884,1596,113,2,14,13,4,19,288
41057960200,2675,2307,115,7,22,38,7,18,368
41057960300,2566,2086,243,4,18,27,7,16,480
41057960401,3216,2631,302,19,39,24,13,11,585
41057960402,4828,3307,1066,9,51,57,17,23,1521
41057960500,2169,1677,307,5,10,22,25,4,492
41057960600,2415,1998,219,8,18,24,0,12,417
41057960700,2780,2330,213,8,27,15,1,10,450
41057960800,2664,2184,241,4,30,20,5,16,480
41057990100,0,0,0,0,0,0,0,0,0
41059940000,2861,1166,102,1,1398,0,8,3,1695
41059950100,4211,3412,543,12,34,12,1,13,799
41059950201,4171,1837,2078,28,22,31,2,15,2334
41059950202,3509,1984,1345,7,12,19,7,13,1525
41059950300,2840,2347,220,2,73,22,0,25,493
41059950400,6199,4833,663,166,194,49,2,37,1366
41059950500,4892,3996,465,28,124,28,8,24,896
41059950601,3433,2463,477,30,164,61,10,12,970
41059950602,3180,2662,232,17,35,47,7,4,518
41059950700,2353,1753,260,16,124,23,2,11,600
41059950800,8201,4615,3012,187,123,54,9,21,3586
41059950900,4697,2288,2135,24,39,23,1,20,2409
41059951000,6709,3089,3153,34,33,106,31,22,3620
41059951100,6570,3830,2321,37,50,62,7,21,2740
41059951201,5660,2250,3050,28,42,58,13,13,3410
41059951202,4590,2756,1477,19,19,79,15,15,1834
41059951300,3824,2572,998,9,30,11,6,16,1252
41059951400,2175,1900,91,7,55,0,1,10,275
41061970100,3346,2880,106,4,24,14,1,8,466
41061970200,3367,2997,133,12,24,19,0,21,370
41061970300,2279,2033,77,2,16,10,11,11,246
41061970400,2935,2510,143,11,19,15,25,12,425
41061970500,3380,2841,186,27,27,22,58,21,539
41061970600,3830,3238,204,31,23,59,52,19,592
41061970700,3133,2354,252,44,42,42,220,6,779
41061970800,3926,3222,246,14,44,35,121,31,704
41063960100,2076,1855,80,1,18,10,0,17,221
41063960200,1860,1658,51,0,19,9,0,18,202
41063960300,3455,3085,126,8,13,12,4,19,370
41065970100,4234,3152,700,17,47,62,26,26,1082
41065970200,3099,2109,630,19,28,44,46,17,990
41065970300,2932,2170,543,15,24,32,8,10,762
41065970400,3130,2130,734,26,38,32,29,7,1000
41065970500,3813,2249,1247,7,61,20,68,7,1564
41065970600,3007,2062,695,5,34,19,0,22,945
41065970700,1913,1505,259,11,12,30,0,5,408
41065970800,4542,3326,209,15,739,9,8,16,1216
41067030103,4851,3581,421,79,13,372,12,29,1270
41067030104,4175,2949,257,110,9,484,8,23,1226
41067030105,3157,1937,363,87,11,520,9,18,1220
41067030106,4119,2958,220,50,3,524,6,28,1161
41067030200,6430,4896,560,117,25,340,13,39,1534
41067030300,4709,3933,276,51,8,166,8,27,776
41067030401,4790,3254,818,119,13,254,14,16,1536
41067030402,4583,3502,424,69,23,221,26,18,1081
41067030501,5344,4157,509,83,17,195,36,28,1187
41067030502,4147,3092,417,92,14,183,13,17,1055
41067030600,5928,4474,541,98,24,310,53,25,1454
41067030700,1563,838,388,41,6,115,50,12,725
41067030801,7288,4876,1279,115,36,373,67,53,2412
41067030803,5257,4063,448,112,8,308,33,9,1194
41067030805,4025,3003,454,81,12,150,54,20,1022
41067030806,2962,2035,458,38,20,174,69,20,927
41067030900,5721,3105,1664,159,29,271,108,42,2616
41067031005,5943,2999,1991,167,14,337,34,34,2944
41067031007,2834,2150,226,32,5,214,7,11,684
41067031008,4732,3054,859,134,24,279,29,37,1678
41067031009,5123,3476,549,106,12,488,19,26,1647
41067031010,2268,1701,175,15,0,233,8,10,567
41067031011,3437,1928,916,109,19,182,41,20,1509
41067031012,2817,1806,503,95,7,208,8,21,1011
41067031100,2964,1478,1024,76,9,150,5,24,1486
41067031201,3050,1656,917,45,17,215,22,14,1394
41067031202,4493,2156,1351,192,22,397,36,27,2337
41067031301,2694,1704,469,89,12,210,21,15,990
41067031302,4894,2177,1925,101,15,359,36,32,2717
41067031402,2961,1382,915,129,15,296,12,24,1579
41067031403,5034,3224,949,95,42,355,26,28,1810
41067031404,5450,3603,919,149,26,369,8,6,1847
41067031504,6625,4749,701,94,30,530,25,45,1876
41067031506,3700,2601,347,74,10,310,24,44,1099
41067031507,5608,3672,562,109,7,776,35,24,1936
41067031509,10964,3770,1041,349,40,5147,28,94,7194
41067031511,3244,2133,262,46,25,512,3,13,1111
41067031514,7254,4044,623,131,14,1950,21,31,3210
41067031515,4966,3111,209,34,5,1217,3,25,1855
41067031516,4048,2585,292,37,5,762,7,28,1463
41067031517,4753,2532,644,130,20,1120,15,22,2221
41067031518,3456,1906,215,82,10,993,21,20,1550
41067031519,7242,3101,323,67,21,3310,8,29,4141
41067031520,6535,2219,286,95,3,3519,4,35,4316
41067031606,6587,3264,1781,295,26,703,87,23,3323
41067031612,4281,2216,775,189,14,725,36,26,2065
41067031614,5551,2607,1120,154,27,1145,57,26,2944
41067031615,5222,2882,1341,76,23,542,33,20,2340
41067031616,3496,1824,515,166,21,677,23,25,1672
41067031617,5516,2569,807,268,25,1482,28,20,2947
41067031618,5719,2924,989,232,19,1130,48,37,2795
41067031619,4284,1781,1617,91,14,517,42,10,2503
41067031620,3918,2381,531,125,14,550,26,14,1537
41067031621,3948,2311,461,55,14,814,32,21,1637
41067031622,3589,1217,404,114,16,1639,5,28,2372
41067031623,3723,1700,910,246,20,554,23,16,2023
41067031624,4652,2314,1304,176,18,412,30,37,2338
41067031625,6559,3261,1559,285,26,830,47,40,3298
41067031626,3250,1462,612,277,13,681,12,12,1788
41067031703,5122,2787,1342,92,16,491,26,22,2335
41067031705,5542,2475,1917,227,31,540,45,37,3067
41067031706,5630,2590,1727,302,38,574,49,29,3040
41067031707,5420,3381,935,156,14,497,29,32,2039
41067031708,3272,1924,864,54,15,173,17,15,1348
41067031804,6711,3698,1348,182,34,912,51,33,3013
41067031806,5748,3586,915,165,21,578,18,28,2162
41067031807,3748,2543,492,73,14,353,21,19,1205
41067031813,6486,4190,540,143,12,1067,15,24,2296
41067031814,4135,2815,310,53,7,593,17,23,1320
41067031816,3966,2564,621,98,17,351,13,22,1402
41067031817,3546,2308,281,55,13,574,16,35,1238
41067031818,3161,2013,523,100,11,233,31,16,1148
41067031819,2708,1593,264,72,5,534,6,7,1115
41067031820,3260,2103,335,83,5,467,8,15,1157
41067031821,3405,2328,219,72,12,500,12,29,1077
41067031904,2941,2202,347,28,12,139,16,12,739
41067031909,6005,3880,515,145,16,959,34,20,2125
41067031911,5418,3838,487,103,17,549,13,26,1580
41067031912,4345,3093,585,65,18,255,40,22,1252
41067031913,2586,1554,518,73,10,270,7,8,1032
41067031914,4731,3680,576,65,18,152,20,7,1051
41067031915,5000,3249,389,134,13,779,40,29,1751
41067031916,4302,2761,383,102,18,707,28,18,1541
41067031917,4081,2789,477,75,6,457,1,20,1292
41067031918,4648,2992,474,77,7,678,58,15,1656
41067032001,5920,4092,1015,87,15,206,71,20,1828
41067032003,4239,2393,1263,57,18,164,85,21,1846
41067032004,2111,1461,358,39,5,71,34,14,650
41067032005,4975,2337,1871,80,18,205,135,38,2638
41067032104,5199,4171,447,27,17,169,19,26,1028
41067032107,1952,1547,196,15,0,45,12,2,405
41067032108,4176,3103,532,25,23,164,20,9,1073
41067032109,3050,2461,172,24,8,156,5,12,589
41067032110,3575,2806,296,98,93,151,7,9,769
41067032111,3577,2860,282,20,8,164,23,10,717
41067032112,7371,5641,837,42,60,286,25,26,1730
41067032201,5254,3903,523,42,29,354,13,17,1351
41067032202,3797,3186,272,11,21,50,4,29,611
41067032301,1354,1003,192,11,4,69,2,7,351
41067032302,5864,2933,1013,315,23,1143,30,41,2931
41067032404,7561,4729,1697,91,39,438,48,43,2832
41067032407,5202,3093,917,95,20,691,26,10,2109
41067032409,5131,1127,3599,86,17,86,23,25,4004
41067032410,4063,1647,1955,31,8,217,13,43,2416
41067032411,4534,2692,646,85,17,723,24,17,1842
41067032412,4124,2322,1156,83,14,279,17,11,1802
41067032413,2958,1585,368,87,11,643,28,14,1373
41067032414,4971,2613,559,95,15,1330,28,24,2358
41067032501,3369,1605,1404,83,14,87,6,31,1764
41067032502,2851,1552,710,97,17,246,20,11,1299
41067032503,3710,2199,965,78,22,181,13,18,1511
41067032603,7323,5145,1084,120,46,359,22,39,2178
41067032604,6355,3715,1891,102,29,245,21,33,2640
41067032606,6327,3469,2247,40,32,173,28,46,2858
41067032608,2267,1368,273,64,10,406,14,19,899
41067032609,2357,1467,268,56,2,383,17,16,890
41067032610,2879,1816,589,47,27,223,5,16,1063
41067032611,2806,1312,294,106,11,905,5,13,1494
41067032612,2811,1604,316,112,6,591,9,18,1207
41067032700,6374,4701,683,64,33,422,6,49,1673
41067032800,1309,1097,125,2,1,16,0,5,212
41067032901,6385,2667,3121,90,48,167,19,27,3718
41067032903,3257,1298,1796,21,13,22,10,7,1959
41067032904,4382,1807,2291,20,17,67,21,16,2575
41067033000,5759,4586,674,21,27,89,9,27,1173
41067033101,3044,2172,593,26,11,41,14,19,872
41067033102,3818,2206,1264,26,26,61,16,12,1612
41067033201,4113,1816,2036,17,14,53,3,15,2297
41067033202,4058,2215,1248,94,22,211,12,32,1843
41067033301,6533,4398,1428,61,35,179,8,16,2135
41067033302,6209,4813,737,26,25,169,17,36,1396
41067033400,2398,2125,106,2,18,30,0,10,273
41067033500,4011,3242,349,10,20,71,8,12,769
41067033600,2359,1913,184,6,17,48,0,4,446
41069960100,1451,1256,84,1,17,8,0,1,195
41071030101,6796,5554,526,55,33,189,8,54,1242
41071030102,9071,7272,935,54,32,138,13,45,1799
41071030201,6661,4894,1101,69,51,116,16,26,1767
41071030202,6577,4495,1416,59,36,102,13,21,2082
41071030302,2185,1882,154,9,9,25,0,16,303
41071030303,4170,3318,510,16,24,56,7,14,852
41071030304,6580,4741,1239,21,80,79,10,63,1839
41071030400,7998,6748,569,17,48,57,9,53,1250
41071030501,6643,4747,812,298,267,130,2,28,1896
41071030502,5205,3868,430,19,392,76,6,30,1337
41071030601,3777,2420,1103,18,22,14,3,29,1357
41071030602,7162,5459,1088,30,46,120,31,31,1703
41071030702,7784,4985,2143,44,65,77,11,38,2799
41071030703,4511,3160,985,21,38,51,2,32,1351
41071030704,3723,2932,433,18,28,71,11,33,791
41071030801,5580,3589,1527,38,65,61,16,29,1991
41071030802,4377,2782,1163,27,31,89,20,18,1595
41071030900,4601,3125,1149,17,38,32,6,21,1476
41071031000,4321,3381,510,19,41,40,5,34,940
42001030101,2646,2426,104,12,3,9,0,16,220
42001030103,2375,2226,49,8,6,9,3,3,149
42001030104,3424,2960,325,15,1,13,2,12,464
42001030200,5346,4349,779,32,11,38,1,10,997
42001030300,4437,3341,896,41,14,15,0,17,1096
42001030400,5543,4848,430,63,7,38,0,9,695
42001030500,3775,3127,477,21,6,14,3,12,648
42001030600,4851,4052,468,133,5,35,2,17,799
42001030700,6424,5555,513,77,6,34,1,11,869
42001030801,3425,2971,250,41,8,36,1,14,454
42001030802,1542,1381,85,14,2,11,1,8,161
42001030803,2714,2510,127,10,3,18,0,0,204
42001030901,3567,2949,458,37,4,11,0,8,618
42001030902,4237,3736,361,35,2,41,0,5,501
42001031000,2310,2092,107,31,0,14,2,5,218
42001031101,5177,4456,411,72,3,41,1,22,721
42001031102,3465,3185,95,60,3,25,1,12,280
42001031201,3789,3392,153,51,2,44,0,19,397
42001031202,2844,2675,57,17,0,11,0,10,169
42001031203,3055,2869,47,13,1,17,0,16,186
42001031300,4803,4276,169,76,10,24,4,14,527
42001031401,4745,3994,319,138,2,96,0,8,751
42001031402,2288,2048,61,44,0,48,0,5,240
42001031501,3157,2452,261,156,16,182,0,11,705
42001031502,3949,2797,613,226,13,87,3,24,1152
42001031600,7138,6628,113,36,14,28,3,44,510
42001031700,2826,2650,62,14,5,13,5,1,176
42003010301,1807,545,48,1199,3,6,0,0,1262
42003010302,4075,2876,283,648,33,116,0,11,1199
42003020100,4729,3324,271,577,4,357,0,54,1405
42003020300,1845,1470,88,51,0,174,1,2,375
42003030500,3041,714,92,1810,9,284,2,16,2327
42003040200,2534,1510,112,603,6,197,0,47,1024
42003040400,2220,1485,96,103,0,468,0,6,735
42003040500,3781,2881,150,191,2,385,0,16,900
42003040600,2054,1552,69,94,2,241,1,8,502
42003040900,3326,1860,180,565,6,563,0,12,1466
42003050100,1757,81,23,1597,0,5,0,4,1676
42003050600,1723,386,44,1130,12,72,0,18,1337
42003050900,1386,51,25,1255,7,3,0,0,1335
42003051000,1703,453,51,1018,4,87,0,12,1250
42003051100,617,42,14,528,1,0,1,5,575
42003060300,2641,2110,74,185,3,143,0,14,531
42003060500,1201,980,36,81,0,17,1,11,221
42003070300,2243,1581,115,102,0,341,0,15,662
42003070500,3040,2143,135,129,1,501,0,16,897
42003070600,2194,1596,108,58,0,327,3,9,598
42003070800,2853,1694,154,97,3,791,0,10,1159
42003070900,4987,2618,203,274,0,1703,1,27,2369
42003080200,1618,1383,48,54,0,46,1,9,235
42003080400,1674,1035,92,86,0,365,0,11,639
42003080600,2008,1609,99,98,5,115,0,9,399
42003080700,1963,1171,148,201,3,345,0,10,792
42003080900,1824,1365,109,172,0,95,0,7,459
42003090100,2038,1749,72,73,0,80,2,8,289
42003090200,2678,2257,95,132,1,84,0,23,421
42003090300,1541,1270,63,100,2,60,0,4,271
42003100500,2013,712,65,1130,0,24,0,5,1301
42003101100,2394,1984,66,154,5,74,0,12,410
42003101400,3252,2628,98,315,3,52,0,14,624
42003101800,2414,1854,43,345,6,56,1,14,560
42003101900,2432,564,69,1591,7,57,2,42,1868
42003110200,3787,2540,184,622,5,204,5,26,1247
42003110600,2440,1725,107,361,3,100,0,22,715
42003111300,2658,1236,146,962,7,134,0,13,1422
42003111400,1211,421,42,622,2,30,0,16,790
42003111500,3529,1239,109,1625,10,375,1,29,2290
42003120300,1424,42,32,1291,0,1,0,12,1382
42003120900,1545,209,32,1181,11,37,1,6,1336
42003130200,1028,36,24,895,0,9,2,8,992
42003130600,2892,64,34,2656,12,4,1,14,2828
42003130700,2231,54,41,2040,10,4,1,23,2177
42003130800,2260,63,41,2007,7,9,0,28,2197
42003140100,5579,4175,363,214,4,549,0,28,1404
42003140200,2771,1876,112,66,0,603,1,4,895
42003140300,3529,2769,125,76,3,364,0,21,760
42003140400,2312,1943,77,32,0,125,0,14,369
42003140500,1988,1039,96,629,9,113,0,13,949
42003140800,4658,3487,161,95,5,640,1,73,1171
42003141100,1339,1150,31,60,0,41,0,4,189
42003141200,4007,3304,168,180,1,137,2,13,703
42003141300,5048,3196,195,182,1,1244,1,16,1852
42003141400,5593,4203,269,235,4,599,0,27,1390
42003151600,2305,1975,82,71,2,57,0,8,330
42003151700,4956,3775,251,235,4,398,5,39,1181
42003160800,2552,1979,109,278,0,36,5,14,573
42003160900,3483,2727,139,240,1,234,1,9,756
42003161000,2666,1543,91,825,1,8,0,35,1123
42003170200,3984,3357,162,141,0,125,0,32,627
42003170600,1775,1405,94,158,1,35,2,9,370
42003180300,2305,1252,81,781,3,19,6,16,1053
42003180700,2050,1517,77,354,2,16,0,1,533
42003190300,1930,1741,49,42,0,27,8,8,189
42003191100,2397,2120,73,67,0,50,2,5,277
42003191400,2725,2216,85,254,2,29,0,8,509
42003191500,2005,1547,55,247,4,18,0,11,458
42003191600,4141,2763,516,570,7,67,0,23,1378
42003191700,3391,2685,121,221,2,191,3,15,706
42003191800,5252,4422,221,248,3,89,0,35,830
42003191900,2177,1792,69,155,7,25,4,17,385
42003192000,3455,2562,264,314,0,90,1,24,893
42003202200,2550,1191,89,855,0,199,4,15,1359
42003202300,4127,3162,158,190,6,385,0,24,965
42003241300,3395,2585,122,424,3,87,0,8,810
42003250900,1140,456,26,578,2,6,0,8,684
42003260200,2092,1216,65,664,0,25,0,5,876
42003260700,1653,896,67,597,0,10,1,13,757
42003261300,2767,840,56,1732,3,16,0,12,1927
42003261400,2241,566,81,1476,4,5,2,22,1675
42003261500,1524,469,49,907,5,11,0,16,1055
42003262000,2400,1533,65,634,3,15,0,30,867
42003270100,2578,1701,93,596,3,37,0,25,877
42003270300,1906,1042,59,686,1,21,0,8,864
42003270800,2621,1889,73,502,5,28,0,16,732
42003271600,4046,1686,98,1904,7,57,3,36,2360
42003281400,2552,1245,65,951,5,52,0,36,1307
42003281500,1447,1012,30,303,3,15,0,11,435
42003290100,2130,1424,92,347,16,109,1,11,706
42003290200,4141,2647,157,708,2,354,1,32,1494
42003290400,4019,2896,154,588,3,170,0,19,1123
42003300100,3493,1138,157,1776,17,89,0,41,2355
42003310200,3155,2750,65,167,2,35,0,5,405
42003320400,1870,1532,46,152,5,26,0,19,338
42003320600,2243,1874,54,165,2,38,0,13,369
42003320700,1613,1422,64,47,1,12,0,5,191
42003401100,4601,4245,44,89,3,62,0,15,356
42003401200,2911,2287,77,287,6,29,0,21,624
42003401300,2645,2428,27,42,2,17,1,7,217
42003402000,3240,2748,63,218,5,19,1,4,492
42003403500,4352,3553,96,348,4,24,0,27,799
42003404000,1490,1318,15,41,2,11,0,8,172
42003405000,1161,1090,16,2,3,6,0,0,71
42003406000,2210,2116,18,7,0,10,1,9,94
42003407001,5586,5295,100,13,5,25,1,7,291
42003407002,6676,6380,83,38,3,18,0,11,296
42003408001,5633,5093,92,36,2,159,0,30,540
42003408002,6309,5815,99,46,5,166,0,18,494
42003409001,9192,7719,258,144,6,677,4,56,1473
42003409002,5499,4660,182,75,5,326,2,12,839
42003410000,1183,1087,25,5,3,15,1,7,96
42003411001,4004,3079,128,42,1,599,0,12,925
42003411002,6076,4333,233,99,6,1187,2,16,1743
42003412002,4865,3946,97,58,4,596,3,21,919
42003412003,6312,5016,132,79,9,848,6,25,1296
42003412004,4302,2828,77,50,3,1174,0,20,1474
42003413100,6998,5742,190,122,11,723,4,13,1256
42003413201,3826,3449,68,68,2,139,2,1,377
42003413202,2860,2589,56,17,0,91,0,11,271
42003413300,4876,4388,72,46,5,199,0,6,488
42003413400,4517,3902,93,60,2,277,1,13,615
42003413500,6621,5487,160,247,0,527,0,19,1134
42003414101,5499,5099,70,50,3,138,1,12,400
42003414102,7044,6405,146,62,2,240,3,19,639
42003414200,5936,5487,104,31,1,131,0,9,449
42003415001,4650,3997,106,82,7,305,2,13,653
42003415002,2604,2306,60,22,0,94,0,7,298
42003416000,1540,1443,24,10,3,3,0,4,97
42003417100,2166,1997,38,15,0,2,0,21,169
42003417200,1234,1119,11,32,3,0,0,6,115
42003418000,1672,1554,26,1,0,9,0,3,118
42003419000,3133,2887,46,37,2,55,0,8,246
42003420000,1454,1182,35,68,0,102,0,7,272
42003421100,4969,4021,150,101,2,468,0,36,948
42003421200,4315,3766,116,53,0,225,0,13,549
42003422000,5343,4548,151,59,0,398,0,12,795
42003423000,2916,2487,93,56,1,172,0,7,429
42003424000,3187,2469,115,362,3,60,0,18,718
42003425000,3437,2968,115,141,2,36,3,22,469
42003426300,5982,5620,91,67,1,33,0,17,362
42003426400,4435,4132,64,37,0,31,0,16,303
42003426700,2303,2093,62,24,5,53,0,6,210
42003426800,5150,4801,75,44,0,78,0,18,349
42003427000,3376,2947,115,120,7,19,0,6,429
42003427100,5340,4989,92,43,6,60,0,12,351
42003427200,4922,4531,80,74,6,61,0,13,391
42003428100,1187,1093,21,11,2,6,0,4,94
42003428200,2068,1925,16,36,0,13,1,16,143
42003429100,2607,2224,45,132,2,74,1,7,383
42003429201,4941,4000,105,110,7,599,2,19,941
42003429202,4605,4142,100,49,1,130,1,19,463
42003429300,6546,5840,101,152,0,242,0,19,706
42003429400,4498,4090,92,61,0,61,0,15,408
42003429500,4412,3716,105,180,3,264,0,7,696
42003429600,3588,3068,72,151,6,113,0,15,520
42003429700,2370,2131,26,92,0,24,0,18,239
42003430100,2134,1876,53,67,5,24,3,10,258
42003430200,4551,4057,124,121,2,55,0,11,494
42003431100,3253,2421,88,471,5,58,2,19,832
42003431400,1893,1520,57,182,0,25,1,2,373
42003431500,3165,2475,99,360,6,44,0,14,690
42003432300,2183,1795,66,202,4,13,0,7,388
42003432400,2579,1993,70,324,5,45,2,17,586
42003434000,1918,1674,51,72,4,23,3,1,244
42003435000,2525,2142,92,102,4,47,0,11,383
42003437000,7178,6432,133,140,3,234,4,28,746
42003439000,1505,1359,39,26,0,22,3,14,146
42003445500,3907,3301,128,195,6,71,1,16,606
42003446000,1669,1518,56,13,0,22,0,6,151
42003447000,1624,1396,59,55,2,35,0,10,228
42003448000,1162,904,43,94,2,23,0,0,258
42003449000,2488,2191,57,91,8,37,0,6,297
42003450700,3033,2412,151,247,3,15,1,20,621
42003450800,2526,1752,192,382,8,12,0,13,774
42003451101,3792,3358,96,110,0,86,2,12,434
42003451102,6047,4394,517,592,14,245,0,23,1653
42003451104,3966,3428,82,109,0,159,1,6,538
42003451105,5625,4103,242,402,10,540,2,35,1522
42003451300,7810,6780,177,182,2,363,3,27,1030
42003452000,6372,5698,167,144,0,104,3,31,674
42003453003,2184,1988,26,53,8,16,1,20,196
42003453004,7258,5991,251,337,4,331,3,42,1267
42003455000,1475,1343,17,24,1,7,0,1,132
42003456001,4679,3855,81,68,10,453,0,6,824
42003456003,8059,6088,161,153,8,1393,0,19,1971
42003456004,5620,4728,121,148,7,419,3,24,892
42003457100,1406,1238,35,52,0,18,0,4,168
42003457200,3398,2989,75,146,2,42,0,14,409
42003458001,4333,3657,103,97,4,306,4,23,676
42003458002,4602,4287,48,55,1,76,1,25,315
42003459101,1733,1459,33,144,3,19,0,12,274
42003459102,6426,5550,168,164,4,336,0,23,876
42003459201,7344,6110,222,283,6,427,0,40,1234
42003459202,677,629,10,12,0,10,0,0,48
42003460001,4925,4497,89,123,2,65,0,15,428
42003460002,3776,3329,52,199,0,70,0,15,447
42003461000,1108,877,61,87,5,8,2,0,231
42003462100,2524,1613,90,648,1,29,0,19,911
42003462600,3902,2169,129,1284,10,21,0,26,1733
42003463900,2712,1548,58,892,8,18,1,21,1164
42003464300,3391,2771,59,305,9,42,0,16,620
42003464400,3208,1306,71,1534,6,57,1,23,1902
42003465600,2494,1949,62,301,0,50,1,10,545
42003465800,3605,3056,112,217,0,34,0,18,549
42003468700,1670,1426,31,98,0,15,0,8,244
42003468800,2553,2046,76,186,0,109,2,18,507
42003468900,3911,2876,112,278,9,362,0,23,1035
42003469000,4941,4175,117,143,0,312,0,13,766
42003470300,4317,3861,66,95,1,165,0,6,456
42003470400,3068,2834,68,15,0,45,0,13,234
42003470501,4317,1961,75,93,9,2099,0,10,2356
42003470502,3011,2590,74,103,0,153,0,7,421
42003470600,2936,2542,77,104,5,40,1,15,394
42003471000,1288,1134,30,51,3,16,0,0,154
42003472100,2395,2021,109,102,3,66,0,4,374
42003472200,2224,1940,91,70,0,51,0,5,284
42003472300,1849,1619,76,59,0,34,3,5,230
42003472400,1776,1609,50,29,0,26,0,9,167
42003473100,4963,4350,167,69,1,172,0,10,613
42003473200,3294,2748,129,62,4,199,0,16,546
42003473300,5771,4986,266,54,0,199,1,13,785
42003473401,3731,3219,118,78,2,146,0,11,512
42003473402,3678,3178,110,51,0,168,3,15,500
42003473500,3788,3350,130,48,4,101,0,26,438
42003473601,4136,3628,95,69,0,177,0,17,508
42003473602,4714,3994,117,49,1,395,0,10,720
42003474101,4460,3424,127,52,2,704,0,18,1036
42003474102,3901,3438,98,35,5,187,2,12,463
42003474201,2634,2193,67,22,0,209,1,14,441
42003474202,5363,4530,155,34,5,448,0,14,833
42003474203,4802,3977,129,46,0,436,0,22,825
42003475101,4977,4344,115,95,0,268,1,6,633
42003475102,1677,1567,19,17,0,25,1,0,110
42003475200,5568,5061,130,73,6,113,0,23,507
42003475301,4460,4002,77,139,5,87,0,17,458
42003475303,4150,3847,64,31,0,41,0,15,303
42003475304,5466,4976,91,53,2,161,3,6,490
42003475401,4066,3689,60,42,0,170,3,8,377
42003475402,3213,2948,38,28,0,68,0,10,265
42003476100,4979,3968,121,225,2,437,0,33,1011
42003476200,3270,2945,50,75,0,92,2,19,325
42003477100,3779,3407,60,30,0,163,0,6,372
42003477200,4466,4005,52,28,0,278,1,6,461
42003477300,6819,4309,98,624,8,1541,2,24,2510
42003478100,4363,3425,161,287,8,307,3,33,938
42003478200,5719,4601,182,275,3,401,0,31,1118
42003479000,1985,1786,23,26,0,74,0,2,199
42003480101,5975,3481,119,654,6,1503,10,25,2494
42003480102,3121,2688,48,67,2,217,2,4,433
42003480200,3797,2856,37,113,6,660,0,10,941
42003480300,3613,3235,37,102,2,128,4,23,378
42003480400,5004,4483,101,147,6,99,0,24,521
42003481000,3394,1567,184,1249,8,136,0,19,1827
42003482500,1872,1474,45,249,0,9,1,10,398
42003483800,2884,804,94,1742,2,54,0,26,2080
42003484300,3122,1956,90,846,9,42,0,26,1166
42003484500,5614,5047,120,220,0,34,0,30,567
42003484600,2038,1556,44,297,1,38,0,15,482
42003485000,1179,868,37,188,0,6,0,9,311
42003486700,2212,830,88,1153,0,5,1,13,1382
42003486800,1653,468,63,989,5,0,0,24,1185
42003486900,1389,435,26,805,3,2,0,15,954
42003487000,1612,1374,20,130,5,5,2,5,238
42003488100,2149,1599,50,375,4,5,0,7,550
42003488200,3441,2362,89,815,4,13,0,26,1079
42003488300,2008,1833,35,63,0,5,0,2,175
42003488400,4649,3603,91,654,4,26,0,23,1046
42003488500,2742,2346,54,136,0,66,0,14,396
42003488600,4600,3802,134,382,3,70,0,17,798
42003489001,4703,4184,79,170,3,136,0,9,519
42003489002,3801,3290,69,94,1,221,0,13,511
42003490002,5102,4390,111,227,3,144,0,13,712
42003490003,3679,3384,39,78,0,68,0,5,295
42003490004,4946,4551,51,107,8,35,5,25,395
42003491101,7681,6659,168,211,5,397,1,21,1022
42003491200,2114,1875,47,52,4,52,0,4,239
42003492700,1819,1232,47,390,8,7,0,9,587
42003492800,2465,661,59,1575,9,19,0,17,1804
42003492900,1897,1095,66,579,2,8,0,16,802
42003494000,1398,1204,23,74,0,2,0,6,194
42003495000,3070,2892,32,31,0,3,2,12,178
42003496101,3031,2825,40,45,1,12,0,8,206
42003496102,4370,4089,34,96,3,15,0,8,281
42003496200,5581,5116,83,145,3,21,0,8,465
42003497000,932,889,5,4,3,0,1,12,43
42003498000,2355,2172,32,45,0,5,0,5,183
42003499300,1678,1454,46,81,5,6,0,21,224
42003499400,2797,2193,82,317,6,10,0,10,604
42003500300,3680,3190,84,152,5,12,0,31,490
42003501000,1476,1158,37,193,3,4,0,14,318
42003503002,5846,5111,91,369,7,34,5,29,735
42003504100,5026,3111,134,1410,7,27,0,26,1915
42003507000,2076,1520,49,378,0,8,0,17,556
42003508000,1781,934,59,663,5,8,0,10,847
42003509400,5114,3061,101,1530,4,44,2,44,2053
42003510000,1927,599,76,1099,5,5,0,20,1328
42003512000,2073,1201,41,689,0,9,0,9,872
42003513000,2247,561,68,1444,1,7,0,9,1686
42003513800,1721,317,42,1219,5,7,1,13,1404
42003514000,1896,256,48,1504,0,6,0,9,1640
42003515100,2566,984,67,1339,3,33,4,22,1582
42003515200,2034,1145,93,625,3,46,2,17,889
42003515300,1734,768,76,748,3,42,4,6,966
42003515401,2290,1772,92,284,0,55,0,5,518
42003516100,1406,1227,37,51,0,40,0,2,179
42003516200,1739,1291,70,250,4,43,0,9,448
42003517000,1730,1005,47,571,3,12,0,10,725
42003518001,3286,2741,73,283,1,70,2,16,545
42003519000,3157,2319,62,519,0,85,0,22,838
42003520001,3258,2347,51,601,0,116,4,20,911
42003520002,3092,2147,98,631,3,36,0,5,945
42003521100,4551,2874,115,1025,4,254,1,37,1677
42003521200,4521,3075,178,709,3,323,1,24,1446
42003521301,4216,2656,111,859,6,345,0,26,1560
42003521302,4516,2795,146,798,7,575,2,24,1721
42003521401,2924,2323,99,234,0,147,3,13,601
42003521402,3855,2892,63,420,4,306,0,24,963
42003521500,4083,3352,78,295,7,185,0,26,731
42003522000,3101,2016,71,782,1,13,3,18,1085
42003523100,3805,384,96,3126,3,18,0,13,3421
42003523200,3743,1168,85,2232,2,17,0,52,2575
42003523300,3807,1843,85,1609,1,44,0,15,1964
42003523400,4921,2324,128,2095,11,56,1,49,2597
42003523501,4703,1872,123,2350,11,35,1,56,2831
42003523502,1497,935,52,419,1,1,0,14,562
42003523600,4852,2541,161,1892,5,47,0,15,2311
42003523701,3868,2972,64,622,3,21,0,11,896
42003523702,5176,3159,119,1544,6,54,0,29,2017
42003523800,4687,3657,106,701,4,20,0,15,1030
42003524000,2492,2070,63,232,0,11,0,13,422
42003525100,2003,1822,62,40,1,10,0,2,181
42003525200,2536,2329,39,59,0,38,0,2,207
42003525300,2219,2062,43,19,0,26,0,0,157
42003526101,7410,6763,83,256,4,75,5,11,647
42003526102,2327,2120,50,53,4,22,0,2,207
42003526201,3704,3335,56,98,0,49,0,9,369
42003526202,4649,3954,101,322,4,71,1,31,695
42003526301,3989,3678,50,104,0,20,0,20,311
42003526302,5065,4334,109,351,6,86,0,12,731
42003550900,1467,555,51,741,12,10,0,18,912
42003551200,3391,1607,116,1425,7,4,0,14,1784
42003551300,2347,1876,64,282,1,9,0,3,471
42003551900,1330,648,77,531,1,0,1,13,682
42003552000,2294,941,88,1099,3,6,1,30,1353
42003552100,1175,420,16,680,0,7,1,0,755
42003552200,969,661,28,190,4,4,0,6,308
42003552300,1862,444,72,1187,6,2,2,10,1418
42003552400,2892,1887,113,691,15,3,0,13,1005
42003560400,1553,710,36,691,1,35,1,7,843
42003560500,2193,1732,98,174,0,91,0,9,461
42003561400,4012,787,92,2861,7,54,1,39,3225
42003561500,2588,680,69,1658,2,45,0,19,1908
42003561900,1898,65,27,1720,6,14,0,10,1833
42003562000,3449,1801,133,312,4,1075,0,14,1648
42003562300,3115,1181,67,1647,10,58,1,19,1934
42003562400,2363,840,105,1236,7,21,0,14,1523
42003562500,2919,983,59,1564,7,18,2,65,1936
42003562600,2398,1379,66,766,3,21,5,9,1019
42003562700,1959,1086,91,421,7,250,2,9,873
42003562800,1516,1078,48,146,5,118,0,5,438
42003562901,1433,838,43,416,4,43,0,8,595
42003563000,2928,1368,115,1044,5,198,3,19,1560
42003563100,3722,2509,131,298,2,596,0,39,1213
42003563201,301,247,11,9,0,15,0,1,54
42003563202,1903,1256,73,438,2,42,2,2,647
42003563300,1546,1381,29,25,0,57,0,18,165
42003563800,3881,3591,73,54,0,33,1,14,290
42003563900,3891,2741,108,775,4,53,0,23,1150
42003564000,7121,6450,166,115,3,140,5,7,671
42003564100,907,851,16,3,0,11,0,2,56
42003564200,2094,1896,60,64,0,10,2,12,198
42003564400,5631,4748,82,499,5,37,2,16,883
42003564500,3032,2842,36,31,0,10,0,1,190
42003564700,2184,464,81,1441,9,13,0,26,1720
42003564800,1819,144,40,1532,4,5,0,5,1675
42003565100,2972,1767,104,903,5,56,0,14,1205
42003565200,2740,799,68,1710,7,31,0,20,1941
42003565300,1238,993,11,150,0,11,0,12,245
42003980000,0,0,0,0,0,0,0,0,0
42003980100,8,5,1,0,0,0,0,0,3
42003980300,0,0,0,0,0,0,0,0,0
42003980400,13,11,0,1,0,0,0,0,2
42003980500,18,16,0,0,0,1,0,0,2
42003980600,19,12,4,0,0,2,0,0,7
42003980700,29,22,2,3,0,0,0,0,7
42003980800,3,0,1,0,0,1,0,0,3
42003980900,0,0,0,0,0,0,0,0,0
42003981000,4,3,1,0,0,0,0,0,1
42003981100,0,0,0,0,0,0,0,0,0
42003981200,0,0,0,0,0,0,0,0,0
42003981800,314,244,5,57,0,5,0,1,70
42003982200,5022,3742,103,546,42,297,0,190,1280
42005950100,4712,4567,17,7,0,9,0,6,145
42005950200,2070,2006,11,3,1,0,0,2,64
42005950300,3276,3141,29,18,0,7,0,5,135
42005950400,2295,2220,6,3,2,10,0,4,75
42005950500,5342,5146,29,17,6,10,0,11,196
42005950600,3248,3063,42,19,9,8,0,15,185
42005950700,3679,3556,36,2,0,3,0,0,123
42005950800,3789,3630,26,24,3,13,0,4,159
42005950900,4922,4689,42,25,1,18,0,6,233
42005951000,2859,2637,33,56,5,4,5,16,222
42005951100,3921,3652,42,40,6,19,0,6,269
42005951200,5753,5545,36,11,0,6,0,12,208
42005951300,2411,2293,16,15,0,8,0,3,118
42005951400,2472,2302,9,63,6,3,1,4,170
42005951500,2867,2599,36,54,4,15,5,6,268
42005951600,4605,4364,16,25,3,4,2,7,241
42005951700,3452,3305,18,11,0,0,1,7,147
42005951800,2149,1974,22,35,9,9,0,3,175
42005951900,1736,1631,24,10,2,1,0,3,105
42007600601,2067,1964,19,10,0,3,2,7,103
42007600602,2680,2510,37,22,4,5,1,9,170
42007600701,3372,3134,71,34,0,13,0,8,238
42007600702,4670,4325,77,54,0,50,0,10,345
42007601000,3768,3376,88,76,3,34,0,8,392
42007601100,3076,2319,83,376,14,55,0,51,757
42007601200,3200,1968,80,830,5,15,2,33,1232
42007601300,2729,1689,52,667,9,8,2,30,1040
42007601400,3244,2553,76,327,14,7,5,5,691
42007601600,1300,1116,32,44,0,0,1,12,184
42007601700,3262,3019,36,57,3,6,3,3,243
42007601801,3561,3383,41,14,2,12,1,9,178
42007601802,3622,3422,40,11,0,6,1,4,200
42007602100,3472,2509,90,562,7,9,1,22,963
42007602300,2486,2244,59,64,0,37,0,10,242
42007602400,1952,1784,37,11,1,22,3,7,168
42007602500,1295,1205,22,21,0,10,2,0,90
42007602601,5249,4879,95,35,10,56,1,16,370
42007602602,3541,3300,61,88,1,12,0,3,241
42007602701,1838,1666,40,28,2,6,0,1,172
42007602702,3420,3142,70,38,5,10,5,7,278
42007602800,2433,1728,119,394,4,20,0,23,705
42007602900,2684,2523,26,7,3,0,0,8,161
42007603000,2793,2639,31,16,9,11,0,6,154
42007603202,7157,6356,151,246,9,89,0,19,801
42007603300,3811,3355,74,152,2,15,0,5,456
42007603400,1814,1609,53,46,5,21,0,0,205
42007603500,1496,1290,27,42,0,8,3,2,206
42007603600,2168,1988,25,29,2,14,0,9,180
42007603700,3904,3597,58,76,3,18,0,8,307
42007603801,2931,2732,49,34,3,14,1,8,199
42007603802,3145,2961,66,34,2,6,1,4,184
42007603803,3022,2805,63,21,2,5,2,18,217
42007603900,3187,2809,65,140,0,34,2,11,378
42007604000,2594,1687,108,517,3,16,0,20,907
42007604100,2779,1781,120,589,2,26,2,18,998
42007604200,1599,1188,84,202,5,24,0,0,411
42007604500,2269,440,80,1592,0,0,0,24,1829
42007604600,2880,2099,89,520,12,17,2,11,781
42007604700,1469,938,109,335,3,16,0,10,531
42007604800,4875,4385,82,160,0,30,0,15,490
42007604901,4026,3486,95,242,4,19,0,15,540
42007604902,4978,4471,148,106,0,79,0,20,507
42007605001,2248,2087,22,0,3,5,1,7,161
42007605002,3459,3255,37,24,4,3,1,9,204
42007605100,4680,4480,37,13,0,15,0,9,200
42007605200,2511,2113,115,152,4,7,1,4,398
42007605300,2998,2778,32,26,0,11,0,11,220
42007605400,3489,2679,81,359,12,23,0,27,810
42007605500,5011,4405,104,195,8,71,6,14,606
42007605600,3276,2860,59,160,4,9,0,4,416
42007605700,2620,1120,103,1222,4,7,0,6,1500
42007605800,6105,5730,93,49,3,13,1,13,375
42009960100,3573,3446,39,14,2,4,0,1,127
42009960200,3382,3261,22,8,5,4,0,0,121
42009960300,4833,4626,26,14,11,15,0,10,207
42009960400,5202,4994,43,13,1,17,0,3,208
42009960500,3327,3203,38,6,2,6,0,4,124
42009960600,4847,4574,60,22,7,12,0,2,273
42009960700,2865,2672,43,32,7,26,0,1,193
42009960800,5105,4740,105,41,14,45,0,11,365
42009960900,4699,4489,79,10,4,1,0,4,210
42009961001,2747,2640,19,1,3,1,0,6,107
42009961002,3043,2946,24,11,3,17,0,3,97
42009961100,3954,3790,21,9,7,5,0,5,164
42011000100,6076,1080,4049,709,22,48,0,35,4996
42011000200,4041,797,2763,348,3,31,0,31,3244
42011000300,2373,570,1558,137,7,44,0,18,1803
42011000400,4114,762,2864,337,3,37,0,18,3352
42011000500,3702,794,2616,169,3,16,1,10,2908
42011000600,3449,1443,1307,534,6,44,1,12,2006
42011000700,4361,733,3273,212,0,26,0,18,3628
42011000800,4658,519,3757,267,3,31,0,40,4139
42011000900,3018,682,1879,336,1,34,0,8,2336
42011001000,3510,301,2742,357,5,26,1,15,3209
42011001100,4448,357,3578,377,4,19,0,38,4091
42011001200,1854,112,1454,224,1,8,0,26,1742
42011001300,3514,516,2623,292,5,5,0,20,2998
42011001400,4833,488,3896,296,8,44,0,28,4345
42011001500,3897,454,3130,199,4,29,2,20,3443
42011001600,2869,485,2124,163,2,19,2,13,2384
42011001700,3353,339,2805,136,3,21,0,7,3014
42011001800,3006,949,1606,304,6,36,0,10,2057
42011001900,2860,514,1873,328,3,47,1,31,2346
42011002001,1443,413,810,151,4,5,0,3,1030
42011002002,3268,708,2059,368,1,13,1,8,2560
42011002100,3290,516,2387,260,5,15,0,12,2774
42011002200,2282,261,1811,154,0,11,2,12,2021
42011002300,2302,332,1758,156,4,0,1,7,1970
42011002500,3499,410,2626,366,2,8,3,24,3089
42011002600,3456,681,2337,284,1,37,0,18,2775
42011002700,2125,1163,725,141,1,29,0,10,962
42011002900,3511,1620,1181,520,16,43,0,11,1891
42011010100,5915,5434,233,32,9,58,0,36,481
42011010201,4444,4011,270,16,3,10,0,11,433
42011010202,5209,4642,326,61,5,29,0,20,567
42011010302,3027,2613,237,45,1,21,0,9,414
42011010303,2023,1709,190,22,11,15,0,10,314
42011010304,6637,5411,759,246,5,47,0,18,1226
42011010401,1616,1465,89,7,0,11,0,3,151
42011010402,7221,6618,324,72,12,31,5,10,603
42011010500,6658,5532,642,186,8,59,1,32,1126
42011010601,2776,2364,223,82,3,34,1,12,412
42011010602,6230,5162,395,170,2,296,1,13,1068
42011010701,2941,2584,161,106,2,19,0,12,357
42011010702,4722,3769,443,269,0,119,6,2,953
42011010801,1953,1746,118,33,1,29,0,1,207
42011010803,5948,3610,1017,644,6,321,2,20,2338
42011010804,3646,3039,240,116,0,149,0,11,607
42011010902,4286,2893,748,284,7,167,0,6,1393
42011010903,6062,4761,551,350,7,219,0,13,1301
42011010904,3797,2795,470,144,20,246,0,14,1002
42011010905,5261,3809,991,208,0,89,0,17,1452
42011011000,4765,3567,662,179,4,169,0,31,1198
42011011101,2530,1615,476,162,5,204,0,13,915
42011011102,5581,4760,453,82,1,103,0,31,821
42011011200,4553,2722,1181,320,0,95,0,27,1831
42011011300,3001,2030,733,83,1,46,0,5,971
42011011400,5475,4016,980,200,4,53,1,24,1459
42011011500,2927,2370,346,77,1,22,0,8,557
42011011601,5536,3834,977,373,5,175,1,20,1702
42011011602,4545,3821,449,64,2,99,0,12,724
42011011603,5538,4761,374,135,10,114,0,16,777
42011011702,4602,4213,151,34,0,70,0,22,389
42011011703,4288,3843,138,54,4,65,0,41,445
42011011704,2527,2332,77,10,2,15,0,6,195
42011011705,5011,4540,186,54,3,21,0,7,471
42011011800,5106,4432,311,113,9,35,1,18,674
42011011902,3886,3493,129,73,2,38,0,14,393
42011011903,5175,4402,182,212,7,144,0,12,773
42011011905,3411,2923,151,101,9,72,0,13,488
42011011906,4810,4008,219,235,0,146,1,16,802
42011012001,2397,2011,161,86,0,23,0,1,386
42011012003,2195,1896,151,54,10,28,0,2,299
42011012004,6757,5353,631,363,0,163,0,23,1404
42011012101,1892,1481,247,73,2,12,0,11,411
42011012103,2500,2275,72,30,5,43,0,6,225
42011012104,3130,2364,540,119,3,11,0,0,766
42011012106,4914,3993,416,214,3,156,0,8,921
42011012107,3573,2991,253,110,5,107,0,7,582
42011012200,3318,1900,1029,189,1,22,0,12,1418
42011012300,4638,3496,808,124,5,37,4,10,1142
42011012400,7853,4197,2847,470,5,102,5,21,3656
42011012500,2242,1162,931,51,2,28,2,11,1080
42011012600,2543,1122,1144,157,1,31,1,19,1421
42011012701,5076,3545,982,216,0,166,2,32,1531
42011012702,4201,2875,835,234,1,119,0,14,1326
42011012800,4277,2422,1530,151,12,35,0,25,1855
42011012901,3834,3377,250,34,6,44,0,1,457
42011012902,3810,3578,109,17,4,14,0,6,232
42011013000,6767,6122,152,272,12,20,2,16,645
42011013100,5112,4817,126,17,0,23,3,7,295
42011013200,4264,3890,139,52,4,29,0,16,374
42011013301,2962,2756,100,13,2,18,0,7,206
42011013302,6555,6067,180,78,0,31,0,15,488
42011013402,2973,2804,48,10,1,20,0,23,169
42011013403,3998,3787,81,19,0,20,0,2,211
42011013404,3646,3443,100,13,7,16,1,3,203
42011013501,3823,3067,391,142,4,100,0,28,756
42011013502,3417,2842,322,90,4,35,0,11,575
42011013503,4527,3820,374,142,7,65,0,16,707
42011013600,4049,3527,290,50,4,43,0,12,522
42011013701,3603,3259,165,28,4,26,0,5,344
42011013702,3835,3510,187,12,1,17,1,2,325
42011013800,4270,3803,252,59,5,24,1,14,467
42011013901,4297,4024,121,21,1,18,0,24,273
42011013902,3460,3185,172,20,6,8,0,5,275
42011014000,4162,3625,267,90,5,50,4,5,537
42011014101,3094,2314,277,333,6,72,0,5,780
42011014102,4526,4037,225,105,9,51,0,5,489
42011014201,3071,2671,299,32,0,8,0,7,400
42011014202,4537,4202,153,18,9,9,0,5,335
42013010101,4280,4079,42,18,10,8,0,7,201
42013010102,2852,2656,47,32,1,10,1,2,196
42013010103,2628,2472,30,15,9,8,0,5,156
42013010401,1827,1705,22,17,0,5,0,6,122
42013010403,2607,2503,13,6,0,12,0,4,104
42013010404,3871,3675,36,8,2,13,0,8,196
42013010500,4155,3938,34,4,5,15,0,17,217
42013010600,2159,2004,35,6,4,52,0,6,155
42013010701,3490,3031,75,163,8,56,0,49,459
42013010702,3297,3062,56,40,0,31,0,0,235
42013010800,3441,3277,56,10,3,10,0,0,164
42013010900,7399,6994,87,24,0,117,0,6,405
42013011001,3360,3181,23,19,4,7,0,6,179
42013011002,4301,3977,53,95,2,58,0,17,324
42013011101,1581,1468,31,10,1,31,0,12,113
42013011102,4687,4373,57,34,4,76,0,10,314
42013011201,3217,3034,35,15,3,33,0,2,183
42013011202,2424,2255,18,64,5,36,4,0,169
42013011300,5561,5355,69,10,2,9,2,7,206
42013011400,2384,2256,29,15,1,11,0,0,128
42013011500,5298,5087,42,15,5,7,0,16,211
42013011600,3788,3615,41,13,2,5,0,13,173
42013100200,2202,2076,28,12,7,12,0,0,126
42013100300,3179,2683,61,224,8,12,0,8,496
42013100400,1666,1441,38,100,2,1,1,8,225
42013100500,3309,2781,69,239,2,4,0,16,528
42013100600,2445,2200,37,85,2,19,0,4,245
42013100700,2366,1961,54,175,1,10,0,5,405
42013100800,1663,1424,33,81,6,59,0,14,239
42013100900,3993,3674,56,77,5,8,1,15,319
42013101100,1490,1397,5,38,0,12,0,1,93
42013101200,3895,3569,91,70,4,34,0,6,326
42013101400,3552,3062,62,171,7,14,0,30,490
42013101500,3373,3147,42,43,0,20,0,13,226
42013101600,3176,2699,77,172,4,28,0,15,477
42013101700,3541,3004,74,164,11,13,0,18,537
42013101800,2902,2658,28,58,0,4,3,18,244
42013101900,1463,1243,22,121,4,8,0,3,220
42015950100,4280,4005,116,9,2,12,0,14,275
42015950200,4783,4458,55,20,7,11,0,19,325
42015950300,5461,4808,103,113,21,136,2,22,653
42015950400,3267,2963,58,44,16,42,5,10,304
42015950501,2930,2659,29,23,6,79,0,2,271
42015950502,3324,3089,40,27,1,46,2,2,235
42015950600,4171,3930,48,1,8,8,0,7,241
42015950700,4426,4187,66,18,7,18,2,0,239
42015950800,3911,3635,43,29,0,14,0,13,276
42015950900,5284,4908,82,34,20,28,0,7,376
42015951000,2798,2499,85,24,7,24,0,9,299
42015951100,2844,2665,34,12,4,14,2,12,179
42015951200,4727,4497,32,11,4,15,0,2,230
42015951300,3957,3813,30,10,6,5,0,6,144
42015951400,3804,3601,52,19,8,8,0,8,203
42017100102,3125,2370,223,185,10,219,0,13,755
42017100103,2391,1768,210,202,1,69,1,21,623
42017100104,4625,1925,1015,496,7,1053,0,23,2700
42017100105,3247,2648,283,53,1,139,5,22,599
42017100201,5243,3425,293,652,4,615,0,23,1818
42017100206,5540,3331,545,461,7,993,4,24,2209
42017100207,4337,2700,374,413,8,696,1,31,1637
42017100208,6511,3238,1472,728,17,800,5,42,3273
42017100210,7389,5082,613,391,12,1004,0,24,2307
42017100211,6745,5197,440,372,2,475,2,23,1548
42017100212,3882,3112,219,118,1,310,0,26,770
42017100213,5472,3010,507,507,3,1223,0,36,2462
42017100214,4200,1779,489,515,2,1240,0,35,2421
42017100302,5053,3966,552,201,11,62,0,24,1087
42017100303,5136,2660,781,1292,5,143,0,30,2476
42017100304,2599,1425,230,502,3,303,0,23,1174
42017100306,3643,2085,421,686,3,328,2,13,1558
42017100307,5039,3349,790,462,13,241,1,18,1690
42017100401,6302,4399,872,490,4,167,0,40,1903
42017100402,6456,4877,706,458,6,124,2,23,1579
42017100403,2130,1127,198,707,0,27,0,4,1003
42017100404,6170,4693,614,383,15,100,0,42,1477
42017100406,3655,2802,235,281,6,204,0,11,853
42017100407,1223,1018,92,31,0,22,1,6,205
42017100408,6885,5419,675,281,5,135,7,39,1466
42017100500,2716,2219,243,112,1,18,0,0,497
42017100600,3735,2602,588,303,7,38,0,4,1133
42017100700,3410,1974,662,481,4,33,0,10,1436
42017100803,4783,3984,245,181,10,158,5,16,799
42017100804,3909,3341,258,77,2,114,0,12,568
42017100805,6235,5321,330,156,1,160,1,11,914
42017100807,4241,3648,127,174,2,209,0,13,593
42017100808,5307,4581,212,116,3,217,3,26,726
42017100809,5894,4936,188,138,5,460,1,12,958
42017100811,4432,2591,385,725,6,505,0,21,1841
42017100900,7694,6630,278,181,12,273,0,42,1064
42017101100,2515,1901,230,209,0,76,2,4,614
42017101401,5278,4265,212,63,11,487,0,24,1013
42017101403,5901,5297,189,71,9,128,0,28,604
42017101404,2512,2134,110,67,2,99,0,11,378
42017101405,6908,5753,388,201,5,292,3,12,1155
42017101503,3912,3452,120,32,2,173,5,15,460
42017101504,2779,2534,80,24,1,89,0,0,245
42017101505,3349,3016,89,42,6,91,0,10,333
42017101506,5229,4793,177,57,1,73,0,8,436
42017101603,3282,2388,570,86,2,98,0,8,894
42017101605,4445,2412,1006,489,3,258,6,35,2033
42017101607,3636,3080,237,91,2,108,0,6,556
42017101609,4527,3859,262,77,2,164,0,16,668
42017101610,4767,4188,200,99,2,112,0,12,579
42017101611,7132,6265,403,94,3,189,0,13,867
42017101802,6440,5212,157,97,6,750,1,28,1228
42017101805,2212,2012,53,3,2,77,0,7,200
42017101807,4576,3099,909,141,6,279,2,26,1477
42017101808,2639,2033,207,91,4,230,0,12,606
42017101809,3510,2885,117,50,0,336,0,17,625
42017101810,6262,4632,209,88,4,1102,0,23,1630
42017101900,4253,3619,164,52,4,305,1,24,634
42017102002,2883,2577,81,38,0,120,0,8,306
42017102003,4473,3671,129,83,0,419,0,20,802
42017102004,4971,4235,187,103,0,263,2,24,736
42017102102,3523,3223,100,32,0,38,0,17,300
42017102104,5993,4852,408,168,9,338,3,37,1141
42017102300,5819,5312,168,62,6,46,6,11,507
42017102401,4061,3707,136,63,5,27,0,3,354
42017102402,5059,4447,250,64,10,113,3,17,612
42017102500,4711,3980,266,157,10,69,3,8,731
42017102600,2199,1742,189,64,2,143,0,8,457
42017102700,5295,4846,132,70,6,96,1,10,449
42017102801,3465,3125,105,39,3,57,0,6,340
42017103101,2359,1971,189,41,7,27,0,12,388
42017103102,2204,1847,164,65,2,16,0,15,357
42017103103,4796,3824,430,178,3,154,10,27,972
42017103300,2201,2065,40,7,1,13,0,13,136
42017103400,5175,4771,122,36,9,42,1,20,404
42017103700,3379,3136,98,19,3,12,2,12,243
42017103800,1234,1140,35,10,5,1,0,3,94
42017103900,3818,3556,89,26,2,25,0,8,262
42017104000,7541,6719,340,66,5,186,0,8,822
42017104100,2177,1709,287,42,0,54,0,21,468
42017104201,2938,2607,114,32,6,80,0,10,331
42017104203,5678,4754,467,63,0,182,0,43,924
42017104204,5405,4567,314,83,2,218,3,19,838
42017104301,2889,2615,103,15,0,49,0,14,274
42017104303,4572,3919,143,49,2,282,1,20,653
42017104304,1248,1117,49,16,1,31,0,1,131
42017104400,2612,2191,209,26,1,82,0,20,421
42017104502,8103,6839,270,112,1,602,0,35,1264
42017104503,4578,4018,182,48,4,156,0,25,560
42017104505,5684,5003,180,56,1,260,0,7,681
42017104506,2486,2157,125,22,0,48,0,11,329
42017104601,4931,4451,180,36,2,90,0,17,480
42017104603,6667,5784,275,301,7,149,2,22,883
42017104604,6365,5712,245,64,4,128,0,17,653
42017104701,3525,3017,171,47,1,145,2,8,508
42017104702,2556,2293,104,45,2,28,0,13,263
42017104703,2227,2022,76,16,0,28,0,8,205
42017104800,2836,2491,138,101,2,42,0,8,345
42017104901,7278,6342,209,75,4,450,0,7,936
42017104902,7573,6408,241,92,1,606,0,12,1165
42017105003,4915,4352,161,18,0,237,0,6,563
42017105004,5654,5130,122,38,1,210,0,18,524
42017105006,5924,5323,136,31,2,274,0,16,601
42017105008,3908,3390,126,56,0,226,5,14,518
42017105009,3478,3152,82,34,1,126,0,11,326
42017105010,3995,3548,123,57,0,163,0,14,447
42017105011,3497,3036,83,40,1,232,0,15,461
42017105012,2724,2533,72,9,1,39,0,1,191
42017105013,5820,5095,192,28,7,335,0,20,725
42017105100,3286,2801,82,55,0,204,0,21,485
42017105202,5102,4271,154,71,0,419,0,14,831
42017105203,2084,1783,87,30,0,129,0,4,301
42017105206,5307,4350,125,50,9,613,0,9,957
42017105207,5029,4023,182,44,0,606,0,16,1006
42017105208,2373,1774,83,10,0,430,1,11,599
42017105300,2268,2091,61,11,0,35,0,13,177
42017105401,4593,3969,94,39,1,316,2,17,624
42017105402,4264,3783,121,18,0,152,0,28,481
42017105505,3949,3451,153,65,0,108,0,22,498
42017105506,4184,3343,153,75,1,471,0,20,841
42017105507,7404,6339,261,112,1,411,4,23,1065
42017105508,3598,2901,100,51,0,396,0,9,697
42017105509,4633,3896,189,66,5,317,0,2,737
42017105510,5257,4074,233,204,0,566,0,18,1183
42017105511,4155,3257,134,125,1,435,3,26,898
42017105600,2605,2244,114,59,2,83,0,3,361
42017105702,3314,2063,495,514,12,44,1,35,1251
42017105704,7143,3918,902,1758,10,163,0,41,3225
42017105801,6209,4074,532,773,1,567,0,20,2135
42017105805,5650,4284,474,385,15,174,3,26,1366
42017105807,3755,2566,275,301,2,399,0,47,1189
42017105808,3723,3017,265,88,0,185,0,18,706
42017105809,4411,3674,213,160,0,166,0,9,737
42017105810,2428,2148,116,32,2,30,0,15,280
42017105811,6181,5097,427,214,7,176,3,13,1084
42017105812,1711,1470,95,36,2,34,0,9,241
42017105900,2282,1918,124,104,8,41,0,5,364
42017106000,4527,3706,227,168,1,220,4,15,821
42017106100,3139,2648,119,167,6,86,0,2,491
42017106201,3520,2885,378,87,0,89,0,1,635
42017106202,3249,3007,71,21,1,77,0,10,242
42017106300,7573,6649,295,153,6,201,1,28,924
42017106401,7751,6567,430,170,7,273,1,26,1184
42017106402,7682,6811,279,159,3,163,12,31,871
42017106500,7438,6515,385,118,7,109,3,41,923
42017106600,1941,1826,51,6,3,15,0,2,115
42017980000,0,0,0,0,0,0,0,0,0
42019902100,2225,1983,52,42,5,10,5,8,242
42019902200,1910,1667,66,47,13,5,4,12,243
42019902300,3544,2936,149,200,9,22,0,7,608
42019902400,2002,1772,43,40,4,14,0,10,230
42019902500,3821,3278,149,118,8,21,0,15,543
42019902600,3082,2876,38,37,1,14,0,4,206
42019902700,2125,1945,53,18,2,1,0,8,180
42019902800,2713,2495,58,30,0,28,2,2,218
42019902900,1948,1836,27,11,1,18,0,9,112
42019903000,4723,4467,70,17,5,22,1,7,256
42019903100,2639,2466,49,16,0,20,2,6,173
42019910100,4090,3900,37,44,4,5,0,8,190
42019910200,4742,4527,21,19,4,9,0,6,215
42019910301,4933,4603,91,55,6,39,1,9,330
42019910302,4237,3963,56,19,5,29,2,19,274
42019910400,3081,2514,87,126,1,175,0,27,567
42019910600,4142,3923,41,8,5,4,0,12,219
42019910700,2769,2664,13,8,4,5,0,6,105
42019910800,2766,2606,44,17,1,12,0,7,160
42019910900,5133,4811,82,26,5,61,1,12,322
42019911000,6159,5822,69,17,6,26,0,8,337
42019911100,4931,4689,46,3,5,22,1,9,242
42019911200,5268,4897,74,118,0,11,0,12,371
42019911300,5166,4968,34,2,3,5,0,7,198
42019911400,3361,3194,32,14,1,3,0,15,167
42019911501,5212,5023,51,22,4,10,0,7,189
42019911502,4333,4190,36,10,0,12,0,6,143
42019911600,4990,4755,76,13,0,16,0,9,235
42019911700,4901,4595,98,8,6,29,0,20,306
42019911800,7628,7096,125,45,0,63,0,16,532
42019911900,4854,4565,91,30,1,27,1,10,289
42019912001,5542,5011,123,89,6,127,0,28,531
42019912002,6650,5444,263,139,7,521,6,45,1206
42019912101,4386,3781,115,130,1,165,4,20,605
42019912102,2607,2254,104,39,3,81,0,14,353
42019912200,3288,2860,104,52,0,137,0,8,428
42019912301,6514,5805,164,125,5,207,2,38,709
42019912303,2922,2587,86,62,0,70,0,11,335
42019912304,4106,3590,116,48,5,188,0,10,516
42019912403,3454,3179,58,11,1,61,0,13,275
42019912404,6130,5478,173,79,1,200,4,20,652
42019912405,5150,4802,118,43,2,52,0,22,348
42019912406,2469,2338,35,5,0,37,0,7,131
42019912701,3339,3165,35,7,10,39,0,0,174
42019912702,4561,4313,47,19,1,33,0,6,248
42019912800,6820,6429,114,26,2,64,0,10,391
42019980100,2397,2019,52,120,1,72,0,12,378
42021000100,1194,871,38,219,3,10,1,0,323
42021000200,604,336,26,173,2,4,0,7,268
42021000300,1554,909,68,402,2,1,0,24,645
42021000500,1488,951,68,278,2,9,1,14,537
42021000600,1606,1088,53,301,2,5,1,12,518
42021000700,2335,1937,91,156,0,29,3,2,398
42021001200,2795,2219,74,317,5,11,1,11,576
42021010100,3811,3589,52,44,2,7,2,8,222
42021010200,1360,1213,35,52,0,0,0,9,147
42021010300,2239,2097,39,28,0,2,1,5,142
42021010500,3357,3026,88,91,3,16,3,10,331
42021010600,2363,2180,29,42,0,26,3,3,183
42021010700,3122,2918,33,29,3,37,2,9,204
42021010801,5407,4968,77,81,2,116,0,7,439
42021011000,1547,1361,46,58,0,1,0,4,186
42021011100,5147,4761,87,84,1,38,2,10,386
42021011200,2045,1821,61,48,0,22,0,12,224
42021011300,4982,4542,114,75,2,92,1,4,440
42021011400,3084,2851,49,58,5,9,2,4,233
42021011500,4236,4078,40,18,7,9,0,7,158
42021011600,2511,2388,21,22,1,0,0,7,123
42021011700,2288,2201,14,8,2,0,0,0,87
42021011800,3938,3802,30,1,5,0,0,9,136
42021011900,3560,3373,30,20,1,12,3,2,187
42021012000,6030,5786,63,8,4,7,0,2,244
42021012100,2372,2247,14,5,3,2,1,11,125
42021012200,3557,3403,40,8,1,6,0,3,154
42021012300,4151,3301,195,511,7,49,1,8,850
42021012400,3662,3537,30,5,0,0,0,3,125
42021012500,5814,5422,53,170,0,32,0,4,392
42021012600,3404,3184,49,50,3,21,0,11,220
42021012700,2526,2388,32,4,1,0,0,2,138
42021012800,4994,4680,56,51,3,35,1,12,314
42021012900,3432,3309,25,0,1,2,0,7,123
42021013000,2459,2328,33,13,0,8,1,2,131
42021013100,2509,2389,17,8,4,0,0,1,120
42021013200,3943,3749,55,15,0,5,0,2,194
42021013300,5752,5503,60,13,2,10,3,5,249
42021013400,2005,1306,78,410,5,1,1,10,699
42021013500,2727,1529,129,823,7,9,0,4,1198
42021013600,3114,1912,176,793,0,7,1,7,1202
42021013700,4448,3927,97,173,5,114,0,46,521
42023960100,1923,1797,54,5,2,11,0,0,126
42023960200,2624,2474,32,7,6,18,0,12,150
42025020102,4507,4179,157,24,2,26,2,9,328
42025020103,3721,3304,210,54,3,22,5,15,417
42025020106,2038,1759,125,43,15,23,1,5,279
42025020107,3481,2486,428,322,6,41,2,32,995
42025020108,2724,2243,225,139,1,20,0,8,481
42025020201,3194,2913,117,18,8,13,0,10,281
42025020202,3090,2682,322,9,0,3,0,1,408
42025020301,3336,2994,162,71,5,13,0,10,342
42025020302,3120,2824,140,27,5,10,0,23,296
42025020400,4141,3279,445,169,21,16,1,6,862
42025020501,4261,3953,155,36,6,16,0,14,308
42025020502,2748,2593,73,3,0,6,0,2,155
42025020600,5248,4608,331,71,9,38,0,29,640
42025020700,5185,4806,140,27,7,27,0,18,379
42025020801,3935,3671,130,17,1,14,0,13,264
42025020802,4427,4130,119,26,1,10,0,11,297
42025020900,5593,5015,363,14,5,29,3,10,578
42027010100,3815,3675,24,9,5,8,0,0,140
42027010200,2702,2616,20,3,0,5,0,0,86
42027010300,3170,2908,79,20,12,27,0,8,262
42027010400,3287,3201,22,8,3,6,0,2,86
42027010500,5102,4848,46,25,5,17,0,27,254
42027010600,3854,3664,51,14,7,8,1,14,190
42027010700,5778,5550,47,14,3,17,0,10,228
42027010801,1998,1949,21,3,2,2,0,1,49
42027010802,3683,3529,44,11,5,0,1,21,154
42027010901,3558,3360,30,23,4,9,1,10,198
42027010902,3552,3402,38,1,1,12,0,7,150
42027011001,2783,2612,65,17,0,18,1,7,171
42027011002,5196,4748,114,67,10,65,2,29,448
42027011101,3466,3170,92,65,1,12,0,13,296
42027011102,2639,2360,78,64,6,25,0,8,279
42027011201,4572,4299,67,46,0,34,2,3,273
42027011202,4392,1917,421,2044,0,5,0,0,2475
42027011301,2451,1102,143,190,2,904,0,19,1349
42027011302,2085,1270,121,111,7,493,0,7,815
42027011303,4608,3310,224,214,7,674,6,11,1298
42027011401,4410,3203,192,148,1,636,0,33,1207
42027011402,3124,2625,134,55,1,174,0,10,499
42027011501,3009,2370,102,80,0,336,1,17,639
42027011503,3325,1979,172,203,0,831,0,32,1346
42027011504,4480,2591,185,123,0,1405,0,12,1889
42027011600,4658,3705,217,164,0,343,0,27,953
42027011702,6104,5052,226,123,4,393,2,31,1052
42027011800,5913,5088,182,209,13,159,0,29,825
42027011901,2790,2556,46,14,0,32,0,5,234
42027011903,1650,1253,74,15,0,257,0,9,397
42027011904,3372,3034,57,31,2,61,0,36,338
42027011905,2145,1462,72,51,1,487,1,5,683
42027012000,5875,4618,361,183,1,397,18,24,1257
42027012100,7317,5895,400,164,0,464,0,0,1422
42027012200,5753,4743,230,128,0,329,0,0,1010
42027012300,1767,1493,90,38,0,77,0,3,274
42027012400,4869,3614,298,130,4,642,1,16,1255
42027012500,4227,3280,285,112,0,365,0,50,947
42027012600,2999,2306,214,91,1,277,0,16,693
42027012700,2983,2433,148,78,10,183,2,7,550
42027012800,4711,2878,219,217,2,1184,0,37,1833
42029300101,3117,2375,97,49,0,485,0,5,742
42029300103,2787,1667,102,195,7,688,0,42,1120
42029300104,5331,4196,145,94,3,577,0,114,1135
42029300106,5610,3195,233,166,5,1816,0,31,2415
42029300107,4572,3536,145,63,2,675,1,16,1036
42029300108,6685,4412,232,189,4,1654,3,16,2273
42029300109,3825,3111,123,133,2,298,0,14,714
42029300201,5355,4287,186,145,3,516,0,9,1068
42029300202,5629,4571,184,21,2,668,0,9,1058
42029300301,4118,3499,87,86,2,312,1,13,619
42029300302,3940,3620,77,24,2,119,0,11,320
42029300303,3215,2702,124,98,0,161,0,9,513
42029300400,3419,2811,181,90,4,203,0,9,608
42029300501,5062,4445,121,90,2,239,0,4,617
42029300502,3718,3143,191,57,16,152,2,9,575
42029300600,6197,4532,542,486,12,256,0,51,1665
42029300700,5423,3923,927,225,4,81,4,68,1500
42029300800,4456,3330,323,272,10,187,0,63,1126
42029300900,2526,1989,243,88,3,68,0,16,537
42029301001,4584,4075,108,75,3,98,0,16,509
42029301002,3676,2989,167,82,8,200,0,40,687
42029301100,3494,2902,211,157,2,38,0,9,592
42029301300,7068,6049,430,176,12,126,3,8,1019
42029301401,3100,2595,89,140,0,70,3,12,505
42029301402,5341,4759,178,123,2,75,6,19,582
42029301500,2796,2495,67,34,2,44,0,23,301
42029301600,2590,2386,64,2,0,20,18,2,204
42029301700,1832,1680,60,13,0,35,0,8,152
42029301800,6668,5189,181,68,8,1026,0,19,1479
42029301900,4024,3517,131,38,0,176,0,22,507
42029302000,6001,4321,226,112,4,1118,0,23,1680
42029302102,4531,3323,251,184,0,614,0,26,1208
42029302103,3813,2226,347,100,7,981,0,21,1587
42029302104,5573,2838,588,145,14,1779,1,40,2735
42029302203,5552,3975,263,263,2,851,2,26,1577
42029302204,6278,4905,321,273,8,495,1,22,1373
42029302205,2703,1723,94,87,2,692,0,13,980
42029302206,5035,3210,143,195,17,1287,0,14,1825
42029302207,64,42,7,0,0,10,0,0,22
42029302300,2872,2450,151,117,0,79,0,9,422
42029302400,3927,2354,858,490,3,61,0,34,1573
42029302500,3791,3210,241,173,5,47,5,5,581
42029302600,4389,2667,824,654,3,72,0,19,1722
42029302702,4877,3235,573,268,4,629,8,15,1642
42029302703,4409,3852,127,90,2,129,6,25,557
42029302704,4987,4253,221,98,6,248,0,12,734
42029302705,3942,3008,254,243,2,281,0,15,934
42029302706,4825,4022,228,198,3,161,0,31,803
42029302802,5267,4900,110,43,0,74,2,7,367
42029302803,2017,1970,14,11,0,10,0,0,47
42029302804,3923,3491,83,78,1,201,0,5,432
42029302806,3162,2411,226,238,0,115,4,15,751
42029302807,4041,3374,148,130,2,264,2,27,667
42029302901,4837,4153,152,155,1,189,0,35,684
42029302902,6317,5484,191,175,10,203,0,19,833
42029303000,3177,2613,113,102,5,231,0,4,564
42029303100,4082,3432,113,40,0,368,1,3,650
42029303301,3333,2044,937,151,0,72,0,19,1289
42029303302,4956,4335,224,91,0,139,3,21,621
42029303401,4083,1781,2006,145,3,40,1,8,2302
42029303402,1853,935,749,90,0,23,0,2,918
42029303501,4372,3783,214,45,1,178,0,5,589
42029303502,2934,2405,171,32,0,198,0,6,529
42029303801,4528,3817,258,83,12,167,3,4,711
42029303803,3692,3163,105,87,9,189,0,4,529
42029303804,6096,4978,194,182,0,466,0,32,1118
42029303901,5039,4080,206,465,5,86,5,15,959
42029303902,5300,4779,153,86,2,134,0,9,521
42029304000,5384,3443,277,308,8,1133,0,40,1941
42029304101,4518,3265,346,470,11,226,0,5,1253
42029304102,3374,2524,288,326,6,66,0,18,850
42029304201,7263,5366,593,730,10,286,0,9,1897
42029304300,9738,7884,345,179,14,957,0,25,1854
42029304403,3998,3183,213,169,6,243,0,11,815
42029304404,5143,3964,243,165,0,608,2,24,1179
42029304405,6469,5262,225,122,1,589,0,38,1207
42029304406,3551,3121,88,51,2,160,1,9,430
42029304502,3125,2747,76,39,0,143,0,12,378
42029304503,4988,2262,116,79,4,2388,0,4,2726
42029304504,4162,3021,130,33,3,796,1,34,1141
42029304600,3711,3303,124,69,1,79,1,7,408
42029304900,8274,7536,285,104,22,59,0,26,738
42029305000,1892,1629,96,34,0,23,0,8,263
42029305101,4213,3752,169,120,5,36,0,16,461
42029305102,4697,4087,153,232,6,34,2,7,610
42029305300,7985,4924,787,1674,9,158,6,36,3061
42029305400,4180,1283,998,1609,9,64,0,16,2897
42029305500,3715,555,1032,1872,10,39,0,36,3160
42029305600,3016,427,753,1591,0,23,0,10,2589
42029305700,2439,872,572,793,5,23,0,17,1567
42029306000,7626,5891,452,784,1,162,3,27,1735
42029306300,2770,1323,1221,111,0,32,0,11,1447
42029306501,4138,3264,413,118,1,145,0,16,874
42029306503,2588,1170,1266,75,3,17,0,9,1418
42029306504,4637,2795,1437,84,2,175,0,7,1842
42029306600,3179,2828,138,29,0,53,0,10,351
42029306700,4433,3862,235,61,5,86,0,17,571
42029306800,1698,1500,97,29,1,15,0,0,198
42029306900,5810,5049,345,86,1,88,0,20,761
42029307000,5644,4425,834,137,1,82,0,15,1219
42029307100,2476,2096,253,32,0,25,1,15,380
42029307200,1259,1029,128,36,1,3,0,12,230
42029307300,4125,3169,267,396,14,80,1,19,956
42029307400,3862,2797,392,416,14,26,1,13,1065
42029307700,2459,2072,303,18,0,10,0,2,387
42029307800,2560,2159,227,66,7,13,0,10,401
42029307900,5420,3343,717,1043,6,115,0,69,2077
42029308000,5736,3135,1879,371,18,39,1,16,2601
42029308101,4360,3656,346,139,2,27,2,15,704
42029308102,4622,3479,825,126,8,27,0,16,1143
42029308200,2764,2176,424,39,7,11,0,8,588
42029311000,7433,5955,441,405,10,270,0,34,1478
42029311100,3876,3317,135,43,0,242,0,19,559
42029311200,2177,1900,122,17,3,32,0,17,277
42029311300,4455,3301,212,254,6,523,3,7,1154
42029311401,7169,4583,765,1211,9,298,6,28,2586
42029311403,3383,2996,136,151,2,20,0,9,387
42029311404,3948,3396,279,80,8,34,1,12,552
42029311500,3581,3255,134,52,5,15,0,15,326
42029311600,2142,880,397,703,1,14,1,10,1262
42029311701,3482,2050,1137,130,9,63,1,17,1432
42029311702,6589,4723,1187,179,0,244,0,29,1866
42029311800,3749,3178,221,178,0,4,0,35,571
42029980000,3692,2792,235,425,2,76,0,5,900
42031160101,1781,1729,11,3,0,2,0,0,52
42031160103,2835,2488,65,168,6,19,1,7,347
42031160104,1712,1621,20,18,3,2,2,3,91
42031160201,1865,1805,6,2,2,0,0,5,60
42031160202,1530,1471,7,8,0,2,0,1,59
42031160300,4640,4395,38,66,6,15,5,11,245
42031160400,3822,3656,23,10,2,7,0,10,166
42031160500,3715,3600,21,5,4,6,0,16,115
42031160600,3931,3361,115,186,10,84,2,24,570
42031160701,2052,1972,24,4,1,5,1,2,80
42031160702,1924,1817,8,11,0,3,1,4,107
42031160800,3754,3584,27,19,5,29,0,19,170
42031160900,3680,3524,22,21,0,1,3,9,156
42033330100,4993,4395,387,29,6,32,0,9,598
42033330200,3304,3064,69,28,5,26,0,6,240
42033330300,4206,3823,58,38,5,62,0,31,383
42033330400,6897,6518,86,28,5,90,0,19,379
42033330500,4312,4119,38,3,4,15,0,5,193
42033330600,3175,3061,27,16,2,15,0,0,114
42033330700,2276,1999,55,165,1,4,0,0,277
42033330800,6702,6451,37,7,10,4,0,5,251
42033330900,6424,4664,1338,188,7,93,0,6,1760
42033331000,4800,4600,24,3,4,8,0,9,200
42033331100,3164,2923,45,37,6,32,0,3,241
42033331200,2798,2598,39,34,2,11,0,10,200
42033331300,4325,4092,63,18,0,17,0,10,233
42033331401,3384,3265,17,5,4,2,0,4,119
42033331402,3560,3394,34,19,0,8,0,12,166
42033331500,1850,1791,11,5,2,2,0,1,59
42033331600,2438,2343,23,5,3,1,0,8,95
42033331700,6959,5490,248,1106,3,21,0,6,1469
42033331800,2748,2600,29,22,6,5,0,0,148
42033331900,2247,2148,9,4,3,2,0,2,99
42035030100,2877,2732,34,20,6,3,0,8,145
42035030200,5231,4907,69,34,4,19,0,10,324
42035030300,4094,3899,45,9,5,16,0,10,195
42035030400,4889,4666,47,32,0,23,4,7,223
42035030500,4058,3734,90,60,11,50,0,5,324
42035030600,1829,1648,40,27,3,20,0,6,181
42035030701,5414,4844,156,112,11,44,3,9,570
42035030702,865,660,49,106,1,18,0,0,205
42035030800,4110,3936,72,8,7,10,0,6,174
42035030900,4083,3907,60,8,3,8,0,9,176
42037050100,5377,5094,86,11,21,14,0,11,283
42037050200,5432,5188,61,16,2,11,0,20,244
42037050300,4975,4639,103,40,4,53,4,11,336
42037050400,3982,3712,73,28,1,41,0,9,270
42037050500,3645,3421,91,17,0,24,0,4,224
42037050600,5202,4457,383,126,11,11,0,21,745
42037050700,5125,4425,329,114,3,41,2,18,700
42037050800,3483,3181,109,42,4,53,0,5,302
42037050900,3563,3140,91,34,2,160,0,15,423
42037051000,2495,2102,142,105,4,38,0,12,393
42037051101,3434,2996,138,73,0,89,0,6,438
42037051102,2505,2136,113,95,0,74,0,7,369
42037051200,4277,3650,245,142,11,106,3,8,627
42037051300,3038,2832,60,17,6,7,0,3,206
42037051400,2502,2368,49,6,1,17,8,8,134
42037051500,5692,5490,67,1,1,9,0,1,202
42039110100,6222,5919,52,10,12,3,6,26,303
42039110201,3538,3328,44,17,0,10,0,11,210
42039110202,4441,3887,126,273,4,18,1,17,554
42039110300,4506,4262,29,24,7,15,0,9,244
42039110400,2726,2581,36,15,2,7,0,8,145
42039110501,1780,1692,30,0,0,0,1,7,88
42039110502,3497,3314,36,7,5,15,1,6,183
42039110600,2775,2632,32,12,3,0,0,12,143
42039110700,3766,3503,37,63,4,12,0,7,263
42039110800,4728,4513,35,14,5,12,2,4,215
42039110900,2791,2608,26,7,6,4,0,10,183
42039111000,2231,2121,13,10,4,8,0,4,110
42039111100,2872,2608,57,51,1,0,0,18,264
42039111200,2390,2171,38,10,9,26,2,0,219
42039111300,5228,4966,43,19,15,20,0,6,262
42039111400,4528,4152,74,92,0,30,0,9,376
42039111500,4955,4121,169,257,10,24,3,19,834
42039111600,3735,3018,100,325,2,23,3,16,717
42039111700,4846,4218,141,236,5,65,2,17,628
42039111800,5331,4945,82,43,10,59,2,12,386
42039111900,3516,3404,15,6,2,5,0,6,112
42039112001,2264,2161,16,1,2,7,3,5,103
42039112002,1272,1223,10,4,1,2,0,0,49
42041010100,5403,4142,393,346,16,170,7,64,1261
42041010201,5163,4435,142,98,12,266,0,10,728
42041010203,3982,2530,509,249,3,520,0,12,1452
42041010204,5182,4286,204,109,5,369,2,18,896
42041010300,4231,3081,321,302,5,279,5,38,1150
42041010400,3866,3417,130,64,6,104,0,18,449
42041010500,4256,3278,282,146,11,333,1,26,978
42041010600,4659,3698,356,195,8,118,0,28,961
42041010700,3864,3404,173,76,0,54,0,11,460
42041010800,3643,2979,286,169,1,33,0,28,664
42041010900,5091,4338,289,148,6,111,2,15,753
42041011002,2398,1814,217,147,6,87,1,14,584
42041011101,5107,4224,195,159,5,309,3,22,883
42041011102,4619,3724,311,235,14,176,9,18,895
42041011200,1634,1364,109,50,4,44,0,9,270
42041011301,5770,4393,195,138,1,812,4,17,1377
42041011303,6968,5914,215,83,0,503,4,19,1054
42041011304,5563,4365,266,174,3,486,4,49,1198
42041011305,6004,3816,397,264,17,1270,4,14,2188
42041011306,3927,2718,162,146,4,735,2,21,1209
42041011307,4529,3534,159,79,7,589,0,9,995
42041011400,4491,3602,273,236,13,120,12,12,889
42041011500,4820,4176,148,150,9,107,0,24,644
42041011602,4055,3762,66,31,3,67,0,11,293
42041011606,5996,4889,404,197,6,220,6,84,1107
42041011607,5644,4902,187,133,12,235,3,18,742
42041011608,4641,3078,264,893,11,212,2,15,1563
42041011700,6230,5655,216,45,2,83,3,21,575
42041011803,7021,6056,300,204,10,169,4,22,965
42041011804,2670,2372,73,11,4,101,2,12,298
42041011805,5675,3612,237,186,6,1414,1,29,2063
42041011806,4880,4247,137,78,4,294,0,10,633
42041011807,6332,4502,177,96,8,1317,2,36,1830
42041011901,5599,4847,215,159,9,107,0,10,752
42041011902,6440,5280,272,401,7,136,5,10,1160
42041012000,5498,3889,363,768,3,171,2,15,1609
42041012100,2657,1795,228,347,0,74,0,10,862
42041012200,2081,1497,195,212,8,40,3,13,584
42041012300,2397,1545,218,320,5,166,1,7,852
42041012400,7485,6044,449,410,8,277,5,40,1441
42041012501,4508,4021,152,85,0,77,0,8,487
42041012502,7689,6957,173,100,5,129,1,31,732
42041012600,5933,5375,203,78,2,53,2,22,558
42041012701,5294,4891,146,45,5,38,0,14,403
42041012702,4446,4230,52,39,3,6,0,16,216
42041012801,4582,4287,84,34,5,19,8,27,295
42041012802,3559,3368,46,15,6,5,0,12,191
42041012900,1376,1258,30,21,3,8,2,3,118
42041013000,6959,6627,96,27,3,14,0,12,332
42041013103,6137,5600,147,115,7,79,0,28,537
42041013104,2667,1967,167,177,0,235,0,4,700
42041013105,5783,5282,160,81,9,72,0,10,501
42041013200,4334,3466,292,232,5,61,1,27,868
42041981001,2884,1489,273,1110,2,7,0,0,1395
42041981606,2847,1968,221,168,1,355,0,1,879
42043020100,3746,1814,361,1149,10,208,3,36,1932
42043020300,1895,694,339,646,8,121,2,26,1201
42043020400,1625,1116,134,237,0,37,2,30,509
42043020500,2987,1586,298,907,1,43,0,10,1401
42043020800,2809,778,592,1199,7,64,0,8,2031
42043020900,3707,1155,513,1526,8,295,2,35,2552
42043021100,3252,263,909,1904,10,18,0,27,2989
42043021200,2586,265,800,1355,10,19,0,16,2321
42043021300,6030,744,2751,2141,19,90,3,39,5286
42043021400,4915,339,2270,1862,13,235,0,19,4576
42043021500,3745,405,1136,1815,3,127,2,46,3340
42043021600,2623,304,769,1342,4,34,0,26,2319
42043021700,6024,1328,1181,2756,9,424,2,44,4696
42043021800,2282,1362,226,501,0,50,0,16,920
42043021901,4778,3319,161,713,2,319,0,48,1459
42043021903,3703,1710,232,1192,3,330,0,21,1993
42043021904,6123,3223,409,1403,8,779,2,29,2900
42043022000,5318,2113,612,1779,3,453,3,42,3205
42043022100,4532,2457,418,820,12,613,0,32,2075
42043022200,3274,1231,501,1088,9,144,0,48,2043
42043022300,5867,3063,686,1252,8,550,0,27,2804
42043022401,4732,3340,187,522,6,452,0,12,1392
42043022403,7108,3991,770,1244,12,647,5,43,3117
42043022501,6308,5038,225,412,7,334,2,13,1270
42043022502,5658,4726,249,282,1,173,0,26,932
42043022601,7368,5337,503,750,8,382,0,29,2031
42043022604,7443,5086,322,798,8,884,0,40,2357
42043022605,5519,2489,477,1060,8,1223,0,22,3030
42043022606,3498,1218,435,1135,11,535,4,19,2280
42043022701,4352,1867,375,840,4,1069,0,25,2485
42043022702,5839,3066,633,951,3,869,3,16,2773
42043022800,6484,3844,676,1012,7,585,0,27,2640
42043022901,3789,1288,840,1037,36,437,2,15,2501
42043022902,5453,2710,952,1289,6,156,3,14,2743
42043023000,1907,1217,212,268,0,104,0,12,690
42043023100,1648,999,213,245,3,73,2,18,649
42043023300,4435,1371,825,1787,8,39,4,47,3064
42043023400,1828,812,312,569,2,4,2,7,1016
42043023500,2741,1653,424,422,7,23,0,23,1088
42043023601,2881,2358,296,68,3,40,0,4,523
42043023602,6650,4756,570,643,8,365,8,23,1894
42043023700,1459,870,181,258,3,23,0,3,589
42043023800,4103,2759,419,413,7,235,2,32,1344
42043023900,3971,2998,464,173,7,113,8,25,973
42043024001,6037,5403,223,116,4,25,0,32,634
42043024002,2952,2728,87,23,8,28,1,0,224
42043024101,2068,1173,230,159,0,400,2,17,895
42043024102,4417,2970,915,198,2,203,3,15,1447
42043024104,6194,4442,238,190,6,1002,0,18,1752
42043024105,5826,4484,239,310,12,546,4,33,1342
42043024200,2662,2014,237,105,0,145,0,8,648
42043024300,3476,2978,162,96,1,101,2,9,498
42043024400,4616,3997,271,75,3,104,0,10,619
42043024502,6019,5193,470,53,5,81,0,35,826
42043024503,7209,6079,330,165,5,318,0,10,1130
42043024601,4933,4230,215,237,0,90,0,33,703
42043024602,5764,4971,186,149,3,194,0,17,793
42043024700,6071,5646,131,76,8,35,0,10,425
42043024801,3608,3461,43,8,0,9,2,10,147
42043024802,4220,3931,78,43,1,32,0,13,289
42043024900,2370,2139,88,52,1,0,0,1,231
42043025000,3032,2774,85,29,3,18,2,6,258
42043025100,3736,3562,72,16,13,7,2,3,174
42043025200,3486,3264,79,19,1,32,0,9,222
42043025300,4010,3769,87,47,3,14,1,7,241
42043025400,2545,2291,76,49,0,28,0,8,254
42043025500,4155,614,851,2424,5,53,3,41,3541
42045400301,6915,676,727,4734,14,483,0,51,6239
42045400302,4167,567,316,2965,6,160,0,34,3600
42045400401,5504,499,827,2487,9,1472,0,77,5005
42045400402,4710,505,504,2854,4,631,4,44,4205
42045400500,4649,1072,577,1990,5,789,2,24,3577
42045400600,5460,2251,537,1510,6,871,1,65,3209
42045400700,5412,1078,587,2001,2,1546,4,34,4334
42045400801,2055,168,118,1571,4,161,0,9,1887
42045400802,3417,1622,224,1135,1,244,0,20,1795
42045400900,1630,1095,60,260,0,118,2,14,535
42045401000,1960,1250,130,385,5,102,3,14,710
42045401101,3095,1985,162,641,2,125,0,20,1110
42045401103,3366,2477,149,461,3,107,1,12,889
42045401104,4346,3129,189,651,3,193,4,17,1217
42045401200,3670,2846,154,434,10,112,0,1,824
42045401302,2990,1968,167,575,6,126,0,27,1022
42045401303,2330,1059,130,811,3,220,3,12,1271
42045401401,2238,1253,126,575,5,154,0,8,985
42045401402,4105,2068,214,1413,8,152,0,34,2037
42045401502,4259,2357,123,1096,9,534,0,10,1902
42045401503,3487,2853,132,290,1,82,0,9,634
42045401600,1816,815,71,727,4,118,0,10,1001
42045401700,2714,429,171,1780,6,201,0,26,2285
42045401800,3932,960,282,2327,17,125,0,33,2972
42045401900,4646,1809,187,2271,8,153,0,39,2837
42045402000,2529,845,115,1311,7,123,0,23,1684
42045402100,5953,267,143,5266,13,46,0,33,5686
42045402200,2422,217,110,1934,3,54,0,22,2205
42045402300,3672,101,81,3369,8,35,0,13,3571
42045402400,3551,240,139,2993,12,21,0,30,3311
42045402500,3602,196,110,3123,4,8,0,29,3406
42045402600,3562,459,219,2733,9,49,0,11,3103
42045402700,2474,225,62,2052,0,21,0,0,2249
42045402800,6014,1136,251,4203,18,137,4,34,4878
42045402900,3357,79,69,3040,13,18,0,40,3278
42045403001,3039,2514,88,308,0,43,0,5,525
42045403002,2823,1868,98,695,4,42,3,6,955
42045403101,3574,1291,209,1738,6,139,0,43,2283
42045403103,2839,998,145,1454,13,95,0,17,1841
42045403104,2495,531,89,1663,11,61,0,15,1964
42045403200,4244,2098,196,1564,2,194,0,55,2146
42045403300,6863,4009,343,1863,8,235,0,78,2854
42045403401,3048,1254,151,1378,6,117,0,14,1794
42045403402,3744,1500,215,1773,0,68,0,31,2244
42045403501,4239,3015,137,770,8,112,3,9,1224
42045403502,2984,2166,119,492,6,68,2,7,818
42045403601,4096,3275,134,314,1,149,4,29,821
42045403602,1847,1626,58,68,0,37,0,2,221
42045403701,1712,1447,79,67,0,55,2,5,265
42045403702,2271,1877,88,59,1,75,0,8,394
42045403800,6427,5079,324,500,4,254,3,18,1348
42045403901,3512,2942,106,241,0,110,0,7,570
42045403902,3674,3305,103,77,1,56,0,16,369
42045404003,2216,1218,62,459,7,392,0,6,998
42045404004,6464,5567,178,284,3,201,4,23,897
42045404101,6438,5377,228,450,2,118,9,16,1061
42045404102,5165,3694,302,770,2,120,1,30,1471
42045404103,3461,3019,93,138,3,72,0,5,442
42045404300,2459,1477,174,509,9,58,0,12,982
42045404400,1446,449,99,827,2,8,0,3,997
42045404500,4720,740,575,3145,9,52,0,20,3980
42045404600,2327,253,245,1724,4,20,0,6,2074
42045404700,3256,1462,364,1266,3,68,1,12,1794
42045404800,2074,219,357,1390,8,6,0,10,1855
42045404900,1212,69,238,844,2,4,0,3,1143
42045405000,1999,92,213,1633,1,4,2,0,1907
42045405100,2170,64,118,1915,7,3,0,7,2106
42045405200,2911,42,154,2623,8,2,0,12,2869
42045405300,2940,165,829,1831,4,18,0,16,2775
42045405400,2426,225,310,1765,2,12,1,14,2201
42045406100,2321,1550,147,417,2,70,0,19,771
42045406201,3214,2678,113,177,10,83,0,11,536
42045406202,5086,4315,127,288,5,156,0,21,771
42045406300,3068,1253,242,1394,1,22,0,13,1815
42045406401,2668,301,137,2076,0,49,0,11,2367
42045406402,1412,190,87,1071,3,6,0,2,1222
42045406500,1976,1124,134,581,5,10,0,21,852
42045406600,2454,1544,121,566,0,18,0,11,910
42045406700,3425,2248,202,736,15,40,0,24,1177
42045406801,4347,3227,154,610,3,184,0,18,1120
42045406802,4315,3179,169,729,11,38,0,15,1136
42045406804,4564,3442,167,475,7,362,0,12,1122
42045406805,3672,2704,195,526,0,124,3,8,968
42045406902,5909,5263,188,125,6,125,3,14,646
42045406903,5084,4642,112,125,2,51,0,2,442
42045406904,5798,5095,176,173,15,149,0,21,703
42045407000,2897,2384,88,98,7,198,0,2,513
42045407101,3824,3085,122,120,3,289,2,34,739
42045407102,3106,2789,48,46,5,104,3,4,317
42045407201,5641,4760,201,211,0,302,1,17,881
42045407202,3802,3299,123,146,9,105,0,16,503
42045407401,4140,3190,129,408,2,214,1,23,950
42045407404,3060,2491,107,143,2,160,1,17,569
42045407501,2502,2122,88,135,1,49,1,12,380
42045407502,3399,2679,114,292,8,141,1,28,720
42045407600,6657,4794,373,362,9,711,0,34,1863
42045407700,2778,1697,86,606,2,246,0,18,1081
42045407801,4549,4039,76,106,0,216,0,2,510
42045407802,6785,5788,172,136,6,511,0,12,997
42045407803,5598,5016,88,129,0,215,4,23,582
42045407804,4639,4192,104,115,2,116,0,11,447
42045407805,1712,1443,40,81,0,88,2,7,269
42045407806,1673,1299,67,85,3,142,0,16,374
42045407901,4249,3726,119,75,0,162,0,24,523
42045407902,3017,2549,80,93,0,164,1,22,468
42045407903,3586,2871,123,204,6,234,0,12,715
42045408001,6374,5422,130,51,2,593,0,13,952
42045408002,4622,3860,121,116,0,391,2,11,762
42045408101,5156,4346,129,148,0,433,1,6,810
42045408102,3557,2952,66,54,10,395,0,11,605
42045408103,4505,3562,136,169,1,524,0,7,943
42045408300,4786,3622,273,280,7,368,2,15,1164
42045408400,2192,1947,52,31,0,100,0,8,245
42045408500,4258,3412,128,189,1,364,0,9,846
42045408600,3629,3247,116,74,0,103,0,5,382
42045408700,5044,4464,120,117,5,128,3,13,580
42045408800,5083,4150,152,267,0,270,0,27,933
42045408900,3098,2626,105,89,4,125,0,10,472
42045409000,3785,3103,95,173,6,241,1,14,682
42045409100,4198,3851,100,49,3,78,0,22,347
42045409200,4194,3690,96,105,2,150,2,11,504
42045409300,2475,2112,62,74,1,141,2,6,363
42045409400,2907,2418,93,135,0,162,0,5,489
42045409500,4782,4073,138,144,0,291,0,10,709
42045409601,4930,3562,192,170,1,816,0,14,1368
42045409602,4629,3448,207,282,4,536,4,23,1181
42045409701,8507,6690,264,279,6,1028,6,27,1817
42045409803,7282,5874,319,248,8,541,0,23,1408
42045409804,5927,4584,202,225,3,707,3,24,1343
42045409902,5860,5099,122,126,2,388,0,6,761
42045409903,3981,3571,107,55,2,113,0,16,410
42045409904,5161,4472,139,69,1,291,0,10,689
42045410000,4283,3824,78,80,1,173,1,7,459
42045410101,3935,3078,203,231,0,268,1,17,857
42045410102,2969,2657,39,44,8,107,0,17,312
42045410200,3972,2965,169,84,5,581,0,34,1007
42045410303,4810,4037,121,95,2,373,0,13,773
42045410304,5053,3871,142,73,11,795,0,11,1182
42045410305,4928,3856,89,91,6,771,4,17,1072
42045410306,3426,2256,143,822,0,124,0,13,1170
42045410401,2910,2198,77,35,2,481,0,4,712
42045410402,3207,2711,61,53,4,289,2,4,496
42045410403,3457,2748,129,81,3,368,2,6,709
42045410500,5319,450,595,969,15,3144,2,27,4869
42045410601,3309,2929,85,93,7,96,0,5,380
42045410602,4782,4138,131,197,5,130,0,13,644
42045410700,5124,747,550,3597,4,30,3,37,4377
42045410800,8342,6436,275,470,4,747,5,23,1906
42045980000,0,0,0,0,0,0,0,0,0
42045980100,1953,1668,14,95,5,150,1,6,285
42045980200,0,0,0,0,0,0,0,0,0
42045980300,78,72,4,1,0,0,0,0,6
42047950100,1573,1512,9,1,1,2,0,3,61
42047950200,3115,2976,34,5,0,1,0,3,139
42047950400,4039,3802,34,18,1,22,0,6,237
42047950500,2404,2218,42,21,4,7,3,1,186
42047950900,2179,2084,13,0,4,7,0,1,95
42047951000,4942,4728,38,4,0,16,1,10,214
42047951100,5553,5280,64,13,3,26,3,8,273
42047951200,2005,1933,16,0,3,8,3,4,72
42047951300,5180,4933,44,12,0,24,2,10,247
42049000100,1724,1063,137,386,7,48,2,22,661
42049000200,3709,3361,92,84,2,53,0,1,348
42049000300,3684,2330,235,773,10,69,1,43,1354
42049000400,2177,1078,240,589,2,122,1,20,1099
42049000500,3059,1390,458,874,1,74,0,9,1669
42049000600,3225,1784,387,665,2,168,0,16,1441
42049000700,2437,1090,378,689,3,76,3,12,1347
42049000800,2634,1121,362,771,9,197,1,5,1513
42049000901,2440,1682,158,370,0,19,0,49,758
42049000902,2633,1825,157,401,10,87,0,34,808
42049001000,3258,2242,226,450,9,61,0,41,1016
42049001100,2690,1839,302,285,0,44,2,21,851
42049001200,2347,1100,397,522,4,111,0,13,1247
42049001300,1720,431,318,725,5,96,4,12,1289
42049001400,1504,655,169,519,0,72,0,12,849
42049001500,2759,747,452,1092,3,281,4,18,2012
42049001600,3962,2136,423,917,5,220,0,39,1826
42049001700,2675,944,428,1004,7,90,0,18,1731
42049001800,2039,522,226,1004,3,138,0,25,1517
42049001900,1601,1025,114,323,5,39,0,5,576
42049002000,3293,2092,356,497,4,52,3,17,1201
42049002100,3577,3138,108,95,4,64,1,10,439
42049002200,3710,3089,191,151,4,80,3,12,621
42049002300,2572,1920,170,230,5,40,0,16,652
42049002400,2987,2195,183,364,0,25,0,21,792
42049002500,2420,1269,254,599,12,83,1,6,1151
42049002600,4049,2448,317,732,5,203,3,27,1601
42049002700,6551,4871,308,593,5,456,6,22,1680
42049002800,6677,5581,272,373,16,215,3,29,1096
42049002900,2771,2479,68,79,0,52,0,8,292
42049003000,3947,3094,220,263,3,213,0,9,853
42049010101,3076,2872,48,13,1,2,0,8,204
42049010103,1912,1828,13,7,0,2,3,0,84
42049010104,2356,2228,21,4,4,2,0,6,128
42049010107,1528,1434,29,2,5,7,0,1,94
42049010108,2279,1069,149,1043,4,3,0,0,1210
42049010201,5934,5473,137,48,8,12,0,22,461
42049010202,5305,5006,70,10,6,7,0,19,299
42049010301,4913,4606,66,23,4,4,0,23,307
42049010303,6307,5626,204,63,5,170,0,19,681
42049010304,4831,4529,69,25,9,36,0,5,302
42049010400,4718,4325,115,59,3,33,1,16,393
42049010500,4084,3651,155,52,5,12,1,15,433
42049010700,3847,3327,155,96,0,64,0,11,520
42049010800,3531,3215,102,50,4,22,0,5,316
42049010902,4338,3920,134,80,7,61,0,3,418
42049010903,6854,5814,165,151,9,497,0,20,1040
42049010904,5132,4585,65,56,5,272,0,10,547
42049011001,6788,5880,217,217,4,226,0,24,908
42049011002,4581,3762,126,156,10,306,0,34,819
42049011101,5415,4517,138,171,0,368,2,6,898
42049011102,3380,2995,73,83,10,111,2,7,385
42049011201,4478,4269,57,11,3,13,2,3,209
42049011202,7342,6775,118,39,1,133,0,17,567
42049011300,3222,2757,175,66,5,42,4,22,465
42049011400,3820,3446,101,51,5,18,0,17,374
42049011503,3736,3472,74,44,0,26,0,7,264
42049011508,5082,4559,105,81,3,109,0,18,523
42049011509,2681,2509,47,17,2,11,0,6,172
42049011510,3086,2932,39,8,0,16,0,2,154
42049011511,2050,1668,109,216,0,15,0,1,382
42049011600,4106,3682,109,42,2,14,2,21,424
42049011701,2910,2662,68,36,2,19,0,1,248
42049011702,5422,5072,97,16,6,19,0,10,350
42049011801,2609,2419,21,12,1,5,0,1,190
42049011802,3021,2842,17,5,5,8,0,0,179
42049011900,6210,5705,90,43,14,10,0,13,505
42049012001,2526,2409,17,4,2,1,0,1,117
42049012002,2927,2709,47,7,7,19,0,10,218
42049012100,7438,6985,97,26,19,23,3,16,453
42049012201,5901,5543,68,11,6,28,0,19,358
42049012202,4964,4301,168,237,9,40,0,13,663
42049012400,1405,1261,49,21,3,24,0,2,144
42049990000,0,0,0,0,0,0,0,0,0
42051260100,5420,5009,86,90,0,13,0,11,411
42051260200,4043,3808,47,35,4,26,0,3,235
42051260300,3468,3254,14,45,2,4,0,11,214
42051260401,2315,2215,24,12,2,4,0,0,100
42051260402,4425,4233,29,7,0,0,1,8,192
42051260500,5781,5571,29,3,3,2,0,13,210
42051260600,3993,3739,38,31,8,5,2,14,254
42051260700,3419,3012,70,165,6,9,2,1,407
42051260800,3612,3249,38,170,5,19,0,5,363
42051260900,4359,4157,24,47,7,13,0,1,202
42051261000,2378,2276,21,9,3,1,2,9,102
42051261100,2517,2421,26,25,4,4,2,1,96
42051261200,2202,1651,32,296,0,4,10,18,551
42051261300,6103,4573,163,1182,9,6,0,6,1530
42051261401,2415,2035,23,180,9,2,3,19,380
42051261402,2664,2345,30,116,3,5,1,3,319
42051261500,4098,3748,61,83,6,1,0,9,350
42051261600,2584,2446,28,36,0,6,2,5,138
42051261700,2749,2316,50,170,2,8,1,3,433
42051261800,3377,3057,38,136,2,11,2,5,320
42051261900,3329,2590,70,420,4,12,26,21,739
42051262000,5042,4659,43,93,2,59,31,6,383
42051262100,2559,2168,34,172,5,19,12,8,391
42051262200,3290,2673,84,297,5,30,19,28,617
42051262300,3365,1804,98,1104,10,20,22,20,1561
42051262400,3289,2986,31,128,3,18,0,14,303
42051262500,3118,2899,46,46,4,11,0,7,219
42051262600,2820,2659,18,36,0,5,0,0,161
42051262701,3355,3142,74,24,3,13,0,13,213
42051262702,2667,2533,23,14,12,7,0,4,134
42051262800,6861,6386,46,115,10,8,18,5,475
42051262900,4669,4192,29,212,5,8,0,22,477
42051263000,3276,2851,24,158,12,14,3,12,425
42051263100,5610,5232,62,32,5,8,1,7,378
42051263200,2206,2106,10,1,1,1,0,1,100
42051263300,1426,1327,15,13,10,0,0,0,99
42053530100,4361,2767,300,1232,8,12,0,2,1594
42053530200,2612,2511,23,3,0,5,0,2,101
42055010100,4251,4064,58,15,9,10,1,0,187
42055010200,4669,4390,86,37,3,20,0,11,279
42055010301,5844,5223,196,136,3,44,0,28,621
42055010302,4099,3768,128,55,5,46,4,4,331
42055010401,4498,3751,261,265,10,35,0,14,747
42055010402,5042,4230,419,117,6,112,5,18,812
42055010501,4679,3941,288,143,3,80,2,11,738
42055010502,4217,3636,257,89,10,42,4,16,581
42055010600,6612,5460,490,278,16,132,3,15,1152
42055010701,4710,4318,162,77,3,27,4,14,392
42055010702,3305,3054,126,34,1,2,0,6,251
42055010800,3933,3066,483,217,0,57,0,4,867
42055010900,4936,2935,1317,403,12,48,4,22,2001
42055011000,5890,3002,1685,754,14,121,1,23,2888
42055011100,3946,2516,849,374,2,44,2,10,1430
42055011200,3198,1707,920,339,16,20,0,17,1491
42055011301,5346,4503,425,146,9,48,0,16,843
42055011302,6028,4957,514,230,7,37,0,27,1071
42055011400,5917,5420,160,60,18,12,1,29,497
42055011500,5969,5481,139,106,6,23,2,9,488
42055011600,6068,5734,89,37,5,16,0,12,334
42055011701,4871,4425,123,64,8,73,0,16,446
42055011702,4205,3790,134,74,1,33,2,23,415
42055011800,4251,3780,124,112,7,63,0,12,471
42055011900,6702,6185,182,75,4,37,2,25,517
42055012001,3881,3569,92,71,13,17,1,5,312
42055012002,3017,2845,74,9,6,12,0,7,172
42055012100,4117,3631,162,127,4,34,0,19,486
42055012200,3559,3121,160,89,3,9,0,21,438
42055012300,4557,3868,208,192,17,24,0,39,689
42055012400,2835,2432,119,92,10,17,1,9,403
42055012501,7230,6569,231,132,7,93,0,10,661
42055012502,3550,3195,103,49,4,20,1,9,355
42057960100,4799,4441,65,93,7,19,2,0,358
42057960200,5065,4855,40,12,11,8,0,5,210
42057960300,4692,4430,41,19,7,14,1,12,262
42059970101,1451,1379,15,3,0,1,0,2,72
42059970102,5364,5006,54,30,4,14,0,6,358
42059970200,3029,2836,25,24,3,8,0,2,193
42059970300,4034,3849,47,19,11,1,1,10,185
42059970400,3702,3527,35,6,11,7,0,0,175
42059970501,4404,3242,150,880,13,48,0,11,1162
42059970502,3622,3432,29,10,17,3,1,10,190
42059970600,4006,3637,100,78,5,32,3,12,369
42059970700,2421,2298,21,1,3,4,0,5,123
42059970800,3921,3692,34,11,2,2,1,5,229
42061950100,1752,1682,12,4,0,5,0,4,70
42061950200,3597,3407,83,14,2,3,0,14,190
42061950301,4624,4349,54,40,6,13,0,14,275
42061950302,3312,1240,310,1739,3,14,0,0,2072
42061950400,6827,6133,147,161,11,140,6,31,694
42061950500,3253,3141,17,10,5,7,0,5,112
42061950600,3998,3866,12,13,9,9,0,2,132
42061950800,3416,3229,37,44,0,5,1,3,187
42061950900,2308,1865,65,199,2,1,0,6,443
42061951000,2546,2412,33,23,0,4,0,5,134
42061951100,1811,1733,18,2,0,1,2,4,78
42061951200,4624,4435,46,15,4,3,0,11,189
42061951300,2024,1928,18,3,7,5,0,1,96
42063960100,3918,3762,19,10,9,1,0,6,156
42063960200,4830,4695,20,10,3,5,0,2,135
42063960300,2324,2227,20,14,5,3,0,11,97
42063960400,3414,3275,27,8,3,6,1,5,139
42063960500,3203,3075,37,7,8,4,0,3,128
42063960600,4800,4579,31,20,6,13,0,15,221
42063960700,5249,4549,92,204,7,191,0,14,700
42063960800,3914,3542,87,59,8,85,0,8,372
42063960900,4771,3637,135,774,8,26,0,8,1134
42063961000,2223,1977,69,60,2,25,0,2,246
42063961102,5988,4573,355,716,5,188,1,11,1415
42063961103,2786,2351,93,138,3,85,0,5,435
42063961104,2038,1716,81,62,0,63,0,0,322
42063961200,2411,2113,78,79,6,42,0,0,298
42063961300,3766,3607,24,20,4,13,0,9,159
42063961400,3085,2977,21,6,7,4,0,2,108
42063961500,3817,3618,44,6,2,5,0,11,199
42063961600,4391,4131,70,26,3,9,4,6,260
42063961700,1730,1640,21,11,0,2,1,2,90
42063961800,1688,1616,9,6,2,1,0,0,72
42063961900,3957,3762,27,7,14,15,0,7,195
42063962000,3491,3213,58,72,4,7,0,10,278
42063962100,3214,2949,45,83,4,16,0,9,265
42063962200,2238,2134,13,11,3,7,0,2,104
42065950100,2276,2148,12,10,2,5,0,1,128
42065950200,3002,2895,11,3,0,1,1,8,107
42065950300,5525,5317,50,4,2,8,0,6,208
42065950400,1876,1779,22,3,0,15,2,2,97
42065950500,2119,1990,36,5,1,16,0,4,129
42065950600,5589,5345,31,26,10,5,0,6,244
42065950700,2549,2396,39,5,2,2,0,2,153
42065950800,3661,3457,16,15,3,6,0,1,204
42065950900,4008,3866,28,0,2,10,0,13,142
42065951000,4397,4230,31,12,6,0,0,19,167
42065951100,3721,3549,16,7,10,8,3,4,172
42065951200,3187,2922,68,28,7,13,0,10,265
42065951300,2582,2423,37,7,0,11,2,16,159
42067070101,3340,3167,71,15,5,10,0,8,173
42067070102,3706,3224,355,19,7,19,1,6,482
42067070201,1770,1698,16,3,0,0,1,0,72
42067070202,5869,5358,302,44,6,14,0,13,511
42067070300,5031,4757,124,19,0,21,2,12,274
42067070400,3793,3626,40,15,1,5,0,9,167
42069100200,3456,1932,255,511,17,614,2,18,1524
42069100300,4228,3004,508,194,27,377,6,21,1224
42069100400,2039,1119,307,239,10,202,0,25,920
42069100500,2195,1529,188,112,6,224,0,28,666
42069100600,4270,2388,555,400,24,625,1,73,1882
42069100800,3103,1959,571,383,4,75,0,14,1144
42069100900,1571,1172,208,97,3,31,1,4,399
42069101000,3107,2745,196,98,3,18,1,1,362
42069101100,2520,1870,330,170,0,30,0,8,650
42069101200,2726,1991,256,174,5,191,0,15,735
42069101300,2714,1939,433,170,5,38,2,11,775
42069101400,2731,1419,838,212,5,65,2,17,1312
42069101600,2529,1694,482,202,1,28,0,0,835
42069101700,3064,2430,374,138,0,16,0,7,634
42069101800,4573,3956,257,132,7,126,0,8,617
42069101900,1412,1066,211,75,0,21,2,5,346
42069102000,2133,1338,447,228,1,14,0,8,795
42069102100,2322,1571,506,110,4,21,4,14,751
42069102200,2412,1791,331,158,0,29,0,13,621
42069102300,3591,2153,766,374,8,62,0,24,1438
42069102500,3246,1545,870,380,3,324,0,12,1701
42069102600,2516,1213,743,204,12,215,0,22,1303
42069102700,2866,1994,477,75,3,191,0,14,872
42069102800,2985,2534,107,81,1,161,1,15,451
42069102900,4163,2062,1227,338,2,353,0,35,2101
42069103000,2158,1152,623,171,6,100,0,14,1006
42069103100,1698,1359,144,70,3,81,0,3,339
42069110100,3068,2758,138,15,9,13,0,10,310
42069110201,3986,3774,74,9,1,16,0,8,212
42069110202,4629,4377,83,21,4,31,0,5,252
42069110300,4200,3848,119,26,0,64,0,15,352
42069110401,6884,5845,165,68,0,577,0,19,1039
42069110402,2912,2491,95,35,0,200,0,13,421
42069110403,3022,2645,126,61,3,101,0,11,377
42069110500,5201,4733,161,32,3,101,0,12,468
42069110600,2888,2699,68,33,2,8,1,3,189
42069110700,2377,2043,183,50,4,8,0,9,334
42069110800,3394,2829,292,76,4,20,0,19,565
42069110900,3057,2678,162,45,14,17,0,31,379
42069111000,2150,1969,85,19,0,8,0,4,181
42069111100,7297,6686,234,65,13,81,0,13,611
42069111200,6657,5981,247,126,4,77,0,13,676
42069111300,4520,4117,168,47,12,32,0,14,403
42069111400,5383,4664,341,87,3,45,1,16,719
42069111500,3367,3012,146,45,2,44,0,5,355
42069111600,2671,2301,144,87,0,48,0,1,370
42069111700,4065,3657,141,43,0,44,0,18,408
42069111801,3765,3539,81,18,6,14,0,7,226
42069111802,5154,4784,132,48,1,37,0,5,370
42069112000,4366,3896,170,83,0,130,1,15,470
42069112100,4293,3700,189,101,6,157,0,22,593
42069112200,2645,2359,100,61,1,31,1,8,286
42069112300,2738,2215,156,80,2,203,0,10,523
42069112400,4213,3946,76,22,4,38,0,13,267
42069112500,6294,5098,716,177,0,71,0,12,1196
42069112600,5667,4925,377,121,4,88,0,9,742
42069112700,2830,2588,123,33,2,35,0,6,242
42069112800,5959,5136,416,84,3,151,0,17,823
42069112901,4096,3715,132,51,9,18,0,3,381
42069112902,5820,5313,217,50,0,22,2,33,507
42071000100,2337,1140,733,315,0,47,0,22,1197
42071000200,3019,1097,1045,344,0,391,0,17,1922
42071000300,4766,2115,1603,608,10,223,1,21,2651
42071000400,4263,2164,1254,463,1,194,1,31,2099
42071000500,4238,3070,534,310,1,163,0,26,1168
42071000600,3248,2118,663,250,3,105,0,11,1130
42071000700,3401,1593,1166,417,3,81,0,18,1808
42071000800,3860,470,2631,490,1,122,0,25,3390
42071000900,3534,588,2181,609,6,45,3,10,2946
42071001000,3829,1100,1830,594,7,105,0,12,2729
42071001100,3460,1440,1236,419,4,137,2,18,2020
42071001200,5087,1754,2155,678,4,283,0,28,3333
42071001400,5188,1118,2824,907,11,105,0,27,4070
42071010102,3792,3284,255,45,1,87,1,8,508
42071010103,3555,3258,139,43,7,31,0,7,297
42071010104,3901,3732,90,14,0,6,1,6,169
42071010201,4840,4538,113,23,1,39,0,26,302
42071010202,6021,5413,225,91,0,146,3,28,608
42071010301,4592,4263,143,33,0,59,0,2,329
42071010302,5618,4938,284,82,0,117,13,19,680
42071010400,5046,4292,417,73,12,61,0,21,754
42071010501,4489,4266,82,31,5,17,0,6,223
42071010502,7535,6806,301,108,2,143,0,25,729
42071010601,4835,4350,215,35,7,53,0,12,485
42071010602,5864,5197,301,102,4,87,0,21,667
42071010701,6025,5266,323,110,4,89,3,23,759
42071010702,5636,4775,356,155,2,132,0,20,861
42071010802,3361,3111,120,29,9,3,0,5,250
42071010803,4641,4306,151,63,0,23,2,14,335
42071010804,4303,3947,132,45,0,56,0,14,356
42071010901,4449,3781,359,93,8,68,2,0,668
42071010902,3876,3166,437,131,2,27,0,8,710
42071011000,2623,2298,149,66,3,9,0,5,325
42071011101,5028,4364,311,145,0,23,1,13,664
42071011102,3656,3205,182,80,1,41,1,28,451
42071011200,1982,1187,502,171,8,11,0,13,795
42071011300,4076,3162,580,165,9,34,0,18,914
42071011400,4149,2936,716,263,3,30,0,25,1213
42071011502,6066,4751,889,158,1,79,0,14,1315
42071011503,3994,3073,414,140,8,212,1,10,921
42071011504,6227,5290,463,106,0,135,2,21,937
42071011505,3750,2992,351,169,13,97,2,16,758
42071011600,6184,5064,600,219,3,86,0,32,1120
42071011701,5077,3707,773,124,13,301,0,29,1370
42071011704,4484,3527,305,121,1,375,0,5,957
42071011705,6543,4602,904,465,2,362,0,26,1941
42071011706,2974,2556,193,45,0,69,0,4,418
42071011707,5615,4773,393,91,2,195,0,23,842
42071011801,3198,2683,168,61,0,165,0,11,515
42071011802,6132,4580,746,289,4,280,1,32,1552
42071011803,7183,5309,685,339,6,621,0,29,1874
42071011805,3143,2065,472,178,4,288,0,28,1078
42071011806,3820,2428,531,204,3,493,0,24,1392
42071011807,5415,4061,571,189,0,387,0,19,1354
42071011901,6662,5221,473,199,3,518,0,36,1441
42071011903,3977,3526,108,54,3,175,0,13,451
42071011904,4890,4289,248,80,8,175,1,6,601
42071012001,5247,4621,291,88,0,99,1,21,626
42071012002,4134,3602,270,79,3,58,1,20,532
42071012103,4121,3804,117,44,0,66,0,10,317
42071012105,3885,3366,238,81,3,76,2,23,519
42071012106,4335,3868,241,34,0,40,2,31,467
42071012107,6681,6083,254,54,0,85,0,22,598
42071012200,7096,5967,621,113,9,100,3,27,1129
42071012301,3545,2967,328,51,15,46,1,2,578
42071012302,3153,2734,248,21,8,26,0,12,419
42071012402,4171,3582,284,92,10,56,0,10,589
42071012403,4405,3877,228,88,9,102,2,1,528
42071012404,5943,5257,330,85,0,129,1,19,686
42071012501,7029,6285,259,79,4,192,4,7,744
42071012502,5654,5218,166,36,7,92,0,9,436
42071012601,7557,7001,211,52,7,110,5,26,556
42071012602,4609,4404,74,18,4,13,4,4,205
42071012701,4039,3809,124,32,1,13,2,11,230
42071012702,4017,3671,145,49,16,76,0,6,346
42071012800,5743,4567,624,156,11,163,0,30,1176
42071012900,7144,6682,251,38,0,73,4,9,462
42071013001,4471,3847,258,69,3,117,1,10,624
42071013002,4089,3714,163,29,7,93,1,6,375
42071013101,5204,4206,570,136,5,158,0,19,998
42071013102,3717,3067,332,87,1,151,0,11,650
42071013202,6042,3784,1100,629,12,313,0,17,2258
42071013203,5470,4341,660,171,2,150,9,9,1129
42071013204,7226,5488,848,301,14,334,0,32,1738
42071013301,4471,3718,419,103,8,103,3,11,753
42071013303,5242,4823,196,29,6,55,0,22,419
42071013305,3507,3156,186,66,1,34,0,3,351
42071013306,5294,4668,268,88,5,105,2,22,626
42071013400,3016,1673,857,231,14,103,0,10,1343
42071013502,4675,3216,766,283,3,264,0,17,1459
42071013503,2579,2215,137,51,4,68,2,17,364
42071013504,6492,2279,2539,1083,10,319,1,29,4213
42071013505,4371,2222,1365,394,6,215,1,18,2149
42071013601,3453,2799,239,225,1,80,0,7,654
42071013602,5183,4166,411,281,5,134,0,19,1017
42071013701,5268,3648,833,195,5,381,1,29,1620
42071013703,6487,4807,831,342,1,257,2,25,1680
42071013704,3912,3115,476,106,6,69,1,25,797
42071013800,3850,3553,165,24,3,20,0,17,297
42071013901,5474,4675,420,136,3,54,1,31,799
42071013902,3914,3589,144,17,9,25,0,8,325
42071014000,7574,6951,290,60,2,67,0,27,623
42071014101,5652,5379,155,18,4,29,4,8,273
42071014102,5672,5134,301,93,0,18,0,0,538
42071014201,5657,5379,121,45,1,15,0,23,278
42071014202,5837,5306,284,83,4,44,1,10,531
42071014301,3181,3033,71,12,0,6,0,14,148
42071014302,4648,4263,148,58,0,7,0,27,385
42071014401,6995,6478,239,50,18,8,2,7,517
42071014402,5082,4549,309,53,4,28,0,10,533
42071014501,5221,4854,160,20,15,15,0,11,367
42071014502,5775,5402,179,38,5,12,0,18,373
42071014601,3936,3719,108,20,0,1,0,14,217
42071014603,3883,3681,88,19,11,14,0,2,202
42071014604,4118,3823,171,32,0,7,1,9,295
42071014700,4381,423,3035,738,4,45,4,17,3958
42073000100,4343,3679,120,254,5,15,0,21,664
42073000200,2020,1557,219,95,3,0,0,9,463
42073000300,3698,2520,113,650,4,31,0,22,1178
42073000400,1776,857,100,638,6,3,0,6,919
42073000600,950,691,70,100,4,1,0,8,259
42073000700,1808,1301,54,306,0,4,0,4,507
42073000800,4020,3199,77,430,2,8,0,30,821
42073000900,1692,1120,71,320,6,3,0,6,572
42073001000,1619,1366,23,68,3,0,0,11,253
42073010100,3790,3600,52,18,0,5,0,2,190
42073010201,3609,3439,34,25,0,41,0,3,170
42073010202,4983,4720,70,17,4,21,0,7,263
42073010300,2092,1878,45,69,0,6,0,12,214
42073010400,3102,2976,16,9,5,4,0,11,126
42073010500,2708,2566,38,8,0,8,0,0,142
42073010600,2260,2074,17,73,1,9,0,3,186
42073010700,2746,2324,47,165,2,2,0,13,422
42073010800,6234,5793,90,71,1,67,0,27,441
42073010900,2913,2729,14,4,2,13,0,7,184
42073011000,4798,4510,42,23,10,10,0,3,288
42073011100,3961,3671,42,47,2,13,0,8,290
42073011200,2423,2276,36,5,0,8,0,6,147
42073011300,4158,3944,50,11,1,0,0,0,214
42073011400,1931,1785,18,13,1,1,0,6,146
42073011500,3960,3644,47,9,5,16,4,13,316
42073011600,3895,3555,69,36,3,12,0,12,340
42073011700,1992,1788,25,19,3,9,0,0,204
42073011800,2589,2249,56,63,2,11,0,1,340
42075000100,5172,2507,2186,280,4,48,0,27,2665
42075000200,5243,3130,1679,196,11,48,2,20,2113
42075000300,4309,1246,2734,134,6,60,0,17,3063
42075000401,4173,1553,2361,178,2,9,4,3,2620
42075000402,4140,1827,2077,119,12,17,0,12,2313
42075000500,3777,2206,1343,101,1,36,0,14,1571
42075002000,2991,2744,108,13,1,29,2,14,247
42075002100,5132,4689,232,40,0,17,0,17,443
42075002200,6699,5941,434,50,7,42,3,22,758
42075002300,2658,2418,103,24,6,11,3,15,240
42075002400,2269,2109,75,20,5,5,0,9,160
42075002500,4757,4109,356,66,0,87,0,12,648
42075002600,2013,1743,151,28,1,33,4,9,270
42075002701,6007,5032,620,91,1,111,0,21,975
42075002702,6034,4705,1008,102,1,81,1,9,1329
42075002801,4940,4570,190,45,2,39,2,16,370
42075002802,4408,4219,77,25,1,32,0,5,189
42075002900,3094,2763,197,50,0,23,1,5,331
42075003000,5864,5398,214,38,4,30,6,14,466
42075003100,4095,3932,64,25,4,5,0,3,163
42075003200,5402,4530,489,131,6,112,1,13,872
42075003300,2336,1806,353,66,3,48,0,0,530
42075003400,2678,2232,290,31,1,22,0,5,446
42075003500,5629,4604,563,135,5,154,0,20,1025
42075003600,3693,2201,1051,154,10,129,2,25,1492
42075003700,3438,3145,108,19,0,46,1,10,293
42075003801,3597,3263,91,35,0,106,0,13,334
42075003802,5314,4796,177,54,5,118,0,11,518
42075003901,3802,3229,223,64,7,141,1,16,573
42075003902,4028,3384,289,85,11,97,3,11,644
42075004000,8776,7668,297,102,2,374,1,47,1108
42075004100,2185,2018,72,16,0,26,2,11,167
42075004200,4604,4287,136,38,0,56,0,14,317
42077000101,3974,1578,1828,316,10,109,0,32,2396
42077000102,4551,1897,2079,364,2,66,0,29,2654
42077000400,3790,1236,2078,330,10,34,0,13,2554
42077000500,2709,359,1920,325,5,12,0,16,2350
42077000600,6235,1805,3630,517,0,138,1,32,4430
42077000700,4222,551,3079,441,2,36,0,49,3671
42077000800,4322,511,3079,563,7,47,0,24,3811
42077000900,1994,285,1340,281,3,40,0,5,1709
42077001000,3279,426,2330,421,9,10,1,25,2853
42077001200,2324,564,1269,434,2,9,1,14,1760
42077001401,8022,2248,4652,735,11,144,0,51,5774
42077001402,2259,1319,693,123,3,42,0,7,940
42077001501,7159,1516,4744,599,3,117,0,33,5643
42077001502,7566,2893,3318,809,10,256,2,66,4673
42077001600,3742,409,2761,404,7,19,4,19,3333
42077001700,5039,573,3852,427,4,58,0,27,4466
42077001800,5086,886,3362,642,8,52,1,16,4200
42077001900,4633,1546,2495,413,2,60,5,20,3087
42077002000,5857,1009,3860,726,5,89,0,35,4848
42077002100,7406,1918,4302,789,23,146,4,56,5488
42077002201,4759,2456,1695,357,1,86,0,18,2303
42077002202,4023,1817,1032,1026,1,20,0,82,2206
42077002302,3216,1904,746,380,2,85,2,30,1312
42077002303,2769,1697,287,119,4,562,0,13,1072
42077002304,4509,3166,842,253,3,95,1,16,1343
42077005100,4283,3538,463,74,0,18,0,6,745
42077005200,6551,5997,289,44,4,23,1,14,554
42077005301,3324,3067,113,21,1,17,1,8,257
42077005302,4232,3919,176,19,13,19,0,4,313
42077005401,2292,2099,63,21,1,22,1,17,193
42077005402,4976,4585,158,28,3,29,3,17,391
42077005503,4166,3775,177,37,2,70,0,9,391
42077005504,4595,3908,356,102,4,94,3,21,687
42077005505,3210,2860,165,29,3,42,1,15,350
42077005506,3684,2953,411,85,3,91,2,31,731
42077005601,5365,4339,582,188,2,93,2,16,1026
42077005602,5423,4109,737,274,3,105,5,10,1314
42077005702,4747,3221,950,253,7,143,1,15,1526
42077005703,3990,1869,1351,523,1,101,0,25,2121
42077005704,3561,1482,1027,540,6,375,0,20,2079
42077005705,6087,3929,1013,470,6,488,0,37,2158
42077005800,3348,2635,420,121,0,50,0,12,713
42077005901,6518,4594,1345,279,0,38,3,20,1924
42077005902,1689,940,484,147,2,46,0,10,749
42077006001,4894,3800,608,109,4,197,6,14,1094
42077006002,6313,4854,453,225,5,559,5,19,1459
42077006101,4196,3360,361,115,2,219,2,13,836
42077006102,5677,4074,669,245,1,458,0,26,1603
42077006203,9604,6657,808,367,12,1409,0,49,2947
42077006204,3964,3171,218,63,1,361,0,14,793
42077006205,5355,3936,445,199,5,587,0,11,1419
42077006206,7454,4198,1040,438,7,1410,3,37,3256
42077006302,7818,5707,898,480,1,385,1,54,2111
42077006303,3257,2643,331,93,4,80,0,15,614
42077006304,4023,3230,322,112,10,210,0,10,793
42077006305,6915,5400,672,331,2,317,2,11,1515
42077006309,3896,2824,372,186,1,392,0,14,1072
42077006310,4970,4176,235,128,1,258,1,21,794
42077006311,4150,3275,293,146,3,289,0,8,875
42077006312,3250,2640,197,160,0,168,0,9,610
42077006401,2846,2599,106,37,2,26,2,6,247
42077006402,4883,4450,214,20,2,44,0,11,433
42077006500,5775,4501,723,205,7,114,0,23,1274
42077006600,5925,5032,462,139,10,98,0,11,893
42077006701,4796,3347,966,186,9,100,0,34,1449
42077006702,2776,2323,265,63,0,35,1,17,453
42077006703,6049,5055,442,161,1,199,0,29,994
42077006800,4832,2617,1582,377,2,44,0,16,2215
42077006902,2449,2104,150,34,1,46,4,11,345
42077006903,6957,5397,483,466,10,364,0,35,1560
42077006905,5468,4655,244,108,1,272,3,15,813
42077006906,4546,3858,288,43,0,182,2,31,688
42077007000,3861,3575,112,4,6,34,0,7,286
42077009100,3741,2623,629,211,9,137,2,12,1118
42077009200,3846,2579,729,265,2,130,1,20,1267
42077009300,3386,2404,638,163,0,52,0,6,982
42077009400,4118,2177,1380,299,0,83,3,35,1941
42077009500,4681,2901,1134,324,5,104,2,23,1780
42077009601,3106,1324,1378,283,0,38,0,18,1782
42077009602,5360,1177,3460,491,5,66,5,28,4183
42077009700,3934,963,2121,625,8,62,1,31,2971
42079200100,3960,2960,371,382,8,122,0,20,1000
42079200200,3683,2083,836,447,10,147,1,13,1600
42079200300,1867,1216,302,218,3,32,0,15,651
42079200400,2632,1276,806,406,10,19,2,7,1356
42079200500,2662,1274,785,431,1,46,1,7,1388
42079200600,2253,1301,602,213,0,19,0,11,952
42079200700,3721,1829,1186,479,4,52,3,24,1892
42079200800,3740,1626,1336,511,4,115,0,19,2114
42079200900,3252,1493,979,529,2,53,1,45,1759
42079201000,2858,923,828,903,4,31,0,17,1935
42079201100,1342,565,483,225,2,6,0,4,777
42079201200,2686,1538,533,500,4,26,0,11,1148
42079201300,2253,1083,681,375,7,31,0,6,1170
42079201400,2390,1269,726,286,3,20,0,6,1121
42079201500,2320,1626,379,184,1,28,0,8,694
42079201600,2739,2266,230,93,0,47,0,12,473
42079210100,3186,2996,71,31,2,12,0,12,190
42079210200,2539,2359,64,33,0,9,0,9,180
42079210300,2507,2311,95,25,1,14,0,0,196
42079210400,1329,1229,33,15,0,10,0,5,100
42079210500,5036,4594,182,69,3,64,0,10,442
42079210600,2704,2314,192,72,3,8,0,11,390
42079210700,1742,1408,152,110,4,4,1,2,334
42079210800,3145,2645,250,104,1,28,1,8,500
42079211000,4652,4162,169,97,0,33,0,18,490
42079211101,5514,5046,164,129,11,28,4,9,468
42079211102,2051,1978,19,4,3,2,0,3,73
42079211201,2694,2495,58,17,1,50,0,2,199
42079211203,1716,1601,30,7,1,9,0,6,115
42079211204,6630,5950,247,91,6,173,2,2,680
42079211205,2469,2321,46,21,2,27,0,1,148
42079211301,4631,3105,286,1132,3,41,0,6,1526
42079211302,3346,3147,57,14,2,21,0,16,199
42079211303,2788,2652,41,0,0,2,0,5,136
42079211304,1993,1887,14,13,0,1,1,4,106
42079211400,7108,6680,100,34,5,80,0,8,428
42079211500,2638,2517,41,13,0,15,0,0,121
42079211600,3102,2815,106,68,7,17,2,6,287
42079211701,4921,4493,143,109,4,87,0,7,428
42079211702,1451,1306,43,19,3,38,1,0,145
42079211800,1981,1694,41,74,2,131,0,0,287
42079211900,5995,5342,261,177,10,63,0,14,653
42079212000,1832,1558,99,64,2,25,0,7,274
42079212100,4239,3781,188,74,0,42,4,16,458
42079212200,5021,4679,134,47,7,33,0,3,342
42079212300,2711,2464,85,40,3,13,2,6,247
42079212700,5217,4032,377,463,5,105,1,11,1185
42079212800,3441,2979,98,112,9,136,0,31,462
42079212900,1451,1184,138,51,1,24,0,15,267
42079213000,1479,1114,130,140,3,28,0,11,365
42079213100,1761,1409,98,119,1,46,1,27,352
42079213200,4929,3381,532,716,14,39,0,13,1548
42079213300,1582,1486,40,22,0,9,3,2,96
42079213400,4225,3791,142,122,4,30,0,7,434
42079213600,2153,1683,156,175,3,10,0,10,470
42079213700,2005,1596,168,139,5,5,1,18,409
42079213800,1605,1266,117,125,1,4,0,9,339
42079213900,1717,1575,71,18,0,1,0,1,142
42079214100,3500,2981,247,109,6,15,0,10,519
42079214200,2950,2405,223,198,4,19,0,3,545
42079214300,2121,1825,147,86,0,4,1,5,296
42079214400,2057,1778,130,76,4,12,0,2,279
42079214500,1742,1470,116,72,1,23,0,4,272
42079214600,4095,3027,604,257,2,17,1,7,1068
42079214900,1458,1300,90,28,3,5,0,8,158
42079215000,1528,1384,56,19,8,6,3,2,144
42079215100,2596,2183,213,107,1,15,0,4,413
42079215200,3183,2486,249,173,0,185,1,5,697
42079215300,3982,3662,129,24,6,36,0,8,320
42079215400,2489,2285,101,12,0,6,0,3,204
42079215501,4703,4153,180,46,2,176,0,13,550
42079215502,5722,5158,186,50,1,165,1,15,564
42079215503,3632,3111,106,28,0,268,0,8,521
42079215504,3796,3640,46,6,4,11,0,6,156
42079215600,4433,3843,208,192,5,12,0,10,590
42079215701,2223,2103,34,18,0,6,0,3,120
42079215702,2667,2485,43,12,0,14,0,0,182
42079215800,2726,2583,22,7,5,10,3,2,143
42079215900,3485,3331,46,6,3,8,0,6,154
42079216100,4027,3645,203,26,0,30,1,6,382
42079216200,5035,4674,106,28,6,10,8,11,361
42079216400,1909,1806,51,9,0,14,1,3,103
42079216501,1825,1630,93,16,0,25,0,4,195
42079216502,3846,3449,232,30,1,55,0,1,397
42079216601,3239,2963,150,22,2,29,0,5,276
42079216602,6246,5430,466,105,10,99,1,7,816
42079216700,3833,2737,882,55,1,25,0,7,1096
42079216800,3516,3166,216,37,0,11,0,0,350
42079216900,4696,3691,780,56,0,63,0,6,1005
42079217001,2339,1606,626,20,1,26,1,2,733
42079217002,3125,1958,1068,29,0,20,2,13,1167
42079217100,3908,1560,2208,68,3,21,0,16,2348
42079217200,3906,959,2814,64,3,14,2,20,2947
42079217300,3671,2406,1130,33,1,48,3,14,1265
42079217400,1751,533,1096,64,0,19,2,6,1218
42079217500,3380,695,2556,48,4,16,0,30,2685
42079217600,3721,794,2771,87,3,5,0,16,2927
42079217700,5490,1853,3412,93,4,40,1,34,3637
42079217800,4136,1094,2911,43,3,30,0,33,3042
42079217900,5163,1834,3099,113,0,22,1,44,3329
42079218000,4150,3275,311,372,3,14,0,7,875
42081000100,3254,2624,111,285,4,24,0,13,630
42081000200,2130,1689,61,203,9,34,0,1,441
42081000300,5766,4004,186,1025,12,26,0,19,1762
42081000400,3902,2168,163,1157,6,32,3,43,1734
42081000500,2555,1780,180,374,4,37,2,9,775
42081000600,2475,1857,123,302,3,55,0,5,618
42081000800,2276,1424,180,508,1,47,0,18,852
42081000900,2301,1876,53,183,1,10,0,20,425
42081001000,3095,2367,109,324,11,27,5,25,728
42081010100,2193,2105,22,4,4,0,0,4,88
42081010200,1014,978,5,5,2,0,2,0,36
42081010300,3253,3102,36,7,1,4,0,11,151
42081010400,4931,4574,72,34,14,36,0,21,357
42081010501,1797,1683,25,10,5,0,0,12,114
42081010502,3804,3603,38,10,4,8,3,15,201
42081010600,4318,4140,17,5,0,11,0,9,178
42081010700,6247,5850,87,20,13,34,3,9,397
42081010800,7191,6719,119,49,17,29,0,17,472
42081010900,2834,2636,39,9,11,16,2,7,198
42081011000,4750,4408,78,28,7,45,2,14,342
42081011100,5697,4847,102,314,8,116,3,31,850
42081011200,5864,5358,75,103,1,131,0,18,506
42081011301,2046,1888,45,16,4,8,0,2,158
42081011302,4975,4518,92,107,18,51,0,9,457
42081011400,1654,1566,11,6,2,6,0,6,88
42081011601,1200,1094,22,7,0,5,0,6,106
42081011603,2225,2025,27,67,3,13,0,3,200
42081011604,4036,3663,61,73,0,32,0,11,373
42081011701,4256,3555,144,384,12,26,0,7,701
42081011702,3301,3150,28,8,8,11,0,11,151
42081011800,3154,3035,17,2,6,12,0,4,119
42081011900,5694,5401,46,43,0,37,2,3,293
42083420100,3318,3125,29,16,9,11,0,0,193
42083420200,2778,2463,49,22,22,16,2,19,315
42083420300,2459,2228,72,29,16,8,0,12,231
42083420400,2611,2395,33,20,5,23,0,8,216
42083420500,2851,2678,28,2,10,18,0,8,173
42083420600,5152,4888,24,3,8,9,0,9,264
42083420700,4357,4073,46,12,11,5,0,11,284
42083420800,3640,3486,34,6,0,11,0,2,154
42083420900,2069,1988,10,0,9,8,0,0,81
42083421000,5378,4182,248,717,12,63,0,6,1196
42083421100,3501,3289,46,16,0,20,0,3,212
42083421200,2318,2196,23,6,0,1,0,4,122
42085030100,1934,1494,56,218,3,11,0,16,440
42085030300,3182,2465,101,378,8,14,0,18,717
42085030400,2701,2368,38,136,0,20,0,2,333
42085030500,2385,1656,39,469,3,8,1,24,729
42085030900,2562,1374,25,997,3,12,0,24,1188
42085031100,1532,1171,30,229,2,2,0,6,361
42085031200,5487,5071,60,109,5,82,0,22,416
42085031300,2618,2368,35,94,3,33,4,10,250
42085031400,5472,4854,74,229,5,100,0,29,618
42085031700,2476,2293,42,35,3,10,0,2,183
42085031800,4729,4539,24,3,4,10,0,6,190
42085031900,4682,4464,43,13,2,51,0,3,218
42085032000,4850,4630,61,20,6,3,0,1,220
42085032100,2752,2378,70,130,5,30,0,11,374
42085032200,2788,2534,51,33,5,20,3,0,254
42085032300,3229,3052,26,22,0,16,0,8,177
42085032401,1477,1348,29,9,1,1,0,3,129
42085032402,1641,1505,23,18,0,1,0,0,136
42085032403,2520,2394,23,5,0,4,0,10,126
42085032502,2199,2108,12,4,5,0,0,4,91
42085032503,1652,1579,6,2,0,3,0,5,73
42085032504,2796,2643,24,11,2,6,1,7,153
42085032505,1458,1382,11,3,5,1,0,3,76
42085032601,5741,5484,49,20,6,24,0,2,257
42085032602,4779,3863,114,609,3,21,0,11,916
42085032701,4340,4032,40,73,0,13,1,8,308
42085032702,2471,2350,28,12,0,7,0,3,121
42085032801,3519,3237,47,44,5,20,0,10,282
42085032802,1957,1737,50,66,2,12,3,14,220
42085032900,3191,2907,51,31,6,32,0,6,284
42085033000,4728,4372,77,46,5,63,0,23,356
42085033100,4678,4463,49,11,3,5,0,6,215
42085033200,2945,1526,82,957,7,33,0,11,1419
42085033300,2881,2419,48,174,7,9,1,15,462
42085033400,2300,938,71,1079,2,6,0,19,1362
42087960100,4018,3803,78,20,2,11,0,1,215
42087960200,4112,3938,42,16,1,24,0,2,174
42087960300,5627,5486,38,15,11,3,0,5,141
42087960400,2847,2700,41,16,1,7,0,5,147
42087960500,3596,3488,32,7,3,3,0,4,108
42087960600,5193,4877,84,40,11,13,0,7,316
42087960700,2342,2028,136,57,3,7,0,21,314
42087960800,3865,3293,255,88,12,12,0,13,572
42087960900,2372,2176,87,31,2,12,0,10,196
42087961000,1991,1857,48,17,0,0,0,7,134
42087961101,3413,3254,51,15,0,22,0,2,159
42087961102,3799,3599,45,20,3,37,0,1,200
42087961200,2968,2844,42,8,2,9,0,0,124
42089300101,3678,2194,661,574,4,65,2,37,1484
42089300103,3587,2370,620,339,8,74,1,41,1217
42089300104,3020,1654,686,492,3,60,0,36,1366
42089300201,4053,3346,316,182,11,45,0,20,707
42089300203,3089,1536,721,576,10,105,0,25,1553
42089300204,2899,2114,391,203,5,51,0,17,785
42089300308,2882,1399,659,586,5,49,8,26,1483
42089300311,2126,1679,217,104,3,58,0,10,447
42089300312,2111,1693,218,104,3,23,0,12,418
42089300313,1956,1527,238,93,1,26,0,24,429
42089300314,2343,1186,569,435,4,53,0,22,1157
42089300315,3223,2071,537,357,13,81,2,39,1152
42089300316,3814,2128,705,716,17,67,0,37,1686
42089300317,3965,1422,1038,1179,6,87,0,69,2543
42089300318,1926,564,598,636,3,11,4,26,1362
42089300319,2874,898,822,905,1,60,0,41,1976
42089300320,1738,1418,124,101,1,22,0,10,320
42089300321,2340,1062,569,460,3,94,1,38,1278
42089300322,2948,733,1003,1025,10,48,0,21,2215
42089300323,1911,481,604,660,10,24,1,29,1430
42089300401,4670,3245,574,474,6,120,2,36,1425
42089300404,5104,3340,730,605,5,188,5,29,1764
42089300405,1110,661,200,170,2,21,0,14,449
42089300406,3153,2363,342,255,3,34,0,16,790
42089300407,3425,2272,444,442,6,75,0,26,1153
42089300501,3267,2041,516,425,8,136,0,19,1226
42089300502,5375,2951,1112,898,15,143,2,28,2424
42089300600,4398,2438,925,664,6,109,2,53,1960
42089300700,5271,2947,1230,723,0,191,0,21,2324
42089300801,2640,1565,521,328,10,77,3,33,1075
42089300802,3287,1825,664,526,4,73,3,37,1462
42089300901,4600,2763,809,495,9,296,0,37,1837
42089300902,1670,1155,234,154,1,51,0,15,515
42089301002,2753,2008,295,196,4,125,0,22,745
42089301003,3203,1204,634,1026,7,136,4,52,1999
42089301004,4691,1640,1467,1173,10,136,3,54,3051
42089301005,2917,1955,447,306,2,73,0,31,962
42089301101,5690,4587,422,288,14,125,1,32,1103
42089301102,2907,2277,262,193,1,54,1,24,630
42089301202,4572,3629,449,201,12,95,0,21,943
42089301203,5475,4787,349,128,2,40,0,15,688
42089301204,4162,3092,558,293,3,38,0,16,1070
42089301206,3299,2211,511,368,0,43,0,28,1088
42089301207,4690,3321,644,424,7,73,1,42,1369
42089301302,2596,2315,126,45,2,14,0,20,281
42089301303,3358,2832,305,79,7,16,1,9,526
42089301304,4115,3376,411,144,3,22,0,12,739
42089301403,2998,1208,693,825,3,110,5,30,1790
42089301404,1719,788,357,395,3,96,0,10,931
42089301405,3348,1739,702,612,11,110,4,29,1609
42089301406,1381,706,329,241,2,24,0,16,675
42091200103,4396,3607,104,45,0,526,0,8,789
42091200104,4446,3699,109,41,0,450,0,14,747
42091200105,2965,2195,57,13,0,606,0,17,770
42091200106,2110,1781,48,52,0,160,0,10,329
42091200200,1272,1119,27,54,5,13,0,13,153
42091200301,6749,4536,628,612,9,643,0,39,2213
42091200305,2237,2005,123,24,3,19,1,8,232
42091200306,3781,3270,188,83,2,102,0,7,511
42091200307,3387,2275,230,448,0,265,0,26,1112
42091200308,4184,2948,286,426,7,306,3,13,1236
42091200309,2770,2341,154,103,0,87,3,11,429
42091200310,3008,2636,120,79,0,72,0,6,372
42091200401,3741,3212,191,136,5,58,0,21,529
42091200402,4497,3719,287,201,0,85,0,8,778
42091200501,4091,3561,173,58,1,137,1,7,530
42091200502,5653,3964,685,413,8,289,0,34,1689
42091200505,6940,5364,218,319,9,787,0,24,1576
42091200506,4458,3616,150,147,3,388,0,10,842
42091200507,5422,4279,252,248,8,459,1,10,1143
42091200602,8218,4945,295,520,2,2189,0,22,3273
42091200603,3762,2617,133,211,7,662,1,12,1145
42091200605,6280,4364,152,335,1,1275,0,7,1916
42091200606,3132,2324,122,133,0,458,0,12,808
42091200607,4470,3211,124,221,6,766,0,0,1259
42091200703,4656,3047,220,233,2,970,0,8,1609
42091200704,3491,2563,186,240,3,334,8,16,928
42091200707,4347,2516,591,318,16,739,2,28,1831
42091200708,6146,4023,310,249,7,1325,0,33,2123
42091200800,3496,1937,343,201,9,854,1,30,1559
42091200901,4681,2597,404,347,8,1118,7,18,2084
42091200902,1367,754,167,98,1,276,5,15,613
42091200903,5193,3139,430,473,9,934,0,24,2054
42091200906,2191,1613,123,133,0,258,0,9,578
42091200907,2736,2204,134,145,1,127,0,7,532
42091200908,2605,1688,305,161,12,298,8,14,917
42091201003,5245,3775,236,242,5,802,2,19,1470
42091201004,5857,3961,156,360,1,1175,2,28,1896
42091201005,3521,2773,105,155,2,361,1,8,748
42091201006,2449,2070,54,78,0,173,0,3,379
42091201100,3426,2844,140,164,3,110,1,16,582
42091201201,6474,4904,206,238,3,902,0,38,1570
42091201203,3313,2741,89,116,1,264,0,7,572
42091201204,2289,1512,99,454,0,121,0,11,777
42091201301,3531,2490,394,332,2,168,1,11,1041
42091201302,3276,1992,456,532,3,109,0,14,1284
42091201404,4868,3786,131,183,4,559,0,28,1082
42091201406,5085,3948,174,385,0,409,0,17,1137
42091201407,2604,1735,77,546,0,119,0,16,869
42091201408,4400,3598,79,73,3,526,0,1,802
42091201409,4423,3664,75,115,6,402,0,14,759
42091201410,2552,2028,92,122,0,203,0,19,524
42091201411,2733,2206,95,149,5,171,0,19,527
42091201501,3810,2851,156,202,2,453,1,19,959
42091201502,2070,1654,127,85,4,97,0,16,416
42091201603,4770,2202,343,1748,2,198,0,19,2568
42091201604,3178,1652,213,1004,7,152,0,10,1526
42091201605,3265,2252,225,484,0,144,2,19,1013
42091201606,2415,1204,200,798,0,63,0,13,1211
42091201607,3604,2640,175,481,3,117,0,17,964
42091201608,4944,3910,246,307,4,290,0,34,1034
42091201703,3107,2551,135,205,3,69,2,18,556
42091201704,3564,2562,156,589,1,73,0,9,1002
42091201705,4530,3862,148,269,0,97,0,9,668
42091201706,4743,3494,313,592,1,164,2,22,1249
42091201800,3603,2829,140,303,4,164,0,12,774
42091201901,5066,4181,189,171,9,310,0,38,885
42091201902,5833,3897,302,915,2,450,4,60,1936
42091202000,2638,2318,95,74,2,58,0,13,320
42091202100,4719,3776,210,345,1,166,0,35,943
42091202201,4821,2532,406,1339,3,301,0,40,2289
42091202202,3115,674,270,1488,2,567,0,23,2441
42091202301,4544,2928,249,908,4,206,1,47,1616
42091202302,2390,1270,126,736,0,138,0,39,1120
42091202401,3252,374,226,2348,11,139,0,34,2878
42091202402,4957,1837,296,2170,20,351,0,39,3120
42091202500,6260,1489,468,3466,16,552,1,33,4771
42091202602,2670,1785,110,526,6,126,0,8,885
42091202603,3096,2192,195,422,8,133,0,12,904
42091202604,2347,1560,97,431,1,140,0,24,787
42091203000,3421,2732,110,176,0,275,1,12,689
42091203103,3530,3131,101,63,0,122,0,10,399
42091203104,4484,4035,117,111,0,94,0,31,449
42091203105,5888,4947,186,220,4,334,0,14,941
42091203106,2384,1926,87,124,3,126,0,9,458
42091203203,4262,3003,226,364,0,515,3,14,1259
42091203204,7350,5051,273,362,0,1438,4,23,2299
42091203205,2245,1727,77,237,0,142,0,4,518
42091203207,3375,2823,117,113,2,235,0,4,552
42091203208,3101,2462,64,89,0,370,0,6,639
42091203302,6197,4742,334,563,6,307,0,38,1455
42091203303,4055,2860,294,492,6,253,0,39,1195
42091203304,3769,2521,236,568,3,282,1,20,1248
42091203401,6348,4279,559,976,9,239,1,29,2069
42091203402,6606,4703,389,628,5,607,2,25,1903
42091203403,3247,2536,164,258,1,150,0,7,711
42091203500,6365,2192,1394,2311,18,145,1,71,4173
42091203601,3068,406,1230,1252,9,22,2,1,2662
42091203602,4037,1483,966,1251,5,101,0,26,2554
42091203701,1620,656,406,419,0,30,0,13,964
42091203801,3746,1137,1407,924,2,75,0,29,2609
42091203803,5956,1259,2815,1491,22,131,5,33,4697
42091203804,3439,746,1375,1077,4,30,0,37,2693
42091203901,3529,386,1524,1440,6,30,1,17,3143
42091203902,3988,1009,1471,1061,7,263,4,16,2979
42091204002,3571,2355,260,446,3,340,0,28,1216
42091204007,2446,1695,147,232,3,262,0,4,751
42091204008,3160,2467,118,216,3,250,0,5,693
42091204009,2201,1694,98,167,0,160,0,5,507
42091204010,2622,2241,64,98,3,143,0,5,381
42091204101,4493,3988,184,102,0,63,1,15,505
42091204103,2076,1639,80,171,2,130,1,2,437
42091204104,2692,2155,167,184,0,69,0,3,537
42091204200,1493,1210,65,96,2,51,0,10,283
42091204300,3259,2437,141,251,3,283,2,22,822
42091204400,3559,2837,147,141,1,250,0,47,722
42091204500,4988,3764,318,302,6,327,0,63,1224
42091204600,4941,4081,161,86,2,396,0,20,860
42091204701,2282,1858,66,63,2,210,0,15,424
42091204702,3531,2620,161,138,3,438,1,17,911
42091204800,5406,4602,143,76,0,327,0,39,804
42091204900,5540,4577,218,237,1,290,1,15,963
42091205000,2675,1728,193,228,6,382,0,8,947
42091205100,1993,1353,133,234,2,171,1,22,640
42091205200,2863,2410,100,54,0,180,0,9,453
42091205300,2219,1128,165,587,2,203,4,23,1091
42091205401,2315,1496,114,94,2,485,0,14,819
42091205402,4794,3766,224,197,2,371,0,26,1028
42091205501,3846,2547,278,635,3,186,1,15,1299
42091205502,3812,2935,127,103,0,412,0,48,877
42091205503,5610,3697,193,627,1,823,1,40,1913
42091205600,4492,3752,154,153,0,194,1,27,740
42091205700,5015,3209,907,487,2,160,3,35,1806
42091205805,3420,2259,259,147,0,666,0,10,1161
42091205806,2213,1420,185,169,2,317,0,10,793
42091205807,1826,953,186,185,4,398,0,15,873
42091205808,5586,3778,251,347,2,982,1,25,1808
42091205809,2767,2009,136,134,4,359,0,18,758
42091205810,4179,1892,225,325,6,1580,0,25,2287
42091205811,2525,1578,148,225,0,441,3,12,947
42091205903,2670,2222,80,80,0,174,0,12,448
42091205904,2331,1838,103,130,3,149,0,8,493
42091205905,3892,1904,274,420,9,1107,0,19,1988
42091205906,2192,1444,191,242,0,209,0,6,748
42091206004,5626,3725,348,837,5,486,1,17,1901
42091206005,4502,3577,304,127,1,326,1,10,925
42091206006,3356,3028,73,85,0,92,0,2,328
42091206007,6093,3793,231,225,14,1630,1,31,2300
42091206104,3938,2969,162,169,1,434,1,24,969
42091206105,6187,4893,172,202,5,714,0,13,1294
42091206106,4524,3841,144,165,3,184,1,26,683
42091206107,6775,4575,225,285,8,1382,0,32,2200
42091206108,2667,2091,71,90,3,274,0,18,576
42091206201,2727,2195,156,161,3,52,1,14,532
42091206202,2213,1695,133,186,3,37,0,11,518
42091206300,5043,4191,257,200,5,205,0,32,852
42091206400,4002,3169,182,182,4,286,0,29,833
42091206501,4147,3322,179,160,3,300,0,15,825
42091206502,4812,3983,209,212,0,162,1,37,829
42091206600,1296,1098,64,55,2,7,0,0,198
42091206703,4239,3705,138,92,0,159,0,6,534
42091206704,6980,5997,166,188,6,354,1,12,983
42091206801,7192,5583,184,274,0,920,0,22,1609
42091206802,3125,2494,150,71,0,287,2,10,631
42091206901,4421,3069,209,306,5,677,2,30,1352
42091206904,6018,4576,270,303,12,645,0,28,1442
42091206905,4632,3571,127,261,4,486,0,29,1061
42091206906,2938,2476,82,98,3,172,5,6,462
42091207001,8059,6724,295,258,9,496,0,23,1335
42091207003,3178,2755,79,89,0,153,4,2,423
42091207004,4659,3931,188,161,0,250,1,14,728
42091207101,6133,5253,185,79,9,442,0,13,880
42091207103,4093,3423,184,133,3,185,0,10,670
42091207104,3033,2729,94,38,2,100,0,3,304
42091207201,2566,1918,309,90,1,149,0,3,648
42091207202,4625,3281,711,190,3,268,1,17,1344
42091207300,2729,1943,365,140,16,125,0,8,786
42091207400,3035,2726,92,40,5,52,2,7,309
42091207500,3172,2923,89,22,0,20,0,9,249
42091207600,4010,3704,110,41,8,19,0,16,306
42091207800,8350,7374,327,191,7,178,2,25,976
42091207900,2496,2246,104,47,1,12,0,5,250
42091208000,3889,3181,206,140,2,193,0,17,708
42091208100,3166,2728,192,57,1,38,0,3,438
42091208201,2180,2079,42,8,4,7,1,4,101
42091208203,5050,4440,210,93,0,99,0,18,610
42091208204,3355,2997,111,41,8,68,0,9,358
42091208301,2523,2344,64,13,1,10,0,9,179
42091208303,5143,4675,147,88,2,83,2,10,468
42091208304,5307,4358,271,275,0,159,0,34,949
42091208400,3703,3405,94,45,5,31,2,21,298
42091208500,4830,4279,177,116,4,54,0,29,551
42091208601,7658,6505,208,255,0,414,3,12,1153
42091208603,6555,5465,220,303,4,281,0,15,1090
42091208604,6245,4988,191,270,5,534,0,18,1257
42091208702,3471,2996,133,150,3,42,0,8,475
42091208703,3936,3328,194,213,2,49,0,9,608
42091208704,4810,3122,322,935,0,134,1,19,1688
42091208801,1512,808,194,381,0,22,1,12,704
42091208802,3142,2156,291,413,7,34,5,17,986
42091208901,3702,2384,393,667,5,45,0,21,1318
42091208903,3017,1666,318,749,3,37,0,25,1351
42091208904,3425,1601,466,1015,7,39,0,30,1824
42091208905,2791,2130,225,253,0,32,3,6,661
42091208906,4194,2382,468,966,5,34,2,30,1812
42091209000,1650,802,223,447,0,7,0,8,848
42091209100,5870,4602,289,555,13,138,0,25,1268
42091209201,1584,1264,85,110,4,15,1,7,320
42091209202,2214,1662,148,243,0,11,2,8,552
42091210100,4384,3547,264,287,0,127,0,11,837
42091210200,2902,2350,69,285,5,95,0,15,552
42091210300,4002,3352,159,261,1,100,2,11,650
42091210400,4946,3686,156,702,3,173,1,9,1260
42091210500,4580,3323,202,665,2,160,1,28,1257
42091210600,4256,3087,159,437,3,419,0,8,1169
42091210700,6048,4738,214,134,6,758,6,6,1310
42091980000,0,0,0,0,0,0,0,0,0
42091980100,3170,802,406,1936,10,16,0,0,2368
42091980200,1,0,1,0,0,0,0,0,1
42091980300,11,4,3,0,0,2,1,0,7
42093050100,3754,3611,40,5,8,6,0,2,143
42093050200,4533,3645,163,186,6,413,0,7,888
42093050300,4239,3562,211,93,8,181,0,9,677
42093050400,5610,5287,73,36,5,68,0,4,323
42095010100,4136,2389,975,349,5,194,0,44,1747
42095010200,3904,3279,285,98,1,147,1,17,625
42095010300,3237,2416,495,143,3,66,0,7,821
42095010400,5396,3711,936,398,2,122,0,43,1685
42095010500,4217,931,2714,417,0,42,1,8,3286
42095010601,4059,2564,1044,213,6,81,2,30,1495
42095010602,3581,2092,1064,236,5,43,0,8,1489
42095010700,4983,3083,1220,317,3,88,3,33,1900
42095010800,2560,1811,476,135,2,31,0,20,749
42095010900,3689,1068,1931,435,3,67,2,32,2621
42095011000,3223,1339,1099,323,2,312,7,49,1884
42095011100,2968,1901,144,157,0,444,1,305,1067
42095011200,5797,1523,3312,625,8,176,0,29,4274
42095011300,4256,1620,1893,339,0,253,1,22,2636
42095014100,5917,4640,504,288,0,211,0,24,1277
42095014200,6106,2389,2151,1108,15,111,5,44,3717
42095014300,4441,1801,1532,805,11,44,3,40,2640
42095014400,2679,1622,523,373,4,42,1,15,1057
42095014500,3334,1256,982,744,6,144,0,5,2078
42095014600,3075,1194,859,734,6,47,0,21,1881
42095014700,2575,1213,693,425,3,53,0,24,1362
42095015202,3208,2783,233,48,1,24,0,3,425
42095015203,3560,2855,447,69,6,11,0,10,705
42095015300,5148,4661,205,61,12,48,0,7,487
42095015400,2921,2644,120,25,3,17,0,17,277
42095015500,6263,5737,216,66,6,17,0,10,526
42095015600,3510,3080,204,54,3,38,0,7,430
42095015700,2820,2507,127,58,8,26,0,0,313
42095015801,5260,4765,220,30,1,79,0,8,495
42095015802,3222,2922,132,30,0,31,0,5,300
42095015901,5591,5141,201,36,6,33,2,20,450
42095015902,3954,3639,150,28,1,18,0,6,315
42095016001,6180,5796,179,34,1,16,3,10,384
42095016002,4594,4196,169,45,2,23,1,14,398
42095016100,2067,1824,135,21,0,9,0,9,243
42095016201,5884,4894,577,149,2,56,1,13,990
42095016202,4511,3837,388,130,0,28,0,19,674
42095016300,2971,2471,312,71,1,21,1,8,500
42095016400,5456,4586,382,186,0,119,0,40,870
42095016500,5013,4403,359,65,0,45,0,11,610
42095016600,2808,2113,369,158,3,14,0,9,695
42095016700,8127,6882,492,178,5,325,3,35,1245
42095016801,4216,3498,421,66,8,43,2,15,718
42095016802,1837,1659,101,12,1,12,0,9,178
42095016901,3388,2953,204,28,0,101,0,8,435
42095016902,3534,2655,253,134,5,349,0,15,879
42095017000,2122,1799,136,58,2,50,1,5,323
42095017101,6598,4367,764,624,5,521,0,29,2231
42095017103,5690,4078,628,478,2,281,2,32,1612
42095017104,3721,2828,284,284,9,188,2,13,893
42095017200,6903,4212,1360,741,6,192,2,30,2691
42095017300,2593,1882,402,167,0,47,2,4,711
42095017402,3992,3215,478,145,3,25,0,7,777
42095017403,6389,4454,729,470,0,499,0,25,1935
42095017404,2146,1552,187,197,3,138,0,9,594
42095017501,4326,3056,505,250,1,332,0,11,1270
42095017502,5529,4153,525,382,3,249,2,20,1376
42095017603,3877,2755,672,203,6,80,4,11,1122
42095017604,4545,3406,535,255,8,136,0,48,1139
42095017605,4343,2802,492,455,6,405,0,40,1541
42095017606,4828,3595,585,240,2,265,1,10,1233
42095017607,8278,5955,914,478,7,643,3,38,2323
42095017702,2370,1919,232,76,0,63,2,3,451
42095017703,3013,2293,252,125,3,246,1,7,720
42095017704,6400,4950,518,207,1,492,0,34,1450
42095017800,2875,1323,963,367,3,54,7,26,1552
42095017901,3920,3297,327,55,3,75,1,12,623
42095017902,2212,1915,151,8,1,39,0,5,297
42095018001,4136,3695,208,36,1,46,3,12,441
42095018003,3225,2702,181,58,0,170,0,11,523
42095018004,3733,3162,291,40,0,129,0,12,571
42095018100,6954,5664,401,396,9,201,0,44,1290
42095018200,3434,2919,229,122,4,43,0,10,515
42095018300,4623,4082,220,68,3,62,2,11,541
42097080100,4436,4224,81,31,5,17,0,7,212
42097080200,6833,6472,76,49,7,35,0,10,361
42097080301,2268,1961,144,46,8,31,1,11,307
42097080302,4373,3586,401,145,11,19,4,19,787
42097080400,3241,3043,60,25,11,7,4,4,198
42097080500,3832,3541,132,52,7,7,1,19,291
42097080600,3911,3441,269,37,4,18,4,11,470
42097080700,3239,2988,88,34,5,54,0,8,251
42097080800,6884,6552,108,23,3,43,0,11,332
42097080900,3060,2925,51,6,0,11,0,5,135
42097081000,3039,2710,144,65,4,14,0,2,329
42097081100,2686,2357,132,49,7,29,0,9,329
42097081200,5841,4192,393,1118,7,19,0,14,1649
42097081300,2286,2081,93,31,2,5,0,0,205
42097081400,2012,1858,68,25,2,0,0,1,154
42097081500,2118,1831,134,64,1,12,0,7,287
42097081600,2521,2154,135,81,6,11,0,0,367
42097081700,2303,1829,200,130,3,18,0,8,474
42097081800,3350,3165,57,6,1,15,2,8,185
42097081900,5882,5621,91,17,0,19,0,8,261
42097082000,3715,2878,498,147,6,5,4,2,837
42097082100,2374,1905,281,87,0,5,1,13,469
42097082200,3630,2909,420,104,3,15,1,9,721
42097082300,5055,4889,37,10,5,12,1,10,166
42097082400,2758,2577,58,10,2,23,1,3,181
42099030100,5031,4703,89,37,4,27,0,32,328
42099030201,2565,2397,57,25,2,0,0,3,168
42099030202,5065,4677,108,34,0,8,0,27,388
42099030301,4575,4178,116,41,5,30,0,18,397
42099030302,4559,4298,70,11,4,15,0,4,261
42099030400,4852,4453,131,50,14,14,0,4,399
42099030501,5301,4982,72,17,8,11,2,19,319
42099030502,6046,5707,102,48,4,17,0,4,339
42099030601,4712,4466,86,16,9,8,0,15,246
42099030602,3136,2977,81,10,0,9,1,13,159
42101000101,2329,1791,130,105,4,200,0,8,538
42101000102,3511,2719,208,132,6,286,1,25,792
42101000200,3367,784,125,251,7,2068,0,15,2583
42101000300,4501,3100,279,300,0,641,3,14,1401
42101000401,3123,1754,167,249,5,796,0,14,1369
42101000403,1139,787,67,78,1,169,0,0,352
42101000404,3822,2988,161,119,4,432,0,11,834
42101000500,3614,1651,340,829,2,693,0,12,1963
42101000600,2317,1558,165,108,4,332,0,29,759
42101000701,2722,1904,160,161,4,398,1,10,818
42101000702,2012,1308,144,87,1,394,0,8,704
42101000801,1748,1380,78,58,6,146,0,13,368
42101000803,4463,3521,266,112,2,417,0,39,942
42101000805,2587,1903,167,105,2,271,0,52,684
42101000806,2702,2066,150,89,3,275,0,15,636
42101000901,2409,1544,200,297,3,263,0,20,865
42101000902,2842,1822,97,146,5,668,0,5,1020
42101001001,2993,2536,93,70,3,191,0,14,457
42101001002,4651,3701,250,263,5,271,0,17,950
42101001101,4297,2811,289,601,10,339,0,48,1486
42101001102,2800,2121,198,105,0,237,3,19,679
42101001201,3953,3143,222,76,4,288,0,30,810
42101001203,1827,1449,94,48,0,155,0,11,378
42101001204,4014,3100,207,170,0,354,1,21,914
42101001301,1671,1000,76,387,6,122,0,4,671
42101001302,5102,3448,246,582,0,541,0,21,1654
42101001400,4736,3239,222,697,5,333,0,28,1497
42101001500,3338,2235,199,399,0,342,0,19,1103
42101001600,2665,2118,178,87,1,134,0,18,547
42101001700,2997,2385,158,109,4,150,3,34,612
42101001800,3476,2373,187,446,5,250,0,32,1103
42101001900,4083,2460,250,812,8,291,0,39,1623
42101002000,2537,880,166,1251,7,130,0,19,1657
42101002100,2462,1063,171,973,6,135,0,7,1399
42101002200,2750,1247,258,939,1,184,0,13,1503
42101002300,3043,1974,385,135,2,393,0,23,1069
42101002400,5624,3361,764,353,10,908,0,34,2263
42101002500,4393,2316,399,1054,4,406,0,27,2077
42101002701,4200,1861,858,495,4,796,2,33,2339
42101002702,4268,3497,237,119,4,211,0,15,771
42101002801,4364,1648,1285,203,2,1069,0,42,2716
42101002802,5375,3603,748,69,3,790,0,29,1772
42101002900,4351,3487,316,86,1,259,0,16,864
42101003001,4188,1381,365,573,0,1721,1,12,2807
42101003002,3529,1512,399,1153,4,298,0,11,2017
42101003100,5089,1693,406,2348,8,395,0,27,3396
42101003200,4511,987,388,2727,15,170,1,45,3524
42101003300,6307,1658,469,3444,31,447,2,23,4649
42101003600,6571,1184,435,3325,6,1403,3,15,5387
42101003701,6106,1212,458,3188,18,950,1,51,4894
42101003702,3678,1021,278,1403,6,834,0,1,2657
42101003800,3820,3225,166,69,0,260,1,13,595
42101003901,6219,3899,526,470,4,1082,0,34,2320
42101003902,5697,5048,211,55,6,202,1,20,649
42101004001,4477,3247,440,105,0,565,2,14,1230
42101004002,5359,3970,502,49,0,682,6,20,1389
42101004101,7166,1788,1982,923,7,2277,0,22,5378
42101004103,4273,1080,1209,213,3,1630,0,15,3193
42101004104,4561,1534,1007,259,5,1614,1,24,3027
42101004201,5287,3933,505,188,2,516,0,22,1354
42101004202,5261,3284,478,291,1,1033,2,14,1977
42101005400,1191,145,51,866,6,76,1,3,1046
42101005500,5498,403,187,4468,5,285,0,39,5095
42101005600,1061,71,68,840,4,36,0,8,990
42101006000,6607,631,197,5003,9,613,0,25,5976
42101006100,3380,273,105,2561,7,346,2,5,3107
42101006200,4498,214,210,3718,2,230,0,18,4284
42101006300,4022,134,365,2884,4,496,0,4,3888
42101006400,4549,174,148,3668,9,436,0,8,4375
42101006500,4663,63,129,4260,10,50,0,23,4600
42101006600,3592,88,270,2738,7,353,3,18,3504
42101006700,7450,443,263,5741,16,711,0,35,7007
42101007000,3892,72,140,3502,16,24,6,20,3820
42101007101,2437,121,68,2121,6,34,0,20,2316
42101007102,4674,114,147,4202,9,18,0,23,4560
42101007200,4502,120,121,4067,12,36,0,32,4382
42101007300,3207,570,153,2272,2,70,0,15,2637
42101007400,4225,508,176,3202,4,144,7,20,3717
42101007700,2302,1009,139,517,6,521,2,19,1293
42101007800,4358,2551,339,951,2,282,1,19,1807
42101007900,4722,2618,321,1065,4,401,1,28,2104
42101008000,3942,965,183,2460,8,94,2,41,2977
42101008101,2715,103,116,2350,9,20,0,20,2612
42101008102,5034,135,143,4473,17,52,4,33,4899
42101008200,6935,104,165,6315,39,32,1,66,6831
42101008301,4310,286,123,3620,11,97,2,32,4024
42101008302,4998,170,209,4285,11,120,4,25,4828
42101008400,4611,97,175,4061,22,110,0,18,4514
42101008500,6773,694,239,5285,30,231,8,39,6079
42101008601,3212,1562,243,815,6,388,0,37,1650
42101008602,3452,859,222,1914,5,281,0,9,2593
42101008701,4347,2183,314,550,4,1040,0,39,2164
42101008702,3441,1644,216,323,0,1048,0,41,1797
42101008801,1600,570,136,137,0,689,2,10,1030
42101008802,6580,2673,588,795,8,2132,4,42,3907
42101009000,7694,4668,562,722,5,1535,0,25,3026
42101009100,3934,1457,220,1161,3,921,2,25,2477
42101009200,3974,841,249,2133,6,560,4,18,3133
42101009300,4261,189,173,3649,8,53,0,34,4072
42101009400,3766,58,115,3391,1,58,0,17,3708
42101009500,3289,17,72,3047,18,14,0,16,3272
42101009600,4275,69,113,3863,5,58,0,12,4206
42101009801,2206,240,61,1782,0,48,0,6,1966
42101009802,5495,392,151,4706,9,69,0,24,5103
42101010000,4397,262,144,3804,6,55,0,22,4135
42101010100,5640,82,207,5113,12,45,4,37,5558
42101010200,3147,47,95,2894,3,8,0,11,3100
42101010300,2572,59,90,2314,5,19,0,13,2513
42101010400,3573,159,123,3126,6,26,0,14,3414
42101010500,3363,90,107,2939,16,69,5,18,3273
42101010600,1476,81,66,1169,8,92,0,4,1395
42101010700,3479,189,131,2945,10,47,0,14,3290
42101010800,3936,514,165,2913,5,192,6,28,3422
42101010900,2641,643,107,1585,7,201,0,16,1998
42101011000,3378,163,141,2941,4,13,4,11,3215
42101011100,3537,60,132,3223,9,14,0,14,3477
42101011200,5598,44,170,5166,19,30,0,17,5554
42101011300,2834,22,67,2655,5,5,1,7,2812
42101011400,6320,141,157,5720,16,48,0,23,6179
42101011500,4104,227,132,3602,6,20,0,26,3877
42101011700,1893,854,91,613,12,251,2,12,1039
42101011800,5491,213,165,4892,19,28,2,23,5278
42101011900,5016,176,130,4442,6,80,0,16,4840
42101012000,1943,524,107,1023,7,211,0,6,1419
42101012100,2817,625,99,1818,6,128,1,42,2192
42101012201,2893,873,177,1340,6,361,0,21,2020
42101012203,658,273,32,141,0,155,0,1,385
42101012204,3694,632,155,2587,3,149,5,16,3062
42101012501,2935,1657,219,338,0,555,10,23,1278
42101012502,5141,3169,360,562,5,812,0,42,1972
42101013100,1709,417,138,932,2,141,0,9,1292
42101013200,3221,631,259,1847,11,382,0,4,2590
42101013300,4057,2238,333,893,15,312,1,23,1819
42101013401,2971,2442,142,112,0,154,3,9,529
42101013402,3635,2478,390,396,0,229,0,8,1157
42101013500,4252,2726,332,832,2,169,0,17,1526
42101013601,2911,2393,139,75,0,160,0,16,518
42101013602,3776,2977,187,228,7,188,0,35,799
42101013701,2122,948,147,764,0,146,0,9,1174
42101013702,3913,1495,236,1876,9,100,0,9,2418
42101013800,2126,536,146,1294,1,47,0,15,1590
42101013900,2520,537,159,1658,8,59,0,11,1983
42101014000,5456,1905,392,2214,1,628,4,46,3551
42101014100,3088,781,439,1531,0,243,2,9,2307
42101014201,3497,2596,274,219,2,210,2,17,901
42101014202,2309,1623,173,136,4,274,2,12,686
42101014300,1937,1561,117,53,2,124,0,4,376
42101014400,5111,3018,920,595,5,329,3,10,2093
42101014500,2718,640,433,1284,20,261,2,19,2078
42101014600,7477,2810,655,2541,13,1149,86,75,4667
42101014700,4781,1746,336,1901,2,543,29,29,3035
42101014800,1099,53,88,870,7,40,0,0,1046
42101014900,3765,247,188,3142,12,51,0,7,3518
42101015101,2217,68,107,1963,8,14,0,7,2149
42101015102,4154,79,180,3714,7,21,0,17,4075
42101015200,5509,170,286,4779,19,42,0,45,5339
42101015300,7943,3552,560,2875,19,584,41,96,4391
42101015600,1902,489,916,362,6,56,1,6,1413
42101015700,2924,1414,1032,209,0,109,0,25,1510
42101015800,6575,5469,408,120,2,257,5,28,1106
42101016001,2695,2247,174,67,0,87,0,12,448
42101016002,4236,3437,325,114,7,168,2,14,799
42101016100,6583,3903,1107,419,5,781,2,63,2680
42101016200,2078,241,1351,390,3,51,0,17,1837
42101016300,3243,222,2231,525,0,215,1,6,3021
42101016400,4181,80,2451,1510,2,38,7,13,4101
42101016500,2477,48,363,1955,5,19,0,5,2429
42101016600,1838,298,186,1172,2,101,3,8,1540
42101016701,2833,76,145,2514,3,8,1,12,2757
42101016702,2908,152,149,2470,4,50,0,11,2756
42101016800,3565,50,128,3208,16,14,0,27,3515
42101016901,3125,59,120,2838,9,8,4,10,3066
42101016902,5030,48,166,4626,15,23,5,4,4982
42101017000,3126,750,175,1945,4,124,3,20,2376
42101017100,3722,47,158,3409,2,13,3,1,3675
42101017201,2903,30,102,2674,4,10,0,5,2873
42101017202,3729,40,151,3426,2,11,0,5,3689
42101017300,2872,31,115,2594,7,25,0,17,2841
42101017400,2307,36,292,1879,1,19,0,16,2271
42101017500,6711,122,4667,1749,11,56,5,20,6589
42101017601,5027,139,4344,425,0,47,2,11,4888
42101017602,3573,139,2832,519,4,33,0,9,3434
42101017701,3552,301,2098,983,0,93,2,18,3251
42101017702,4582,324,3372,719,0,94,2,25,4258
42101017800,6246,1160,3212,1491,9,164,0,31,5086
42101017900,6152,2202,2315,1163,13,149,2,35,3950
42101018001,2485,1943,298,77,3,60,0,7,542
42101018002,5439,4642,394,125,1,68,0,17,797
42101018300,4326,3928,189,31,0,24,1,18,398
42101018400,2278,2047,96,10,12,10,0,19,231
42101018801,4445,859,2273,1093,8,71,0,25,3586
42101018802,3570,581,1806,1023,9,31,0,16,2989
42101019000,7806,811,4972,1377,16,452,2,61,6995
42101019100,8237,907,5455,742,2,987,0,29,7330
42101019200,7661,667,5164,1403,7,266,0,30,6994
42101019501,4689,166,3925,503,1,34,1,26,4523
42101019502,3494,129,2870,412,4,32,0,10,3365
42101019700,6416,145,4353,1700,8,91,0,22,6271
42101019800,5763,82,3709,1727,3,159,0,20,5681
42101019900,4389,70,2598,1610,7,20,0,2,4319
42101020000,1277,65,139,946,6,68,0,7,1212
42101020101,3750,140,261,3126,19,81,1,21,3610
42101020102,3490,59,228,3055,9,37,3,23,3431
42101020200,4932,125,263,4376,14,9,0,9,4807
42101020300,2786,75,397,2154,9,13,0,38,2711
42101020400,3052,42,172,2699,7,31,0,20,3010
42101020500,2728,51,160,2347,6,57,0,24,2677
42101020600,2043,1013,145,633,2,151,2,22,1030
42101020701,3863,2924,219,351,3,152,5,15,939
42101020702,2464,1521,166,485,0,188,4,2,943
42101020800,2490,1264,165,719,6,176,5,16,1226
42101020900,3165,2448,173,224,4,139,0,13,717
42101021000,5470,4399,294,306,4,204,1,42,1071
42101021100,2656,1976,190,241,4,133,3,6,680
42101021200,2423,1829,113,284,0,87,0,8,594
42101021300,3573,2898,205,238,0,85,0,15,675
42101021400,4217,3345,258,275,9,135,1,21,872
42101021500,4135,3282,189,293,5,164,1,13,853
42101021600,2251,1539,106,318,7,147,0,19,712
42101021700,5783,4292,318,676,10,241,0,37,1491
42101021800,4424,2541,299,1156,5,194,0,19,1883
42101021900,1492,1155,61,117,2,82,0,9,337
42101022000,1446,1132,30,155,0,82,0,8,314
42101023100,1285,1086,55,48,0,41,0,6,199
42101023500,1108,665,63,282,0,41,0,5,443
42101023600,2698,1516,115,831,4,59,1,24,1182
42101023700,4850,1572,210,2675,4,82,0,24,3278
42101023800,4441,1433,236,2426,5,59,2,31,3008
42101023900,1857,550,121,905,4,179,0,15,1307
42101024000,3808,992,205,2240,6,160,6,23,2816
42101024100,1343,251,58,945,5,16,0,6,1092
42101024200,4113,508,195,3174,5,23,2,68,3605
42101024300,3878,446,215,2979,10,50,3,27,3432
42101024400,3152,162,124,2685,8,7,5,22,2990
42101024500,4251,224,203,3623,9,34,0,20,4027
42101024600,2956,172,147,2488,4,25,4,24,2784
42101024700,4489,266,196,3775,18,22,0,44,4223
42101024800,1912,40,63,1731,3,0,0,7,1872
42101024900,3412,49,129,3077,20,24,0,27,3363
42101025200,7267,475,280,6142,28,36,3,50,6792
42101025300,3859,380,135,3048,14,46,0,33,3479
42101025400,4152,420,136,3365,9,41,0,24,3732
42101025500,2667,1044,131,1259,7,47,1,14,1623
42101025600,2609,1303,120,984,4,51,1,16,1306
42101025700,3456,1798,182,1133,9,178,1,16,1658
42101025800,1663,58,64,1454,4,11,0,4,1605
42101025900,4674,76,97,4302,14,15,0,53,4598
42101026000,2850,32,68,2615,3,27,0,13,2818
42101026100,3060,60,69,2785,15,14,0,16,3000
42101026200,4076,64,95,3791,9,9,2,22,4012
42101026301,3726,46,84,3463,5,9,0,40,3680
42101026302,5353,63,149,4916,18,38,2,27,5290
42101026400,5199,55,102,4829,11,10,0,23,5144
42101026500,4285,40,95,3981,17,0,0,15,4245
42101026600,6409,49,134,6013,10,26,0,24,6360
42101026700,6617,72,227,6125,10,25,0,35,6545
42101026800,4651,221,305,3813,9,104,1,17,4430
42101026900,2231,314,188,1595,5,72,1,11,1917
42101027000,2270,202,130,1724,5,115,0,16,2068
42101027100,2353,94,206,1451,2,542,0,8,2259
42101027200,4256,151,402,3259,11,291,0,36,4105
42101027300,5951,220,1219,3041,10,1292,0,42,5731
42101027401,3298,151,567,1712,1,781,0,24,3147
42101027402,6499,317,1237,3804,12,925,0,35,6182
42101027500,4503,256,608,2954,12,528,0,50,4247
42101027600,3546,102,195,3105,10,29,0,33,3444
42101027700,4918,65,162,4360,17,196,2,16,4853
42101027800,4655,68,169,4184,9,57,4,24,4587
42101027901,3796,36,124,3449,17,13,0,33,3760
42101027902,3572,902,357,1978,17,201,0,23,2670
42101028000,4180,51,260,3711,5,17,1,16,4129
42101028100,3362,80,191,2931,9,44,0,14,3282
42101028200,4696,158,305,3846,8,256,3,20,4538
42101028300,6294,144,566,4932,1,410,7,47,6150
42101028400,3811,49,977,2606,13,52,0,33,3762
42101028500,2303,68,908,1022,1,250,0,10,2235
42101028600,6668,187,2690,3102,6,540,0,26,6481
42101028700,2371,58,1762,461,2,36,0,7,2313
42101028800,4251,249,2701,913,7,271,0,31,4002
42101028901,3932,232,2653,769,0,186,1,21,3700
42101028902,6047,413,3644,1469,2,410,0,31,5634
42101029000,6195,336,2269,2418,8,996,0,43,5859
42101029100,4826,253,1676,1660,5,1091,0,8,4573
42101029200,4205,449,1971,1353,2,303,0,9,3756
42101029300,3026,609,1217,1017,14,42,5,32,2417
42101029400,3308,531,1292,1260,10,69,0,21,2777
42101029800,4847,931,1802,1813,14,106,3,27,3916
42101029900,4617,637,1749,1981,11,82,0,26,3980
42101030000,7402,870,2032,3972,28,163,0,55,6532
42101030100,6215,1012,1666,3130,18,97,0,52,5203
42101030200,7431,1019,2499,3485,28,201,2,46,6412
42101030501,5450,490,1538,2807,9,413,2,42,4960
42101030502,5847,707,1455,3042,15,428,5,19,5140
42101030600,7142,2084,1837,2522,5,466,4,36,5058
42101030700,3743,1227,824,1310,1,212,0,40,2516
42101030800,5138,1719,952,1218,20,952,0,55,3419
42101030900,4137,687,992,1643,0,641,0,54,3450
42101031000,7266,1654,1670,1559,10,1908,23,144,5612
42101031101,5194,680,1584,2066,4,591,0,112,4514
42101031102,4618,481,1398,2225,8,334,0,59,4137
42101031200,4804,622,1382,2120,12,459,0,65,4182
42101031300,7416,1286,2145,1660,20,1703,6,184,6130
42101031401,7456,1388,2216,1226,13,1839,2,342,6068
42101031402,5956,1166,1504,711,3,2115,0,184,4790
42101031501,7381,3061,1527,630,8,1753,0,157,4320
42101031502,4746,1681,971,457,3,1167,0,269,3065
42101031600,6729,2417,1692,868,8,1353,0,152,4312
42101031700,6597,1808,2189,1511,10,707,4,106,4789
42101031800,4093,635,1508,1507,9,242,2,48,3458
42101031900,5133,1495,1730,1568,13,158,3,29,3638
42101032000,7327,2721,2393,1666,7,247,1,51,4606
42101032100,3985,1393,1238,1054,13,125,1,23,2592
42101032300,4078,1333,1255,1168,11,69,0,46,2745
42101032500,6210,2610,1527,1607,14,168,4,41,3600
42101032600,7761,3386,1993,1610,11,402,2,82,4375
42101032900,4431,1904,991,1113,9,175,0,41,2527
42101033000,8213,3295,2146,2009,11,337,9,97,4918
42101033101,5398,2963,909,674,0,527,0,91,2435
42101033102,4478,2756,809,533,12,152,0,53,1722
42101033200,3292,1289,523,247,6,947,0,154,2003
42101033300,4339,2763,437,532,3,425,1,70,1576
42101033400,5447,2226,701,796,5,1289,2,153,3221
42101033500,4214,1580,657,556,2,1079,1,117,2634
42101033600,8155,4176,1045,1070,6,1079,0,243,3979
42101033701,5672,3181,598,613,0,777,3,109,2491
42101033702,5679,3023,590,568,10,1089,0,107,2656
42101033800,6285,3444,978,959,7,518,0,117,2841
42101033900,3106,1942,415,490,0,151,0,19,1164
42101034000,2971,2015,330,204,2,281,0,28,956
42101034100,5829,4364,547,491,3,218,0,24,1465
42101034200,3732,2684,236,438,3,270,0,21,1048
42101034400,7814,5293,483,400,8,1447,0,24,2521
42101034501,3783,1974,340,633,4,647,1,40,1809
42101034502,5928,3056,407,1148,10,920,0,39,2872
42101034600,2840,1136,360,786,3,458,0,17,1704
42101034701,6736,3366,798,963,18,1266,2,90,3370
42101034702,3896,2695,390,366,2,295,0,39,1201
42101034801,4553,3561,411,332,4,99,1,20,992
42101034802,5570,2914,773,1400,10,197,0,50,2656
42101034803,4516,3323,413,358,8,236,1,31,1193
42101034900,5740,2644,1043,1323,11,435,1,36,3096
42101035100,4268,3492,226,284,4,126,1,20,776
42101035200,4871,3890,288,252,2,297,3,34,981
42101035301,5260,4081,451,317,6,203,1,26,1179
42101035302,4719,3355,441,491,13,210,0,8,1364
42101035500,8239,5105,592,473,6,1681,0,52,3134
42101035601,5794,4102,325,145,5,1014,0,29,1692
42101035602,3693,2197,195,213,3,987,0,19,1496
42101035701,5528,2454,271,257,7,2060,1,36,3074
42101035702,5181,3700,179,131,1,822,2,22,1481
42101035800,6282,4280,336,338,10,1063,1,28,2002
42101035900,5361,3691,355,215,7,918,3,30,1670
42101036000,3247,1634,179,285,6,1044,2,9,1613
42101036100,4029,2648,483,601,8,126,0,28,1381
42101036201,5093,3928,461,402,16,136,4,24,1165
42101036202,6191,4722,457,528,4,298,0,20,1469
42101036203,5134,4187,364,199,3,259,1,14,947
42101036301,3843,2613,354,226,7,517,0,27,1230
42101036302,3712,2128,603,662,3,170,0,17,1584
42101036303,6695,5565,455,186,5,242,6,16,1130
42101036400,971,721,69,126,2,29,0,3,250
42101036501,5698,4008,353,501,5,580,0,29,1690
42101036502,4130,3405,248,135,7,187,0,11,725
42101036600,2171,1539,159,128,4,251,0,10,632
42101036700,3856,2691,257,363,2,322,0,27,1165
42101036901,4,2,2,0,0,0,0,0,2
42101036902,6598,2645,539,766,8,2258,3,66,3953
42101037200,4524,2576,377,240,1,1211,0,22,1948
42101037300,5913,4464,265,573,11,521,0,27,1449
42101037500,4074,1990,199,1539,0,181,1,30,2084
42101037600,3664,1609,422,590,6,845,0,20,2055
42101037700,4583,1381,809,1953,13,265,1,32,3202
42101037800,2389,1848,233,100,11,91,0,13,541
42101037900,5313,4575,338,109,1,115,2,20,738
42101038000,2502,1241,816,285,3,50,1,18,1261
42101038100,753,323,218,181,1,7,0,5,430
42101038200,2801,1328,929,395,3,47,1,6,1473
42101038301,2663,206,1815,592,0,8,0,10,2457
42101038400,2411,1886,108,204,0,104,0,14,525
42101038500,1855,1579,82,65,2,63,0,10,276
42101038600,1338,1034,67,122,0,55,0,5,304
42101038700,2249,1725,138,259,2,44,1,41,524
42101038800,3883,2249,178,1061,2,103,5,31,1634
42101038900,2988,110,79,2673,8,19,2,11,2878
42101039001,3979,401,1191,2139,5,112,6,31,3578
42101039002,4421,395,1493,2238,9,156,0,15,4026
42101039100,2577,63,109,2267,7,12,1,27,2514
42101980001,3,3,0,0,0,0,0,0,0
42101980002,12,2,6,2,0,2,0,0,10
42101980003,21,0,0,19,0,0,0,0,21
42101980100,52,37,3,9,0,0,0,0,15
42101980200,336,274,23,32,2,3,0,0,62
42101980300,3,2,0,0,0,0,0,0,1
42101980400,0,0,0,0,0,0,0,0,0
42101980500,2,0,2,0,0,0,0,0,2
42101980600,2,0,2,0,0,0,0,0,2
42101980701,0,0,0,0,0,0,0,0,0
42101980702,9,0,4,4,0,0,0,0,9
42101980800,13,4,3,3,0,0,0,0,9
42101980901,44,4,6,25,0,6,0,0,40
42101980902,0,0,0,0,0,0,0,0,0
42101980903,6,0,2,3,0,0,0,0,6
42101980904,1,0,0,0,0,0,0,0,1
42101980905,0,0,0,0,0,0,0,0,0
42101980906,0,0,0,0,0,0,0,0,0
42101989100,3688,329,619,2690,0,31,0,0,3359
42101989200,3,1,1,1,0,0,0,0,2
42101989300,65,24,14,20,0,1,0,0,41
42103950102,2528,2209,182,22,5,9,0,6,319
42103950103,2362,1936,219,25,5,55,1,8,426
42103950104,2537,2202,168,29,8,42,0,1,335
42103950202,1532,1350,96,12,0,8,0,4,182
42103950203,1652,1473,94,17,1,12,1,1,179
42103950204,1888,1635,129,36,5,19,0,9,253
42103950302,761,708,24,3,0,4,0,0,53
42103950303,1467,1335,76,17,0,9,1,0,132
42103950304,978,846,60,24,0,4,0,8,132
42103950501,1619,1276,197,58,10,18,0,2,343
42103950503,1884,1590,177,47,4,27,0,6,294
42103950504,1912,1609,183,40,0,32,0,2,303
42103950601,1523,1305,95,24,10,45,0,4,218
42103950603,1103,941,105,3,2,24,0,2,162
42103950606,6089,5047,570,150,12,60,3,27,1042
42103950607,2797,2095,400,100,1,57,0,14,702
42103950608,3604,2915,349,110,10,44,0,10,689
42103950701,3751,3122,367,87,5,25,3,7,629
42103950702,3702,3039,348,78,6,38,0,16,663
42103950803,1430,879,281,135,7,18,1,6,551
42103950804,3727,1833,916,720,4,74,1,26,1894
42103950805,2903,1321,696,652,6,86,0,29,1582
42103950806,2783,1213,722,590,8,99,2,37,1570
42103950901,2512,2195,167,15,9,21,0,6,317
42103950902,1491,1301,98,33,3,11,1,3,190
42105950101,2240,2175,16,4,0,4,0,4,65
42105950102,2109,1988,38,3,3,5,0,18,121
42105950200,3091,2934,45,6,11,4,0,0,157
42105950300,4157,3810,89,15,8,42,0,17,347
42105950401,1099,1034,30,4,0,2,0,0,65
42105950402,1694,1632,11,0,1,8,0,5,62
42105950500,2006,1921,18,11,2,4,0,8,85
42107000100,5007,4643,205,24,3,15,0,5,364
42107000200,2471,1635,688,35,0,33,0,8,836
42107000300,5295,4952,203,24,0,15,0,6,343
42107000400,5781,3285,539,1882,3,21,0,2,2496
42107000500,3499,2733,581,66,4,15,0,10,766
42107000601,3216,1928,1125,62,1,11,0,11,1288
42107000602,1027,736,242,32,0,0,0,3,291
42107000700,3364,2956,277,25,4,9,0,9,408
42107000800,3860,3527,162,38,3,40,0,2,333
42107000901,3396,3199,87,31,3,5,0,6,197
42107000902,3579,2563,248,712,2,14,0,3,1016
42107001000,2471,2297,70,23,3,7,0,4,174
42107001100,2238,2165,28,8,0,7,1,0,73
42107001200,4198,4073,39,8,0,12,0,23,125
42107001300,2974,2827,34,19,2,0,0,6,147
42107001400,2112,1992,54,16,0,7,0,0,120
42107001500,4370,3808,276,90,5,33,0,7,562
42107001600,3877,3720,58,14,0,6,0,10,157
42107001700,3248,2964,101,57,1,33,0,6,284
42107001800,1980,1761,73,51,4,18,0,4,219
42107001901,1085,889,67,64,4,10,1,1,196
42107001902,3700,2884,335,248,6,15,0,10,816
42107002000,3333,2638,366,137,8,20,2,21,695
42107002100,1431,1320,53,18,0,9,4,0,111
42107002200,2669,2483,79,17,6,12,0,12,186
42107002300,2745,2499,98,30,0,22,0,3,246
42107002400,2227,2064,74,21,8,0,0,6,163
42107002500,2063,1977,40,8,4,0,0,5,86
42107002600,4003,3409,350,47,5,33,2,6,594
42107002700,2913,2477,260,58,1,10,0,4,436
42107002800,2426,2129,159,18,5,7,0,6,297
42107002900,5283,5056,82,17,6,24,0,16,227
42107003000,5417,5046,143,31,18,51,0,4,371
42107003100,3000,2769,73,25,0,51,0,10,231
42107003200,5785,5354,158,45,6,74,0,7,431
42107003300,5236,4788,165,58,10,37,3,11,448
42107003400,3515,3293,100,19,7,9,0,9,222
42107003500,5213,4894,134,15,5,34,0,3,319
42107003600,3130,2999,47,3,10,2,0,1,131
42107003700,3847,3660,96,8,0,10,0,7,187
42107003800,2049,1925,54,7,1,9,0,2,124
42107003900,4016,3875,41,4,7,8,0,18,141
42109070100,5798,5308,204,69,7,93,1,9,490
42109070200,7689,7130,183,98,0,38,1,7,559
42109070300,5951,5647,67,34,4,8,2,8,304
42109070400,5556,5384,73,14,0,12,3,3,172
42109070500,3650,3525,27,10,4,7,2,14,125
42109070600,5379,5163,54,28,1,10,0,15,216
42109070701,3638,3147,231,95,2,59,0,2,491
42109980705,2075,1688,138,156,14,69,2,0,387
42111020101,1936,1860,26,6,1,9,0,4,76
42111020102,5011,4819,35,6,3,12,0,10,192
42111020200,4416,4246,39,6,0,6,0,7,170
42111020300,3941,3669,68,24,8,8,0,1,272
42111020400,3453,3320,26,5,3,3,3,4,133
42111020500,2768,2641,14,7,1,0,2,4,127
42111020601,2514,2409,23,14,0,5,0,3,105
42111020602,3098,2950,39,5,2,6,0,4,148
42111020700,2882,2755,33,3,3,6,0,20,127
42111020801,2899,2752,49,10,5,14,0,0,147
42111020802,3465,2047,216,1157,0,14,0,6,1418
42111020900,5719,4880,170,511,10,14,0,0,839
42111021000,3988,3710,71,39,2,49,0,12,278
42111021100,2060,1882,47,22,4,11,0,6,178
42111021200,2676,2584,21,4,2,3,0,5,92
42111021300,3329,3209,22,5,0,4,0,8,120
42111021400,4382,4233,50,14,2,8,0,13,149
42111021500,2562,2501,6,2,0,2,0,1,61
42111021600,2070,1986,8,4,0,3,0,0,84
42111021700,2969,2891,11,2,0,5,0,3,78
42111021800,3470,3336,22,13,3,4,2,7,134
42111021902,2190,2094,31,0,0,5,0,6,96
42111021903,1348,1315,9,1,0,0,0,0,33
42111021904,983,955,1,3,1,3,0,2,28
42113960101,1336,1137,59,70,1,5,0,10,199
42113960102,1932,1824,15,5,4,6,0,4,108
42113960201,1571,1485,19,2,2,6,0,5,86
42113960202,1001,960,12,0,2,0,0,10,41
42115032000,2849,2699,44,2,3,7,0,6,150
42115032100,3476,3252,43,6,7,8,0,18,224
42115032200,3509,3246,95,20,10,10,0,5,263
42115032300,3432,3151,84,9,2,13,0,6,281
42115032401,2151,1981,49,8,14,3,0,5,170
42115032402,1868,1778,23,2,6,4,0,3,90
42115032500,3855,3626,55,14,4,17,0,6,229
42115032600,3926,3673,81,28,6,16,0,12,253
42115032700,3329,3079,120,10,3,5,0,7,250
42115032800,4559,4255,98,19,3,6,0,26,304
42115032901,3700,3483,77,5,1,23,0,1,217
42115032902,1780,1576,78,15,0,23,0,3,204
42117950100,4186,3932,49,19,3,9,1,9,254
42117950200,3623,3375,58,19,9,0,0,5,248
42117950300,3695,3503,43,11,2,8,4,4,192
42117950400,4089,3882,35,7,0,9,0,2,207
42117950500,4614,4349,58,14,23,12,0,15,265
42117950600,5008,4393,153,194,8,46,0,15,615
42117950700,5441,5053,116,8,9,19,0,21,388
42117950800,3469,3204,55,22,6,62,1,8,265
42117950900,3949,3749,45,11,10,15,1,13,200
42117951000,2971,2817,28,16,3,9,0,7,154
42119090102,5495,5094,152,75,7,16,0,5,401
42119090201,1999,1931,31,3,1,2,0,1,68
42119090202,4264,4073,58,33,6,10,1,11,191
42119090300,3583,3353,50,56,3,8,0,18,230
42119090400,4185,3964,52,26,1,16,0,19,221
42119090502,7040,6287,293,135,11,100,0,19,753
42119090600,5914,5093,262,119,5,172,6,10,821
42119090700,3329,2812,164,115,7,93,1,16,517
42119980101,3005,807,589,1539,30,37,0,0,2198
42119980501,547,184,128,213,7,7,0,1,363
42119980800,3320,2452,221,145,4,353,0,12,868
42121200000,3191,3018,28,10,1,6,0,12,173
42121200100,3580,3437,27,2,3,1,3,5,143
42121200201,3376,3183,31,25,4,3,2,12,193
42121200202,1861,1778,16,6,0,2,0,0,83
42121200300,1606,1427,18,33,1,2,0,2,179
42121200400,2259,2021,41,38,2,22,1,6,238
42121200500,2212,1952,42,53,6,26,0,5,260
42121200600,4775,4520,28,27,13,6,0,6,255
42121200700,1944,1731,34,51,2,4,0,1,213
42121200800,2278,2070,71,38,3,8,2,1,208
42121200900,2317,2132,38,39,4,7,2,6,185
42121201000,3074,2827,59,37,4,0,0,7,247
42121201100,4553,4342,37,16,6,12,0,1,211
42121201200,2787,2636,22,8,10,20,0,5,151
42121201300,3555,3353,24,22,1,18,0,8,202
42121201400,3706,3473,28,24,0,15,0,13,233
42121201500,3380,3217,33,5,8,20,0,6,163
42123970100,2187,2082,16,4,3,7,0,5,105
42123970200,3885,3681,52,7,3,24,0,5,204
42123970300,5136,4859,31,6,7,12,0,5,277
42123970400,2646,2525,22,2,5,0,3,0,121
42123970500,3456,3288,28,11,5,8,0,0,168
42123970600,3427,3195,56,18,5,13,0,5,232
42123970700,2506,2322,29,11,3,25,0,6,184
42123970800,3532,3224,52,45,12,19,0,2,308
42123970900,3366,3103,44,31,9,11,1,11,263
42123971000,2042,1938,23,4,7,12,0,1,104
42123971100,2788,2660,22,2,6,16,0,7,128
42123971200,2018,1920,18,3,4,5,1,2,98
42123971400,1598,1513,22,0,2,2,0,8,85
42125704100,1701,1168,64,337,0,37,2,12,533
42125711000,3535,3334,62,9,6,8,0,7,201
42125712700,1425,1280,43,21,0,7,0,9,145
42125713700,4233,3895,81,35,5,8,0,0,338
42125714000,2631,2465,38,27,0,9,0,6,166
42125715700,1664,1484,23,63,3,11,0,4,180
42125721000,3847,3604,60,26,0,5,0,10,243
42125722700,3290,3116,35,27,2,10,1,2,174
42125731000,5736,5423,67,16,3,13,1,7,313
42125732000,2888,2732,42,8,8,4,0,0,156
42125741100,4824,4463,68,54,2,39,0,11,361
42125741300,3857,3436,77,107,3,85,1,5,421
42125742101,4861,4331,89,191,0,25,3,24,530
42125742102,2066,1921,20,39,7,16,3,1,145
42125742200,1705,1523,99,21,0,0,0,9,182
42125743700,1172,1022,29,48,1,12,0,4,150
42125744101,3660,3120,87,210,3,51,0,10,540
42125744102,2530,1972,106,226,2,32,0,14,558
42125744200,3554,3034,93,181,8,26,0,19,520
42125745101,3973,3542,78,129,1,68,0,11,431
42125745102,5593,5044,107,119,3,136,0,16,549
42125745200,6134,5652,103,76,8,84,0,29,482
42125746100,6079,5613,133,31,3,123,0,14,466
42125746200,4467,4122,65,28,0,112,0,8,345
42125746301,5687,5246,135,46,3,101,0,10,441
42125746302,6713,6070,150,39,5,192,3,20,643
42125751100,5016,4560,87,85,9,8,0,11,456
42125751200,3193,2800,32,131,6,11,0,11,393
42125752700,4825,4364,72,106,4,32,8,21,461
42125753700,1853,1498,83,139,0,23,0,6,355
42125754200,2630,2121,105,237,6,24,3,6,509
42125754300,3211,2065,88,714,3,44,5,13,1146
42125754400,1722,1111,50,387,8,9,2,14,611
42125754500,2369,1772,95,252,7,30,0,20,597
42125754600,1543,1179,62,178,2,9,0,0,364
42125755100,4294,3863,84,160,7,47,5,5,431
42125755200,5319,4917,78,63,5,80,3,8,402
42125755700,3679,3489,26,15,0,14,0,4,190
42125761000,5156,4873,35,27,6,11,0,9,283
42125762000,2444,2272,25,31,3,2,1,11,172
42125763700,1547,1400,14,64,0,0,2,4,147
42125764000,3297,3024,28,69,10,11,2,18,273
42125771100,5558,5251,64,23,10,15,1,14,307
42125771200,3133,2947,42,40,2,17,2,6,186
42125772700,2049,1927,24,12,3,2,0,6,122
42125773100,2824,2460,81,90,6,5,0,10,364
42125773200,1335,1160,35,43,3,7,1,4,175
42125774700,5380,5010,129,77,0,18,0,19,370
42125775200,2254,1696,51,315,2,1,0,20,558
42125775300,2315,1735,52,318,5,9,0,16,580
42125781700,4099,3851,49,62,1,6,0,3,248
42125782700,1303,1112,39,59,5,6,2,4,191
42125783200,2445,1866,75,256,3,29,1,22,579
42125783300,1789,1395,64,190,3,23,0,4,394
42125784000,2580,2424,17,36,0,3,0,2,156
42125791000,1408,1308,25,10,0,0,1,0,100
42125792100,3126,2687,103,155,11,36,2,8,439
42125792200,2346,1889,66,210,7,39,8,10,457
42125795700,2311,2115,18,49,8,0,0,5,196
42125795800,5928,5349,89,77,1,196,0,18,579
42125795900,4233,3923,60,62,1,12,0,15,310
42125796000,3010,2875,20,5,7,5,0,11,135
42127960100,1291,1201,32,4,3,10,0,1,90
42127960200,3091,2852,75,25,8,26,0,10,239
42127960300,2277,2138,52,8,0,7,0,9,139
42127960400,3157,2942,66,12,4,22,0,11,215
42127960500,3674,3406,105,19,1,26,0,17,268
42127960600,4958,4504,203,31,0,41,0,11,454
42127960700,4458,3920,216,46,5,43,0,10,538
42127960800,4200,3850,111,26,7,41,0,10,350
42127960900,6700,4697,514,1233,32,60,0,18,2003
42127961001,1972,1793,80,12,0,12,0,10,179
42127961002,2878,2520,184,57,6,24,0,5,358
42127961101,1858,1694,99,9,2,5,0,1,164
42127961102,1818,1572,142,14,0,14,0,14,246
42127961201,2807,2499,136,43,0,23,0,8,308
42127961202,1308,1186,58,13,0,5,0,1,122
42127961300,2832,2471,149,46,5,47,0,11,361
42127961400,1876,1576,125,49,0,12,0,18,300
42129800100,1042,549,20,341,8,13,4,11,493
42129800200,1282,688,46,397,5,6,0,14,594
42129800300,2448,1853,28,356,1,4,1,19,595
42129800400,1405,1211,26,66,0,7,0,11,194
42129800500,2484,2198,34,123,4,17,0,9,286
42129800600,2171,1293,83,551,5,19,0,22,878
42129800700,1965,1181,86,523,6,3,0,10,784
42129800800,1714,1497,39,80,0,8,0,9,217
42129800900,2431,2035,72,197,0,6,0,2,396
42129801001,4021,3804,60,27,0,20,0,5,217
42129801002,2569,2340,36,68,3,14,0,18,229
42129801100,5168,4810,55,80,3,35,0,16,358
42129801200,5634,5348,32,29,4,13,0,13,286
42129801300,4472,4142,71,48,6,8,1,8,330
42129801400,1815,1592,40,50,2,6,0,8,223
42129801500,2517,2194,28,125,3,6,0,7,323
42129801600,1345,1109,10,112,6,9,0,2,236
42129801701,2164,2032,21,41,2,7,1,8,132
42129801702,4349,4143,46,39,4,12,0,7,206
42129801703,2534,2390,36,20,1,12,0,8,144
42129801801,3768,3549,23,31,0,4,0,12,219
42129801802,2088,1899,37,35,0,4,0,10,189
42129801901,2863,2716,26,45,0,3,1,3,147
42129801902,3230,3055,44,8,5,17,1,4,175
42129802001,2529,2301,25,23,0,87,0,3,228
42129802003,4152,3777,77,45,0,141,3,14,375
42129802004,3640,3191,65,68,2,184,0,5,449
42129802101,5260,4677,130,46,9,265,0,15,583
42129802102,6352,5617,109,98,2,325,2,25,735
42129802103,2563,2189,42,15,9,216,1,19,374
42129802200,3227,2878,78,96,3,38,0,14,349
42129802301,6021,5645,76,42,0,62,0,18,376
42129802303,3071,2916,45,11,0,15,0,12,155
42129802304,6845,6443,88,34,0,80,0,17,402
42129802400,4318,4022,55,58,1,24,0,10,296
42129802500,2105,1814,35,121,2,2,0,7,291
42129802600,3130,2581,47,246,1,5,1,12,549
42129802700,1877,1669,15,67,0,13,0,7,208
42129802800,2103,1589,57,266,2,3,0,10,514
42129802900,5950,5575,87,34,5,59,0,16,375
42129803000,4725,4301,69,99,0,63,2,7,424
42129803100,3938,3718,56,40,0,26,0,0,220
42129803200,2435,2279,23,21,2,6,2,1,156
42129803301,6003,5643,82,38,1,71,0,7,360
42129803302,4135,3954,27,28,3,14,0,2,181
42129803400,3857,3546,65,52,0,67,0,9,311
42129803501,5139,4832,63,22,7,74,0,21,307
42129803502,4008,3745,60,25,7,40,0,9,263
42129803600,1661,1533,32,13,0,9,0,0,128
42129803700,4256,3943,50,49,0,38,0,12,313
42129803800,5902,5480,95,75,5,78,0,11,422
42129803901,3366,3026,58,108,0,31,0,6,340
42129803902,3820,3272,75,203,6,45,0,8,548
42129804000,1389,1130,22,112,0,8,0,2,259
42129804100,2651,2109,79,194,2,28,0,19,542
42129804200,3750,3343,78,144,4,43,0,12,407
42129804300,2219,1976,33,46,0,6,0,9,243
42129804400,2135,1970,42,35,4,22,0,3,165
42129804501,4751,4431,70,58,5,45,0,9,320
42129804503,2767,2458,61,70,1,87,1,0,309
42129804504,2997,2798,39,25,4,35,0,2,199
42129804600,2975,2750,39,43,5,16,0,13,225
42129804701,2966,2816,29,27,2,8,0,0,150
42129804703,2244,2091,48,22,1,23,0,2,153
42129804704,1058,995,17,12,0,5,1,1,63
42129804705,1121,914,13,177,0,0,0,1,207
42129804706,1307,1210,17,25,0,9,0,8,97
42129804801,2251,1971,80,81,0,22,0,1,280
42129804803,3050,2891,35,33,0,8,0,1,159
42129804804,3000,2782,42,24,2,34,0,16,218
42129804901,2682,2496,31,36,2,10,0,8,186
42129804902,2687,2539,34,22,5,27,0,7,148
42129805000,3556,3368,46,12,8,1,0,3,188
42129805100,2652,2464,19,31,4,13,0,11,188
42129805200,1851,1232,38,396,6,4,0,11,619
42129805400,1377,672,65,486,3,2,2,18,705
42129805500,3648,3137,64,247,3,14,0,18,511
42129805600,1873,1639,75,60,0,14,0,14,234
42129805800,3174,2869,59,112,5,23,0,5,305
42129805901,1514,1394,17,18,3,15,0,2,120
42129805903,3820,3603,48,35,4,15,0,8,217
42129805904,2885,2607,56,45,2,42,0,5,278
42129806000,2665,2481,22,51,6,2,0,4,184
42129806100,3334,3203,24,20,5,17,0,4,131
42129806200,2435,2306,9,8,0,8,0,5,129
42129806300,1980,1848,18,23,1,1,4,4,132
42129806400,2450,2309,30,14,2,12,0,10,141
42129806500,4701,4460,42,42,6,30,0,16,241
42129806600,3020,2815,37,17,0,11,0,12,205
42129806700,2750,2560,53,37,0,3,0,3,190
42129806800,1495,1377,17,32,0,5,0,6,118
42129806900,3949,3681,48,49,6,17,0,7,268
42129807000,3083,2987,25,8,0,2,0,3,96
42129807100,3087,2944,24,5,0,12,0,4,143
42129807201,4622,4317,65,22,9,43,0,14,305
42129807202,3026,2835,41,30,0,26,0,0,191
42129807300,4691,4457,48,15,1,13,0,8,234
42129807401,2082,1961,26,20,0,0,0,10,121
42129807403,2293,2125,53,15,1,28,0,2,168
42129807404,5144,4653,138,132,16,42,1,16,491
42129807500,2266,2088,31,40,0,18,0,3,178
42129807600,2370,2193,41,31,1,10,0,2,177
42129807700,3424,3163,54,60,0,16,2,0,261
42129807800,3878,3684,23,43,7,5,0,10,194
42129807901,3057,2941,6,12,0,7,2,6,116
42129807902,3148,3020,16,5,3,3,0,0,128
42129808100,4049,3793,50,100,1,18,0,5,256
42129808200,2639,2464,38,23,5,2,0,7,175
42129808300,4903,4627,39,32,6,8,0,8,276
42129808401,1792,1725,14,7,0,3,0,7,67
42129808402,4410,4196,53,11,4,10,0,19,214
42129808500,1513,1438,28,0,2,6,3,9,75
42129808600,4190,4024,36,18,3,10,0,7,166
42131400100,2818,2618,119,12,4,8,0,9,200
42131400200,3890,3640,73,18,9,12,0,8,250
42131400300,4435,3952,147,109,7,29,0,4,483
42131400400,3992,3718,65,30,0,23,0,7,274
42131400500,3741,3499,74,4,5,8,2,6,242
42131400600,3202,2962,57,22,5,34,0,1,240
42131400700,3991,3753,46,19,2,1,1,5,238
42133000100,1559,653,392,420,2,17,0,8,906
42133000200,2990,744,1309,784,4,14,1,17,2246
42133000300,2440,685,1008,577,4,15,0,34,1755
42133000400,2192,828,777,404,8,20,2,23,1364
42133000500,2566,739,985,657,6,50,1,18,1827
42133000600,2857,912,1159,586,11,38,0,14,1945
42133000700,3309,387,1856,868,4,30,3,23,2922
42133000800,2307,952,712,498,1,22,1,11,1355
42133000900,3213,1058,1079,884,5,26,2,33,2155
42133001000,1531,369,623,457,1,13,3,3,1162
42133001100,3847,831,1744,1028,14,15,1,30,3016
42133001200,3070,1011,1179,698,1,7,0,28,2059
42133001300,3319,1501,975,620,7,27,2,27,1818
42133001400,4262,2247,1153,615,9,58,0,21,2015
42133001500,3687,942,1618,899,14,15,1,23,2745
42133001600,1651,670,507,375,1,17,0,24,981
42133010120,4891,3796,383,335,6,142,3,29,1095
42133010130,3793,3191,172,150,3,136,0,23,602
42133010131,3512,2606,383,248,5,142,1,13,906
42133010132,5175,3398,943,490,26,145,1,30,1777
42133010210,3346,2551,296,212,4,150,0,8,795
42133010220,6341,4825,541,403,8,338,1,30,1516
42133010300,1742,1339,166,110,0,40,0,0,403
42133010400,3817,3018,294,215,7,84,0,25,799
42133010510,5708,4690,304,337,4,170,2,16,1018
42133010520,2416,2041,136,83,2,42,0,10,375
42133020100,3339,2802,238,95,5,30,1,17,537
42133020220,4630,4106,188,75,5,64,0,18,524
42133020221,4880,4245,272,73,4,119,0,18,635
42133020222,4602,4245,153,31,0,31,3,12,357
42133020310,2675,2528,42,9,0,24,0,9,147
42133020321,3491,3329,48,10,2,10,0,6,162
42133020322,3935,3681,92,15,6,10,0,21,254
42133020410,5550,5075,145,53,1,44,1,21,475
42133020421,4352,3895,166,53,3,77,4,18,457
42133020422,5136,4733,119,35,4,82,0,20,403
42133020510,3969,3728,82,22,9,12,15,6,241
42133020522,4309,3868,161,87,3,29,0,8,441
42133020523,2372,2021,172,70,8,14,2,11,351
42133020524,4439,3631,278,242,6,61,1,18,808
42133020601,3102,2917,68,24,4,7,0,7,185
42133020602,4115,3753,130,78,4,14,2,12,362
42133020710,6884,5718,455,324,4,62,3,21,1166
42133020721,5477,4616,362,239,3,39,0,14,861
42133020722,4742,3966,383,192,7,53,1,8,776
42133020801,3774,3146,215,216,2,39,0,2,628
42133020802,4754,3452,427,519,1,87,4,19,1302
42133020910,6629,5800,304,153,9,49,0,22,829
42133020921,7355,6566,276,114,11,46,0,34,789
42133020922,3688,3389,106,21,7,16,0,9,299
42133021010,5345,4627,279,205,7,59,5,19,718
42133021020,7160,5925,501,311,9,72,4,22,1235
42133021100,4970,3751,461,410,9,117,0,28,1219
42133021221,4148,3486,116,188,5,174,0,11,662
42133021222,3667,2836,165,289,9,185,0,16,831
42133021223,3083,1909,554,320,0,58,0,19,1174
42133021224,5847,4728,351,256,8,254,0,15,1119
42133021300,5094,2921,1092,620,5,42,1,59,2173
42133021410,5059,4104,307,338,5,122,1,19,955
42133021420,7376,6131,407,366,2,168,0,37,1245
42133021500,3910,3259,294,184,3,59,1,11,651
42133021600,2861,2301,307,136,2,19,0,12,560
42133021711,3031,2843,68,13,4,18,0,13,188
42133021712,6424,5976,170,44,4,27,0,29,448
42133021720,4688,4025,149,292,3,48,2,13,663
42133021801,5291,4824,144,91,3,61,0,19,467
42133021802,4218,3840,132,57,11,57,1,11,378
42133021901,3086,2707,171,44,7,21,0,5,379
42133021902,4892,4111,283,127,12,90,2,17,781
42133022000,3885,3127,494,74,14,22,0,14,758
42133022100,3419,2526,598,117,8,12,2,10,893
42133022200,4911,4310,284,87,9,57,0,9,601
42133022300,4214,3372,491,89,13,49,6,13,842
42133022401,3462,3211,70,8,5,16,0,3,251
42133022403,3295,2808,111,162,7,61,2,7,487
42133022404,5777,5056,191,248,0,85,1,13,721
42133022500,3904,3555,105,68,15,8,1,3,349
42133022601,2739,2288,107,178,2,62,1,6,451
42133022602,6543,5523,267,400,1,118,0,18,1020
42133022701,3107,2829,96,56,9,51,2,3,278
42133022702,3390,2578,290,267,9,137,3,8,812
42133022801,4556,3974,147,160,6,91,5,12,582
42133022802,3385,2835,204,178,5,64,0,9,550
42133022920,4889,4161,204,280,13,60,0,24,728
42133022921,1168,1020,45,33,5,31,0,2,148
42133022922,4088,3235,237,213,5,232,2,4,853
42133022923,5138,3620,598,509,5,187,0,39,1518
42133023000,5250,4345,387,247,9,20,1,17,905
42133023100,6510,5596,316,212,8,35,0,31,914
42133023200,6497,5701,278,214,14,34,0,7,796
42133023301,6353,5311,250,446,6,121,0,25,1042
42133023302,6361,5424,202,399,3,88,2,26,937
42133023400,5799,5099,282,155,4,42,0,22,700
42133023500,5160,4646,232,67,3,26,0,15,514
42133023601,3732,3435,119,24,1,7,0,7,297
42133023602,4960,4575,135,30,17,26,0,17,385
42133023710,3832,3579,58,22,8,12,0,6,253
42133023721,5936,5567,75,43,1,22,4,11,369
42133023722,3031,2902,33,5,8,14,0,9,129
42133023810,4742,4312,143,71,9,25,0,21,430
42133023821,5727,5160,153,121,15,66,1,19,567
42133023823,4311,3756,108,220,6,77,3,17,555
42133023824,2971,2560,132,116,2,54,1,8,411
42133023902,2945,2759,65,19,0,8,0,11,186
42133023903,3231,2896,61,87,1,34,1,5,335
42133023904,4169,3844,69,55,3,23,0,21,325
42133024001,5673,5110,136,69,15,20,0,21,563
42133024002,3488,3250,60,25,3,17,1,8,238
44001030100,4801,4179,159,66,0,187,0,14,622
44001030200,3580,2890,158,41,4,285,0,13,690
44001030300,4775,4108,165,33,0,267,0,13,667
44001030400,3997,3459,141,10,1,185,0,14,538
44001030500,3474,2985,149,91,16,42,0,24,489
44001030601,3553,3240,86,35,1,39,0,5,313
44001030602,4120,3743,126,50,8,43,0,16,377
44001030700,3852,3371,204,70,9,44,1,6,481
44001030800,5590,4684,358,245,36,63,0,7,906
44001030901,6085,5617,171,33,6,50,0,30,468
44001030902,6966,6395,226,58,4,74,0,27,571
44003020101,6857,5639,477,131,6,273,2,30,1218
44003020102,5048,4025,420,134,13,163,0,54,1023
44003020200,5112,4077,464,133,23,117,3,14,1035
44003020300,6218,4852,614,200,46,104,1,36,1366
44003020400,3263,2642,348,74,11,32,1,10,621
44003020500,4514,3638,351,135,20,129,2,25,876
44003020601,6431,5728,231,80,15,89,0,33,703
44003020602,3512,3142,143,28,11,51,1,14,370
44003020603,6791,6079,215,60,14,142,5,13,712
44003020604,5441,4773,259,65,14,64,0,11,668
44003020701,1894,1758,46,9,0,23,1,1,136
44003020702,4595,4239,118,22,5,26,0,21,356
44003020703,7024,6408,217,47,4,63,0,28,616
44003020800,6528,5828,148,51,12,181,0,39,700
44003020901,3591,3129,183,47,6,103,2,1,462
44003020903,6876,5671,291,65,1,499,1,36,1205
44003020904,3845,3326,121,32,1,221,0,19,519
44003021001,2421,1860,271,54,3,81,0,11,561
44003021002,4686,3955,324,74,6,114,1,11,731
44003021100,5380,4183,497,178,19,198,2,30,1197
44003021200,3657,3001,278,123,12,84,0,18,656
44003021300,4624,4231,171,62,2,40,0,5,393
44003021401,4063,3439,274,69,3,112,0,14,624
44003021402,3882,3239,254,83,12,94,0,9,643
44003021501,3399,2820,250,71,10,95,0,18,579
44003021502,4212,3571,258,73,9,82,1,16,641
44003021600,1570,1424,33,19,0,31,1,1,146
44003021700,4927,4076,346,96,16,111,1,13,851
44003021800,4075,3419,254,66,12,139,4,21,656
44003021901,3152,2694,175,38,11,63,0,19,458
44003021902,2678,2221,183,60,2,84,0,25,457
44003021903,3888,3380,171,66,12,95,0,13,508
44003022000,3447,3079,129,46,6,57,0,13,368
44003022100,5588,4916,234,66,2,156,2,35,672
44003022201,6679,5742,317,102,4,284,0,39,937
44003022202,3912,3149,204,98,0,313,1,21,763
44003022300,4300,3294,340,113,17,298,0,41,1006
44003022400,2283,2114,56,19,4,19,0,9,169
44003980000,0,0,0,0,0,0,0,0,0
44005040101,4974,4429,198,79,13,49,0,12,545
44005040102,5968,5365,165,44,13,89,4,37,603
44005040104,5056,4297,232,112,1,136,4,15,759
44005040105,1873,1683,53,38,5,28,0,7,190
44005040200,1612,883,256,188,6,117,7,39,729
44005040302,2615,2053,188,107,5,58,10,28,562
44005040303,3348,2219,390,265,8,179,2,44,1129
44005040304,3340,2511,301,149,16,96,1,38,829
44005040400,6160,5445,218,97,8,119,0,33,715
44005040500,4409,2301,953,489,106,76,1,52,2108
44005040600,4750,3145,837,288,12,82,0,57,1605
44005040700,3210,2747,196,59,3,47,0,30,463
44005040800,2656,2196,145,105,22,26,0,37,460
44005040900,4896,4246,319,100,2,66,0,26,650
44005041000,2029,1741,99,54,5,24,0,10,288
44005041100,1479,1136,162,67,2,24,1,9,343
44005041200,1734,1012,264,210,16,93,11,17,722
44005041300,5559,5174,126,39,7,43,0,21,385
44005041400,3616,3402,65,8,0,14,1,20,214
44005041601,3155,2773,157,43,6,46,4,9,382
44005041602,4654,4302,93,43,0,55,0,13,352
44005041701,3346,3080,68,29,5,31,2,10,266
44005041702,5204,4774,107,32,4,45,1,35,430
44005990000,0,0,0,0,0,0,0,0,0
44007000101,4571,1410,2006,680,30,126,0,81,3161
44007000102,5527,844,3437,650,22,329,0,41,4683
44007000200,6957,785,4809,767,39,340,2,59,6172
44007000301,2613,181,1756,427,18,116,1,33,2432
44007000302,4728,475,3071,734,31,227,0,43,4253
44007000400,4058,189,2804,716,22,144,9,34,3869
44007000500,3287,110,2262,603,50,92,2,57,3177
44007000600,2246,365,1151,402,13,185,2,34,1881
44007000700,2714,594,1126,718,37,48,0,30,2120
44007000800,4646,2398,881,446,34,636,4,34,2248
44007000900,2250,1232,575,210,14,81,3,23,1018
44007001000,2584,1119,953,299,6,58,0,20,1465
44007001100,2602,1671,436,171,5,149,0,16,931
44007001200,3425,712,1938,470,11,132,1,30,2713
44007001300,4296,1338,2143,289,7,341,0,22,2958
44007001400,6949,342,4854,838,43,662,1,65,6607
44007001500,2936,588,1507,327,6,385,0,45,2348
44007001601,3194,288,2420,283,8,93,0,18,2906
44007001602,5619,460,4466,409,5,164,0,33,5159
44007001700,4371,591,3201,304,25,114,2,39,3780
44007001800,7606,1132,5115,755,47,296,1,68,6474
44007001900,6247,895,4098,747,39,162,6,47,5352
44007002000,6569,1945,2992,990,31,232,0,60,4624
44007002101,2790,820,1295,415,19,67,0,42,1970
44007002102,6445,959,4069,916,38,193,0,71,5486
44007002200,5216,564,3494,721,17,196,0,31,4652
44007002300,5597,3001,1504,616,20,146,0,34,2596
44007002400,8281,5665,1436,597,6,183,2,59,2616
44007002500,4096,1812,1080,417,9,477,1,45,2284
44007002600,3613,649,1741,687,30,246,0,49,2964
44007002700,4725,920,2416,955,36,139,4,53,3805
44007002801,3709,821,1552,900,36,80,4,85,2888
44007002802,2909,816,1209,599,21,78,0,55,2093
44007002900,7508,2373,2834,1375,40,190,0,220,5135
44007003100,4342,2271,683,565,36,302,0,119,2071
44007003200,3340,2237,355,253,5,152,2,76,1103
44007003300,4285,3183,304,212,5,222,5,70,1102
44007003400,4855,4046,228,80,1,257,0,36,809
44007003500,4859,3498,257,148,5,684,4,43,1361
44007003601,3243,1774,262,143,11,836,2,20,1469
44007003602,7475,4361,821,457,14,1348,8,88,3114
44007003700,3651,2483,274,138,13,451,0,39,1168
44007010101,3874,3041,284,165,8,53,0,72,833
44007010102,3471,2976,135,86,9,53,0,39,495
44007010200,6602,4498,622,450,37,83,1,276,2104
44007010300,4152,2823,291,334,29,51,0,162,1329
44007010400,6715,4642,574,418,8,200,0,226,2073
44007010501,4615,3211,577,259,13,84,0,142,1404
44007010502,4978,3700,284,256,23,285,3,102,1278
44007010600,6207,5012,371,260,13,112,1,65,1195
44007010701,2349,2086,63,53,1,22,0,29,263
44007010702,4176,3675,127,69,6,41,0,52,501
44007010800,5515,1222,3280,411,18,60,4,122,4293
44007010900,5709,1284,3489,424,8,20,1,156,4425
44007011000,6389,1012,4433,290,5,21,2,162,5377
44007011100,4970,628,3550,212,3,20,0,248,4342
44007011200,5983,4064,1205,230,20,66,0,89,1919
44007011301,4982,4002,531,148,4,100,2,38,980
44007011302,4197,3690,190,44,1,87,0,49,507
44007011402,4720,4137,155,55,4,211,1,4,583
44007011403,7348,6216,333,117,6,420,0,24,1132
44007011404,4572,4038,136,26,2,172,0,22,534
44007011405,4603,3772,142,57,5,403,3,33,831
44007011500,6742,5488,423,176,7,294,2,43,1254
44007011600,6464,5457,264,88,6,363,0,40,1007
44007011701,4818,3922,377,84,7,148,0,64,896
44007011702,4505,3567,438,110,10,110,0,38,938
44007011800,7145,4380,1327,701,21,182,4,142,2765
44007011901,3278,2192,512,322,3,93,0,29,1086
44007011902,5030,3869,411,249,6,249,0,52,1161
44007012000,6293,4623,781,447,8,134,0,65,1670
44007012102,4938,3188,963,401,16,114,2,44,1750
44007012103,2987,2121,300,225,4,174,3,31,866
44007012104,4443,3101,639,306,15,117,0,36,1342
44007012200,7445,6234,601,162,4,197,0,34,1211
44007012300,6806,5430,772,222,1,141,3,32,1376
44007012401,7283,5256,1214,273,11,263,4,37,2027
44007012402,2636,1961,389,75,3,105,0,8,675
44007012500,5398,3908,868,217,8,174,0,21,1490
44007012601,4516,2606,130,131,2,1389,4,75,1910
44007012602,7469,6648,332,67,12,99,0,37,821
44007012701,5563,5092,212,40,7,83,0,18,471
44007012702,4570,4176,151,28,3,88,0,20,394
44007012801,5244,4678,242,70,1,54,1,23,566
44007012802,2394,2175,113,27,0,24,0,10,219
44007012803,4950,4491,179,35,4,86,0,27,459
44007012900,4954,4514,184,30,7,15,2,12,440
44007013001,3410,3145,104,17,0,20,2,14,265
44007013002,7794,7154,267,46,12,40,3,22,640
44007013101,4680,4306,127,8,4,32,0,29,374
44007013102,5294,4866,148,35,0,27,0,26,428
44007013201,4561,4199,134,25,1,40,0,19,362
44007013202,5823,5381,163,37,6,51,0,17,442
44007013300,4469,4155,91,24,7,33,0,17,314
44007013400,3992,3149,378,133,10,105,3,17,843
44007013500,5378,2767,1427,407,16,464,4,59,2611
44007013600,3068,1689,729,195,5,257,0,30,1379
44007013701,4492,2266,1194,315,9,469,0,40,2226
44007013702,2851,1761,518,160,9,226,1,37,1090
44007013800,4950,3391,716,211,23,347,0,28,1559
44007013900,3166,2441,362,53,4,211,1,7,725
44007014000,5982,3351,1340,308,22,681,0,45,2631
44007014100,5304,1628,2518,399,13,550,0,34,3676
44007014200,4757,2760,936,732,31,199,2,15,1997
44007014300,4984,3906,382,119,2,415,5,12,1078
44007014400,3859,3295,264,49,10,148,2,9,564
44007014501,5134,4551,177,75,8,182,0,19,583
44007014502,4269,3538,340,97,5,84,0,24,731
44007014600,7170,6022,361,88,8,421,0,46,1148
44007014700,7833,3519,2843,552,24,527,2,64,4314
44007014800,5745,4420,582,155,13,407,2,23,1325
44007015000,4573,1879,1184,590,3,52,2,288,2694
44007015100,4802,985,1723,655,21,26,0,434,3817
44007015200,3046,1015,1108,419,38,63,0,117,2031
44007015300,2316,751,849,322,6,20,2,78,1565
44007015400,2381,641,807,417,3,19,0,100,1740
44007015500,4521,1976,1216,541,8,56,0,177,2545
44007015600,2633,1404,677,248,12,30,1,64,1229
44007015700,3753,2583,620,167,0,53,0,73,1170
44007015800,3774,2550,643,175,4,43,9,96,1224
44007015900,3357,2024,657,300,7,39,0,76,1333
44007016000,3523,1381,886,754,16,41,4,124,2142
44007016100,5018,1134,1480,1012,19,75,5,305,3884
44007016300,2901,1405,595,394,4,53,1,153,1496
44007016400,5180,1231,1284,1044,7,67,2,354,3949
44007016500,3978,2540,471,257,12,191,0,127,1438
44007016600,1787,678,480,257,3,34,0,90,1109
44007016700,3420,1498,892,474,10,26,1,136,1922
44007016800,3093,2006,573,201,5,32,0,49,1087
44007016900,1918,1486,216,81,0,15,0,41,432
44007017000,4635,3044,821,311,18,76,8,79,1591
44007017100,4995,2216,1545,522,13,79,1,176,2779
44007017300,3167,2228,408,193,6,120,0,23,939
44007017400,4304,1937,1509,346,12,269,1,36,2367
44007017500,3319,2279,494,194,7,156,1,20,1040
44007017600,2721,1262,719,386,6,140,0,19,1459
44007017700,3637,2720,392,139,8,172,4,31,917
44007017800,2620,1540,538,239,14,125,0,13,1080
44007017900,3556,2064,748,342,19,103,7,42,1492
44007018000,2869,1681,661,212,9,97,1,35,1188
44007018100,2961,1618,746,223,13,161,0,20,1343
44007018200,2919,1485,652,197,10,374,0,33,1434
44007018300,1842,936,512,145,5,126,3,29,906
44007018400,6511,3943,1421,264,20,517,0,39,2568
44007018500,2814,2112,286,112,8,105,1,20,702
44009041500,1410,1271,66,17,1,5,0,8,139
44009050102,2465,2190,78,20,11,72,4,13,275
44009050103,5958,4797,389,172,67,167,4,30,1161
44009050104,3942,3617,123,22,0,52,0,1,325
44009050301,4852,4409,102,45,5,103,4,19,443
44009050302,2863,2560,99,28,23,33,0,15,303
44009050401,4849,4385,153,27,24,80,1,9,464
44009050402,2803,2612,68,16,8,20,2,3,191
44009050500,6460,5894,188,26,21,70,1,33,566
44009050600,8020,7342,168,44,43,72,3,45,678
44009050701,4166,3831,110,22,20,30,0,16,335
44009050702,4232,3898,104,9,42,24,0,14,334
44009050801,6113,4941,545,102,74,148,4,23,1172
44009050802,3748,3267,160,24,18,146,8,9,481
44009050901,6255,5468,242,44,28,237,0,5,787
44009050902,5572,5042,108,43,39,83,5,18,530
44009051000,1671,1597,22,4,5,12,0,4,74
44009051101,4676,4242,97,23,77,26,1,24,434
44009051102,3321,3072,55,14,30,24,0,7,249
44009051201,4574,3679,226,116,167,119,0,30,895
44009051202,4545,3948,136,64,89,80,0,15,597
44009051302,4028,3758,79,16,3,18,0,17,270
44009051304,2185,2020,50,14,1,16,0,5,165
44009051305,3934,3481,80,37,29,174,0,18,453
44009051306,6170,5323,172,69,20,275,0,42,847
44009051400,6495,5001,660,373,9,329,4,5,1494
44009051502,6716,6250,135,27,36,79,2,21,466
44009051503,3917,3576,80,39,16,84,2,14,341
44009051504,3899,3618,83,11,11,27,3,27,281
44009990100,0,0,0,0,0,0,0,0,0
44009990200,0,0,0,0,0,0,0,0,0
45001950100,3094,2483,69,406,8,4,0,13,611
45001950200,4190,3279,107,655,6,14,2,16,911
45001950300,3189,2784,37,215,8,10,5,5,405
45001950401,3248,2188,51,899,2,9,0,7,1060
45001950402,2628,1946,60,526,1,13,0,7,682
45001950500,5298,2846,50,2221,7,14,0,8,2452
45001950600,2648,1218,49,1262,12,7,0,14,1430
45003020100,4877,3140,539,999,8,4,4,15,1737
45003020200,5910,4239,427,959,27,19,5,9,1671
45003020301,2468,1726,255,352,9,10,0,3,742
45003020303,1778,379,154,1118,6,2,1,12,1399
45003020304,4757,2692,256,1504,27,55,4,28,2065
45003020401,7216,4041,645,2072,19,96,9,22,3175
45003020402,1968,1030,222,611,8,14,1,7,938
45003020500,9244,6840,558,1302,12,145,0,45,2404
45003020601,3935,2813,173,690,13,34,1,12,1122
45003020603,3070,1867,263,779,6,7,2,7,1203
45003020604,2717,1275,349,905,6,17,0,21,1442
45003020701,5767,4076,251,1086,7,64,7,33,1691
45003020702,4792,1813,790,1922,13,32,0,18,2979
45003020801,3158,2675,91,233,7,44,8,5,483
45003020802,5712,3868,473,931,22,156,8,30,1844
45003020901,2206,1348,129,594,20,11,3,1,858
45003020903,3673,2675,252,564,11,17,0,8,998
45003020904,3137,1556,192,1149,17,25,2,29,1581
45003021001,4747,2985,517,962,30,30,0,25,1762
45003021003,3131,2104,461,379,16,8,1,5,1027
45003021004,1904,618,295,905,9,5,1,2,1286
45003021101,2609,1896,177,394,16,10,2,3,713
45003021102,3580,2565,272,502,20,7,1,11,1015
45003021201,6002,4698,218,738,3,105,1,14,1304
45003021202,3582,2779,116,502,3,37,0,16,803
45003021204,3075,1873,152,762,9,150,4,9,1202
45003021205,6839,5777,225,422,13,182,0,23,1062
45003021300,4908,3562,166,927,7,76,4,10,1346
45003021401,2149,662,100,1298,6,0,0,10,1487
45003021402,3292,475,81,2547,2,18,3,43,2817
45003021500,5121,3389,271,1143,13,55,0,27,1732
45003021601,5530,2497,290,2458,17,20,2,24,3033
45003021603,2943,1853,136,695,3,99,7,21,1090
45003021604,5486,3979,284,807,17,111,1,20,1507
45003021700,4410,2870,105,1214,27,12,6,9,1540
45003021800,2433,1423,41,848,20,7,1,12,1010
45003021901,2852,1868,479,345,11,7,0,16,984
45003021902,2946,1808,345,637,14,11,0,6,1138
45003022001,4746,3275,407,842,8,17,4,19,1471
45003022003,4592,3245,194,944,12,34,0,18,1347
45003022004,2495,1563,93,724,2,6,0,10,932
45003022100,3051,2101,82,700,14,14,3,11,950
45003980100,0,0,0,0,0,0,0,0,0
45005970201,2378,221,46,2067,5,0,0,5,2157
45005970202,1620,468,38,1066,4,4,0,7,1152
45005970500,4041,1296,110,2513,36,13,1,1,2745
45007000200,4739,3940,177,410,14,38,0,12,799
45007000300,5415,3459,590,1056,6,107,0,8,1956
45007000500,2831,860,86,1729,11,14,0,24,1971
45007000600,3255,764,135,2156,8,9,0,25,2491
45007000701,2600,839,217,1403,4,5,0,6,1761
45007000702,1687,605,181,798,7,3,1,5,1082
45007000800,2586,1304,260,881,2,8,0,18,1282
45007000900,2883,1715,173,835,0,24,4,13,1168
45007001000,2683,1786,167,486,3,122,1,8,897
45007001100,5625,4282,276,676,5,161,1,27,1343
45007010103,9518,7668,658,594,12,190,5,46,1850
45007010105,2774,1714,109,460,4,356,1,45,1060
45007010106,4944,4327,170,221,9,30,0,16,617
45007010107,4092,3468,146,228,22,60,0,15,624
45007010108,5548,4711,241,302,17,23,0,30,837
45007010200,5828,4878,235,369,14,58,0,21,950
45007010300,4240,3578,264,179,13,11,0,9,662
45007010403,3304,2749,197,184,17,4,1,3,555
45007010404,2732,1973,235,422,13,5,0,3,759
45007010405,3728,2970,466,145,13,5,0,8,758
45007010406,3211,2764,119,198,8,1,0,5,447
45007010501,4013,3389,135,258,12,90,0,4,624
45007010502,3733,3026,264,235,6,15,3,9,707
45007010601,3862,3254,92,287,20,18,1,15,608
45007010602,4014,3443,133,214,4,49,1,9,571
45007010701,1952,1318,60,408,0,59,0,7,634
45007010702,4320,2836,234,929,11,43,4,26,1484
45007010800,5171,4349,93,423,3,45,3,10,822
45007010900,4504,4099,93,136,11,21,2,19,405
45007011001,5163,4494,145,289,12,16,0,17,669
45007011002,4425,3535,118,563,6,34,0,15,890
45007011100,2658,1882,97,488,1,75,1,8,776
45007011201,5143,4348,152,301,2,163,0,11,795
45007011203,4947,3958,180,440,4,172,0,21,989
45007011204,4588,3824,164,314,8,122,0,10,764
45007011301,3668,2882,67,549,8,15,0,9,786
45007011302,3884,2793,128,785,9,9,0,7,1091
45007011401,4016,3141,159,485,15,15,0,16,875
45007011402,3364,2472,89,653,2,19,1,2,892
45007011501,3367,3014,47,193,3,7,0,5,353
45007011502,3085,2370,64,529,10,11,0,8,715
45007011600,2034,1884,24,57,1,4,0,7,150
45007011701,2190,1652,59,347,16,5,0,15,538
45007011702,3740,3373,69,149,8,17,0,12,367
45007011800,4038,3319,149,348,10,16,0,7,719
45007011901,5349,3122,631,1274,11,19,4,17,2227
45007011902,2975,1242,178,1408,0,4,4,10,1733
45007012001,5219,3661,220,1029,12,58,3,11,1558
45007012002,5056,3311,273,1259,6,18,2,16,1745
45007012200,5513,4470,176,600,7,13,3,13,1043
45007012300,3504,1581,179,1532,5,18,0,15,1923
45009960101,1469,524,16,895,4,11,0,1,945
45009960102,3312,294,17,2918,4,17,0,14,3018
45009960201,2610,1261,14,1230,8,23,0,6,1349
45009960202,3448,1221,47,2059,4,2,0,13,2227
45009960300,1132,780,24,298,5,4,0,2,352
45009960400,1340,930,23,349,0,9,0,0,410
45011970101,1863,657,50,1066,8,3,1,0,1206
45011970102,3396,2078,98,1069,17,12,0,15,1318
45011970200,3296,984,63,2135,18,8,0,7,2312
45011970300,3529,1398,72,1834,8,88,3,20,2131
45011970401,2315,1581,26,641,4,5,0,1,734
45011970402,2710,2035,111,390,5,36,8,3,675
45011970500,3473,1613,99,1650,1,9,2,12,1860
45011980100,7,6,1,0,0,0,0,0,1
45013000100,3982,1291,116,2431,9,13,0,14,2691
45013000200,4952,1662,396,2703,13,16,3,7,3290
45013000300,3888,2252,662,614,6,82,13,21,1636
45013000400,1982,1057,574,220,6,73,8,4,925
45013000501,6624,3081,1028,2161,14,64,17,31,3543
45013000502,6019,3013,832,1666,30,145,9,31,3006
45013000503,6430,4181,708,998,16,159,9,50,2249
45013000600,2316,1399,144,608,1,20,6,9,917
45013000700,6070,4289,283,1150,12,87,5,48,1781
45013000800,5350,3050,383,1545,13,97,8,21,2300
45013000901,3254,2580,154,391,5,19,1,14,674
45013000902,8756,6459,707,1027,24,110,9,42,2297
45013000903,2042,1325,139,495,2,44,0,0,717
45013001000,5201,3199,1033,663,12,118,3,0,2002
45013001101,3551,2364,86,996,8,10,0,12,1187
45013001103,1425,193,79,1107,3,0,0,9,1232
45013001104,3046,913,209,1822,7,6,1,10,2133
45013001200,1192,1110,17,21,0,9,2,6,82
45013002101,557,496,19,14,0,5,0,2,61
45013002102,5966,4420,825,371,13,83,2,23,1546
45013002103,9703,7357,1200,515,25,160,8,43,2346
45013002105,4787,3634,470,322,8,97,3,13,1153
45013002106,11418,7465,2312,914,19,270,1,38,3953
45013002107,10963,5511,3736,1223,25,118,3,35,5452
45013002108,5070,3336,1241,240,13,51,0,9,1734
45013002109,4376,4181,58,75,4,16,0,0,195
45013002110,7940,6738,338,576,9,106,0,13,1202
45013002201,7620,6732,390,252,8,70,0,7,888
45013002202,4234,3567,209,262,3,42,3,28,667
45013010100,1615,1536,19,10,1,9,0,11,79
45013010200,3433,2901,376,58,2,31,1,10,532
45013010300,4124,3765,167,50,2,39,1,12,359
45013010400,5735,4273,783,496,1,40,0,13,1462
45013010500,4172,2329,1154,537,9,29,0,10,1843
45013010600,4109,3848,106,36,2,26,0,5,261
45013010700,4725,4386,114,68,9,30,1,15,339
45013010800,3106,868,1558,576,3,19,1,24,2238
45013010900,1852,1473,212,60,3,14,1,23,379
45013011000,1545,887,377,202,4,25,0,2,658
45013011100,2468,2251,105,37,4,17,0,2,217
45013011200,685,615,24,15,5,8,0,0,70
45013011300,834,717,68,18,1,4,0,8,117
45013990100,0,0,0,0,0,0,0,0,0
45015020101,2974,1171,57,1629,21,13,2,5,1803
45015020102,4063,2359,102,1403,22,6,0,25,1704
45015020201,3507,1648,70,1579,30,9,4,18,1859
45015020202,2926,379,14,2439,6,8,0,11,2547
45015020301,3062,2495,53,390,5,7,2,6,567
45015020303,1833,848,49,873,3,6,0,5,985
45015020304,4476,3493,95,694,18,16,1,16,983
45015020401,3890,2443,108,1170,10,12,1,13,1447
45015020404,6963,5506,322,685,16,119,3,34,1457
45015020405,3447,1452,135,1745,5,9,1,8,1995
45015020406,2858,2501,182,25,2,65,1,6,357
45015020407,9274,8129,318,284,25,204,5,23,1145
45015020503,5227,3451,247,1185,55,19,6,12,1776
45015020504,4151,2158,82,1700,16,40,0,15,1993
45015020505,4699,2298,334,1700,19,101,9,15,2401
45015020506,6008,3175,307,2187,28,22,5,21,2833
45015020601,4792,3123,346,884,25,84,11,41,1669
45015020602,7949,4872,453,2006,15,146,1,22,3077
45015020707,7411,3883,535,2215,50,170,3,100,3528
45015020710,7202,4326,541,1738,36,139,2,33,2876
45015020711,14020,10095,933,1729,56,318,11,72,3925
45015020712,3411,2703,263,142,44,25,0,24,708
45015020713,7268,4956,650,1008,36,189,9,44,2312
45015020714,6016,3711,502,1337,31,83,1,25,2305
45015020715,3912,2432,469,705,23,36,3,23,1480
45015020716,8619,4786,1118,1869,57,279,2,55,3833
45015020717,5246,2560,756,1409,34,92,6,62,2686
45015020718,6953,3074,1100,2147,32,69,0,70,3879
45015020719,5283,3056,484,1022,24,176,5,106,2227
45015020720,4816,3588,297,483,14,159,5,18,1228
45015020721,3384,2087,544,371,5,213,0,11,1297
45015020722,3151,2391,186,293,8,83,1,26,760
45015020723,3093,1850,366,464,27,60,7,84,1243
45015020724,4034,2794,544,371,16,134,4,8,1240
45015020725,1562,1059,191,135,4,40,10,8,503
45015020804,3030,1169,436,1014,11,181,0,49,1861
45015020806,3717,1883,400,1019,14,53,1,105,1834
45015020807,10031,4735,930,3102,33,472,27,115,5296
45015020808,3802,1592,622,1188,31,114,1,45,2210
45015020809,3294,1518,544,769,16,140,1,64,1776
45015020810,3861,1517,1108,756,19,208,3,47,2344
45015020811,4779,1758,900,1557,45,193,0,77,3021
45015020812,6008,4452,398,491,2,298,5,45,1556
45015020901,1652,906,449,167,4,36,0,14,746
45015020903,3412,2410,283,476,15,50,5,16,1002
45015020904,4129,2547,429,467,16,318,0,62,1582
45015021000,4666,2501,1076,762,11,139,9,16,2165
45015980100,0,0,0,0,0,0,0,0,0
45017950100,5383,3488,179,1508,25,10,5,12,1895
45017950201,1883,1025,53,731,6,5,1,0,858
45017950202,3741,1478,162,1992,15,6,0,16,2263
45017950400,3112,1792,93,1130,16,6,0,2,1320
45019000100,2087,1695,60,259,3,12,0,12,392
45019000200,1372,1311,23,11,0,5,0,5,61
45019000400,3213,2525,192,398,1,23,2,0,688
45019000500,1761,1656,27,9,0,33,0,0,105
45019000600,1074,883,39,61,1,52,0,3,191
45019000700,2432,1912,122,279,1,34,1,1,520
45019000900,1560,796,81,594,7,15,3,7,764
45019001000,2331,1771,76,362,4,36,2,12,560
45019001100,2988,1541,94,1153,4,71,4,17,1447
45019001500,1520,840,44,579,4,6,2,0,680
45019001901,4394,3682,141,364,8,50,3,12,712
45019001902,4601,3668,152,488,10,90,0,20,933
45019002002,6128,5091,205,456,13,63,5,45,1037
45019002004,1595,1504,13,7,4,8,0,6,91
45019002005,7122,6356,199,201,17,100,1,16,766
45019002006,5022,3956,137,667,12,64,3,9,1066
45019002007,3749,3428,95,27,3,38,0,10,321
45019002008,4703,3374,144,998,5,40,1,14,1329
45019002009,4264,2561,138,1342,10,42,2,9,1703
45019002103,4771,2804,548,1235,14,20,3,13,1967
45019002104,2012,1915,30,20,0,22,0,8,97
45019002105,2184,2109,25,12,2,9,0,0,75
45019002106,3543,2876,166,311,12,40,6,11,667
45019002107,11798,8351,1129,1697,21,85,1,50,3447
45019002108,2742,1906,342,383,4,11,3,16,836
45019002200,2848,1419,82,1234,12,10,0,10,1429
45019002300,1884,1195,65,574,4,2,0,4,689
45019002401,1468,707,37,671,0,3,2,3,761
45019002402,2627,950,106,1468,4,4,0,18,1677
45019002503,2382,1063,124,1121,5,11,2,3,1319
45019002504,5169,2834,438,1733,13,23,0,8,2335
45019002604,3619,2527,239,622,3,110,0,23,1092
45019002605,3907,2050,393,1220,15,52,38,10,1857
45019002606,2130,1868,56,121,0,36,0,3,262
45019002611,3007,2261,132,402,7,58,1,16,746
45019002612,6677,3551,358,2229,11,225,34,15,3126
45019002613,5255,3607,384,860,8,119,2,26,1648
45019002614,3469,2079,156,875,15,140,24,37,1390
45019002701,2597,1040,153,1197,6,88,1,7,1557
45019002702,4679,1532,165,2822,13,22,1,17,3147
45019002801,4409,3435,115,598,7,71,11,14,974
45019002802,2663,2394,94,51,2,32,1,6,269
45019002900,2839,1894,95,672,4,57,2,3,945
45019003000,3897,3544,105,59,5,62,1,6,353
45019003104,5741,1353,2636,1478,10,109,2,15,4388
45019003105,4018,695,1939,1220,3,26,0,15,3323
45019003106,8631,3642,981,3354,35,143,10,35,4989
45019003107,7501,2605,1139,3028,51,210,9,95,4896
45019003108,3797,836,396,2296,16,107,2,14,2961
45019003109,3376,1351,472,1296,13,77,10,14,2025
45019003110,7197,2079,1831,2902,13,94,10,42,5118
45019003111,5102,949,745,3076,13,126,0,21,4153
45019003113,4771,1708,939,1686,15,183,14,19,3063
45019003115,7372,3439,767,2581,34,128,3,66,3933
45019003116,4736,1861,412,1936,14,253,13,53,2875
45019003117,3686,1814,233,1240,14,169,4,20,1872
45019003200,1638,1033,243,176,5,57,16,13,605
45019003300,3763,640,566,2399,12,23,3,13,3123
45019003400,4870,1302,1370,1954,17,69,0,21,3568
45019003500,3333,2689,155,309,9,27,1,14,644
45019003600,2729,1829,158,550,10,50,1,14,900
45019003700,3291,612,232,2297,8,51,1,13,2679
45019003800,3187,465,179,2387,11,25,0,21,2722
45019003900,2973,1414,202,1218,15,45,2,4,1559
45019004000,2411,199,76,2091,0,9,1,2,2212
45019004300,2144,182,89,1825,6,2,0,0,1962
45019004400,2240,346,63,1761,6,11,0,3,1894
45019004607,5719,5108,198,124,7,121,5,11,611
45019004609,7846,5990,331,1137,10,112,2,26,1856
45019004610,5007,3885,203,541,5,191,3,21,1122
45019004612,7245,6286,321,230,6,179,0,26,959
45019004613,1595,1472,25,30,5,14,1,5,123
45019004614,7689,6140,282,818,13,213,0,16,1549
45019004615,5406,4756,183,167,8,91,6,6,650
45019004616,9300,8016,354,346,8,227,2,21,1284
45019004617,9958,8641,408,285,17,252,3,22,1317
45019004618,6534,5583,232,235,11,224,0,27,951
45019004619,5467,4674,168,338,13,125,0,22,793
45019004620,5455,4926,136,119,8,111,1,17,529
45019004621,5968,5237,143,307,8,68,1,20,731
45019004622,4013,3314,126,412,5,41,1,16,699
45019004701,5804,5239,153,212,4,47,4,11,565
45019004702,2332,1912,185,125,2,25,0,2,420
45019004800,1891,1770,47,7,0,16,0,1,121
45019004901,1838,1716,42,5,0,15,0,5,122
45019004902,2509,2369,51,7,2,20,2,11,140
45019005001,1696,935,23,692,2,3,0,2,761
45019005002,3111,1534,37,1472,3,8,0,11,1577
45019005100,1639,1162,35,378,7,7,1,9,477
45019005300,3629,1262,106,2087,10,20,1,12,2367
45019005400,2100,392,69,1570,2,14,1,6,1708
45019005500,1377,201,72,1058,1,7,0,0,1176
45019005601,10428,7368,560,1581,18,438,14,25,3060
45019005602,6558,4730,376,982,11,210,0,22,1828
45019005701,5736,4747,211,398,10,97,1,24,989
45019005702,3790,2913,162,345,4,141,1,19,877
45019005800,8075,5700,526,1228,10,255,0,60,2375
45019005900,5521,4078,173,1008,23,81,5,5,1443
45019990100,0,0,0,0,0,0,0,0,0
45021970101,3514,2990,175,214,8,8,0,8,524
45021970102,4535,3882,211,245,10,52,0,7,653
45021970201,3903,2148,197,1343,11,58,0,24,1755
45021970203,2728,1526,323,756,19,19,0,11,1202
45021970204,4514,3652,323,314,6,63,0,25,862
45021970301,3766,1425,192,1975,9,52,2,14,2341
45021970302,4176,1870,376,1769,4,8,0,4,2306
45021970401,3598,2995,69,326,27,14,2,4,603
45021970403,3035,2500,83,333,0,11,1,9,535
45021970404,3065,2780,84,89,7,14,0,11,285
45021970501,2004,1550,109,254,9,0,0,0,454
45021970502,4532,1620,233,2481,8,12,0,15,2912
45021970503,1231,1090,42,38,0,1,1,3,141
45021970601,5491,4104,185,926,17,14,6,45,1387
45021970602,2440,2285,15,47,4,5,0,4,155
45021970700,3684,3159,160,182,22,10,2,11,525
45023020100,1812,659,52,998,3,16,0,12,1153
45023020200,3126,1012,73,1871,6,24,1,13,2114
45023020300,3377,681,58,2530,6,14,2,9,2696
45023020400,2635,1665,99,725,7,6,0,27,970
45023020500,3138,2206,41,772,17,2,0,3,932
45023020601,2467,1804,41,530,17,5,1,10,663
45023020602,3997,2656,124,1018,19,10,0,11,1341
45023020700,2006,1274,82,496,6,43,0,13,732
45023020800,5285,3685,170,1133,40,14,2,4,1600
45023020900,2289,1717,32,413,19,7,7,14,572
45023021000,2162,1232,23,801,5,5,1,17,930
45025950101,4815,2703,531,1342,14,22,0,9,2112
45025950102,4464,2156,352,1751,23,18,0,8,2308
45025950200,4113,2739,195,957,15,23,0,19,1374
45025950300,2533,1784,109,526,11,5,0,1,749
45025950401,2903,2104,37,652,9,7,0,5,799
45025950402,3756,2463,39,1100,14,13,0,14,1293
45025950501,2034,906,57,951,12,4,2,15,1128
45025950503,2318,1029,31,1086,8,42,0,4,1289
45025950504,3455,1912,78,1204,19,87,2,10,1543
45025950601,1940,966,26,833,18,8,0,9,974
45025950602,3285,1516,86,1529,7,25,0,6,1769
45025950701,3454,2845,250,207,10,3,0,7,609
45025950702,1571,1160,22,307,16,3,0,2,411
45025950800,2632,1546,273,705,8,9,0,9,1086
45027960100,3215,2322,131,688,13,7,0,2,893
45027960201,1590,914,65,573,3,0,0,3,676
45027960300,2041,988,117,867,5,5,1,8,1053
45027960400,2203,969,63,1114,6,8,0,2,1234
45027960500,4553,1060,154,3161,17,43,0,2,3493
45027960600,2640,1097,72,1396,6,7,0,4,1543
45027960701,3486,1725,78,1479,21,90,0,19,1761
45027960702,1123,797,15,265,8,3,0,3,326
45027960703,3473,2716,54,561,14,27,0,3,757
45027960801,2954,837,68,1966,3,19,7,17,2117
45027960802,2851,1612,62,1044,19,16,0,10,1239
45027980000,1015,272,28,707,5,0,0,0,743
45029970100,1718,831,48,766,13,1,1,3,887
45029970200,1571,1107,88,338,7,0,0,1,464
45029970301,3962,2335,107,1279,9,49,0,17,1627
45029970302,1825,518,46,1223,0,0,0,2,1307
45029970401,4294,2721,209,1170,31,1,0,8,1573
45029970402,3655,2429,193,823,23,41,5,13,1226
45029970501,2957,711,71,2070,7,4,0,5,2246
45029970502,2622,1427,107,926,10,59,0,7,1195
45029970601,4508,2750,250,1241,32,4,1,18,1758
45029970602,2927,1153,59,1620,7,6,0,9,1774
45029970701,3187,2271,87,629,29,8,4,7,916
45029970702,2848,2016,88,449,130,9,1,4,832
45029970800,2530,1547,27,867,4,4,4,7,983
45029990100,0,0,0,0,0,0,0,0,0
45031010100,2916,1024,33,1786,6,0,0,1,1892
45031010200,5294,4407,153,545,10,22,0,12,887
45031010300,4790,3326,100,1110,15,62,1,1,1464
45031010400,5888,4664,142,845,20,34,0,13,1224
45031010500,2582,1793,86,560,2,40,0,4,789
45031010600,4652,1875,171,2413,7,37,0,23,2777
45031010700,2222,80,17,2068,0,1,0,2,2142
45031010800,2678,1371,74,1150,4,3,0,1,1307
45031010901,3856,2119,80,1546,11,0,0,10,1737
45031010902,3159,1715,100,1237,10,3,0,25,1444
45031011000,2949,1647,49,1150,9,24,2,0,1302
45031011100,1915,960,37,816,4,18,0,9,955
45031011201,2031,755,28,1176,5,1,0,2,1276
45031011202,2159,1073,39,981,4,1,1,5,1086
45031011301,2581,1183,86,1232,7,8,0,2,1398
45031011302,2275,1169,25,998,3,0,0,7,1106
45031011400,3808,848,72,2810,2,19,0,4,2960
45031011500,4091,2230,63,1632,8,8,0,5,1861
45031011600,3059,1582,41,1331,9,9,0,2,1477
45033970100,3121,1076,187,1563,156,4,0,18,2045
45033970200,5197,2311,247,2246,148,6,0,17,2886
45033970301,2713,2002,43,536,22,37,0,3,711
45033970302,2373,498,30,1709,39,2,0,12,1875
45033970401,2001,489,66,1324,41,1,0,6,1512
45033970402,2162,414,65,1592,27,0,0,0,1748
45033970500,3731,2152,78,1336,51,4,0,4,1579
45033970601,3262,1814,74,1178,70,1,1,2,1448
45033970602,3732,2231,66,1225,49,8,0,13,1501
45035010100,2527,1449,57,923,19,14,1,9,1078
45035010200,4745,2159,79,2264,18,32,6,8,2586
45035010301,2127,1299,52,667,23,1,1,0,828
45035010302,3433,1986,91,1217,28,8,2,10,1447
45035010400,6367,3396,246,2218,239,9,3,17,2971
45035010501,7294,4926,386,1468,32,68,8,22,2368
45035010503,5966,4546,314,733,19,69,2,15,1420
45035010505,6635,4740,460,964,20,76,5,41,1895
45035010506,2060,1355,131,364,18,39,0,8,705
45035010507,2389,1368,127,728,8,24,0,11,1021
45035010508,3691,2414,219,753,31,72,3,26,1277
45035010603,8338,5700,936,1133,50,86,6,35,2638
45035010604,4449,3009,206,924,12,23,4,53,1440
45035010606,1898,1557,42,206,2,13,2,11,341
45035010607,5272,3530,225,1085,21,75,0,23,1742
45035010608,3654,2659,190,511,22,54,2,12,995
45035010700,5738,2962,293,2039,27,47,11,21,2776
45035010801,6861,5323,267,849,21,80,3,21,1538
45035010807,5254,3827,291,700,33,79,7,38,1427
45035010808,7394,5155,435,1252,31,108,16,30,2239
45035010809,3663,2596,224,596,14,42,5,18,1067
45035010813,9041,5483,557,2294,43,112,15,60,3558
45035010814,6622,3963,528,1520,25,153,9,24,2659
45035010815,2986,1585,205,933,13,48,4,12,1401
45035010817,6773,4044,527,1496,8,276,5,36,2729
45035010818,9316,2781,1654,4025,32,321,29,66,6535
45035010819,5009,3062,296,1071,2,254,5,14,1947
45035010820,7209,4003,529,1921,21,294,19,47,3206
45035010821,2322,1467,198,363,13,135,0,21,855
45035010822,3866,2204,307,796,12,264,6,27,1662
45035010823,8641,4597,789,2265,29,410,20,57,4044
45037970201,1800,1286,26,425,5,5,0,0,514
45037970203,2328,1387,50,828,5,9,0,3,941
45037970204,4072,1491,292,2132,25,22,0,4,2581
45037970300,4147,1783,392,1823,3,21,4,5,2364
45037970400,3323,1603,238,1351,9,8,0,11,1720
45037970501,4711,2989,236,1248,11,15,0,50,1722
45037970502,5276,4351,137,494,9,38,2,20,925
45039960100,1803,395,23,1341,3,0,1,2,1408
45039960200,3506,1685,74,1638,8,12,0,1,1821
45039960301,2950,1266,70,1496,12,11,5,3,1684
45039960302,2652,1686,33,797,10,12,0,7,966
45039960401,3714,1082,119,2331,8,51,1,9,2632
45039960402,1845,765,50,949,10,11,0,14,1080
45039960501,2292,1015,43,1159,7,3,0,9,1277
45039960502,2186,609,11,1490,6,1,0,10,1577
45041000101,4006,2584,238,811,17,224,2,9,1422
45041000102,6020,4279,239,1025,0,282,9,9,1741
45041000201,2661,1699,54,664,10,186,0,0,962
45041000202,8528,4767,340,2527,23,541,5,47,3761
45041000300,4278,630,79,3435,14,9,1,15,3648
45041000400,4747,2477,132,1891,13,32,1,15,2270
45041000501,2661,1212,73,1231,11,6,3,53,1449
45041000502,3476,1074,169,2084,15,10,5,2,2402
45041000600,4808,2494,155,1879,7,82,1,9,2314
45041000700,2580,142,34,2323,3,6,1,2,2438
45041000800,3445,38,20,3299,1,0,0,22,3407
45041000900,3118,98,36,2897,3,1,2,0,3020
45041001000,1728,958,68,610,4,22,1,7,770
45041001100,4703,2323,215,1885,7,57,5,17,2380
45041001200,3336,2676,69,441,4,48,0,11,660
45041001300,3792,2319,170,1062,3,105,2,14,1473
45041001400,8460,5255,220,2497,15,252,0,9,3205
45041001503,4018,2131,133,1476,7,146,0,17,1887
45041001504,6791,3285,253,2962,19,90,2,9,3506
45041001505,3612,2284,135,1085,13,14,1,6,1328
45041001506,1907,1125,33,683,6,3,1,1,782
45041001601,6600,2522,222,3631,12,43,0,8,4078
45041001602,4687,3175,152,1163,14,4,1,15,1512
45041001700,2460,1442,47,897,3,2,0,3,1018
45041001800,3331,2161,134,916,10,15,0,10,1170
45041001901,2597,1643,22,857,13,10,1,3,954
45041001902,3452,2299,63,958,10,18,0,8,1153
45041002000,3479,2039,59,1259,8,8,0,15,1440
45041002202,3226,926,40,2161,8,18,0,1,2300
45041002203,3995,778,93,2977,7,33,0,5,3217
45041002204,997,161,44,742,9,9,0,3,836
45041002300,3885,2921,291,555,11,4,0,5,964
45041002400,3629,2356,93,1050,11,14,0,2,1273
45041002500,2713,1772,90,756,13,8,3,4,941
45041002600,3333,976,68,2188,6,7,1,8,2357
45041980100,0,0,0,0,0,0,0,0,0
45043920100,3184,1803,45,1260,0,1,2,3,1381
45043920202,2100,1228,83,728,8,6,0,3,872
45043920203,2474,1965,92,360,4,6,0,3,509
45043920204,2565,695,64,1744,5,1,1,9,1870
45043920301,4552,2306,229,1913,7,17,1,10,2246
45043920302,2921,2119,141,551,10,35,1,2,802
45043920400,2923,819,43,1985,6,5,0,7,2104
45043920502,4189,3540,99,395,5,13,0,12,649
45043920504,5709,4965,123,395,11,28,0,17,744
45043920506,3216,2968,61,86,11,12,0,11,248
45043920507,3772,2828,149,647,6,13,10,8,944
45043920508,3143,2849,80,126,8,12,0,0,294
45043920509,1650,1553,34,20,0,10,1,5,97
45043920510,1935,1803,49,14,5,7,0,0,132
45043920511,3991,3668,82,93,9,37,0,11,323
45043920601,4128,860,168,2957,4,18,6,6,3268
45043920602,2067,887,118,1018,4,0,4,3,1180
45043920701,1919,1320,122,422,1,7,0,6,599
45043920702,3405,1805,331,1159,5,20,1,7,1600
45043920800,3561,1205,112,2178,2,10,0,7,2356
45043990100,0,0,0,0,0,0,0,0,0
45045000100,2643,1883,159,493,3,29,2,6,760
45045000200,1530,1295,62,81,0,40,3,0,235
45045000400,1404,1121,59,142,5,30,0,0,283
45045000500,1387,609,67,669,3,7,0,8,778
45045000700,3318,1789,214,1137,6,57,0,8,1529
45045000800,1343,219,254,806,12,2,0,2,1124
45045000900,1189,467,59,601,3,8,0,3,722
45045001000,2210,1605,105,406,1,21,0,1,605
45045001101,4269,3652,174,183,10,62,33,15,617
45045001102,1855,1597,63,86,1,14,1,21,258
45045001203,2353,1900,151,72,1,138,6,16,453
45045001204,3008,1831,214,790,2,60,5,8,1177
45045001205,1402,683,120,510,4,29,6,10,719
45045001302,1534,1339,69,69,2,3,0,14,195
45045001400,3832,3242,131,309,4,33,2,8,590
45045001501,4383,3996,107,142,3,28,0,3,387
45045001502,2668,544,198,1829,5,9,6,8,2124
45045001600,4795,3687,508,276,4,111,10,13,1108
45045001700,4440,2297,1304,459,13,167,0,18,2143
45045001803,4115,2602,704,472,6,169,0,14,1513
45045001804,4982,3515,466,543,8,252,11,20,1467
45045001805,4699,3678,362,311,9,155,4,24,1021
45045001807,5704,3873,640,784,16,133,10,28,1831
45045001808,4331,2544,409,957,8,158,5,31,1787
45045001809,3337,2074,412,607,4,107,1,21,1263
45045001810,3400,1553,790,789,1,102,14,27,1847
45045001900,7665,5988,286,963,7,175,6,24,1677
45045002001,2898,270,385,2131,0,8,1,19,2628
45045002003,4827,966,1774,1906,8,11,1,25,3861
45045002005,3767,907,428,2219,10,25,1,18,2860
45045002103,3475,1866,625,892,3,9,2,5,1609
45045002104,1542,505,481,507,1,4,0,8,1037
45045002105,2859,876,793,1080,1,11,0,4,1983
45045002106,3628,1393,1046,1012,10,11,5,24,2235
45045002107,2676,1298,458,785,7,11,6,8,1378
45045002108,1513,834,120,473,1,5,3,4,679
45045002202,2768,886,915,875,3,11,0,4,1882
45045002203,3265,1229,1385,506,6,10,0,9,2036
45045002204,3099,1157,1523,309,10,10,0,9,1942
45045002301,4024,2381,921,522,9,36,3,6,1643
45045002302,3993,1782,1168,840,5,41,4,19,2211
45045002303,1845,563,715,492,4,5,0,6,1282
45045002304,2846,955,371,1374,0,30,7,16,1891
45045002403,4524,4140,161,44,4,13,0,18,384
45045002404,4085,3836,98,24,6,15,2,0,249
45045002405,7757,6658,453,215,18,57,4,23,1099
45045002406,1790,1441,165,100,9,15,0,9,349
45045002503,11447,7703,1488,1024,20,722,2,47,3744
45045002504,1796,961,226,524,3,11,1,0,835
45045002505,3662,1745,1012,731,7,24,0,8,1917
45045002506,4003,3328,225,211,3,38,2,20,675
45045002507,5142,3747,527,612,6,51,6,26,1395
45045002602,4295,2870,602,436,13,193,0,27,1425
45045002604,6557,4004,765,1159,7,314,0,58,2553
45045002606,6599,5674,392,251,7,37,4,33,925
45045002609,7094,5468,480,620,6,252,4,25,1626
45045002610,3069,1958,404,447,2,93,0,18,1111
45045002611,5885,4252,504,779,18,95,3,13,1633
45045002612,8199,5649,661,526,11,945,0,48,2550
45045002613,1711,1462,75,46,0,60,0,5,249
45045002701,4551,3972,188,115,11,39,4,21,579
45045002703,5402,4521,276,240,4,99,0,18,881
45045002704,2370,1772,197,207,11,72,0,11,598
45045002804,2418,2153,59,62,1,56,0,11,265
45045002805,5340,3849,380,633,4,217,1,39,1491
45045002811,10439,6398,915,1971,10,637,41,50,4041
45045002812,7396,5431,515,599,7,501,0,41,1965
45045002813,4529,3697,204,143,5,289,0,23,832
45045002814,6513,5097,344,301,15,453,3,35,1416
45045002815,6313,5126,295,282,16,321,4,40,1187
45045002817,4766,3972,227,177,2,185,1,29,794
45045002818,3291,1956,314,523,9,368,0,6,1335
45045002819,5254,3677,343,782,10,260,2,17,1577
45045002820,2587,1399,149,438,12,499,2,16,1188
45045002821,6556,4609,626,697,9,275,4,46,1947
45045002822,6757,4758,630,616,9,424,5,35,1999
45045002901,6059,2534,731,2355,3,111,6,79,3525
45045002903,7366,4281,732,1848,14,142,14,34,3085
45045002904,5864,3090,624,1688,6,187,0,33,2774
45045002905,4946,2863,508,1253,9,84,4,18,2083
45045003005,2779,1667,316,609,2,52,0,23,1112
45045003008,7245,5829,352,518,8,219,0,49,1416
45045003009,9608,7402,699,809,15,229,13,43,2206
45045003010,8180,5820,755,1060,13,170,3,31,2360
45045003011,5747,4005,416,934,16,102,0,29,1742
45045003012,5806,3347,777,1281,14,56,11,43,2459
45045003013,8256,5055,835,1744,12,158,8,38,3201
45045003014,6464,4341,626,1072,25,135,1,13,2123
45045003016,5131,3727,355,687,9,91,4,29,1404
45045003017,5545,3988,428,776,5,101,5,30,1557
45045003101,8662,4905,866,2446,12,64,7,38,3757
45045003103,2902,2294,234,241,2,13,2,9,608
45045003104,2597,2165,183,138,4,19,1,6,432
45045003202,3620,3125,146,167,6,13,0,25,495
45045003203,3948,2799,157,813,7,7,1,21,1149
45045003204,1746,1497,80,102,4,5,0,4,249
45045003301,6571,4327,473,1366,19,27,1,28,2244
45045003303,5732,3169,377,1765,10,52,2,35,2563
45045003304,8367,3562,1133,3133,13,93,9,64,4805
45045003401,1111,319,192,550,0,3,2,4,792
45045003500,2870,1295,483,960,4,2,3,9,1575
45045003601,6215,2454,1675,1804,5,15,0,19,3761
45045003602,2664,562,700,1280,7,16,0,13,2102
45045003701,5792,3819,840,780,13,64,4,34,1973
45045003704,4057,1291,1851,781,5,38,0,13,2766
45045003705,2022,1022,677,208,6,25,5,6,1000
45045003706,3683,1330,1241,921,7,57,3,3,2353
45045003707,4280,2281,854,818,7,73,6,17,1999
45045003802,6074,4412,468,848,9,81,9,10,1662
45045003803,4575,3982,151,196,5,122,0,9,593
45045003804,2805,2107,248,240,4,51,6,15,698
45045003902,4091,3555,171,135,9,24,4,5,536
45045003903,4470,3884,155,127,25,17,2,20,586
45045003905,4317,3478,193,385,8,13,4,25,839
45045003906,2535,1742,165,441,10,33,1,18,793
45045004001,3206,2813,101,130,16,19,0,4,393
45045004003,3676,3108,170,184,12,16,1,8,568
45045004004,1793,1679,38,14,1,3,0,8,114
45045004101,3867,3259,268,141,4,13,0,6,608
45045004102,1069,986,28,6,1,3,0,2,83
45045004200,2453,2167,70,117,1,24,2,6,286
45045004300,3891,968,112,2648,4,21,0,16,2923
45045004400,1959,858,276,661,8,45,1,2,1101
45047970101,3503,2441,100,791,1,17,1,14,1062
45047970102,4506,3294,106,906,8,18,0,15,1212
45047970201,5913,4113,145,1393,9,60,5,13,1800
45047970202,6853,3853,328,2234,17,144,13,13,3000
45047970301,4874,3163,429,1097,14,53,4,3,1711
45047970303,3043,1795,105,892,12,113,4,8,1248
45047970304,3070,2475,79,298,1,112,5,10,595
45047970401,2733,1384,264,996,6,16,0,4,1349
45047970402,3490,2868,91,359,1,44,0,14,622
45047970500,4443,357,1030,2922,2,8,0,22,4086
45047970601,4133,2181,703,1127,5,4,1,8,1952
45047970602,3390,1594,140,1523,2,15,2,8,1796
45047970701,2375,2052,49,191,1,15,1,11,323
45047970702,5260,3088,165,1747,7,22,2,18,2172
45047970801,4595,1475,687,2270,3,15,3,5,3120
45047970802,3340,1602,168,1443,3,15,0,3,1738
45047970900,1934,1288,112,465,5,0,0,5,646
45047971000,1896,1602,48,166,5,7,0,11,294
45049920100,2281,1546,32,621,2,19,1,0,735
45049920201,3663,1452,64,2030,14,19,4,7,2211
45049920202,2847,1414,59,1251,0,35,8,8,1433
45049920300,2270,820,40,1320,8,1,2,20,1450
45049920401,1829,315,324,1156,9,14,0,0,1514
45049920402,4120,1937,114,1983,2,12,2,1,2183
45049920500,1551,318,33,1175,6,0,0,4,1233
45051010100,2909,2067,184,569,19,3,2,0,842
45051020100,2865,2036,65,617,13,3,0,4,829
45051020201,3147,1737,141,1149,11,11,0,2,1410
45051020202,3160,1804,123,1077,13,33,3,7,1356
45051020301,4367,3435,171,580,12,9,4,0,932
45051020302,3231,2102,160,825,23,14,2,14,1129
45051030102,3837,2750,195,668,15,11,1,10,1087
45051030104,5686,3888,222,1314,18,39,3,13,1798
45051040101,6408,5023,243,764,27,99,0,19,1385
45051040102,6282,4504,429,1051,28,43,15,20,1778
45051040103,6927,5651,321,524,33,101,8,21,1276
45051040104,3564,2954,177,243,21,24,5,7,610
45051040105,2793,2553,77,60,18,11,0,0,240
45051040200,4425,3876,179,187,23,22,1,15,549
45051040300,4997,4613,109,85,19,46,0,7,384
45051040400,4346,3685,309,135,22,45,7,22,661
45051040500,3803,3238,211,188,4,36,0,27,565
45051050102,3748,3243,143,161,13,83,0,22,505
45051050200,2006,1850,53,26,6,28,0,0,156
45051050303,3231,2919,76,57,8,54,0,10,312
45051050401,3285,2318,415,325,15,66,0,18,967
45051050402,2147,1926,101,41,4,20,0,8,221
45051050500,4619,3601,341,348,17,70,3,17,1018
45051050600,5196,1378,890,2146,8,282,8,50,3818
45051050700,1795,831,341,460,10,15,5,22,964
45051050901,2368,1494,260,351,14,64,0,27,874
45051050902,4139,1624,1453,732,15,62,20,46,2515
45051051000,7115,6082,321,264,10,121,1,18,1033
45051051201,1653,1522,33,21,9,10,3,1,131
45051051202,2469,2280,57,25,6,11,5,5,189
45051051301,1526,1421,27,4,1,5,0,9,105
45051051302,2770,2566,63,13,1,6,0,7,204
45051051403,5386,4556,266,155,5,148,3,14,830
45051051404,4109,3517,151,150,12,78,38,8,592
45051051405,3693,3242,158,88,5,34,15,12,451
45051051406,3311,3080,78,51,9,9,0,12,231
45051051501,3894,2876,406,264,25,76,14,8,1018
45051051502,8703,6341,694,937,25,200,9,44,2362
45051051503,4305,2165,1663,182,15,86,8,13,2140
45051051603,6790,5890,289,299,12,54,2,26,900
45051051605,7887,6737,271,419,11,102,11,31,1150
45051051606,5577,4321,628,261,20,63,0,13,1256
45051051607,6269,4822,501,436,19,155,8,20,1447
45051051608,5915,5507,134,94,6,36,3,16,408
45051051609,5974,5267,242,161,13,76,9,15,707
45051051700,2035,1707,58,145,13,21,0,2,328
45051060101,5537,3678,369,1154,23,63,1,34,1859
45051060102,3062,2143,604,126,12,15,0,7,919
45051060203,9445,7392,778,595,20,119,11,62,2053
45051060204,9668,7418,879,713,36,118,3,60,2250
45051060206,8668,6525,749,752,30,209,8,42,2143
45051060207,7842,6206,518,396,16,244,3,74,1636
45051060209,7589,5741,460,742,16,210,8,55,1848
45051060210,3598,2746,235,211,18,114,3,47,852
45051060211,2664,1978,137,246,2,44,0,40,686
45051060301,4780,3549,190,786,13,26,0,9,1231
45051060303,3584,3276,96,77,3,23,4,8,308
45051060309,3055,2533,149,171,23,43,3,14,522
45051060310,6273,4397,286,1152,13,120,5,31,1876
45051060403,3402,2231,613,339,36,34,3,13,1171
45051060404,2658,2005,147,327,6,39,0,8,653
45051060405,7690,5131,745,1374,15,101,3,33,2559
45051060406,7005,5726,459,360,12,129,2,34,1279
45051070101,4971,3811,210,673,18,33,2,13,1160
45051070102,3657,2819,232,403,20,8,0,8,838
45051070200,3068,2298,254,366,5,29,3,6,770
45051070300,4075,2215,172,1386,23,73,0,5,1860
45051070400,6193,2875,265,2777,10,42,4,13,3318
45051070500,3447,1830,143,1292,11,14,7,21,1617
45051070601,4738,3735,231,452,20,28,0,19,1003
45051070602,4536,2947,204,1168,9,18,0,15,1589
45051070701,6589,4796,394,1007,33,45,11,27,1793
45051070702,5932,3927,877,843,19,16,0,20,2005
45051080101,3939,3345,188,296,32,0,0,6,594
45051080102,3306,2792,70,301,21,10,0,2,514
45051080200,5175,4478,211,230,13,16,3,10,697
45051980100,221,187,10,0,0,10,0,4,34
45051990100,0,0,0,0,0,0,0,0,0
45053950100,5047,2314,463,2065,7,9,6,25,2733
45053950201,7760,5188,729,1556,8,56,4,26,2572
45053950203,4672,1449,849,2247,11,25,3,11,3223
45053950204,3266,1398,591,1145,3,31,5,6,1868
45053950301,3839,1496,1191,1001,4,29,3,12,2343
45053950302,4207,1211,1256,1545,26,37,2,28,2996
45053990100,0,0,0,0,0,0,0,0,0
45055970100,2634,1775,94,661,5,8,0,11,859
45055970200,2928,2453,79,262,20,9,0,9,475
45055970300,2330,1741,42,461,2,8,0,4,589
45055970401,4855,3794,135,633,25,19,0,14,1061
45055970402,2988,2016,95,742,5,10,0,6,972
45055970403,2204,1540,110,435,0,16,0,12,664
45055970500,6087,3724,267,1828,15,44,1,24,2363
45055970601,4689,3101,339,1012,2,25,0,32,1588
45055970603,3983,2313,278,1205,11,9,1,14,1670
45055970604,2730,1966,149,502,6,0,0,6,764
45055970700,1612,928,54,588,1,3,0,8,684
45055970800,6303,3213,334,2513,2,43,0,21,3090
45055970902,3060,2137,256,464,9,22,0,25,923
45055970905,2913,2217,147,379,1,40,2,1,696
45055970906,4025,2464,253,995,11,66,14,19,1561
45055970907,4962,3281,297,1035,17,37,7,13,1681
45055970908,3419,2313,150,730,2,34,0,14,1106
45055970909,3681,2415,387,638,12,24,4,6,1266
45057010100,3680,3127,78,285,10,6,0,17,553
45057010201,3559,2199,95,1147,4,5,0,2,1360
45057010202,4002,2947,59,805,21,10,1,14,1055
45057010300,5385,3711,128,1355,11,10,0,32,1674
45057010400,3125,1927,192,902,3,13,1,4,1198
45057010500,5056,2375,676,1778,8,8,0,20,2681
45057010600,5481,3016,588,1677,16,8,0,16,2465
45057010700,3623,576,246,2642,9,11,0,8,3047
45057010800,2356,929,236,1080,11,11,0,9,1427
45057010900,3848,2638,290,716,9,72,0,4,1210
45057011001,5557,4030,155,1110,23,28,0,12,1527
45057011002,4474,3489,169,610,18,4,0,3,985
45057011100,5190,3425,183,1355,2,24,0,25,1765
45057011203,3415,2168,297,357,4,399,0,20,1247
45057011204,6624,4728,671,499,6,382,0,45,1896
45057011205,6621,4628,672,696,12,283,0,28,1993
45057011206,1599,1240,110,111,4,35,4,7,359
45057011207,3551,2665,317,324,15,84,0,11,886
45057011208,5099,4004,388,370,6,158,5,15,1095
45057011209,8975,7692,263,646,20,132,0,24,1283
45057011210,4338,3109,468,514,7,81,3,19,1229
45057011211,458,304,13,122,1,1,0,2,154
45059920102,1751,1372,116,153,3,7,0,6,379
45059920104,3431,2847,199,209,2,12,0,9,584
45059920105,5116,3058,524,1282,16,12,12,13,2058
45059920106,3325,2302,339,453,2,11,1,21,1023
45059920107,2256,1675,154,317,5,5,0,8,581
45059920108,2345,1326,258,631,10,0,1,17,1019
45059920201,3196,2815,70,178,9,1,0,6,381
45059920202,3306,2994,55,106,13,3,1,9,312
45059920301,3843,2748,130,839,9,11,0,10,1095
45059920302,4315,2202,236,1719,2,26,0,16,2113
45059920400,5367,2693,373,2086,8,34,0,24,2674
45059920501,1799,1301,47,349,6,12,0,7,498
45059920503,2858,1154,775,822,8,6,2,8,1704
45059920504,3081,1968,186,769,4,7,5,13,1113
45059920600,4264,2981,102,1018,7,28,1,18,1283
45059920700,4426,1659,102,2426,16,43,0,20,2767
45059920800,5090,3726,192,956,2,60,1,16,1364
45059920900,2395,1779,159,357,4,9,0,8,616
45059921001,2643,1776,52,694,10,4,0,1,867
45059921002,2732,1982,78,573,8,4,0,8,750
45061920100,1476,757,47,601,14,2,0,4,719
45061920201,2180,1227,18,870,8,0,0,0,953
45061920202,2126,652,28,1383,2,12,0,2,1474
45061920301,215,29,8,177,0,0,0,0,186
45061920302,4350,856,73,3327,6,2,0,6,3494
45061920401,2363,972,58,1269,7,1,0,1,1391
45061920402,1193,674,37,436,7,2,0,2,519
45061920500,1361,359,17,964,1,2,0,0,1002
45061920600,1267,195,9,1027,4,13,0,0,1072
45063020100,2549,1231,147,965,13,64,0,7,1318
45063020201,2535,1899,149,295,6,83,1,4,636
45063020202,2168,1181,99,677,6,98,0,8,987
45063020300,4333,2847,440,601,6,242,4,24,1486
45063020505,3846,1691,961,965,18,50,0,10,2155
45063020506,4562,3118,577,570,7,128,1,12,1444
45063020508,2086,1839,48,109,2,34,0,4,247
45063020509,3146,1895,243,700,11,132,1,11,1251
45063020510,4644,2148,282,1842,3,175,14,18,2496
45063020511,2981,1215,193,1248,7,116,5,26,1766
45063020512,3249,2323,207,521,4,62,1,11,926
45063020513,3271,1680,848,508,3,54,0,8,1591
45063020601,3965,2396,401,870,20,67,0,26,1569
45063020602,4415,3111,515,551,16,53,0,10,1304
45063020604,3352,2190,340,620,3,72,0,12,1162
45063020605,2397,1597,113,522,6,61,0,7,800
45063020703,4341,3098,252,681,18,44,3,12,1243
45063020705,3719,1840,432,1218,13,26,0,22,1879
45063020706,2977,617,429,1787,7,25,0,17,2360
45063020707,3753,2265,446,827,10,33,4,19,1488
45063020708,2470,1929,146,229,1,20,0,4,541
45063020801,1437,1002,61,298,10,7,0,3,435
45063020802,2798,1866,197,562,21,20,1,10,932
45063020803,3320,2304,205,638,8,12,5,9,1016
45063020804,2828,1784,489,391,11,8,1,12,1044
45063020806,2633,1701,450,315,11,7,0,8,932
45063020807,2862,1700,557,470,10,0,2,11,1162
45063020904,2974,2379,194,242,15,19,0,6,595
45063020905,3677,2577,375,506,18,14,5,18,1100
45063020906,3992,3242,271,163,20,6,2,36,750
45063020908,3828,2792,202,497,13,84,1,9,1036
45063020909,2570,2053,148,212,12,8,0,11,517
45063020910,2381,1908,287,36,19,6,1,4,473
45063020911,2187,1763,174,129,12,3,5,3,424
45063020912,3042,1721,228,831,12,63,1,13,1321
45063020913,2429,1473,146,663,2,39,1,13,956
45063021019,2529,1809,103,200,7,304,1,11,720
45063021020,4125,3074,299,399,17,104,0,35,1051
45063021021,1957,1790,62,13,3,14,0,5,167
45063021023,3018,2339,181,261,9,83,4,18,679
45063021025,3879,3583,81,32,8,58,2,16,296
45063021028,3785,2808,182,525,10,88,4,17,977
45063021029,2995,1969,142,693,10,67,2,1,1026
45063021030,5186,3758,332,661,5,213,0,17,1428
45063021031,4224,3357,204,298,10,159,9,21,867
45063021032,4006,3260,158,190,8,265,4,2,746
45063021033,4420,3058,370,688,26,54,4,32,1362
45063021034,4766,3391,301,727,17,85,0,16,1375
45063021035,3006,2213,180,396,9,16,0,13,793
45063021036,4486,3057,436,695,26,41,0,20,1429
45063021037,4189,3022,286,550,11,57,0,24,1167
45063021038,4294,2838,336,344,0,554,0,16,1456
45063021039,4102,3530,105,71,3,233,1,13,572
45063021040,5274,4030,293,433,12,253,0,24,1244
45063021041,2786,2125,153,328,4,48,1,9,661
45063021042,3072,2333,161,348,15,24,3,7,739
45063021043,2879,2077,171,416,9,57,4,14,802
45063021044,2622,1939,191,337,6,23,3,14,683
45063021045,3395,2618,181,347,6,86,9,19,777
45063021046,2656,2283,108,95,3,45,0,16,373
45063021047,3116,2693,122,63,10,119,0,6,423
45063021048,2590,2103,125,133,9,109,0,11,487
45063021049,2790,2099,139,178,4,256,10,1,691
45063021050,2452,1820,418,66,2,77,1,9,632
45063021051,2428,1748,153,349,8,26,0,6,680
45063021052,2948,2141,254,351,29,7,0,10,807
45063021106,2750,1867,95,611,4,59,6,13,883
45063021109,3264,2053,135,802,6,104,4,16,1211
45063021110,2819,1913,140,557,9,65,0,8,906
45063021111,2449,1157,138,942,11,48,20,16,1292
45063021112,2730,1814,117,541,12,137,3,9,916
45063021113,3156,1766,199,906,18,106,21,17,1390
45063021114,3668,2957,107,349,9,101,0,8,711
45063021115,2700,2033,110,312,12,126,2,14,667
45063021116,3183,2127,194,613,3,86,0,14,1056
45063021204,4873,3887,291,387,5,114,0,8,986
45063021205,3336,3073,90,43,6,26,2,9,263
45063021206,3208,2689,103,251,7,29,1,12,519
45063021207,2248,2068,57,32,4,22,0,1,180
45063021208,4582,4040,175,163,6,37,0,6,542
45063021303,4577,4286,72,48,8,29,0,8,291
45063021305,3002,2421,154,279,8,5,0,7,581
45063021306,3997,3251,401,156,26,10,0,10,746
45063021307,1854,1439,181,111,10,10,0,5,415
45063021309,1894,1731,75,18,2,2,0,0,163
45063021310,2549,2063,229,141,8,28,0,14,486
45063021311,2405,1948,235,114,7,4,0,6,457
45063021312,1992,1432,248,234,15,3,0,13,560
45063021402,3835,1888,262,1557,7,23,3,2,1947
45063021403,2178,1560,328,194,8,3,0,2,618
45063021404,3047,2150,181,574,13,7,2,10,897
45063980100,3,1,1,1,0,0,0,0,2
45065920100,2531,1968,32,448,5,11,0,8,563
45065920200,4978,1977,56,2791,11,18,2,14,3001
45065920300,2017,1210,35,677,11,7,0,10,807
45067950100,4139,1661,49,2297,12,12,0,0,2478
45067950200,6195,2520,124,3273,31,70,0,16,3675
45067950300,2614,828,35,1679,13,4,0,4,1786
45067950400,3147,1329,59,1625,15,11,0,2,1818
45067950500,4301,2175,132,1833,20,26,0,5,2126
45067950600,5467,1405,127,3755,12,1,0,15,4062
45067950700,1340,449,18,841,4,0,0,0,891
45067950800,1980,713,166,1030,2,4,0,0,1267
45069960100,3263,1802,37,1146,99,7,0,8,1461
45069960201,3905,913,37,2799,33,16,2,3,2992
45069960202,1944,683,16,1103,64,2,0,8,1261
45069960301,4258,1552,57,2425,25,51,1,1,2706
45069960302,4875,1523,338,2814,63,13,2,9,3352
45069960400,4393,2232,41,1221,644,10,2,10,2161
45069960500,1973,586,32,1163,124,0,0,0,1387
45069960600,2056,1265,17,631,78,0,0,0,791
45071950100,3643,2694,196,628,11,5,0,14,949
45071950201,2413,929,573,854,9,2,0,10,1484
45071950203,3723,1547,684,1348,12,35,0,4,2176
45071950204,4003,2577,489,775,11,29,1,4,1426
45071950300,3165,2247,74,703,17,6,1,9,918
45071950502,5560,1551,624,3115,12,22,2,4,4009
45071950601,4939,3307,288,1159,10,14,0,19,1632
45071950603,2571,2067,56,359,2,8,0,1,504
45071950604,3809,3355,70,250,13,10,0,2,454
45071950700,3893,2361,251,1169,10,4,0,5,1532
45073030100,4164,3875,88,13,4,6,1,12,289
45073030201,2500,2318,45,8,7,6,0,1,182
45073030202,3739,3573,54,8,2,17,0,6,166
45073030301,2011,1773,114,8,9,7,0,1,238
45073030302,5175,4755,133,27,13,21,0,15,420
45073030402,2212,1849,203,45,4,8,0,0,363
45073030403,2598,1587,769,85,10,14,1,9,1011
45073030404,4142,3177,610,116,9,9,3,5,965
45073030500,4757,4065,303,149,20,20,0,3,692
45073030601,4845,3984,191,370,9,97,0,12,861
45073030602,4869,3939,221,332,6,97,1,14,930
45073030701,3592,1999,273,1049,15,23,1,24,1593
45073030702,6761,4997,270,975,2,141,2,12,1764
45073030801,3211,2340,184,468,7,16,0,16,871
45073030802,4415,3030,266,873,11,56,4,14,1385
45073030901,3148,2905,59,38,8,10,0,8,243
45073030903,4688,4250,138,82,5,13,3,7,438
45073030904,3020,2696,83,87,7,12,0,1,324
45073031000,5143,4284,275,319,10,14,0,5,859
45073031100,3617,3300,105,67,18,4,0,17,317
45075010101,1729,515,24,1145,6,1,0,4,1214
45075010102,1098,186,21,862,6,0,0,0,912
45075010103,865,754,11,60,12,1,0,1,111
45075010104,967,485,19,416,5,12,0,0,482
45075010200,4730,1492,75,2942,85,23,0,3,3238
45075010301,1185,279,33,837,6,4,0,0,906
45075010302,1054,228,11,779,14,1,0,2,826
45075010303,689,202,19,442,6,4,0,2,487
45075010304,1376,61,11,1256,3,12,0,5,1315
45075010305,1240,943,17,181,8,46,0,5,297
45075010400,3464,1223,45,2067,11,10,0,9,2241
45075010500,3233,1274,80,1785,6,3,0,11,1959
45075010601,1067,363,49,618,2,3,0,0,704
45075010602,760,256,65,413,1,2,0,3,504
45075010603,1371,209,70,1047,8,13,0,6,1162
45075010604,1002,23,58,900,0,2,2,1,979
45075010700,2742,752,44,1873,12,6,0,8,1990
45075010801,1107,10,7,1076,2,2,0,0,1097
45075010802,1142,46,17,1047,0,2,0,0,1096
45075010803,1941,515,13,1355,7,15,0,6,1426
45075010901,1786,855,26,789,2,64,0,8,931
45075010902,6374,1993,244,3789,31,154,1,19,4381
45075011000,5905,1201,100,4136,15,313,19,20,4704
45075011100,2760,161,12,2497,6,28,9,10,2599
45075011200,2743,40,34,2594,19,23,0,5,2703
45075011300,3036,273,77,2612,5,4,0,7,2763
45075011400,3359,792,79,2316,14,62,1,9,2567
45075011500,3161,1035,76,1928,4,8,0,7,2126
45075011600,6060,2717,319,2703,37,9,2,21,3343
45075011701,680,421,4,227,4,4,0,4,259
45075011702,1530,883,10,587,11,9,0,0,647
45075011703,1233,912,54,225,0,1,0,3,321
45075011704,1092,729,20,292,12,1,0,2,363
45075011801,993,565,24,370,6,0,1,1,428
45075011802,1131,452,6,636,0,3,0,2,679
45075011803,763,394,5,329,8,7,0,2,369
45075011804,1180,532,22,577,12,6,0,2,648
45075011900,3952,2280,87,1377,51,8,0,6,1672
45075012000,3723,1736,79,1717,30,26,2,6,1987
45077010100,3265,3050,70,30,7,7,1,11,215
45077010201,1466,1377,26,8,2,3,0,11,89
45077010202,3336,3021,83,25,7,9,0,8,315
45077010301,3397,3169,49,12,6,17,0,13,228
45077010302,2731,2507,46,22,4,7,0,9,224
45077010401,2010,1845,42,0,4,0,1,6,165
45077010403,2158,1979,44,31,3,6,0,2,179
45077010404,2346,1722,95,384,2,6,0,7,624
45077010405,3471,3117,85,63,19,9,0,8,354
45077010501,2968,2746,60,14,3,11,0,1,222
45077010502,3482,3088,92,132,3,2,2,3,394
45077010601,3620,3292,99,61,12,10,3,0,328
45077010603,3745,3277,169,77,18,9,8,8,468
45077010604,3870,3184,254,221,13,26,1,11,686
45077010700,4447,3832,220,125,15,18,0,17,615
45077010802,3631,2691,219,515,2,29,1,15,940
45077010803,4507,3256,467,495,16,3,1,14,1251
45077010804,3778,2926,237,411,0,13,2,13,852
45077010805,2731,1861,263,454,8,7,0,7,870
45077010806,2153,1570,219,252,8,6,0,14,583
45077010901,5413,4371,374,404,8,41,1,14,1042
45077010903,6130,4807,522,421,7,120,1,26,1323
45077010904,3836,3233,189,199,1,73,0,4,603
45077010905,3826,3074,154,361,4,48,1,24,752
45077011001,3199,2733,161,85,13,9,0,12,466
45077011003,2630,2347,125,35,3,6,0,6,283
45077011004,4021,3480,158,152,11,19,0,3,541
45077011005,2802,2331,119,158,26,9,0,11,471
45077011101,2650,2134,128,178,3,94,2,5,516
45077011103,1223,1123,32,33,0,5,0,0,100
45077011104,4553,2940,261,643,12,433,7,24,1613
45077011105,3102,2021,372,502,15,61,0,20,1081
45077011202,6309,4922,333,565,13,172,4,8,1387
45077011204,5688,3827,280,640,17,672,0,26,1861
45077011205,5597,4658,244,189,11,281,0,42,939
45077011206,3537,2749,147,336,4,152,1,17,788
45077011207,3776,2987,134,188,4,330,0,6,789
45079000100,2176,251,92,1746,5,15,0,3,1925
45079000200,1385,242,41,1028,5,11,0,2,1143
45079000300,2528,199,107,2147,3,7,1,0,2329
45079000400,1905,683,50,1069,7,22,0,7,1222
45079000500,2163,80,71,1913,11,35,0,5,2083
45079000600,2332,1557,76,568,4,43,0,4,775
45079000700,1722,1225,58,323,2,21,0,4,497
45079000900,2160,65,28,2017,2,5,0,0,2095
45079001000,2692,621,49,1870,1,57,4,6,2071
45079001100,3817,1813,148,1689,1,29,4,8,2004
45079001200,1791,1567,44,101,9,22,7,7,224
45079001300,1713,208,36,1387,5,11,0,11,1505
45079001600,2272,1499,177,347,2,133,3,15,773
45079002100,2808,2206,88,352,2,65,0,10,602
45079002200,1273,966,32,202,3,21,0,1,307
45079002300,2421,2270,74,30,3,12,0,4,151
45079002400,4732,4026,294,224,0,59,3,0,706
45079002500,3660,3060,145,257,3,68,1,17,600
45079002602,2951,2153,136,474,1,52,1,9,798
45079002605,5467,2582,454,2115,21,74,4,11,2885
45079002700,2647,2141,93,100,0,238,3,3,506
45079002800,7956,6075,444,653,13,491,1,19,1881
45079002900,5124,3970,238,396,3,284,5,5,1154
45079003000,2701,2057,123,305,3,113,3,9,644
45079003100,3264,2158,193,551,1,228,1,16,1106
45079010104,5057,2586,256,1850,12,74,5,40,2471
45079010105,7088,1852,548,4157,16,165,7,31,5236
45079010106,5267,2497,254,2088,14,161,3,27,2770
45079010107,10964,4615,568,4891,13,315,18,69,6349
45079010108,5667,1064,332,3931,8,89,0,29,4603
45079010109,7125,1174,425,4915,12,270,27,41,5951
45079010200,6066,2868,282,2659,14,46,6,29,3198
45079010304,7646,2897,431,3716,19,183,19,63,4749
45079010305,7165,3758,416,2353,27,164,8,52,3407
45079010308,5687,3731,215,1276,12,227,5,26,1956
45079010310,5170,4392,166,283,4,111,3,12,778
45079010311,7162,5287,279,879,14,421,0,39,1875
45079010312,6149,4455,249,909,8,217,0,15,1694
45079010313,5650,4624,172,504,8,87,1,9,1026
45079010314,4523,2770,205,1163,11,121,5,26,1753
45079010315,4472,2153,178,1833,11,53,9,38,2319
45079010403,4073,1479,150,2157,11,76,0,20,2594
45079010407,4179,745,112,3091,9,44,5,17,3434
45079010408,4495,2013,119,2323,12,8,0,0,2482
45079010411,3325,584,129,2393,6,72,1,20,2741
45079010412,3428,869,153,2194,5,86,0,12,2559
45079010413,2061,498,114,1343,5,29,0,11,1563
45079010414,5730,1012,351,3749,13,336,1,29,4718
45079010501,1674,710,89,713,0,68,1,7,964
45079010502,1101,41,4,1033,3,0,0,2,1060
45079010600,4382,240,185,3781,2,27,13,10,4142
45079010701,2677,79,126,2389,0,10,0,6,2598
45079010702,3397,173,195,2945,5,6,2,0,3224
45079010703,3064,38,80,2852,2,0,1,7,3026
45079010803,2056,300,228,1414,4,58,1,5,1756
45079010804,2142,165,57,1846,8,5,3,3,1977
45079010805,2531,249,244,1935,3,35,0,15,2282
45079010806,1176,493,75,595,3,1,2,1,683
45079010900,2786,32,71,2619,6,3,0,0,2754
45079011000,1296,67,37,1147,3,4,0,8,1229
45079011101,3549,1955,170,1213,7,32,8,10,1594
45079011102,3881,2988,194,516,5,64,2,11,893
45079011201,2040,1802,46,118,2,25,2,3,238
45079011202,3625,2755,95,581,8,45,4,13,870
45079011303,5265,826,329,3560,34,296,6,42,4439
45079011304,5118,694,666,3381,4,162,3,22,4424
45079011305,5058,984,1277,2429,15,140,13,27,4074
45079011306,3582,2412,150,766,8,108,5,10,1170
45079011307,2952,1356,264,1148,4,58,4,18,1596
45079011407,5878,2755,412,1947,10,421,10,27,3123
45079011411,4312,1960,251,1786,11,102,18,23,2352
45079011412,5959,1414,1434,2508,4,338,0,54,4545
45079011413,9125,3962,583,3477,23,676,9,54,5163
45079011414,5751,2305,824,2104,12,240,21,26,3446
45079011417,8261,1515,475,5602,24,244,6,48,6746
45079011418,4146,1628,214,1996,12,115,2,26,2518
45079011419,4984,1495,314,2782,16,124,15,22,3489
45079011420,4301,1047,390,2567,6,122,4,23,3254
45079011421,4720,709,377,3367,14,71,4,21,4011
45079011422,4965,2293,294,1849,5,208,6,27,2672
45079011423,9096,2341,680,5264,15,350,14,79,6755
45079011424,7008,2209,365,3881,22,197,2,68,4799
45079011425,4677,1756,422,2138,5,118,11,24,2921
45079011501,6957,3295,1790,1378,68,317,10,8,3662
45079011502,1156,501,189,343,0,25,20,3,655
45079011603,5660,3540,351,1334,8,221,0,13,2120
45079011604,5989,4745,198,614,7,173,3,20,1244
45079011606,4717,1440,174,2847,13,72,17,21,3277
45079011607,4720,1203,452,2655,12,223,0,25,3517
45079011608,7511,2260,436,4361,21,108,8,38,5251
45079011701,3993,1982,146,1531,9,136,0,49,2011
45079011702,3208,272,109,2725,0,6,1,8,2936
45079011801,2892,497,86,2219,3,5,3,7,2395
45079011802,2676,243,55,2284,2,2,0,36,2433
45079011901,8422,1469,364,6220,27,43,7,33,6953
45079011902,4829,2270,312,2004,16,33,0,31,2559
45079012000,4610,1399,211,2823,13,14,2,7,3211
45079980100,463,183,210,33,10,8,0,0,280
45081960100,2777,1890,497,324,3,0,0,3,887
45081960201,4654,2174,1062,1314,8,12,0,12,2480
45081960202,3706,1471,1021,1092,9,10,0,5,2235
45081960301,2895,2308,82,398,5,7,0,6,587
45081960302,2060,1821,82,82,10,4,0,6,239
45081960400,2770,1600,268,818,9,2,0,6,1170
45083020301,2961,1544,149,1128,11,44,0,2,1417
45083020400,1040,141,114,733,4,14,10,3,899
45083020500,1416,121,45,1201,6,1,0,4,1295
45083020601,3112,858,299,1617,6,183,0,29,2254
45083020602,2082,848,161,878,9,88,4,1,1234
45083020603,2392,1234,211,795,2,31,0,20,1158
45083020701,3061,511,194,2142,0,24,3,13,2550
45083020702,2056,733,162,989,2,71,0,13,1323
45083020800,1264,99,86,1007,2,2,0,9,1165
45083020900,1402,563,119,649,0,21,4,0,839
45083021001,2612,283,121,2109,3,6,0,7,2329
45083021100,3889,1538,203,1880,6,130,5,7,2351
45083021200,3821,3091,156,382,9,57,0,40,730
45083021301,2473,1214,183,861,2,66,35,10,1259
45083021302,2627,2319,45,159,3,24,2,10,308
45083021303,5403,3870,167,1089,8,77,3,14,1533
45083021401,1613,1244,80,189,4,30,0,0,369
45083021402,3938,2868,229,526,11,131,2,8,1070
45083021403,3876,1768,574,1229,6,143,7,14,2108
45083021500,3470,1862,350,1032,11,81,2,18,1608
45083021600,3525,1230,555,1485,6,125,1,16,2295
45083021700,4405,1224,977,2042,13,11,1,34,3181
45083021803,8730,5262,876,1878,15,384,4,20,3468
45083021804,2136,745,694,543,5,59,1,0,1391
45083021805,2751,859,1287,515,5,19,0,6,1892
45083021806,2867,1293,405,946,2,101,0,22,1574
45083021902,8535,5374,747,1423,42,500,0,25,3161
45083021903,1967,866,608,287,3,108,0,14,1101
45083021904,4489,1939,1345,695,10,286,2,18,2550
45083022003,4549,2683,282,1280,10,117,1,24,1866
45083022004,2732,1131,171,966,9,332,6,4,1601
45083022005,6247,3769,440,1433,17,345,2,19,2478
45083022006,4177,1507,566,1895,9,41,8,18,2670
45083022007,4444,2283,310,1443,8,221,0,14,2161
45083022101,3490,2447,95,779,2,75,0,7,1043
45083022102,2087,1790,59,146,0,11,1,7,297
45083022201,4552,3521,233,525,19,69,1,5,1031
45083022202,4256,3266,288,530,0,19,3,9,990
45083022303,1967,1446,150,299,3,5,0,1,521
45083022304,5148,4181,361,337,24,23,0,5,967
45083022305,989,714,161,79,3,0,2,0,275
45083022306,4417,3843,178,208,21,47,0,19,574
45083022404,6717,5677,294,347,15,131,4,15,1040
45083022405,4109,3255,294,310,8,129,1,2,854
45083022406,9337,6231,596,1509,17,531,0,40,3106
45083022407,2933,2601,78,72,8,24,2,8,332
45083022408,4215,3306,184,462,18,74,1,1,909
45083022409,1978,1739,44,94,10,20,1,9,239
45083022410,4257,3270,209,516,11,91,2,15,987
45083022411,4012,2952,234,460,5,210,1,12,1060
45083022500,4437,3948,180,108,6,51,0,9,489
45083022600,3466,2917,162,241,1,11,0,14,549
45083022701,1903,1672,67,44,9,33,2,3,231
45083022702,6458,5635,317,175,6,57,0,17,823
45083022803,2054,1867,53,43,5,29,0,4,187
45083022804,5262,3902,395,689,6,105,0,15,1360
45083022805,2588,2210,128,97,2,36,0,6,378
45083022806,6366,4630,370,889,8,265,0,13,1736
45083022901,2625,1659,188,550,3,118,0,5,966
45083022902,5148,3716,266,799,16,118,3,3,1432
45083023002,3503,2451,267,487,8,141,0,20,1052
45083023003,3029,2506,233,87,11,36,6,8,523
45083023004,8703,6052,948,1095,17,196,3,41,2651
45083023101,5693,3184,683,1499,8,72,8,13,2509
45083023103,1996,1002,140,701,5,21,0,9,994
45083023104,4653,2782,410,1176,5,55,1,22,1871
45083023201,4034,3223,336,274,6,29,2,7,811
45083023202,4534,3017,570,639,3,84,1,16,1517
45083023301,2042,1494,258,179,2,18,0,3,548
45083023302,5270,1612,1755,1618,12,42,4,27,3658
45083023401,2459,1444,199,679,3,39,0,8,1015
45083023402,4301,3505,170,402,1,73,6,10,796
45083023405,7046,5257,570,460,14,384,9,32,1789
45083023406,4346,2736,313,828,3,251,3,34,1610
45083023407,4035,2932,229,597,7,102,2,22,1103
45083023408,6231,4403,402,917,15,197,13,35,1828
45083023409,3514,2717,191,399,1,72,0,11,797
45083023500,5287,4509,262,299,7,28,0,20,778
45083023601,1334,1040,80,151,2,0,0,3,294
45083023602,4848,3040,469,1006,17,43,0,20,1808
45083023700,4304,3509,262,315,12,4,5,2,795
45083023803,2652,2051,71,394,20,32,0,11,601
45083023804,3035,2554,105,199,5,46,0,4,481
45083023805,2775,2460,94,108,1,21,0,9,315
45083023806,2618,1903,84,574,8,7,0,4,715
45083023901,1389,1122,34,187,3,7,0,0,267
45083023902,3533,2666,102,561,18,21,0,11,867
45085000100,2888,635,75,2125,1,0,3,3,2253
45085000201,4220,2045,239,1595,10,91,0,15,2175
45085000202,6858,2924,312,3005,41,145,10,23,3934
45085000300,3744,2054,401,799,16,132,22,23,1690
45085000401,5856,2384,298,2714,30,103,9,32,3472
45085000402,2474,1135,79,1147,10,10,0,13,1339
45085000500,1993,645,61,1233,0,5,0,3,1348
45085000600,3542,1764,84,1566,22,9,0,12,1778
45085000700,4118,994,241,2729,7,26,3,9,3124
45085000800,3808,270,102,3309,19,14,0,6,3538
45085000901,4236,1400,216,2261,10,153,5,17,2836
45085000902,4607,3650,146,503,10,72,2,12,957
45085001100,3753,852,215,2578,15,2,0,2,2901
45085001300,1782,275,37,1434,0,1,1,3,1507
45085001500,1596,17,19,1528,1,0,0,2,1579
45085001600,3303,214,86,2933,12,1,4,0,3089
45085001701,7363,4863,239,1759,12,210,2,12,2500
45085001703,5379,3095,158,1754,12,83,0,17,2284
45085001704,5708,2696,190,2540,12,55,4,10,3012
45085001801,3851,2144,119,1349,19,16,1,21,1707
45085001803,4824,2435,263,1730,12,127,3,32,2389
45085001804,3562,1090,87,2214,5,25,0,9,2472
45085001902,5305,2857,249,1941,26,31,8,9,2448
45085001903,4294,2547,158,1309,14,40,6,6,1747
45085001904,2458,1582,29,710,9,8,1,6,876
45085002000,4034,1875,199,1771,13,41,3,19,2159
45087030100,2191,1147,39,924,0,15,0,8,1044
45087030200,2760,1051,38,1526,7,12,0,13,1709
45087030300,3749,2236,77,1289,7,8,0,1,1513
45087030401,3224,2001,47,1070,2,4,0,3,1223
45087030402,2731,2057,76,495,6,10,0,0,674
45087030500,2053,1473,27,453,7,9,1,1,580
45087030600,1629,591,7,960,8,2,0,12,1038
45087030700,3098,2365,39,619,5,7,0,1,733
45087030800,3521,2530,70,760,5,9,0,7,991
45087030900,2288,1828,18,339,9,2,2,3,460
45089970100,2093,1187,57,760,14,2,1,12,906
45089970200,1330,296,9,1003,0,0,0,4,1034
45089970300,4334,1782,68,2374,3,14,0,12,2552
45089970400,2768,1163,20,1533,2,3,0,2,1605
45089970501,3258,710,42,2434,4,4,0,0,2548
45089970502,3942,223,37,3608,2,15,0,0,3719
45089970601,2500,1115,27,1249,16,45,0,9,1385
45089970602,2268,1018,37,1112,4,41,0,9,1250
45089970700,2114,456,30,1570,6,4,0,3,1658
45089970801,2562,350,19,2127,8,1,0,9,2212
45089970802,1319,296,226,757,24,14,0,0,1023
45089970900,2538,1390,47,1052,2,4,0,1,1148
45091060102,2628,1920,188,371,15,11,2,10,708
45091060200,3872,1943,370,1288,30,52,3,27,1929
45091060300,4009,1040,264,2513,27,0,3,12,2969
45091060401,2698,183,89,2307,11,1,4,6,2515
45091060402,2806,650,155,1857,6,29,0,20,2156
45091060501,3358,1046,117,2035,8,36,12,10,2312
45091060502,2332,337,97,1812,1,15,0,1,1995
45091060600,1719,816,109,733,7,20,0,5,903
45091060700,5770,4137,283,1031,28,67,2,10,1633
45091060802,1810,1183,224,258,7,52,3,7,627
45091060803,5170,2641,915,1238,28,102,0,20,2529
45091060804,4719,2573,729,1027,11,159,0,19,2146
45091060901,6338,2938,716,2176,44,171,0,38,3400
45091060904,7421,5055,386,1455,40,141,2,42,2366
45091060908,3752,1846,274,1440,8,40,5,23,1906
45091060909,5493,3860,311,997,14,95,6,27,1633
45091060910,4597,3651,181,439,15,134,1,30,946
45091060911,4903,3360,541,663,31,78,3,20,1543
45091060912,2347,1706,139,319,11,70,0,6,641
45091060913,7169,4290,608,1706,19,232,9,30,2879
45091061004,9513,7228,598,857,16,370,1,18,2285
45091061006,3705,2759,228,326,10,241,1,16,946
45091061007,8780,4992,1509,1136,22,661,8,64,3788
45091061008,8430,5914,638,774,15,670,4,34,2516
45091061009,11031,8343,668,579,18,908,5,28,2688
45091061010,5617,3796,322,537,17,653,0,30,1821
45091061011,8633,5405,800,886,30,1122,0,33,3228
45091061012,4681,3432,344,397,13,274,0,22,1249
45091061101,4230,2913,202,813,19,39,0,12,1317
45091061103,10273,7624,677,986,46,430,1,29,2649
45091061104,6825,5046,437,491,24,430,5,35,1779
45091061202,4472,3003,197,248,707,16,0,10,1469
45091061203,6483,5003,248,732,100,71,1,25,1480
45091061204,4579,2337,273,1545,27,198,0,25,2242
45091061205,4458,3142,307,638,60,87,2,19,1316
45091061301,4903,1678,197,2781,14,23,0,16,3225
45091061302,4950,3273,173,1205,37,17,7,43,1677
45091061401,4253,3435,200,385,46,17,1,5,818
45091061403,5836,4536,201,782,20,54,2,7,1300
45091061404,3711,2637,132,742,15,67,0,18,1074
45091061503,3410,2858,174,111,31,34,0,10,552
45091061504,4846,3850,212,505,15,35,0,10,996
45091061505,2718,2153,116,288,12,19,0,8,565
45091061506,5666,4776,224,326,20,62,1,19,890
45091061601,3366,1486,164,1523,10,32,3,17,1880
45091061602,5847,3283,613,1639,21,43,2,9,2564
45091061701,4473,4012,95,139,15,43,0,6,461
45091061705,5754,4732,219,364,18,113,0,6,1022
45091061706,7100,5543,414,636,24,127,5,34,1557
45091061708,6779,5088,441,704,16,125,2,60,1691
45091061709,6986,5414,439,611,20,120,5,46,1572
45091061710,3925,3299,175,207,10,50,0,20,626
45091061801,3207,1918,300,769,13,28,0,15,1289
45091061802,5083,4038,202,503,20,46,0,28,1045
45091061900,4656,3894,103,468,30,15,0,5,762
46003973600,2747,2409,219,14,38,13,0,0,338
46005956600,1962,1846,42,12,27,1,0,0,116
46005956700,1997,1887,54,4,2,5,0,1,110
46005956800,1867,1303,335,12,15,132,10,1,564
46005956900,3165,1701,764,38,98,445,11,9,1464
46005957000,6314,4342,991,42,66,696,27,13,1972
46005957100,3844,2290,555,34,35,789,9,4,1554
46007941000,1520,427,49,5,903,7,0,0,1093
46007941200,1861,570,38,2,1157,0,0,2,1291
46009967600,3432,3289,44,4,15,0,2,3,143
46009967700,3571,2871,73,102,440,11,3,3,700
46011958600,4500,4070,248,32,33,10,0,8,430
46011958700,5366,4983,173,28,38,15,0,12,383
46011958803,5677,5055,176,72,34,138,2,10,622
46011958804,2709,2219,106,93,61,152,0,4,490
46011958805,3849,3186,310,60,71,62,2,7,663
46011958900,6471,5468,203,171,76,338,5,10,1003
46011959000,5803,4941,211,172,59,197,4,13,862
46013951300,6006,5216,237,77,170,120,1,10,790
46013951400,7414,6481,278,86,213,86,19,5,933
46013951500,2270,1744,218,50,101,52,3,8,526
46013951600,4587,3779,237,64,166,152,6,16,808
46013951700,4425,3561,248,16,186,191,12,18,864
46013951800,6143,4912,279,232,176,299,3,27,1231
46013951900,3380,3148,109,5,31,15,0,2,232
46013952000,4076,3864,53,5,60,3,0,10,212
46015973100,2491,2300,26,0,71,0,2,0,191
46015973200,2756,2040,80,28,424,26,3,6,716
46017940200,1948,286,13,0,1582,1,0,0,1662
46019967600,2890,2686,57,1,40,9,3,11,204
46019967701,4379,3934,165,4,80,13,2,7,445
46019967702,2974,2527,188,7,62,8,0,12,447
46021964100,1377,1270,37,0,31,6,0,0,107
46023940200,3366,1445,87,4,1701,7,0,1,1921
46023940300,3222,1639,104,8,1282,16,14,0,1583
46023970100,2785,2636,37,3,28,8,0,2,149
46025955800,3837,3573,169,12,20,2,2,0,264
46027965700,6316,5167,222,111,308,192,1,18,1149
46027965800,2850,2699,21,4,26,7,1,5,151
46027965900,5801,4789,215,120,218,162,2,15,1012
46029954100,3620,3409,86,8,26,17,0,6,211
46029954301,4495,3996,145,34,119,54,3,9,499
46029954302,5403,5103,84,14,48,45,0,3,300
46029954401,2780,2483,74,21,83,20,0,8,297
46029954402,2403,2109,99,10,74,23,0,6,294
46029954501,2298,1963,118,17,107,11,0,0,335
46029954502,4949,4494,113,5,159,20,0,12,455
46029954600,2377,2284,20,0,29,7,0,4,93
46031941000,1662,661,16,1,894,8,0,0,1001
46031941100,2240,296,30,5,1808,12,0,0,1944
46033965100,5857,5303,138,16,122,13,0,30,554
46033965200,2461,2203,73,16,39,12,0,12,258
46035962600,2865,2685,63,3,29,12,0,2,180
46035962700,5845,5289,197,43,120,43,0,4,556
46035962801,3063,2463,219,36,209,15,0,9,600
46035962802,3131,2812,112,19,84,17,0,0,319
46035962900,5052,4376,322,26,160,30,0,14,676
46037952700,1575,1484,48,1,8,5,0,0,91
46037952800,1981,1802,72,1,43,10,2,1,179
46037952900,1893,1309,33,1,485,4,2,0,584
46039953600,2931,2752,113,5,11,2,2,1,179
46039953700,1364,1293,24,5,15,0,3,0,71
46041941500,2519,116,46,7,2262,4,0,0,2403
46041941700,2720,733,35,2,1820,2,0,4,1987
46043969600,2835,2653,54,7,33,3,1,1,182
46045962100,2505,2385,29,9,22,13,0,0,120
46045962200,1481,1394,32,3,17,10,0,0,87
46047964100,3044,2697,50,5,117,13,8,12,347
46047964200,3929,3235,130,30,274,34,3,17,694
46049961100,2125,2003,46,2,45,3,0,1,122
46051953100,5457,4905,342,0,38,15,3,5,552
46051953300,2099,1901,138,0,33,1,0,3,198
46053971100,1929,1697,29,6,111,20,2,0,232
46053971200,2065,1794,23,3,153,1,2,2,271
46055960100,1872,1717,19,2,34,14,2,14,155
46057955100,2798,2536,173,3,25,10,4,2,262
46057955200,3366,3130,115,2,16,3,2,9,236
46059975600,1440,1398,7,0,1,5,0,5,42
46059975700,1705,1594,42,7,10,2,0,9,111
46061964100,3461,3316,33,5,6,0,0,15,145
46063968700,1311,1205,32,5,29,0,0,7,106
46065977700,5783,4777,175,28,462,68,3,20,1006
46065977800,5719,4359,165,33,758,36,0,11,1360
46065977900,3056,2254,88,17,533,16,1,10,802
46065978000,3207,2695,62,5,315,8,0,10,512
46067968600,3162,2953,108,2,34,12,0,10,209
46067968700,2345,2226,24,5,36,3,0,3,119
46067968800,1920,1830,25,2,18,6,0,4,90
46069976700,1262,1088,24,4,99,5,1,3,174
46071941200,1794,272,44,6,1372,5,1,0,1522
46071961100,1012,773,17,5,137,2,2,4,239
46073974100,1663,1545,74,0,11,3,0,0,118
46075091600,917,773,11,4,49,0,0,2,144
46077958100,3143,2974,91,3,9,4,5,2,169
46077958200,2044,1952,28,2,16,7,2,0,92
46079960100,2241,2146,31,0,7,6,0,6,95
46079960201,2463,2094,167,32,51,10,5,2,369
46079960202,3872,3214,386,53,49,50,4,13,658
46079960300,2483,2395,22,0,7,0,2,7,88
46081966101,4222,3848,96,10,68,26,6,8,374
46081966102,2250,2013,78,1,33,10,0,7,237
46081966200,3973,3547,158,28,77,22,0,8,426
46081966301,5585,4923,222,53,131,51,1,5,662
46081966303,2678,2345,122,9,43,40,0,4,333
46081966304,2455,2196,78,4,26,23,4,2,259
46081966601,1768,1599,31,12,55,5,1,0,169
46081966602,2837,2464,137,11,53,19,6,17,373
46083010103,6059,5079,238,235,55,133,5,13,980
46083010107,7366,6740,213,75,42,19,0,14,626
46083010109,6129,5475,133,90,24,201,1,18,654
46083010110,6720,5704,258,185,53,210,0,12,1016
46083010111,3643,3237,100,93,15,73,0,6,406
46083010112,5922,5203,156,184,45,124,2,8,719
46083010113,3648,3207,111,78,35,64,0,11,441
46083010114,3466,3298,43,17,9,24,0,8,168
46083010115,6926,6333,154,70,47,22,1,20,593
46083010116,4206,3899,67,32,14,79,0,11,307
46083010200,3628,3388,48,29,33,25,0,11,240
46083010300,4887,4580,77,21,52,11,0,16,307
46083010400,2561,2366,81,7,8,8,0,6,195
46085940100,1614,40,17,1,1518,4,0,0,1574
46085972600,2104,1875,28,2,109,0,0,1,229
46087964600,3131,2956,81,6,16,3,0,4,175
46087964700,2551,2321,94,3,35,1,0,6,230
46089963100,2411,2265,53,3,27,3,1,0,146
46091950800,4306,3599,255,6,324,12,1,0,707
46093020200,1923,1152,227,209,13,83,31,8,771
46093020302,6392,5734,169,16,111,34,0,13,658
46093020303,6820,5863,274,22,231,44,1,13,957
46093020304,1592,1435,41,3,31,15,1,0,157
46093020401,3336,2965,109,13,82,8,1,10,371
46093020402,3940,3410,161,28,112,20,2,9,530
46093020500,5849,4735,320,117,204,71,12,34,1114
46095940300,1918,651,39,1,1101,3,0,7,1267
46097961600,2298,2183,42,4,8,6,0,5,115
46099000100,6363,4047,460,583,867,137,5,24,2316
46099000201,4300,2797,438,509,234,67,0,19,1503
46099000202,2111,1397,148,305,87,104,2,0,714
46099000300,3846,2151,730,466,164,130,2,14,1695
46099000401,2998,2051,249,320,102,120,1,6,947
46099000405,5454,2810,367,1186,131,743,1,25,2644
46099000406,3035,2080,275,315,96,69,2,18,955
46099000407,4176,2755,443,517,103,177,1,15,1421
46099000408,4883,2490,562,786,115,767,1,8,2393
46099000500,3573,2423,370,327,194,62,5,11,1150
46099000600,2337,1799,150,86,126,49,0,6,538
46099000701,1558,959,97,343,42,52,0,5,599
46099000702,2835,1787,293,262,276,33,3,10,1048
46099000900,3495,2409,396,285,115,46,4,13,1086
46099001001,4068,2758,665,197,189,35,0,12,1310
46099001002,5206,3305,937,344,206,166,4,4,1901
46099001105,7186,5947,365,274,92,167,4,26,1239
46099001107,3722,3189,152,86,65,39,0,11,533
46099001108,4802,3906,247,243,135,48,0,12,896
46099001109,1362,955,135,158,32,18,2,3,407
46099001110,3389,2407,395,240,92,77,1,2,982
46099001111,7304,6322,224,238,57,118,0,10,982
46099001112,5191,4462,159,166,40,138,0,11,729
46099001200,4691,3959,232,178,80,54,2,13,732
46099001501,3279,2371,275,196,174,71,2,15,908
46099001502,2582,1921,191,134,140,31,0,39,661
46099001600,3077,2765,108,40,28,18,0,6,312
46099001700,2167,1826,112,58,23,19,4,8,341
46099001801,6851,5332,294,591,158,147,4,17,1519
46099001804,3946,3105,256,235,32,99,0,15,841
46099001805,3873,3476,85,83,14,77,0,4,397
46099001806,5517,4693,193,253,31,153,0,17,824
46099001901,1808,1585,61,49,16,18,0,8,223
46099001902,5437,5054,133,46,27,39,3,12,383
46099010101,5049,4663,131,13,44,14,0,16,386
46099010102,4426,4206,64,6,24,11,0,14,220
46099010200,2843,2723,29,11,15,7,0,5,120
46099010300,6494,6088,94,34,63,11,0,4,406
46099010401,5578,4977,188,111,33,87,0,11,601
46099010402,2641,2471,42,6,13,15,2,16,170
46099010403,3212,3001,53,25,8,22,1,10,211
46099010404,4991,4385,152,161,75,24,4,4,606
46099010405,6122,4735,390,557,77,92,5,22,1387
46099010406,5202,4521,200,138,43,67,2,3,681
46099010501,6190,5647,164,89,32,47,3,19,543
46099010502,3865,3553,90,24,25,27,0,5,312
46099010600,4179,3477,240,137,72,56,1,6,702
46101959600,3206,2996,46,9,29,1,0,20,210
46101959700,3130,1832,268,10,711,85,0,5,1298
46102941000,5886,241,173,21,5342,20,0,2,5645
46102941100,5731,131,140,3,5328,16,0,1,5600
46102941200,2055,66,89,0,1860,3,0,2,1989
46103010201,3465,1693,222,77,1185,53,2,2,1772
46103010202,2262,1319,133,77,597,31,0,12,943
46103010300,3385,1635,247,60,1107,56,3,15,1750
46103010400,3853,2076,334,59,1020,74,2,10,1777
46103010500,3344,2047,233,65,650,125,8,3,1297
46103010600,3460,2447,209,33,398,48,4,19,1013
46103010700,3983,2652,274,40,682,41,1,6,1331
46103010800,3741,2929,181,58,287,46,0,22,812
46103010904,4649,3719,230,72,323,67,1,6,930
46103010905,6518,5269,264,91,465,114,5,19,1249
46103010906,5794,4598,289,58,341,68,4,22,1196
46103010907,3363,2563,169,54,347,27,1,8,800
46103010908,7499,5844,396,113,422,96,17,33,1655
46103011001,2563,2177,90,8,104,31,0,17,386
46103011002,6946,5946,235,99,217,119,0,35,1000
46103011004,6790,6068,220,16,71,130,2,22,722
46103011005,2180,2003,42,2,52,4,2,6,177
46103011100,2844,2163,168,46,208,29,1,9,681
46103011200,2832,2227,139,41,221,26,1,0,605
46103011300,6707,5833,208,47,193,30,2,38,874
46103011400,8657,5987,513,104,1214,127,11,46,2670
46103011601,3772,3132,157,38,111,33,3,11,640
46103011602,3957,3068,153,38,377,29,5,14,889
46103011700,3996,3393,287,11,99,35,0,26,603
46103011800,2662,1955,182,56,236,24,3,10,707
46105968300,2835,2651,38,2,64,5,3,8,184
46107000100,2472,2314,39,6,55,14,0,3,158
46109940400,3099,1060,108,24,1686,14,0,8,2039
46109940700,2521,1737,37,1,628,3,0,5,784
46109940800,2861,1094,35,7,1603,7,0,5,1767
46109950400,1799,1686,35,0,15,3,0,0,113
46111962100,2330,2182,57,0,20,9,0,0,148
46115000100,1790,1723,20,3,5,0,0,0,67
46115000200,2521,2298,88,20,51,2,0,1,223
46115000300,2050,1974,35,0,5,0,0,0,76
46117960100,2980,2553,31,12,193,5,9,5,427
46119979100,1446,1334,42,5,10,6,0,0,112
46121940100,4101,177,78,4,3750,24,0,0,3924
46121940200,5218,508,144,6,4372,21,0,0,4710
46123971600,2233,1909,11,5,214,0,0,2,324
46123971700,3391,2403,43,5,758,5,0,2,988
46125965100,4474,4107,139,11,27,5,2,8,367
46125965200,4199,3936,110,26,27,7,0,5,263
46127020100,4311,4014,130,2,27,18,0,2,297
46127020200,2869,2605,105,16,18,18,1,4,264
46127020301,5025,4314,225,94,22,176,26,8,711
46127020302,4606,4061,201,57,53,35,0,15,545
46129965100,1692,1569,20,3,40,3,0,5,123
46129965200,3623,2547,79,5,746,8,0,4,1076
46135966100,3007,2361,183,65,196,22,3,8,646
46135966200,5723,5086,281,39,116,18,2,0,637
46135966301,4126,3683,132,35,126,31,1,13,443
46135966302,6791,5615,574,161,167,58,3,12,1176
46135966400,3663,3450,64,12,33,0,0,8,213
46137941600,2413,404,34,0,1899,3,3,2,2009
47001020100,3164,1906,144,781,12,77,11,16,1258
47001020201,4527,3604,180,190,17,356,6,14,923
47001020202,4650,3600,458,172,11,143,4,21,1050
47001020300,4028,3153,264,228,17,28,8,26,875
47001020400,4602,3669,276,280,8,42,9,27,933
47001020500,3837,2763,310,341,12,51,0,17,1074
47001020600,2505,2071,157,115,3,32,2,5,434
47001020700,1485,1410,20,0,7,0,0,0,75
47001020800,4632,4294,48,22,12,18,0,4,338
47001020901,6212,5819,100,16,17,20,0,15,393
47001020902,6365,5891,116,39,9,36,1,13,474
47001021001,2722,2504,51,17,5,7,0,1,218
47001021002,3203,2909,61,70,10,12,0,8,294
47001021100,4087,3664,94,79,13,49,1,19,423
47001021201,4890,4359,77,156,15,24,2,23,531
47001021202,5217,4640,139,130,16,52,2,7,577
47001021301,3555,3248,71,34,6,14,0,17,307
47001021303,3933,3465,144,80,20,13,3,23,468
47001021304,3509,3075,110,91,7,1,4,16,434
47001980100,0,0,0,0,0,0,0,0,0
47003950100,4130,3621,151,121,9,43,0,16,509
47003950201,3368,2986,168,55,3,21,0,9,382
47003950202,3991,3545,233,83,9,10,0,4,446
47003950300,3933,3441,232,100,5,17,2,3,492
47003950401,6422,4236,1351,530,13,18,1,18,2186
47003950402,7909,4976,1722,793,12,86,0,27,2933
47003950500,6660,3876,1532,823,26,81,9,14,2784
47003950600,7814,4395,2078,943,22,33,1,37,3419
47003950700,3045,2698,132,73,19,22,0,1,347
47003950800,2965,2725,66,42,9,6,0,11,240
47005963000,3194,2972,66,1,10,8,4,3,222
47005963100,2941,2692,49,52,9,31,0,9,249
47005963200,2064,1890,34,30,4,12,0,4,174
47005963300,3822,3307,141,170,12,42,0,6,515
47005963400,3843,3517,85,63,15,14,0,8,326
47007953000,3755,3330,216,0,14,9,0,2,425
47007953101,1687,1588,48,1,1,2,0,0,99
47007953102,3813,3533,71,69,20,11,0,0,280
47007953200,5658,4678,124,711,13,15,0,0,980
47009010100,2888,1494,308,879,14,16,2,23,1394
47009010200,7589,6195,515,347,18,90,0,32,1394
47009010301,5713,4576,384,393,13,44,3,25,1137
47009010302,3588,3123,143,102,13,26,0,7,465
47009010400,3213,2769,159,91,14,24,0,0,444
47009010500,3055,2383,286,159,3,43,4,8,672
47009010600,4485,3748,208,266,8,43,0,27,737
47009010700,4996,4217,303,143,17,61,0,14,779
47009010800,3237,2449,487,141,10,13,0,7,788
47009010900,6481,5614,346,127,17,69,0,26,867
47009011001,6705,5918,296,73,17,93,0,17,787
47009011002,4371,4015,106,34,11,17,0,7,356
47009011101,5341,4848,176,67,7,18,0,16,493
47009011102,9154,8318,241,91,10,118,1,23,836
47009011201,6103,5052,303,180,13,196,2,26,1051
47009011202,4181,3574,146,86,2,127,1,23,607
47009011301,6102,5648,154,26,13,27,0,10,454
47009011302,5733,5200,172,29,22,16,0,13,533
47009011401,1815,1703,38,4,0,9,2,1,112
47009011403,2310,2136,27,12,7,12,0,4,174
47009011404,2488,2346,33,8,0,9,1,13,142
47009011501,1730,1620,31,5,2,0,0,9,110
47009011502,4331,3998,107,16,21,12,0,13,333
47009011503,7169,6603,148,63,29,43,0,16,566
47009011603,5005,4588,107,27,20,35,2,10,417
47009011604,3925,3570,112,39,5,26,0,12,355
47009011605,3521,3235,78,30,6,17,2,11,286
47009011606,6045,5484,156,48,19,37,0,22,561
47009011607,3978,3512,136,66,8,39,3,20,466
47009980100,0,0,0,0,0,0,0,0,0
47009980200,28,16,3,0,0,0,0,4,12
47011010100,4564,3358,538,254,5,147,2,16,1206
47011010201,2813,2157,309,149,3,38,2,16,656
47011010202,3900,2834,415,257,18,95,13,21,1066
47011010300,3577,2572,422,261,19,56,9,15,1005
47011010400,2847,1693,542,405,4,20,5,12,1154
47011010500,3686,2836,262,330,8,41,0,14,850
47011010600,3509,2528,504,220,12,21,17,11,981
47011010700,5105,3407,783,602,13,7,23,15,1698
47011010800,3394,2170,532,433,18,5,1,12,1224
47011010900,2969,2559,185,24,8,8,1,4,410
47011011000,5914,4809,493,194,15,38,12,17,1105
47011011101,6059,5423,229,89,5,32,3,23,636
47011011102,3649,3160,180,131,9,14,1,21,489
47011011201,6643,5561,293,360,14,91,0,6,1082
47011011203,4639,4062,211,99,10,75,5,13,577
47011011204,6563,5023,588,473,16,156,6,15,1540
47011011301,5061,4608,96,77,16,16,3,17,453
47011011302,2539,2264,86,36,4,16,0,9,275
47011011402,3189,2235,510,203,7,24,2,9,954
47011011403,4303,3523,363,141,12,75,6,8,780
47011011404,4412,3817,155,89,12,131,0,35,595
47011011501,5570,4781,360,127,6,43,3,16,789
47011011502,3738,3388,99,46,12,23,3,14,350
47011011601,5034,4537,142,79,15,7,0,5,497
47011011602,4943,4525,164,26,10,9,0,4,418
47013950100,2972,2874,16,0,2,5,0,2,98
47013950200,2388,2258,14,42,6,3,0,2,130
47013950300,1732,1656,16,2,3,3,0,1,76
47013950400,4644,4310,76,6,8,20,0,6,334
47013950500,5336,5067,55,11,6,34,0,29,269
47013950601,2096,1930,59,14,4,3,0,5,166
47013950602,2373,2199,71,11,7,3,0,1,174
47013950701,1791,1687,32,5,7,0,0,1,104
47013950702,2860,2680,35,13,2,7,0,0,180
47013950800,2367,2274,25,7,6,0,0,0,93
47013950900,2906,2758,25,9,7,0,0,10,148
47013951000,2396,2295,15,0,8,4,0,1,101
47013951100,5411,5113,61,10,11,12,0,29,298
47015960100,4070,3639,97,44,12,7,2,16,431
47015960201,2426,2130,89,70,5,17,0,0,296
47015960202,4532,4123,94,34,1,12,0,8,409
47015960300,3478,3172,115,44,7,2,2,17,306
47017962000,4260,3743,70,236,14,9,2,16,517
47017962101,3373,2833,54,284,12,11,2,13,540
47017962102,3831,3035,83,479,6,24,0,14,796
47017962201,3210,2443,117,467,7,8,0,20,767
47017962202,4583,3900,228,239,6,29,0,16,683
47017962300,4395,3601,118,483,18,16,0,15,794
47017962400,2612,2338,51,95,0,3,0,10,274
47017962500,2176,1851,48,162,12,24,1,0,325
47017980100,0,0,0,0,0,0,0,0,0
47019070100,2063,1890,54,26,10,6,0,4,173
47019070200,4103,3786,92,46,4,20,2,4,317
47019070300,5747,5103,143,190,12,39,2,14,644
47019070400,2221,2013,42,29,13,2,0,5,208
47019070500,4179,3960,48,12,15,12,1,10,219
47019070600,2480,2341,41,5,6,3,0,1,139
47019070700,3438,3125,84,55,7,14,0,4,313
47019070800,2902,2520,91,122,3,20,0,13,382
47019070900,3583,3102,150,133,6,43,0,10,481
47019071000,2705,2454,50,23,5,19,0,9,251
47019071100,1538,1442,21,5,5,1,0,4,96
47019071200,3806,3469,147,18,9,5,0,11,337
47019071301,3766,3548,65,9,18,12,0,10,218
47019071302,3443,3203,50,17,3,12,0,7,240
47019071400,3314,3091,34,3,16,2,0,0,223
47019071500,2109,2012,20,4,3,7,2,0,97
47019071600,1462,1404,3,2,12,5,0,0,58
47019071700,3497,3327,46,3,6,9,0,2,170
47021070102,4108,3678,179,48,11,15,1,12,430
47021070103,3524,3082,195,61,6,15,2,12,442
47021070104,5896,5176,217,167,10,22,4,10,720
47021070201,4807,4208,207,116,13,46,4,12,599
47021070202,5587,5043,189,62,18,13,3,23,544
47021070203,3763,3306,155,64,13,19,4,13,457
47021070300,3854,3154,348,167,8,26,7,12,700
47021070401,2473,2197,85,68,1,5,0,15,276
47021070402,7060,6455,264,62,12,23,0,18,605
47023970101,2630,2344,94,93,5,4,0,12,286
47023970102,3596,3151,110,186,8,12,0,9,445
47023970200,5487,4047,189,939,19,42,0,13,1440
47023970301,1659,1452,41,88,10,4,0,5,207
47023970302,3969,3477,94,188,10,8,0,23,492
47025970100,2685,2570,17,8,4,10,2,10,115
47025970200,2709,2476,39,38,7,41,0,20,233
47025970300,4341,3956,95,91,8,43,0,19,385
47025970400,783,755,2,0,0,0,2,0,28
47025970500,2721,2595,30,8,1,4,3,0,126
47025970600,4584,4278,91,21,9,15,0,9,306
47025970700,5788,5482,86,44,10,14,1,5,306
47025970800,3880,3620,59,42,10,8,1,6,260
47025970900,4552,4234,71,62,9,13,2,18,318
47027955000,4910,4671,57,76,17,3,1,3,239
47027955100,2671,2531,73,0,0,2,0,1,140
47029920100,3974,3704,91,6,15,9,5,2,270
47029920200,6063,5336,190,164,22,37,0,10,727
47029920300,4043,3732,109,51,17,12,2,5,311
47029920400,1803,1731,24,1,2,3,0,0,72
47029920501,6227,5522,209,173,21,26,2,8,705
47029920502,5215,4895,97,20,14,18,0,8,320
47029920600,4369,3837,144,161,13,31,0,7,532
47029920700,4294,3969,89,6,21,14,0,5,325
47029980100,11,7,1,0,1,0,0,1,4
47031970100,3877,3496,175,47,10,28,0,12,381
47031970201,3482,3147,127,42,16,38,2,5,335
47031970202,3977,3564,134,73,6,44,0,10,413
47031970300,2028,1870,55,23,6,18,2,1,158
47031970401,1793,1657,49,13,0,11,0,2,136
47031970402,5234,4025,707,183,18,55,5,11,1209
47031970501,1242,1038,88,51,2,6,0,0,204
47031970502,5583,4508,381,232,18,130,1,23,1075
47031970600,4445,3800,305,95,8,41,1,8,645
47031970700,4586,4095,225,29,0,26,1,22,491
47031970801,4249,3532,238,223,9,39,4,14,717
47031970803,2880,2536,93,56,8,31,3,16,344
47031970804,3635,3090,148,163,14,64,2,8,545
47031970900,4519,3303,230,582,3,21,12,21,1216
47031971001,1159,946,66,60,9,26,2,6,213
47031971002,5197,4376,238,225,18,33,2,12,821
47031980100,3,0,0,0,0,0,0,0,3
47033961000,2174,1741,89,285,3,2,0,4,433
47033961100,4078,2813,551,587,1,4,0,20,1265
47033961200,1652,1399,125,66,7,0,0,5,253
47033961300,2154,1668,157,270,7,0,0,4,486
47033961400,3853,2435,576,671,1,19,1,17,1418
47035970101,4659,4339,147,29,8,15,0,8,320
47035970103,3106,2876,50,30,5,13,0,9,230
47035970104,3213,3025,48,28,7,10,0,1,188
47035970201,4412,4157,85,11,6,23,0,6,255
47035970202,1948,1834,28,1,14,8,2,0,114
47035970301,3426,3158,116,21,0,13,0,6,268
47035970302,4526,4152,148,13,9,13,1,13,374
47035970401,4568,3879,374,65,6,77,0,1,689
47035970402,2170,2014,32,13,7,18,0,12,156
47035970501,2624,2371,117,10,7,11,0,5,253
47035970502,4178,3646,331,26,13,32,0,1,532
47035970601,5249,4840,156,21,6,78,1,14,409
47035970602,3983,3743,77,8,3,9,0,6,240
47035970603,2085,1968,34,7,8,4,5,0,117
47035970701,2267,2087,49,6,7,16,1,6,180
47035970702,4744,4443,90,5,14,16,2,5,301
47035970800,3987,3781,54,5,10,10,0,9,206
47037010103,2459,2081,154,114,5,12,4,6,378
47037010104,3213,2648,111,228,11,13,7,16,565
47037010105,4478,878,193,3206,0,58,0,18,3600
47037010106,3042,784,176,1961,7,25,0,13,2258
47037010201,4200,1615,632,1716,15,59,1,31,2585
47037010202,4158,3280,240,395,12,46,4,28,878
47037010301,3895,1919,379,1358,6,56,5,10,1976
47037010302,1817,1044,274,376,6,10,6,9,773
47037010303,5746,2870,675,1735,12,141,25,23,2876
47037010401,5293,2166,1180,1663,8,74,5,22,3127
47037010403,3613,1073,608,1711,11,13,0,25,2540
47037010404,2410,807,862,590,3,1,0,10,1603
47037010501,5593,4251,408,615,18,45,0,17,1342
47037010502,5279,3749,338,713,22,125,6,32,1530
47037010601,5366,2012,1187,1877,7,63,0,17,3354
47037010602,3544,998,952,1425,11,44,1,10,2546
47037010701,4281,1833,1057,1189,5,18,0,16,2448
47037010702,3391,1245,1064,891,3,20,3,21,2146
47037010801,5703,2200,1037,2110,13,88,0,22,3503
47037010802,3330,1925,385,804,6,69,3,15,1405
47037010901,3305,1471,511,1200,5,25,0,10,1834
47037010903,5858,611,558,4424,15,45,9,29,5247
47037010904,2931,304,143,2381,10,5,1,13,2627
47037011001,6579,1830,1570,2797,21,104,2,48,4749
47037011002,2632,1286,200,973,4,40,0,25,1346
47037011100,3961,3184,235,255,5,79,3,13,777
47037011200,4337,3314,242,459,8,52,0,23,1023
47037011300,5113,2025,1319,1477,14,75,0,11,3088
47037011400,5032,2763,288,1644,28,50,4,34,2269
47037011500,3819,2834,201,565,4,58,1,17,985
47037011600,5257,3781,283,849,8,80,2,17,1476
47037011700,6055,4103,426,1190,13,78,0,16,1952
47037011800,2577,898,92,1468,6,24,2,20,1679
47037011900,2982,1354,338,1124,12,39,2,9,1628
47037012100,2649,2243,125,112,3,29,0,24,406
47037012200,2187,1765,105,172,0,29,0,11,422
47037012600,2005,669,100,1109,6,17,0,20,1336
47037012701,5963,452,236,5052,12,22,0,17,5511
47037012702,3323,403,164,2586,9,26,4,20,2920
47037012801,4944,715,269,3771,9,17,2,22,4229
47037012802,4148,1133,161,2716,11,25,0,8,3015
47037013001,252,193,20,25,0,3,0,3,59
47037013002,1398,640,40,708,3,4,0,0,758
47037013100,2322,1306,101,711,6,82,0,19,1016
47037013201,3092,1960,471,140,3,377,0,12,1132
47037013202,3472,2431,448,279,11,151,0,15,1041
47037013300,5165,3734,549,513,13,116,2,16,1431
47037013400,4460,3921,140,85,7,86,0,2,539
47037013500,2398,1662,116,461,5,45,2,19,736
47037013600,6488,1562,181,4481,20,82,0,28,4926
47037013701,3637,812,139,2499,5,29,2,19,2825
47037013702,3186,866,121,1915,9,135,0,12,2320
47037013800,1464,182,55,1152,3,7,0,11,1282
47037013900,1662,361,119,1121,2,5,0,5,1301
47037014200,2418,372,82,1876,0,21,0,17,2046
47037014300,1767,287,115,1251,3,24,4,25,1480
47037014400,2577,1126,112,1092,1,131,0,15,1451
47037014800,1382,40,38,1259,3,0,0,3,1342
47037015100,4119,2867,518,346,7,133,0,22,1252
47037015200,2588,2096,213,107,9,47,2,5,492
47037015300,5962,4476,416,673,13,121,8,14,1486
47037015401,5493,3962,394,645,16,209,3,14,1531
47037015402,4934,3161,731,709,8,80,4,17,1773
47037015404,3115,1865,632,392,7,46,0,8,1250
47037015405,4747,2941,558,892,6,103,0,25,1806
47037015501,3228,2271,192,462,11,131,2,17,957
47037015502,4100,2836,449,454,12,91,0,32,1264
47037015609,5236,3213,397,867,23,465,2,31,2023
47037015613,5270,1551,1662,1619,5,286,0,20,3719
47037015614,4540,1604,1344,1245,11,186,1,29,2936
47037015615,5138,975,2698,1040,9,241,2,23,4163
47037015617,2480,1339,322,669,3,37,0,8,1141
47037015618,6801,2375,1614,2240,5,175,9,60,4426
47037015619,5546,2097,775,2171,4,222,5,39,3449
47037015620,7522,2388,2080,2607,11,147,2,30,5134
47037015622,3845,2202,455,867,8,103,6,24,1643
47037015623,5872,2739,574,2060,17,161,0,35,3133
47037015624,4766,2428,446,1474,7,158,5,27,2338
47037015625,5717,3536,541,1218,14,153,0,25,2181
47037015626,6737,2060,1123,3058,11,224,3,29,4677
47037015627,3415,833,1274,947,3,250,1,6,2582
47037015628,3744,681,771,2001,8,77,3,15,3063
47037015629,5461,1408,971,2669,11,158,0,32,4053
47037015630,5457,1607,668,2604,7,322,8,21,3850
47037015632,3928,2077,391,1107,10,112,9,15,1851
47037015633,5019,3782,217,655,10,150,0,14,1237
47037015634,12357,4461,2526,4467,3,388,3,82,7896
47037015635,2640,1226,339,923,4,49,4,3,1414
47037015636,3670,1442,864,1129,4,75,2,24,2228
47037015637,4414,1562,612,1922,8,80,0,28,2852
47037015700,1672,814,627,129,7,25,1,17,858
47037015804,4377,1496,1094,1535,11,84,0,14,2881
47037015805,3720,1301,1710,481,8,73,7,14,2419
47037015806,6001,1753,2634,1405,12,66,0,15,4248
47037015900,3068,1861,530,507,17,50,1,33,1207
47037016000,2411,429,177,1672,0,18,0,6,1982
47037016100,2411,1197,209,861,2,46,0,3,1214
47037016200,3476,1429,129,1714,6,88,2,6,2047
47037016300,2693,1420,141,907,5,90,2,6,1273
47037016400,5124,3680,312,412,8,518,4,17,1444
47037016500,4812,2693,314,534,6,1033,2,17,2119
47037016600,3604,2493,176,394,6,361,0,10,1111
47037016700,5616,4953,193,112,4,166,1,20,663
47037016800,4427,3438,201,109,7,454,3,24,989
47037016900,4752,3977,189,181,9,201,1,30,775
47037017000,4567,3536,235,513,14,83,4,26,1031
47037017100,4194,3362,188,343,8,123,1,8,832
47037017200,1767,1205,310,111,4,39,1,15,562
47037017300,3287,1458,1203,315,16,170,4,25,1829
47037017401,2453,940,1121,249,2,70,1,11,1513
47037017402,6073,3096,2024,523,10,194,1,30,2977
47037017500,3035,1766,883,213,10,48,3,15,1269
47037017701,2476,2222,72,34,5,61,0,3,254
47037017702,4983,4377,177,164,6,117,0,9,606
47037017800,5964,5007,224,237,8,256,1,19,957
47037017901,5688,4853,182,197,10,240,0,9,835
47037017902,4852,4280,126,68,7,228,0,22,572
47037018000,5168,4576,162,102,9,158,0,23,592
47037018101,5173,2569,1293,785,7,337,0,15,2604
47037018102,3598,3162,106,118,1,109,0,3,436
47037018201,3144,2732,122,84,0,77,0,5,412
47037018203,1490,1370,39,19,0,16,1,2,120
47037018204,3356,2217,213,598,3,127,1,26,1139
47037018205,3478,2632,170,385,1,131,1,26,846
47037018302,3031,2561,83,148,1,89,0,9,470
47037018303,4873,3288,366,611,12,360,2,28,1585
47037018304,4431,3428,169,219,10,384,1,34,1003
47037018404,5185,3810,353,590,12,205,5,35,1375
47037018405,5041,4218,256,229,23,115,2,4,823
47037018407,5195,4086,236,283,4,331,3,28,1109
47037018408,3552,2913,118,146,4,214,0,14,639
47037018409,4287,3467,265,203,4,152,0,10,820
47037018410,3457,2409,254,381,0,169,1,17,1048
47037018411,2843,1820,267,450,3,170,1,9,1023
47037018412,4443,3382,218,447,5,174,1,40,1061
47037018500,5360,5009,82,36,1,55,0,15,351
47037018601,2387,2219,60,22,0,50,0,0,168
47037018602,4515,4096,123,50,5,101,0,13,419
47037018700,3715,3418,84,53,3,59,0,3,297
47037018801,6132,5072,224,209,10,419,0,11,1060
47037018803,4054,3293,159,208,0,228,0,20,761
47037018804,4980,3849,179,326,12,412,1,13,1131
47037018901,3392,2000,703,398,6,130,0,22,1392
47037018902,2515,1820,387,134,7,51,0,10,695
47037018904,4003,1911,1342,434,17,176,0,9,2092
47037018905,3511,1562,970,252,6,614,0,8,1949
47037019003,4552,1328,2014,734,5,344,2,18,3224
47037019004,4827,1353,2005,634,5,653,9,39,3474
47037019007,2444,867,1066,233,1,187,0,6,1577
47037019008,6432,1432,2400,1840,5,557,0,29,5000
47037019105,6311,2597,1702,1230,10,521,0,34,3714
47037019106,4179,2530,544,493,6,395,4,32,1649
47037019108,3527,606,2034,601,5,182,6,19,2921
47037019109,5605,1453,2463,775,5,692,0,28,4152
47037019110,4042,1431,1710,538,7,222,2,10,2611
47037019111,4516,1221,1532,1296,5,272,1,26,3295
47037019112,5228,1931,1358,1278,9,455,2,23,3297
47037019115,3906,2713,188,472,3,299,3,23,1193
47037019116,7366,4446,636,1339,3,505,2,49,2920
47037019117,5296,2049,713,1808,0,469,0,17,3247
47037019118,5636,1315,1157,2112,12,819,1,17,4321
47037019119,8008,5440,538,1181,16,425,0,34,2568
47037019120,2909,1919,219,411,5,202,1,11,990
47037019121,4326,2733,256,697,3,437,2,11,1593
47037019200,3567,2258,149,897,4,73,0,21,1309
47037019300,3544,818,119,2363,14,28,7,16,2726
47037019401,4054,2326,171,1248,11,111,0,9,1728
47037019402,4231,3264,211,430,0,111,0,12,967
47037019501,3441,2635,220,139,3,307,3,16,806
47037019502,3732,2922,187,285,7,178,0,12,810
47037019503,5241,3446,290,1050,9,239,1,37,1795
47037019600,3666,1838,758,751,19,85,1,22,1828
47037980100,14,7,1,5,0,0,0,0,7
47037980200,3,0,2,1,0,0,0,0,3
47039955001,1788,1686,40,18,1,0,2,1,102
47039955003,2617,2388,83,42,0,31,0,7,229
47039955004,2057,1786,131,82,2,2,0,0,271
47039955101,1817,1609,40,100,2,3,1,5,208
47039955102,3156,2993,64,28,4,6,2,2,163
47041920101,2492,2303,78,18,7,9,0,0,189
47041920102,4582,4093,309,14,8,8,0,10,489
47041920201,5221,4295,573,78,12,42,5,15,926
47041920202,2179,1813,244,53,2,0,0,0,366
47041920300,5606,5022,245,71,15,17,0,28,584
47043060100,4236,3897,90,55,9,12,0,5,339
47043060201,3796,3405,108,124,9,6,0,8,391
47043060202,3556,3231,88,124,11,9,1,5,325
47043060300,6945,6300,268,37,26,25,0,27,645
47043060401,3312,3056,82,23,9,21,1,7,256
47043060402,6890,6032,352,191,26,52,2,13,858
47043060501,6559,5560,305,307,28,54,0,14,999
47043060502,3376,2744,302,173,10,12,0,12,632
47043060601,4041,3195,356,265,16,18,0,19,846
47043060602,6879,5286,505,526,21,93,0,45,1593
47043060700,4725,4288,126,106,16,8,0,5,437
47045964001,4153,3356,151,433,24,12,0,9,797
47045964002,2614,2275,91,98,9,11,1,9,339
47045964200,5767,4195,235,990,6,106,3,22,1572
47045964300,5453,3694,305,1076,10,32,3,24,1759
47045964401,3261,1743,163,1157,4,17,0,8,1518
47045964402,2324,1071,58,1111,4,0,4,3,1253
47045964500,2343,2142,39,63,4,2,0,6,201
47045964600,2693,2362,99,117,6,2,0,1,331
47045964800,3008,2729,60,116,12,3,0,6,279
47045964900,5185,4705,102,174,2,28,0,12,480
47047060300,2786,1290,65,1305,10,2,2,14,1496
47047060401,3344,2371,345,441,4,40,3,15,973
47047060402,4157,2867,133,945,8,28,2,10,1290
47047060403,4304,3099,139,854,8,43,1,13,1205
47047060404,6391,4456,204,1378,1,67,0,35,1935
47047060501,4566,2746,150,1479,6,16,0,0,1820
47047060502,3987,2701,97,1023,7,6,2,12,1286
47047060600,3870,2210,71,1443,4,9,0,19,1660
47047060701,2227,1532,53,566,3,2,3,8,695
47047060702,3734,2691,81,794,5,44,1,15,1043
47047060800,2624,1595,92,810,3,12,4,17,1029
47049965000,3381,3242,42,4,4,3,0,0,139
47049965100,4417,4115,101,10,9,10,0,0,302
47049965201,2346,2269,26,0,0,4,0,0,77
47049965202,3165,3059,17,6,7,5,0,0,106
47049965300,5180,4856,130,5,6,11,0,18,324
47051960100,3573,3106,136,153,11,11,1,3,467
47051960201,6378,5834,116,58,20,21,5,16,544
47051960202,5574,5000,99,168,9,42,1,17,574
47051960300,3149,2801,143,78,1,14,4,7,348
47051960401,3458,2754,151,276,20,53,0,6,704
47051960402,4482,3787,179,253,17,80,2,15,695
47051960500,3963,3049,218,476,9,36,3,22,914
47051960600,5253,4534,124,316,11,11,0,9,719
47051960700,3959,3392,130,121,5,76,1,136,567
47051960800,2985,2607,206,63,14,4,0,6,378
47053966100,2487,2033,39,286,9,2,0,5,454
47053966200,3566,2875,66,492,6,4,2,5,691
47053966300,2603,2270,98,121,5,11,0,4,333
47053966400,5217,4233,148,582,7,9,0,15,984
47053966501,2535,1697,73,654,1,14,0,0,838
47053966502,3551,2385,98,928,14,19,2,5,1166
47053966600,1871,1617,39,137,0,5,0,4,254
47053966701,2560,1516,118,831,3,5,0,3,1044
47053966702,3243,2421,115,561,12,11,5,8,822
47053966800,1201,1057,15,68,2,4,0,6,144
47053966900,2180,488,77,1541,2,5,0,4,1692
47053967001,3819,2591,97,1004,7,9,1,7,1228
47053967002,3378,1792,210,1224,6,6,3,12,1586
47053967100,7829,6861,197,389,12,85,0,25,968
47053967300,1066,1016,10,4,5,0,2,3,50
47053967400,3322,3077,39,107,6,11,0,6,245
47053980100,1,1,0,0,0,0,0,0,0
47055920100,3377,3019,83,96,4,8,0,24,358
47055920200,5058,3882,187,651,25,41,3,25,1176
47055920301,4966,3562,116,963,22,22,1,7,1404
47055920302,1869,1724,31,33,8,13,2,0,145
47055920400,2943,2405,83,274,5,31,1,0,538
47055920500,4557,3678,109,476,17,20,1,7,879
47055920600,2783,2603,17,51,8,5,0,0,180
47055920700,1757,1483,42,129,13,6,0,10,274
47055920800,3036,2564,60,254,11,30,1,2,472
47057500100,3962,3792,43,14,7,5,0,5,170
47057500200,5139,4816,91,27,4,16,2,7,323
47057500301,3341,3096,87,18,6,12,0,0,245
47057500302,3391,2853,380,15,10,8,0,9,538
47057500401,2493,2332,44,10,4,1,0,8,161
47057500402,5201,4859,128,34,11,11,0,4,342
47059090100,6555,5185,535,444,15,22,0,18,1370
47059090200,3727,3029,286,207,19,55,1,45,698
47059090300,6001,5264,303,103,10,90,1,17,737
47059090400,5475,4765,300,156,5,28,0,15,710
47059090501,5543,4855,274,116,3,40,0,14,688
47059090502,1679,1583,33,6,4,3,0,7,96
47059090600,3852,3604,86,32,4,5,3,12,248
47059090700,2666,2491,44,16,6,4,1,7,175
47059090800,4384,4098,74,30,10,4,0,12,286
47059090900,5342,4944,161,42,6,3,2,17,398
47059091001,4637,4370,60,25,12,7,0,13,267
47059091002,3039,2825,96,13,6,7,0,0,214
47059091100,3452,3260,58,22,9,10,1,4,192
47059091200,3562,3308,65,24,9,5,3,3,254
47059091300,4358,4024,107,21,11,4,1,8,334
47059091400,2766,2559,37,43,7,6,1,1,207
47059091500,3114,2979,16,8,6,6,0,1,135
47061955000,2815,2602,55,11,6,11,0,6,213
47061955100,1556,1466,14,9,0,6,0,4,90
47061955200,3956,3743,34,4,7,10,0,0,213
47061955300,5202,4809,72,14,20,17,0,12,393
47063100100,6470,3721,2200,270,11,27,9,12,2749
47063100200,5632,3516,1515,293,12,69,23,2,2116
47063100300,3589,1877,1234,232,12,11,73,4,1712
47063100400,6184,3755,1552,503,19,70,37,23,2429
47063100500,3011,2616,197,84,4,19,1,9,395
47063100600,7532,6267,631,186,16,78,4,13,1265
47063100700,6039,5276,304,130,12,48,0,14,763
47063100800,3251,2466,546,78,7,11,2,5,785
47063100900,5315,4049,651,127,5,163,108,3,1266
47063101000,5313,4923,133,45,5,17,1,14,390
47063101100,5444,4881,185,47,16,68,3,26,563
47063101200,6719,5850,335,111,11,131,7,27,869
47065000400,3002,321,81,2505,6,12,0,8,2681
47065000600,3620,3153,131,94,12,72,0,22,467
47065000700,4392,3796,180,169,11,74,2,12,596
47065000800,1976,1492,64,253,0,65,0,4,484
47065001100,1519,646,104,715,4,5,0,6,873
47065001200,2949,521,90,2226,0,3,0,7,2428
47065001300,1965,696,483,701,3,10,0,14,1269
47065001400,1879,873,391,518,1,15,3,8,1006
47065001600,3004,830,77,1904,8,34,1,14,2174
47065001800,2539,1884,89,374,9,20,0,14,655
47065001900,4329,462,180,3537,2,8,0,7,3867
47065002000,2229,1171,162,751,10,34,0,9,1058
47065002300,1546,482,528,462,3,1,1,7,1064
47065002400,4978,1519,2300,984,13,13,0,12,3459
47065002500,4832,1258,1554,1804,18,5,3,16,3574
47065002600,2737,435,1361,877,8,0,1,10,2302
47065002800,3758,2555,212,773,8,41,2,10,1203
47065002900,2603,1119,202,1131,2,13,0,9,1484
47065003000,2403,950,480,775,7,64,0,10,1453
47065003100,2073,1540,78,327,6,57,1,5,533
47065003200,3166,552,100,2374,15,10,0,16,2614
47065003300,6451,1375,338,4465,14,37,0,23,5076
47065003400,4245,2026,868,1078,12,54,1,17,2219
47065010101,6114,5358,138,256,11,41,2,13,756
47065010103,3966,3510,117,129,4,20,2,15,456
47065010104,4005,3608,108,51,15,9,7,8,397
47065010201,4054,3776,56,23,6,21,0,12,278
47065010202,4674,4212,87,133,11,17,0,9,462
47065010303,3472,3160,68,50,10,31,0,2,312
47065010304,5625,5156,125,76,6,41,2,12,469
47065010305,3461,3258,71,16,1,14,2,7,203
47065010306,3681,3273,172,55,3,10,0,5,408
47065010308,3012,2780,70,27,5,8,2,1,232
47065010309,2892,2621,68,14,19,11,0,5,271
47065010411,7099,6166,205,243,16,183,3,13,933
47065010412,5121,4496,129,160,5,40,1,15,625
47065010413,3984,3518,116,100,7,78,2,8,466
47065010431,7568,5845,452,593,18,320,0,21,1723
47065010432,7112,5974,251,229,23,333,4,16,1138
47065010433,5358,3495,563,880,8,116,2,26,1863
47065010434,2567,2344,57,37,1,13,0,6,223
47065010435,5686,4337,525,422,23,87,11,13,1349
47065010501,6301,4940,393,559,12,94,2,24,1361
47065010502,3160,2633,168,122,7,82,0,18,527
47065010600,2832,2345,170,146,2,22,0,17,487
47065010700,3090,2467,223,183,6,44,1,11,623
47065010800,4095,3076,372,373,5,49,0,10,1019
47065010901,2319,1885,100,153,3,70,1,6,434
47065010902,940,815,53,20,1,10,0,4,125
47065010904,2535,1929,140,212,1,135,0,9,606
47065010905,3982,3254,191,284,9,103,0,18,728
47065011001,1996,1865,32,1,5,0,0,2,131
47065011003,3960,3546,132,17,8,68,3,13,414
47065011004,4397,3981,143,23,9,67,6,14,416
47065011100,6524,6045,164,34,0,74,0,5,479
47065011203,7216,5392,681,450,3,325,7,43,1824
47065011204,5766,4668,500,160,20,111,5,26,1098
47065011205,8762,7313,342,483,13,245,0,39,1449
47065011206,4682,3585,420,311,8,122,3,17,1097
47065011311,10069,6800,1033,1542,25,293,11,40,3269
47065011314,5494,4074,390,584,11,181,2,25,1420
47065011321,7726,4803,549,929,35,1095,2,20,2923
47065011323,6133,4375,293,898,12,284,0,31,1758
47065011324,4249,3250,210,375,10,240,0,5,999
47065011325,6332,4756,222,679,10,365,3,28,1576
47065011326,5464,3635,342,888,15,302,0,29,1829
47065011402,5720,1770,260,3413,8,49,2,26,3950
47065011411,4211,2076,226,1630,9,57,4,20,2135
47065011413,7880,5330,272,1732,13,106,4,30,2550
47065011442,2876,1920,142,625,3,62,1,6,956
47065011444,3384,510,132,2591,3,20,3,19,2874
47065011445,3994,1701,539,1481,10,104,0,24,2293
47065011446,4036,2599,344,668,7,216,1,26,1437
47065011447,8839,6983,520,752,16,113,3,47,1856
47065011448,4061,2309,351,1043,12,162,6,15,1752
47065011449,2381,1324,122,774,6,73,0,8,1057
47065011600,6225,4028,1129,617,18,109,1,26,2197
47065011700,4381,3194,397,517,7,70,0,19,1187
47065011800,6854,4576,1021,744,26,127,0,22,2278
47065011900,1705,981,180,398,0,29,1,6,724
47065012000,2058,1945,27,13,0,19,0,3,113
47065012100,6066,5371,130,160,14,136,4,17,695
47065012200,1984,122,59,1727,11,0,0,9,1862
47065012300,4467,1412,122,2649,8,19,0,13,3055
47065012400,5415,3813,408,728,5,247,0,12,1602
47065980100,0,0,0,0,0,0,0,0,0
47065980200,0,0,0,0,0,0,0,0,0
47067960500,2768,2665,21,6,10,0,0,9,103
47067960600,3894,3726,19,27,15,1,0,2,168
47069950100,3599,2952,72,452,10,20,3,5,647
47069950200,6156,2629,194,3218,5,10,0,11,3527
47069950300,3845,1525,64,2097,4,34,3,20,2320
47069950400,5069,2178,78,2618,15,35,0,16,2891
47069950500,4233,3647,62,339,6,58,0,6,586
47069950600,2560,1039,24,1426,6,5,0,10,1521
47071920100,4189,3875,67,73,14,29,0,8,314
47071920200,4609,4222,83,104,18,18,0,4,387
47071920300,4069,3554,57,249,9,37,0,8,515
47071920401,1850,1658,54,49,1,12,0,8,192
47071920402,3235,2662,103,221,15,31,0,11,573
47071920501,4037,3745,104,51,11,12,0,9,292
47071920502,1509,1451,35,0,2,2,0,3,58
47071920600,3333,3105,62,58,11,7,0,2,228
47073050100,3903,3666,58,17,4,11,0,10,237
47073050200,4854,4604,46,27,7,6,0,5,250
47073050301,4821,4401,93,137,9,26,0,6,420
47073050302,3917,3532,81,93,5,36,0,14,385
47073050400,5647,5306,125,28,7,17,2,12,341
47073050501,4098,3862,41,20,14,4,0,6,236
47073050502,3425,3168,49,53,5,5,3,8,257
47073050503,4797,4493,60,52,9,30,1,4,304
47073050601,5753,5170,135,157,9,73,2,18,583
47073050602,4393,4113,72,52,9,26,1,5,280
47073050700,3349,3201,37,3,8,4,2,6,148
47073050800,4928,4616,64,23,11,13,0,14,312
47073050900,2836,2692,28,9,7,5,2,2,144
47075930100,2558,1870,106,516,7,0,0,10,688
47075930200,1558,975,43,508,0,0,0,3,583
47075930301,4341,1434,204,2579,9,12,2,22,2907
47075930302,2744,624,153,1887,5,3,2,2,2120
47075930400,4206,1399,283,2422,5,7,2,14,2807
47075930500,2457,1252,49,1081,7,4,0,5,1205
47077975000,2784,2560,45,99,8,5,0,3,224
47077975100,3475,2885,66,327,5,6,2,9,590
47077975200,5769,5318,140,125,11,7,0,6,451
47077975301,3512,2921,121,308,1,14,0,19,591
47077975302,3925,3280,88,298,5,47,0,30,645
47077975400,4583,3364,174,755,7,8,0,8,1219
47077975500,3794,3562,85,19,16,3,0,6,232
47079969001,2352,2196,31,11,5,10,7,5,156
47079969002,2133,2023,26,21,7,0,0,0,110
47079969100,2817,2567,78,66,3,4,0,3,250
47079969200,1689,1521,28,36,0,13,0,16,168
47079969300,3175,1926,88,860,6,25,0,37,1249
47079969400,2006,1384,46,431,10,11,0,27,622
47079969501,1960,1677,75,120,2,15,0,3,283
47079969502,3728,3071,86,321,6,83,0,8,657
47079969601,3009,2574,67,168,9,17,0,7,435
47079969602,4702,4265,134,91,13,13,0,11,437
47079969700,2285,2054,47,89,5,5,0,6,231
47079969800,2343,1992,171,93,10,6,0,2,351
47081950100,5458,4952,147,93,14,14,0,12,506
47081950201,3493,3108,123,80,26,7,1,10,385
47081950202,3622,3262,113,31,23,14,0,7,360
47081950301,2758,2407,68,139,4,2,0,11,351
47081950302,4786,4413,103,63,9,18,0,3,373
47081950400,2132,1952,33,24,12,5,0,10,180
47081950500,2676,1992,94,501,13,12,0,0,684
47083120100,3174,2871,66,81,12,13,2,19,303
47083120200,2077,1881,35,83,6,0,5,3,196
47083120300,3032,2739,101,36,14,3,1,18,293
47085130100,5379,4977,124,36,12,14,0,5,402
47085130200,1971,1815,37,14,0,2,0,16,156
47085130300,5845,5090,172,316,12,23,0,10,755
47085130400,2830,2535,52,85,9,8,0,42,295
47085130500,2965,2685,64,43,10,10,0,1,280
47087960100,1865,1742,36,3,5,0,0,7,123
47087960200,2361,2146,58,6,16,11,0,3,215
47087960300,5545,5132,129,17,14,3,0,16,413
47087960400,1846,1758,22,5,0,3,0,2,88
47089070101,2527,2276,173,11,3,7,0,6,251
47089070102,4700,4014,424,32,12,18,8,12,686
47089070200,4837,4458,171,46,5,16,0,4,379
47089070300,7066,5928,487,258,20,77,2,40,1138
47089070400,3716,3372,142,36,8,7,1,13,344
47089070500,5556,5055,114,67,20,16,2,15,501
47089070600,5365,4656,392,80,17,23,2,19,709
47089070701,4422,3955,161,103,12,26,3,19,467
47089070702,3815,3565,46,42,15,20,2,1,250
47089070801,3713,3426,89,31,23,15,0,4,287
47089070802,4146,3832,98,21,15,14,0,10,314
47089070900,4820,4438,95,60,9,18,0,14,382
47091956000,963,925,7,0,0,0,1,2,38
47091956100,4281,3412,93,676,6,3,0,0,869
47091956200,2313,2192,45,1,1,0,1,0,121
47091956300,5605,5126,218,39,13,17,5,6,479
47091956400,4786,4471,153,8,8,7,2,0,315
47093000100,2907,2392,100,226,5,62,1,17,515
47093000800,3502,2467,169,530,10,108,2,20,1035
47093000901,1986,1500,116,164,22,159,1,0,486
47093000902,4873,3808,233,442,36,295,0,2,1065
47093001400,2261,905,605,604,7,10,0,5,1356
47093001500,3459,2440,501,298,13,29,1,14,1019
47093001600,2978,2347,213,237,4,4,0,13,631
47093001700,2588,1742,343,322,4,18,1,12,846
47093001800,2447,1715,259,282,3,15,0,13,732
47093001900,1555,441,119,886,8,9,2,12,1114
47093002000,3114,389,241,2265,5,0,2,20,2725
47093002100,2857,874,232,1516,18,49,0,25,1983
47093002200,3658,2988,118,304,15,7,0,11,670
47093002300,3261,2532,216,232,9,94,0,29,729
47093002400,4088,2897,283,616,14,21,0,15,1191
47093002600,2777,1508,296,617,12,166,0,12,1269
47093002700,2733,1762,346,399,17,22,0,25,971
47093002800,5449,1776,1321,1953,7,41,2,39,3673
47093002900,3769,2019,320,1129,14,17,1,18,1750
47093003000,4864,3376,384,686,9,70,0,23,1488
47093003100,2886,1937,133,640,6,20,4,13,949
47093003200,3289,1191,161,1734,11,16,0,2,2098
47093003300,2147,1422,68,532,8,13,1,10,725
47093003400,3900,3344,144,166,6,36,0,13,556
47093003501,2794,2408,73,125,9,35,3,7,386
47093003502,2778,2308,105,124,1,89,0,0,470
47093003700,2566,1986,146,210,6,68,1,17,580
47093003801,4182,2851,398,501,10,188,0,13,1331
47093003802,3203,2271,219,461,6,46,9,17,932
47093003901,4271,2858,489,561,10,96,3,27,1413
47093003902,3206,2074,538,318,12,80,0,11,1132
47093004000,4738,3138,685,565,17,45,4,17,1600
47093004100,4462,3446,308,395,12,35,0,15,1016
47093004200,3243,2723,171,163,11,24,0,24,520
47093004300,3208,2295,215,437,9,27,3,5,913
47093004401,5339,4721,163,137,4,88,8,10,618
47093004403,5317,4003,379,312,21,299,0,35,1314
47093004404,4300,3471,188,222,4,267,3,14,829
47093004501,3216,2319,194,277,8,256,4,3,897
47093004502,3438,2835,176,148,9,125,1,16,603
47093004606,6982,5626,404,306,12,269,2,28,1356
47093004607,6585,5024,586,514,4,87,12,15,1561
47093004608,2868,2189,207,273,16,33,0,11,679
47093004609,5043,3760,435,369,1,178,8,39,1283
47093004610,5071,3298,636,576,19,208,69,27,1773
47093004611,4344,3444,424,142,5,119,0,24,900
47093004612,2758,2185,179,162,3,73,4,6,573
47093004613,5814,4203,654,505,16,99,13,31,1611
47093004614,3092,2320,230,237,8,83,12,12,772
47093004615,4559,3278,403,534,0,95,0,11,1281
47093004700,4194,3239,270,315,7,59,4,13,955
47093004800,5564,4165,412,482,19,124,0,17,1399
47093004900,5936,4842,262,385,16,133,0,19,1094
47093005000,4059,3380,189,213,13,8,5,34,679
47093005100,7073,6077,219,394,16,116,1,19,996
47093005202,4075,3099,148,562,7,57,1,20,976
47093005203,4845,3900,185,526,8,79,2,10,945
47093005204,1697,1529,28,64,2,4,0,4,168
47093005301,4487,3966,110,185,5,12,0,18,521
47093005302,3737,3352,159,56,14,16,0,16,385
47093005401,3660,3192,120,157,11,17,1,18,468
47093005402,3247,2916,78,89,15,11,0,9,331
47093005501,2831,2493,93,63,3,11,2,16,338
47093005502,3190,2886,98,29,14,21,1,4,304
47093005602,4015,3648,104,24,11,15,0,15,367
47093005603,4263,3608,167,159,20,47,1,32,655
47093005604,2797,2435,90,45,2,19,0,10,362
47093005701,5079,4484,148,97,6,91,0,18,595
47093005704,6341,5091,354,306,11,253,14,25,1250
47093005706,4659,3642,245,214,5,305,0,23,1017
47093005707,3649,2970,106,106,0,323,0,1,679
47093005708,3173,2746,131,70,9,72,1,1,427
47093005709,2590,2241,110,41,0,92,0,12,349
47093005710,2433,2146,91,31,0,54,0,17,287
47093005711,5951,4972,225,180,10,321,4,14,979
47093005713,4044,3525,144,65,4,156,0,5,519
47093005714,4655,4022,144,153,13,158,1,2,633
47093005803,2829,2273,183,84,10,137,0,26,556
47093005807,3289,2544,286,92,10,215,1,11,745
47093005808,5438,4505,288,165,8,204,7,20,933
47093005809,5476,4678,135,84,4,359,0,45,798
47093005810,3929,3433,119,68,0,171,2,10,496
47093005811,3700,2998,117,78,5,371,4,3,702
47093005813,6612,5414,228,117,6,618,0,26,1198
47093005814,4767,4070,181,97,9,189,2,15,697
47093005815,3079,2594,111,54,3,197,0,5,485
47093005903,5181,4165,279,230,19,213,4,19,1016
47093005906,2461,2193,72,32,6,52,0,8,268
47093005907,5375,4426,224,188,8,275,4,34,949
47093005908,5523,4508,437,197,12,60,2,18,1015
47093005909,1376,1205,45,16,7,43,0,0,171
47093005910,1889,1462,95,91,1,146,0,14,427
47093005911,2937,2265,200,189,3,94,0,25,672
47093005912,4598,3500,400,166,1,270,1,22,1098
47093006001,4527,3662,273,236,11,102,4,11,865
47093006002,6043,5252,194,207,15,63,6,21,791
47093006003,5149,4485,250,134,10,63,4,17,664
47093006102,5356,4886,142,95,7,35,0,5,470
47093006103,5006,4394,228,122,3,21,0,10,612
47093006104,6285,5295,518,130,6,85,0,8,990
47093006202,5293,4849,107,75,5,57,3,8,444
47093006203,5130,4563,168,106,5,48,3,6,567
47093006205,4830,4492,74,40,8,62,1,12,338
47093006206,5219,4752,119,84,9,37,2,12,467
47093006207,3764,3199,181,136,13,41,0,12,565
47093006208,5803,4640,783,98,29,28,9,10,1163
47093006301,3611,3303,92,26,8,14,3,9,308
47093006302,2846,2657,73,12,8,6,1,5,189
47093006401,4377,3862,234,67,6,9,2,7,515
47093006402,5394,4986,107,44,7,24,3,20,408
47093006403,3189,2915,84,49,11,11,3,0,274
47093006501,3579,3242,143,58,0,8,1,4,337
47093006502,3468,3134,76,103,4,10,0,11,334
47093006600,3127,2542,155,214,13,32,0,20,585
47093006700,2922,1261,133,1318,9,4,0,10,1661
47093006800,4483,1473,247,2448,21,17,2,21,3010
47093006901,3326,2537,291,189,1,187,10,12,789
47093006902,2309,1786,113,222,8,140,1,5,523
47093006903,1908,1491,89,102,6,153,0,6,417
47093007000,2627,1028,212,1178,3,13,0,19,1599
47093007100,3972,3499,126,47,4,130,0,4,473
47095960100,4872,3129,119,1481,13,8,1,2,1743
47095960200,2133,1626,56,351,2,4,4,3,507
47097050100,3143,2200,67,768,9,0,0,2,943
47097050200,3426,2460,86,662,15,11,0,35,966
47097050300,2657,2062,87,362,16,0,0,3,595
47097050400,2954,2546,60,196,16,4,0,1,408
47097050503,2314,1684,45,480,7,9,0,3,630
47097050504,2826,1294,89,1358,4,20,0,1,1532
47097050505,3466,728,71,2543,14,6,0,3,2738
47097050506,2299,1136,42,1031,6,0,0,8,1163
47097050600,2058,906,40,985,46,3,0,6,1152
47099960100,4890,4662,73,18,13,1,0,5,228
47099960200,2437,2295,43,31,5,8,0,0,142
47099960300,5856,5474,100,42,9,18,0,20,382
47099960401,5690,5086,184,99,13,54,0,22,604
47099960402,4274,3868,123,50,7,35,0,2,406
47099960501,4660,3736,333,280,12,23,0,27,924
47099960502,4572,4176,78,101,12,13,0,6,396
47099960600,2148,2012,30,22,7,3,0,3,136
47099960700,3957,3750,63,13,4,7,1,12,207
47099960800,3666,3412,70,28,6,4,0,21,254
47099960900,2009,1897,20,10,4,1,0,2,112
47101970100,4830,4398,119,73,21,9,3,22,432
47101970200,7752,7112,207,111,10,46,2,14,640
47103975000,1745,1590,37,31,9,2,0,4,155
47103975100,2300,2073,49,69,3,14,0,0,227
47103975200,1838,1708,25,23,2,3,0,0,130
47103975300,6512,4643,244,1174,27,47,2,16,1869
47103975400,4101,3339,133,395,15,13,0,21,762
47103975500,5237,4610,250,58,24,7,11,13,627
47103975601,5952,5054,212,288,23,44,3,11,898
47103975602,4306,3733,229,134,6,29,0,16,573
47103975700,3328,3053,89,26,7,19,0,0,275
47105060100,4987,4463,254,43,10,41,0,31,524
47105060201,3920,3210,407,90,4,43,0,8,710
47105060203,2977,1814,1022,20,2,8,0,6,1163
47105060204,5535,3973,1213,78,10,50,0,12,1562
47105060301,4257,3659,295,43,5,98,0,1,598
47105060303,4033,3617,209,38,4,21,0,9,416
47105060304,2905,2614,110,20,5,38,1,12,291
47105060400,5502,5114,116,26,15,21,0,14,388
47105060502,2619,2231,228,29,2,7,0,17,388
47105060503,3548,3112,272,16,12,15,0,14,436
47105060504,4708,4532,55,10,2,24,0,9,176
47105060505,2091,1995,33,7,4,17,0,7,96
47105060600,4815,3410,999,113,14,61,1,16,1405
47105060700,2989,2675,143,45,6,6,0,5,314
47107970102,4830,4299,150,95,8,74,2,14,531
47107970103,3338,3057,72,35,18,12,1,2,281
47107970104,3806,3397,85,136,11,5,1,14,409
47107970201,2480,1894,221,187,4,20,4,0,586
47107970202,3502,2616,333,289,11,16,4,9,886
47107970300,3389,2550,265,350,13,28,0,11,839
47107970401,3672,3142,158,124,6,40,2,7,530
47107970402,5268,4527,238,159,12,108,0,15,741
47107970500,3863,3573,95,13,6,6,1,0,290
47107970601,2851,2611,39,23,8,15,1,4,240
47107970602,3608,3128,161,102,8,21,0,5,480
47107970700,4239,3714,90,187,19,19,0,9,525
47107970801,4497,4049,124,66,6,51,1,10,448
47107970802,3933,3436,130,76,10,15,0,7,497
47109930100,4256,3904,71,76,12,17,0,12,352
47109930200,2136,1963,54,30,9,7,0,4,173
47109930300,2796,2462,61,147,3,5,0,12,334
47109930400,2107,1975,17,50,4,4,0,0,132
47109930501,2458,2097,29,231,0,7,0,2,361
47109930502,5239,4138,134,683,17,21,0,18,1101
47109930600,3671,3297,46,241,10,8,0,0,374
47109930700,3203,3011,26,87,0,9,0,3,192
47111970100,5042,4571,286,20,10,10,3,2,471
47111970200,6471,5854,358,23,13,9,0,15,617
47111970301,4787,3996,583,36,7,14,1,6,791
47111970302,4128,3648,284,29,18,4,4,5,480
47111970400,4788,4370,173,12,12,7,0,6,418
47113000100,4014,1419,240,2115,6,50,0,28,2595
47113000200,6276,1732,500,3726,7,47,0,21,4544
47113000300,4138,2265,220,1455,5,47,1,9,1873
47113000400,3603,700,116,2657,10,15,0,11,2903
47113000500,3835,268,45,3398,9,4,0,16,3567
47113000600,1833,733,54,970,0,3,0,10,1100
47113000700,2325,1049,141,968,9,15,2,9,1276
47113000800,2462,777,120,1514,4,0,1,2,1685
47113000900,2249,142,59,1980,3,1,0,11,2107
47113001000,1874,159,48,1578,2,1,0,2,1715
47113001100,992,53,25,864,4,1,0,1,939
47113001300,5939,4409,265,940,10,16,1,20,1530
47113001401,2006,1271,113,524,7,8,0,6,735
47113001402,2200,1485,97,505,12,12,0,10,715
47113001501,4781,2333,224,1954,15,51,0,17,2448
47113001502,5620,4719,150,506,10,20,0,35,901
47113001603,2361,1523,101,631,2,27,0,8,838
47113001604,2852,2001,109,623,0,25,1,0,851
47113001605,3048,2098,105,646,20,85,0,18,950
47113001607,5998,3275,926,1434,3,172,0,22,2723
47113001608,2464,1913,80,380,1,18,0,3,551
47113001609,1883,1521,74,206,0,7,0,4,362
47113001610,7016,5632,186,728,11,253,0,29,1384
47113001611,2834,1671,91,865,4,94,0,13,1163
47113001612,7797,4044,355,2878,4,231,3,31,3753
47113001700,1473,753,63,622,2,2,0,3,720
47113001800,2994,1954,79,884,1,14,0,8,1040
47113001900,3956,3365,136,286,14,8,4,12,591
47115050101,3625,3394,59,1,14,9,0,3,231
47115050102,5953,5528,117,59,8,14,0,2,425
47115050201,4596,4129,103,104,20,14,0,6,467
47115050203,2561,2379,39,29,6,5,1,4,182
47115050204,3522,2999,94,233,6,16,0,18,523
47115050301,5554,4466,133,592,14,65,0,14,1088
47115050302,3026,2794,56,15,25,25,1,6,232
47117955000,8820,7873,387,179,23,15,0,18,947
47117955100,5730,5009,283,145,8,8,0,17,721
47117955200,6713,5455,420,480,20,65,0,18,1258
47117955300,4203,2438,614,801,21,30,4,21,1765
47117955400,4256,3302,405,334,10,19,3,10,954
47117955500,4596,4178,126,79,21,5,0,9,418
47119010100,3638,3347,112,53,6,17,0,0,291
47119010201,8425,6939,547,483,21,76,6,28,1486
47119010203,4991,4019,372,311,14,57,4,20,972
47119010204,10119,7544,871,909,18,235,6,29,2575
47119010205,1817,1540,150,38,4,8,0,8,277
47119010301,7889,6270,581,537,13,77,2,60,1619
47119010302,2884,2549,132,75,1,10,1,8,335
47119010401,4033,2982,427,405,13,30,4,6,1051
47119010402,2674,1865,209,444,10,13,0,21,809
47119010500,5039,1907,530,2291,12,11,2,16,3132
47119010600,5356,2899,814,1277,28,42,2,32,2457
47119010700,4838,3225,769,575,8,29,5,16,1613
47119010801,3481,2742,287,289,7,31,0,11,739
47119010802,8302,5500,801,1418,11,104,6,51,2802
47119010900,3313,2754,143,255,21,8,1,10,559
47119011001,2942,2456,88,274,4,8,2,12,486
47119011003,2619,2016,84,371,6,5,2,7,603
47119011004,4064,3151,99,561,11,29,1,12,913
47119011101,5043,4305,195,300,16,71,0,9,738
47119011102,3084,2434,195,278,5,59,1,8,650
47119011200,6423,5738,254,97,19,14,0,19,685
47121960100,3387,3159,69,16,11,6,0,12,228
47121960200,4949,4578,65,49,26,11,0,15,371
47121960300,4422,4086,86,66,21,9,1,11,336
47123925001,4245,3941,89,12,25,20,0,9,304
47123925002,3876,3499,251,10,7,14,0,4,377
47123925101,3964,3593,136,43,12,17,0,9,371
47123925102,4265,3448,556,66,9,9,0,12,817
47123925200,4903,3958,229,388,12,41,0,15,945
47123925301,3833,3487,124,29,9,20,0,5,346
47123925302,3694,3279,136,38,12,10,2,10,415
47123925401,4541,4148,154,24,9,32,0,9,393
47123925402,4539,3992,128,122,15,17,0,8,547
47123925501,2973,2763,47,0,13,2,0,0,210
47123925503,3282,3067,44,4,14,10,0,0,215
47123925504,2135,2010,43,0,4,2,0,4,125
47125100100,1627,919,117,495,4,15,0,2,708
47125100200,1771,1118,143,353,14,12,4,8,653
47125100300,5588,3517,402,1158,11,56,30,43,2071
47125100500,5074,3331,392,839,29,74,12,23,1743
47125100601,2326,1928,95,160,2,24,0,6,398
47125100602,2812,2149,174,298,7,38,0,9,663
47125100800,3553,1322,164,1899,2,18,7,11,2231
47125100900,2546,1046,452,813,10,31,7,18,1500
47125101001,4388,2297,605,1004,12,69,30,35,2091
47125101002,3569,1670,416,1089,14,63,25,34,1899
47125101101,2765,1250,386,802,11,56,25,18,1515
47125101102,10017,5235,1266,2353,32,172,49,61,4782
47125101103,2738,1839,302,332,19,23,14,10,899
47125101201,2343,796,349,931,9,65,27,26,1547
47125101202,4451,2540,560,865,16,76,17,20,1911
47125101304,6228,2376,1087,2038,18,162,44,44,3852
47125101305,6862,3066,1007,1906,17,257,66,61,3796
47125101306,5709,2507,769,1814,20,127,32,36,3202
47125101307,2376,1151,319,675,20,41,15,8,1225
47125101308,3941,1724,551,1094,12,195,38,25,2217
47125101309,7817,3508,1165,2079,23,294,62,45,4309
47125101400,6912,4161,1248,750,42,153,58,26,2751
47125101501,3389,2605,217,254,21,43,15,22,784
47125101502,4171,3452,207,133,23,35,3,19,719
47125101600,5704,4638,249,429,18,38,3,22,1066
47125101701,3527,3220,71,92,9,18,9,6,307
47125101702,5572,4835,221,155,13,20,3,40,737
47125101803,8928,6662,561,772,18,331,16,60,2266
47125101805,3928,3202,214,225,11,94,2,22,726
47125101806,7834,6664,341,289,23,95,10,19,1170
47125101807,3799,3066,233,216,15,56,0,19,733
47125101808,3930,2986,290,383,8,76,3,1,944
47125101902,2650,2005,174,263,4,41,2,11,645
47125101904,6833,4531,621,837,17,357,25,39,2302
47125101905,5381,3512,451,788,14,258,10,20,1869
47125101906,6161,3570,580,1199,14,313,15,26,2591
47125102001,6596,3869,641,1376,32,106,18,32,2727
47125102003,7422,3542,1084,1955,16,164,51,55,3880
47125102004,5939,2590,702,1837,18,230,22,27,3349
47125102005,7270,3427,880,2050,32,266,43,48,3843
47125102007,2071,1090,268,543,10,20,19,9,981
47125102008,7152,3818,914,1695,43,149,25,38,3334
47125102009,6179,3498,725,1206,12,169,43,38,2681
47125102010,4671,2539,599,985,26,98,31,30,2132
47125102100,5154,2335,650,1816,14,33,0,34,2819
47125980100,395,188,72,104,2,8,6,1,207
47127930100,3985,3772,58,39,11,6,1,2,213
47127930200,2476,2227,43,64,6,23,0,8,249
47129110100,3145,3008,27,7,11,3,3,7,137
47129110200,3379,3172,39,3,5,8,2,19,207
47129110300,5707,4517,114,946,15,18,0,6,1190
47129110400,3936,3789,37,0,5,4,2,4,147
47129110500,4868,4543,82,15,18,8,1,28,325
47131965000,4069,3488,67,377,6,8,0,11,581
47131965100,2335,2059,126,73,4,0,0,1,276
47131965200,2082,1980,26,21,1,7,0,2,102
47131965300,3513,3372,26,13,4,1,0,6,141
47131965400,4204,3894,97,84,4,5,0,6,310
47131965500,2838,1961,309,368,5,37,0,11,877
47131965600,4145,2006,437,1455,16,13,0,16,2139
47131965700,4674,3402,335,664,6,28,0,10,1272
47131965800,1652,1452,117,30,1,4,0,2,200
47131965900,1275,1122,34,52,3,0,0,2,153
47133950100,1668,1574,31,4,8,7,0,8,94
47133950200,1716,1662,19,0,2,1,0,2,54
47133950301,4524,4246,65,30,18,12,0,9,278
47133950302,3022,2824,58,15,7,21,0,0,198
47133950400,2109,2004,26,1,8,2,0,2,105
47133950501,4355,4073,73,25,9,11,0,5,282
47133950502,2469,2340,31,3,6,3,0,4,129
47133950600,2648,2500,41,8,2,4,0,1,148
47135930100,3334,3122,47,26,22,6,1,9,212
47135930201,2603,2346,33,113,8,13,0,6,257
47135930202,2429,2232,47,56,11,7,0,6,197
47137925101,3040,2944,36,7,3,11,1,5,96
47137925102,1961,1867,47,1,5,4,0,0,94
47139950100,1583,1460,13,2,1,0,0,6,123
47139950201,2275,2136,34,4,5,7,3,2,139
47139950203,3106,2872,70,12,17,4,2,1,234
47139950204,2868,2711,21,12,12,1,0,7,157
47139950300,4187,3895,96,24,7,5,3,4,292
47139950400,3525,3239,63,7,17,16,2,3,286
47141000100,5922,4661,995,36,4,22,0,9,1261
47141000201,5918,5174,259,106,12,120,2,8,744
47141000202,4808,4263,227,79,7,24,6,18,545
47141000301,2976,2663,122,13,3,18,0,10,313
47141000303,2636,1960,523,36,3,15,0,2,676
47141000304,4333,2769,1092,189,4,104,1,8,1564
47141000305,2667,2084,262,80,6,81,0,3,583
47141000400,4186,3652,231,63,15,72,1,0,534
47141000500,2106,1813,102,40,7,91,0,4,293
47141000600,4279,3585,230,95,8,175,0,11,694
47141000700,3824,2882,468,216,5,74,1,13,942
47141000800,6135,4364,509,822,11,99,2,18,1771
47141000900,6763,6001,295,145,12,39,2,14,762
47141001000,3742,3486,69,23,10,16,0,8,256
47141001100,7538,6799,317,61,18,23,10,17,739
47141001201,5549,4871,294,66,11,59,6,17,678
47141001202,4235,3725,204,63,20,46,1,12,510
47141001300,2237,2030,57,28,5,8,1,7,207
47143975000,4962,4597,76,68,20,30,0,8,365
47143975100,4775,4424,91,42,17,16,0,15,351
47143975200,6530,5878,273,64,16,25,4,5,652
47143975300,5906,5079,470,64,23,20,1,9,827
47143975401,7003,5507,774,290,20,77,1,23,1496
47143975402,3694,3156,276,70,4,27,0,9,538
47145030100,3387,2855,115,146,4,64,8,18,532
47145030203,3848,3549,59,49,8,41,0,11,299
47145030204,3464,3033,99,160,5,20,3,6,431
47145030205,3088,2836,74,16,7,12,0,8,252
47145030206,3961,3591,72,48,17,42,0,14,370
47145030301,2921,2718,53,5,11,12,0,3,203
47145030302,3658,3353,99,8,8,6,0,20,305
47145030401,2643,2430,37,35,7,18,0,11,213
47145030402,3836,3462,58,101,13,24,1,23,374
47145030500,4103,3579,108,173,14,20,0,6,524
47145030600,3466,3146,40,69,14,17,5,15,320
47145030700,4087,3688,60,100,17,22,1,5,399
47145030801,2008,1675,38,146,9,18,0,1,333
47145030802,3196,2839,39,174,9,6,1,3,357
47145030900,5738,5340,60,72,18,19,0,13,398
47145980100,0,0,0,0,0,0,0,0,0
47147080101,4286,3750,146,178,1,13,0,10,536
47147080103,6840,5853,338,172,12,90,1,34,987
47147080104,7632,6711,318,180,5,30,0,34,921
47147080200,6151,5347,460,117,18,10,0,14,804
47147080301,3329,1552,892,705,9,5,3,4,1777
47147080302,3160,1451,728,859,2,14,0,7,1709
47147080401,5445,2462,1379,1315,2,26,3,32,2983
47147080402,5252,3034,1233,705,20,39,0,21,2218
47147080500,5030,4065,431,304,6,28,1,12,965
47147080603,4770,4259,187,84,16,36,1,19,511
47147080604,4095,3663,121,56,12,87,2,7,432
47147080605,3071,2772,101,59,4,15,3,13,299
47147080606,6120,5376,275,166,9,20,2,7,744
47147080701,3447,3120,97,56,11,11,0,12,327
47147080702,4175,3634,172,135,12,23,5,20,541
47149040101,4486,1549,1879,811,5,81,2,27,2937
47149040102,4262,1699,1123,1138,13,91,1,20,2563
47149040104,5786,2347,1234,1735,16,168,1,42,3439
47149040105,4716,2301,1393,641,10,141,5,18,2415
47149040106,3544,1155,930,1166,6,125,0,23,2389
47149040107,5349,1545,1287,2079,21,203,9,27,3804
47149040200,4131,2289,747,699,2,222,2,39,1842
47149040303,2412,1542,255,447,5,45,0,5,870
47149040304,3017,1554,468,675,10,86,0,29,1463
47149040305,2589,1493,376,454,8,112,4,7,1096
47149040307,3240,2215,267,370,5,231,2,8,1025
47149040308,7032,4150,796,1234,2,478,3,33,2882
47149040309,6132,4459,516,646,9,199,0,20,1673
47149040310,4062,2812,501,335,9,146,0,15,1250
47149040311,2852,1597,362,601,1,137,13,8,1255
47149040312,2956,1014,1014,612,3,161,3,22,1942
47149040404,3885,2236,1070,304,9,135,2,8,1649
47149040405,4131,1820,1220,719,5,141,6,19,2311
47149040501,9212,7551,466,520,21,158,5,24,1661
47149040502,8339,7072,387,439,26,67,8,19,1267
47149040600,5167,4415,314,138,22,68,4,9,752
47149040702,6970,5366,407,635,26,128,0,33,1604
47149040703,8582,6204,529,1110,26,253,9,39,2378
47149040704,4866,4028,220,294,14,68,0,17,838
47149040806,8601,6552,696,668,17,302,8,18,2049
47149040807,6996,5562,420,478,21,152,3,15,1434
47149040808,11023,8392,731,931,9,394,9,35,2631
47149040809,4664,3996,185,147,8,70,0,17,668
47149040810,3139,2829,129,48,1,13,0,14,310
47149040811,7302,4702,435,1299,5,537,3,34,2600
47149040812,4198,2064,727,884,5,256,8,44,2134
47149040901,5418,3498,618,648,16,310,5,59,1920
47149040904,5175,3599,347,720,5,252,5,15,1576
47149040906,7682,4420,806,1487,14,513,0,57,3262
47149040907,11593,7727,906,1623,26,694,4,33,3866
47149040908,7337,4626,593,1344,18,344,4,53,2711
47149040909,6889,4235,680,1320,17,256,1,45,2654
47149040910,6238,4061,438,1158,16,164,1,24,2177
47149040911,6495,4635,364,857,13,324,1,20,1860
47149041000,8704,6870,542,653,10,228,1,39,1834
47149041102,3111,2381,220,323,3,37,3,11,730
47149041103,4602,3419,232,560,9,147,1,21,1183
47149041104,4418,3336,220,510,3,136,0,27,1082
47149041201,6451,4609,412,880,25,251,1,24,1842
47149041202,4967,3633,276,416,10,373,7,15,1334
47149041301,6414,5276,227,415,4,238,8,32,1138
47149041302,5779,4528,321,547,7,111,3,24,1251
47149041401,4930,3198,283,1089,15,137,0,19,1732
47149041404,4272,1878,762,1294,18,45,2,16,2394
47149041405,2584,1382,390,583,10,49,1,15,1202
47149041406,5090,2706,452,1430,12,184,5,47,2384
47149041407,4781,2935,379,1039,14,165,0,15,1846
47149041500,2900,1720,104,874,5,45,1,14,1180
47149041601,3542,1945,409,846,16,65,7,16,1597
47149041602,2313,1464,170,496,14,19,0,28,849
47149041700,4946,3197,518,828,18,83,9,19,1749
47149041800,5201,2787,589,1331,22,145,1,29,2414
47149041900,4405,1581,695,1838,24,28,1,16,2824
47149042000,5451,3246,887,827,24,229,2,35,2205
47149042101,5974,2682,871,1803,10,306,8,29,3292
47149042102,4942,2763,663,1057,16,134,6,82,2179
47149042200,4946,2962,1119,465,8,163,3,23,1984
47149042301,5903,2628,1283,1013,17,691,12,30,3275
47149042302,4392,2757,457,739,10,160,6,22,1635
47151975000,4130,3970,32,6,5,10,0,0,160
47151975101,2721,2575,40,6,1,21,0,2,146
47151975102,4223,4023,48,5,10,9,0,4,200
47151975200,5708,5520,38,15,13,6,0,0,188
47151975300,2351,2273,19,0,0,2,0,0,78
47151975400,2717,2596,28,0,7,3,0,0,121
47153060102,2555,2379,58,4,12,16,0,5,176
47153060103,4484,3951,309,28,12,26,3,13,533
47153060104,4265,3918,157,17,14,12,1,6,347
47153060200,4522,4161,97,23,11,11,0,18,361
47155080101,4290,3864,169,35,17,10,3,6,426
47155080103,3921,3506,145,19,18,40,1,14,415
47155080104,3879,3417,203,21,6,21,1,2,462
47155080202,6448,5782,232,65,17,40,1,10,666
47155080203,5252,4803,140,27,13,48,0,10,449
47155080204,3626,3363,89,22,5,15,0,11,263
47155080300,5642,5052,191,59,23,71,1,11,590
47155080401,3297,3012,136,6,20,5,0,4,285
47155080402,4077,3648,211,30,10,4,0,6,429
47155080500,5644,4312,868,66,17,141,3,47,1332
47155080601,5073,3918,752,94,24,80,0,0,1155
47155080603,3852,3513,170,24,14,11,0,10,339
47155080604,5275,4867,175,19,22,26,0,18,408
47155080701,3792,3464,139,17,11,47,0,6,328
47155080702,4666,4326,128,15,15,13,0,10,340
47155080801,2934,1641,1112,62,15,14,3,4,1293
47155080803,5141,4192,587,31,9,134,0,31,949
47155080804,2870,2094,596,25,3,64,1,2,776
47155080901,3457,2979,347,16,8,37,0,5,478
47155080903,2327,2154,59,20,4,5,0,5,173
47155080904,2370,1805,320,14,8,121,0,11,565
47155081001,3336,2306,860,30,8,26,1,6,1030
47155081002,2542,2054,307,28,6,52,2,10,488
47155081101,1461,1018,335,9,7,46,0,6,443
47155081103,1758,1455,223,5,7,20,4,1,303
47155081104,1428,1245,113,7,5,10,2,8,183
47155980100,22,11,7,0,0,2,1,0,11
47157000100,5821,3526,295,972,10,842,1,21,2295
47157000200,1117,30,9,1033,3,10,0,5,1087
47157000300,675,8,5,643,1,1,0,0,667
47157000400,1350,14,16,1290,2,0,0,0,1336
47157000600,1695,15,20,1596,0,0,0,2,1680
47157000700,4654,416,108,3993,5,10,1,24,4238
47157000800,1934,27,34,1814,10,4,0,8,1907
47157000900,2519,70,93,2266,11,7,0,11,2449
47157001100,3474,641,1566,1112,14,22,1,8,2833
47157001200,4101,1398,1551,865,5,140,0,18,2703
47157001300,3676,409,981,2136,8,45,0,4,3267
47157001400,1426,70,282,1035,3,14,1,0,1356
47157001500,1721,248,176,1211,9,24,1,7,1473
47157001600,3159,1977,648,309,1,92,0,11,1182
47157001700,3493,1569,112,1575,9,56,4,11,1924
47157001900,1148,14,18,1085,4,2,1,0,1134
47157002000,1578,64,23,1440,0,18,0,5,1514
47157002100,1422,187,31,1134,4,5,1,11,1235
47157002400,2352,228,61,1947,1,51,0,4,2124
47157002500,3104,1307,353,1155,7,151,0,13,1797
47157002600,2441,2008,57,174,3,55,1,15,433
47157002700,1774,660,279,651,7,106,0,10,1114
47157002800,3392,421,207,2612,0,31,4,8,2971
47157002900,4882,4186,139,291,6,70,0,25,696
47157003000,2798,1382,86,1163,8,61,2,14,1416
47157003100,3598,2509,301,491,9,97,0,7,1089
47157003200,3783,2515,180,787,12,106,2,21,1268
47157003300,2146,1821,69,124,5,26,0,16,325
47157003400,2065,1288,120,511,6,53,0,7,777
47157003500,3081,2252,96,524,6,61,0,20,829
47157003600,1586,628,144,570,6,147,1,13,958
47157003700,1291,300,30,883,2,37,0,9,991
47157003800,818,197,19,545,3,15,0,10,621
47157003900,1532,220,48,1059,4,148,0,3,1312
47157004200,3432,2047,108,993,12,112,0,21,1385
47157004300,3091,1654,82,1104,3,122,0,24,1437
47157004500,831,19,3,784,3,0,0,2,812
47157004600,1492,185,23,1232,0,25,0,5,1307
47157005000,1021,16,29,958,0,2,0,1,1005
47157005300,3023,17,20,2889,7,0,0,6,3006
47157005500,1934,25,20,1836,3,2,0,4,1909
47157005600,3675,20,26,3537,11,0,0,7,3655
47157005700,1921,21,18,1849,0,0,0,1,1900
47157005800,967,8,6,928,2,0,0,2,959
47157005900,1952,24,51,1812,1,3,0,14,1928
47157006000,1759,25,14,1667,0,15,0,4,1734
47157006200,1676,101,54,1451,13,3,1,7,1575
47157006300,2182,1476,69,515,6,17,0,10,706
47157006400,1520,120,27,1311,8,8,4,3,1400
47157006500,2346,29,33,2224,10,0,1,7,2317
47157006600,2127,1143,49,784,6,27,0,7,984
47157006700,3023,56,84,2833,1,1,0,1,2967
47157006800,2056,24,40,1919,6,4,3,3,2032
47157006900,2688,32,71,2520,5,1,0,6,2656
47157007000,3137,600,169,2223,7,46,0,10,2537
47157007100,2393,1612,77,616,2,28,0,3,781
47157007200,2966,2502,78,172,0,86,0,6,464
47157007300,2996,1473,89,974,9,341,4,7,1523
47157007400,3085,2109,131,504,1,184,2,6,976
47157007500,1342,6,6,1291,0,2,0,0,1336
47157007810,2747,67,61,2566,2,0,0,8,2680
47157007821,4450,63,66,4182,10,12,0,5,4387
47157007822,1433,76,221,1084,6,3,0,8,1357
47157007900,4839,143,232,4368,0,0,0,12,4696
47157008000,4891,964,616,3102,5,40,0,16,3927
47157008110,1989,36,203,1711,4,4,0,1,1953
47157008120,4759,89,248,4317,3,7,2,19,4670
47157008200,4287,209,1360,2584,3,32,1,16,4078
47157008500,4447,4003,62,100,1,157,3,13,444
47157008600,6109,4539,425,751,4,179,0,7,1570
47157008700,5126,2317,1683,698,4,177,0,38,2809
47157008800,7232,1801,4172,985,11,65,2,25,5431
47157008900,4018,741,2057,1063,3,47,1,22,3277
47157009100,2933,875,1629,250,7,50,0,17,2058
47157009201,3670,2993,134,205,2,159,6,16,677
47157009202,3788,2870,195,200,7,350,2,12,918
47157009300,4656,3065,501,807,4,59,1,19,1591
47157009400,3141,2432,198,327,8,35,0,11,709
47157009501,2943,2299,171,304,0,37,3,7,644
47157009502,3422,2939,89,239,3,43,5,11,483
47157009600,4968,4364,130,143,8,188,0,27,604
47157009700,3065,582,890,1426,10,50,2,20,2483
47157009800,3483,1609,1138,441,6,122,5,28,1874
47157009901,2832,693,242,1766,4,4,0,8,2139
47157009902,2334,305,73,1856,4,3,0,14,2029
47157010001,3822,123,92,3499,0,6,0,6,3699
47157010002,3238,190,47,2913,9,5,1,4,3048
47157010120,5311,440,183,4568,6,11,0,8,4871
47157010121,3166,208,82,2759,26,6,4,20,2958
47157010122,2981,173,57,2637,5,3,0,2,2808
47157010210,5253,261,129,4699,0,8,4,5,4992
47157010220,6618,504,202,5681,17,17,0,20,6114
47157010300,1258,33,4,1195,1,0,0,6,1225
47157010500,1642,143,289,1147,3,21,1,8,1499
47157010610,6086,291,1163,4431,2,63,0,24,5795
47157010620,3475,73,700,2602,5,29,0,10,3402
47157010630,4377,105,1626,2535,4,14,2,7,4272
47157010710,5105,374,1082,3380,13,185,0,13,4731
47157010720,4158,241,528,3246,6,32,0,8,3917
47157010810,6149,226,1174,4478,3,149,0,32,5923
47157010820,4270,207,358,3571,6,70,0,6,4063
47157011010,3913,528,621,2674,6,21,3,5,3385
47157011020,1457,66,152,1182,7,19,0,2,1391
47157011100,1477,19,48,1361,13,1,0,12,1458
47157011200,1373,9,17,1312,10,1,0,0,1364
47157011300,1285,204,50,913,4,89,1,1,1081
47157011401,1188,98,13,1053,4,7,0,0,1090
47157011402,3499,1096,637,1640,5,44,1,20,2403
47157011500,2337,27,36,2210,0,5,0,6,2310
47157011600,2274,36,14,2187,3,0,0,0,2238
47157011700,1280,24,8,1202,1,1,0,12,1256
47157011800,5743,1512,1939,1996,10,70,0,21,4231
47157020101,4134,1211,221,2509,11,10,0,34,2923
47157020102,3095,2447,83,370,8,23,5,9,648
47157020210,5867,3297,418,1640,23,130,2,21,2570
47157020221,2742,1403,120,1006,23,32,1,3,1339
47157020222,3168,1202,433,1351,14,19,1,17,1966
47157020301,1920,1467,86,240,1,26,2,4,453
47157020302,3507,2072,169,933,14,56,1,15,1435
47157020400,976,545,155,169,0,28,5,5,431
47157020511,2165,235,71,1791,0,2,0,0,1930
47157020521,3364,150,71,3066,4,9,0,5,3214
47157020523,3156,200,196,2659,6,9,1,13,2956
47157020524,4795,285,272,4087,7,6,2,30,4510
47157020531,5694,672,1161,3661,3,25,0,30,5022
47157020532,6041,759,268,4833,12,42,0,16,5282
47157020541,5479,617,313,4320,6,39,0,32,4862
47157020542,5237,438,324,4313,11,30,0,26,4799
47157020543,2938,171,101,2584,3,5,0,15,2767
47157020544,2295,278,118,1784,8,9,0,26,2017
47157020610,4408,841,375,2952,0,62,1,19,3567
47157020621,7036,2124,415,4066,27,112,1,38,4912
47157020622,4347,3080,254,777,9,55,0,11,1267
47157020632,5689,4271,291,619,13,261,1,11,1418
47157020633,2920,2451,122,176,7,51,2,7,469
47157020634,2836,2289,95,254,3,74,1,0,547
47157020635,2576,2112,114,179,10,15,2,9,464
47157020651,6642,3399,487,2356,12,100,4,30,3243
47157020652,5230,4080,221,550,15,100,1,14,1150
47157020653,4173,2161,175,1573,3,102,0,11,2012
47157020654,5138,2879,186,1716,10,120,6,22,2259
47157020655,3160,2380,123,443,3,63,0,21,780
47157020656,5147,2913,224,1472,5,291,6,15,2234
47157020657,5033,1923,243,2513,8,170,4,22,3110
47157020658,5098,1384,376,3067,6,92,2,25,3714
47157020700,2547,2084,71,272,8,10,0,5,463
47157020833,5858,3364,246,1492,3,490,3,33,2494
47157020834,3057,2221,107,518,12,65,0,10,836
47157020835,2564,1737,84,624,0,15,0,13,827
47157020836,8194,6171,269,757,15,561,4,35,2023
47157020837,7686,5251,846,975,18,247,5,18,2435
47157020901,5762,4245,320,707,16,156,4,29,1517
47157020902,6867,5204,319,853,19,150,2,29,1663
47157021020,7444,3705,353,2822,10,260,0,48,3739
47157021021,6566,1771,369,3889,5,323,0,18,4795
47157021022,6856,1807,328,4112,7,304,0,42,5049
47157021023,5247,2444,270,2183,4,128,0,23,2803
47157021111,4120,1146,1002,1719,1,74,1,19,2974
47157021112,6975,2322,2705,1582,12,87,6,25,4653
47157021113,3808,1311,805,1376,3,153,0,33,2497
47157021121,4888,1788,284,2499,6,124,2,42,3100
47157021122,5637,1800,1124,2208,8,266,2,10,3837
47157021124,8045,2297,1153,3898,7,345,7,36,5748
47157021125,4495,2008,354,1717,12,209,0,20,2487
47157021126,4312,1587,354,1795,14,320,0,61,2725
47157021135,6576,2290,808,2809,8,364,6,40,4286
47157021136,5284,2007,281,2531,5,271,0,31,3277
47157021138,4213,1486,218,2105,1,241,0,19,2727
47157021139,4273,2326,163,1252,11,334,0,10,1947
47157021140,4740,2395,339,1581,5,188,2,37,2345
47157021141,7638,2527,660,3791,11,385,1,24,5111
47157021142,3636,1692,253,1435,3,77,1,16,1944
47157021143,4419,1945,367,1698,5,231,1,20,2474
47157021144,3768,1447,297,1613,19,200,0,23,2321
47157021200,1689,498,110,1058,6,11,0,0,1191
47157021311,4850,3910,118,398,3,295,0,17,940
47157021312,2100,1520,93,275,1,106,3,19,580
47157021320,5989,4051,199,1475,5,86,0,32,1938
47157021331,3500,1874,171,1266,8,58,0,26,1626
47157021333,3988,1542,274,1916,4,103,1,11,2446
47157021334,3682,851,252,2373,5,81,0,12,2831
47157021341,5686,4837,164,259,9,238,0,21,849
47157021351,5273,4259,195,199,7,415,0,27,1014
47157021352,6969,5939,183,145,15,451,0,15,1030
47157021354,6169,1592,292,3193,16,881,1,32,4577
47157021355,5383,3506,136,1093,27,432,4,26,1877
47157021356,4125,3327,111,149,7,382,0,11,798
47157021357,5712,4525,165,133,7,675,1,10,1187
47157021410,2983,2601,86,67,3,130,0,16,382
47157021420,3373,2781,114,140,5,218,0,3,592
47157021430,4103,3276,133,311,4,200,1,12,827
47157021530,5956,4499,163,269,20,814,0,15,1457
47157021541,8296,6147,290,367,10,1103,2,38,2149
47157021542,4491,3419,221,184,6,437,3,20,1072
47157021543,4589,1575,235,1568,4,1029,0,22,3014
47157021544,3294,1429,148,353,2,1267,0,23,1865
47157021545,3524,2089,147,635,7,538,0,10,1435
47157021546,3770,1314,175,1240,7,911,1,21,2456
47157021547,6507,587,347,5126,6,297,0,50,5920
47157021548,3058,912,127,1563,8,341,1,21,2146
47157021611,6080,5040,236,322,8,203,5,17,1040
47157021612,4485,4022,116,91,5,78,0,3,463
47157021613,4537,3670,208,193,4,264,5,7,867
47157021620,3067,1221,312,1318,0,127,1,4,1846
47157021710,2772,125,97,2493,2,10,0,5,2647
47157021721,4860,213,393,4111,4,37,3,31,4647
47157021724,2283,110,321,1780,0,13,1,4,2173
47157021725,3798,141,301,3273,3,18,0,18,3657
47157021731,2855,54,916,1844,3,8,0,2,2801
47157021744,5802,427,589,4581,0,70,3,18,5375
47157021745,8226,587,709,6640,13,91,9,36,7639
47157021746,4653,235,451,3854,2,28,0,7,4418
47157021747,3985,152,528,3180,7,42,3,28,3833
47157021751,7520,376,568,6295,5,134,1,15,7144
47157021752,5080,176,226,4483,10,57,9,31,4904
47157021753,3208,192,397,2526,6,38,0,8,3016
47157021754,4343,206,425,3573,10,55,1,8,4137
47157021755,1763,100,74,1539,0,1,0,0,1663
47157021756,2144,669,166,1266,2,1,0,5,1475
47157021757,3743,91,368,3199,5,13,0,22,3652
47157021758,3030,137,299,2496,15,20,0,6,2893
47157021759,4194,149,797,3163,0,18,1,12,4045
47157021760,3950,144,730,2975,6,19,0,16,3806
47157021900,4929,88,207,4534,1,9,0,31,4841
47157022023,1703,16,15,1640,0,1,0,1,1687
47157022024,3246,85,30,3083,3,0,0,6,3161
47157022025,3097,82,56,2849,3,3,0,12,3015
47157022026,2304,77,28,2137,3,15,1,7,2227
47157022111,5307,107,214,4843,19,5,3,9,5200
47157022121,4267,143,46,4001,1,4,0,24,4124
47157022122,3934,79,26,3733,4,7,0,22,3855
47157022130,4944,145,58,4640,12,8,0,17,4799
47157022131,2892,41,30,2743,6,0,1,15,2851
47157022132,2974,76,34,2795,6,3,0,19,2898
47157022210,4280,61,73,4049,3,7,1,5,4219
47157022220,3418,59,32,3229,6,3,1,17,3359
47157022310,5479,32,51,5277,9,1,0,26,5447
47157022321,4034,43,28,3889,7,4,0,16,3991
47157022322,3972,41,48,3825,3,1,0,18,3931
47157022330,4607,29,237,4216,22,3,0,8,4578
47157022410,5592,213,154,5086,9,5,3,34,5379
47157022500,4550,234,650,3568,7,28,0,17,4316
47157022600,4508,216,1123,3080,2,16,1,5,4292
47157022700,6387,83,50,6122,2,5,0,20,6304
47157980100,15,2,1,6,0,4,1,0,13
47157980200,11,1,3,4,0,0,0,0,10
47157980300,0,0,0,0,0,0,0,0,0
47157980401,1829,335,26,1465,0,2,0,1,1494
47157980402,9,7,0,0,0,0,0,0,2
47159975000,4182,3842,95,37,19,1,0,4,340
47159975100,2974,2622,99,113,9,29,0,0,352
47159975200,5919,5360,199,116,19,27,0,10,559
47159975300,2102,1914,36,25,5,5,0,2,188
47159975400,4727,4316,89,65,9,22,0,4,411
47161110201,4718,4278,135,20,15,13,2,18,440
47161110202,1770,1620,55,7,2,0,0,8,150
47161110600,2526,2222,45,72,17,4,0,11,304
47161110700,4640,4199,101,72,40,59,0,8,441
47161980100,3,2,0,0,0,0,0,0,1
47161980200,0,0,0,0,0,0,0,0,0
47163040200,2558,1815,77,452,13,35,0,17,743
47163040300,2654,2266,84,133,5,44,0,12,388
47163040500,4523,3764,191,195,31,17,2,12,759
47163040600,3128,2570,172,181,7,26,1,7,558
47163040700,2409,2208,63,51,4,11,0,8,201
47163040800,3914,3317,148,173,22,55,3,17,597
47163040900,3360,2918,91,104,5,48,0,17,442
47163041000,4465,4075,112,40,5,74,0,14,390
47163041100,2910,2552,78,67,7,59,2,14,358
47163041200,6635,6025,197,94,8,58,1,25,610
47163041300,5137,4658,163,52,9,47,0,17,479
47163041400,5174,4845,85,40,2,12,0,11,329
47163041500,2754,2523,33,66,0,25,0,11,231
47163041600,2637,2379,63,71,6,21,2,8,258
47163041700,3209,2934,106,36,17,6,2,2,275
47163041800,4731,4204,131,100,11,11,3,18,527
47163041900,3079,2858,57,16,7,19,0,10,221
47163042000,3260,3064,51,16,7,5,0,7,196
47163042100,5671,5076,110,101,8,155,2,33,595
47163042200,3174,2921,70,18,13,15,0,10,253
47163042300,6743,6317,89,58,8,50,1,13,426
47163042400,3539,3325,29,27,9,23,4,6,214
47163042500,3376,3116,71,55,3,32,0,6,260
47163042600,4212,3812,106,62,7,33,0,4,400
47163042702,2279,2073,64,48,0,18,1,10,206
47163042703,2214,1867,75,73,16,14,1,9,347
47163042704,2382,2079,80,72,3,25,0,8,303
47163042801,2524,2258,56,107,1,8,0,4,266
47163042802,4521,3988,99,231,7,27,2,17,533
47163042900,4418,4018,83,90,5,55,1,15,400
47163043000,4394,3975,137,58,6,36,2,3,419
47163043100,2738,2593,39,19,6,3,0,0,145
47163043201,4203,3944,57,25,8,9,0,10,259
47163043202,4588,4394,30,15,11,21,0,13,194
47163043301,6343,5852,125,59,17,52,3,9,491
47163043302,5891,5515,81,44,15,25,0,3,376
47163043401,5304,5005,75,25,9,27,0,15,299
47163043402,4657,4350,57,77,4,19,0,10,307
47163043500,3893,3673,35,11,16,15,3,8,220
47163043600,4562,4228,78,35,12,35,0,24,334
47165020101,3826,3510,122,40,14,13,0,9,316
47165020102,5187,4722,148,34,17,24,0,17,465
47165020203,2742,2397,142,62,7,3,0,6,345
47165020204,3827,3320,186,139,12,13,0,4,507
47165020205,3095,2536,167,219,5,11,1,16,559
47165020206,1332,1152,79,41,1,10,2,0,180
47165020207,1911,1619,118,48,12,18,0,3,292
47165020208,2683,2337,128,71,1,16,1,4,346
47165020209,2172,2000,82,27,4,5,0,2,172
47165020300,5425,4344,517,200,14,36,0,13,1081
47165020403,2201,2026,56,19,3,13,1,8,175
47165020404,2079,1896,68,16,1,25,1,1,183
47165020405,2597,2308,109,55,11,18,0,4,289
47165020406,3900,3517,128,52,5,24,0,15,383
47165020407,4686,4111,238,84,11,31,2,17,575
47165020501,9087,7432,453,534,11,297,9,48,1655
47165020502,6772,5498,391,401,12,129,5,38,1274
47165020503,2753,2392,127,88,21,22,2,2,361
47165020601,3616,3310,100,80,3,8,3,8,306
47165020602,4548,3969,162,194,7,22,0,16,579
47165020603,3688,3179,156,165,4,16,2,10,509
47165020700,5636,3939,566,808,16,54,0,14,1697
47165020800,7233,2522,1400,2907,25,14,6,38,4711
47165020901,1352,974,211,97,4,0,0,5,378
47165020903,4668,3837,230,337,13,70,0,17,831
47165020904,4054,2290,659,828,11,4,3,16,1764
47165020905,4113,2576,477,752,10,53,4,12,1537
47165021002,8739,6482,527,928,29,359,2,33,2257
47165021004,3769,2585,494,428,7,41,8,17,1184
47165021005,6063,4898,355,401,14,119,5,17,1165
47165021006,3755,3229,127,210,1,31,3,17,526
47165021007,4309,3502,178,292,13,141,4,16,807
47165021008,7382,5865,341,550,17,246,1,15,1517
47165021009,5559,4146,472,463,6,128,21,14,1413
47165021103,6143,4939,342,382,21,103,5,15,1204
47165021104,2073,1407,369,180,2,24,2,8,666
47165021105,6672,4617,657,880,18,84,10,24,2055
47165021106,4040,2989,337,394,7,71,0,4,1051
47165021107,5733,4417,350,533,23,78,7,18,1316
47165021201,7634,6746,226,231,13,104,3,39,888
47165021203,8433,7144,334,386,24,200,0,37,1289
47165021204,7891,5920,451,865,25,195,1,33,1971
47165021205,2903,2570,90,116,1,59,2,5,333
47167040100,4695,3724,142,527,16,23,4,18,971
47167040200,2007,1726,68,85,4,4,0,1,281
47167040302,10574,8132,348,1270,34,134,16,46,2442
47167040303,6701,5109,233,805,35,71,6,34,1592
47167040304,6581,5564,238,397,21,46,3,17,1017
47167040400,2937,2727,54,46,9,6,1,7,210
47167040500,6158,4937,195,645,10,33,4,16,1221
47167040601,4575,2659,84,1595,19,13,0,20,1916
47167040602,3175,2326,87,640,8,10,0,7,849
47167040700,4911,2047,59,2580,10,32,2,8,2864
47167040800,4297,3703,85,306,9,16,0,14,594
47167040900,1491,1021,23,405,3,2,0,0,470
47167041000,2868,1250,70,1459,2,3,3,2,1618
47169090100,8700,6661,271,1462,20,16,0,16,2039
47169090200,2915,2125,104,455,6,11,0,4,790
47171080100,2357,2233,37,1,6,6,0,3,124
47171080200,6124,5426,497,22,13,7,0,5,698
47171080300,5297,4743,358,9,14,13,0,8,554
47171080400,4150,3773,215,12,5,11,0,5,377
47173040101,4285,3994,116,18,5,6,1,10,291
47173040102,3068,2940,41,5,1,4,0,7,128
47173040201,3971,3672,124,8,4,13,0,8,299
47173040202,5946,5643,92,20,17,6,4,12,303
47173040300,2532,2393,31,2,6,7,0,4,139
47175925000,3073,2900,41,12,2,4,1,0,173
47175925200,3095,2966,42,8,5,6,0,0,129
47177930100,3613,3078,312,63,9,9,0,6,535
47177930201,3132,2701,272,53,5,5,0,3,431
47177930202,3593,3030,431,33,10,11,0,5,563
47177930300,2784,2504,141,34,5,10,0,3,280
47177930400,5834,4581,639,216,7,55,3,55,1253
47177930500,5083,3711,882,250,10,34,4,24,1372
47177930600,3629,2924,348,195,9,23,2,6,705
47177930700,5006,4242,362,101,12,43,0,16,764
47177930800,6430,5583,421,137,12,48,1,15,847
47177930900,1849,1626,135,8,5,20,0,5,223
47179060100,4115,2763,458,550,19,43,1,29,1352
47179060401,2158,1897,68,65,5,23,0,7,261
47179060402,4504,3866,103,146,11,198,0,30,638
47179060501,4718,3871,279,193,15,89,7,11,847
47179060503,2562,2106,194,101,6,22,4,3,456
47179060504,3764,3135,196,176,7,57,0,15,629
47179060601,3321,2641,323,125,6,40,2,12,680
47179060602,5317,3851,445,562,11,194,1,82,1466
47179060700,2492,2016,64,305,7,25,0,70,476
47179060800,3115,2501,176,167,5,44,4,18,614
47179060901,2859,1977,153,471,12,13,1,11,882
47179060902,3140,2287,247,342,6,28,3,14,853
47179061000,2338,1687,187,286,3,14,0,0,651
47179061100,4634,4026,166,167,7,54,1,24,608
47179061200,3499,2896,195,149,8,30,2,16,603
47179061301,2945,2121,508,115,5,56,3,21,824
47179061302,5375,4490,225,179,13,202,3,4,885
47179061401,5242,4709,169,72,18,70,0,6,533
47179061403,4907,4238,125,119,15,138,1,30,669
47179061404,3316,2823,109,62,6,165,4,17,493
47179061500,7461,6805,215,126,8,46,1,16,656
47179061601,4820,4469,124,23,7,22,2,19,351
47179061603,4944,4602,84,18,10,7,0,8,342
47179061604,4280,3998,59,14,10,30,1,12,282
47179061701,7051,6215,178,184,15,231,0,13,836
47179061703,3324,2987,138,38,2,20,1,14,337
47179061704,3962,3505,95,144,6,21,4,19,457
47179061800,6559,6091,126,40,13,13,2,28,468
47179061902,5045,4642,149,51,3,10,2,10,403
47179061903,3616,3334,102,21,4,2,1,5,282
47179061904,3355,3066,85,21,10,5,0,8,289
47179062000,4263,2991,391,479,16,68,2,34,1272
47181950100,4401,3390,126,784,8,0,0,6,1011
47181950200,5387,5023,99,76,7,24,0,26,364
47181950300,3373,3167,84,10,0,0,1,11,206
47181950400,3071,2923,70,8,3,3,0,11,148
47183968000,1077,930,56,11,0,12,2,2,147
47183968101,3424,2452,116,593,1,49,0,16,972
47183968102,1797,1560,71,69,0,17,0,4,237
47183968201,4690,3895,209,335,6,41,0,13,795
47183968202,1989,1397,38,485,5,9,0,0,592
47183968203,3026,2151,100,579,5,20,0,13,875
47183968300,2120,1906,32,91,3,5,0,6,214
47183968400,5582,5060,118,178,10,20,1,12,522
47183968500,4484,4141,95,98,12,8,0,4,343
47183968600,3425,3099,47,153,10,11,0,6,326
47183968700,1288,1222,23,1,0,0,0,3,66
47185935000,4376,4039,106,17,13,17,2,5,337
47185935100,5927,5469,142,26,15,28,5,5,458
47185935200,4347,4047,87,17,12,8,1,3,300
47185935300,5481,4837,190,145,13,56,2,30,644
47185935400,3729,3199,142,183,13,9,0,10,530
47185935500,3491,3242,69,17,9,14,0,3,249
47187050102,7462,5820,357,423,11,517,4,27,1642
47187050103,7004,5886,245,300,10,262,1,25,1118
47187050104,5714,4030,307,308,4,825,1,12,1684
47187050105,9689,7670,434,423,7,650,7,28,2019
47187050204,5726,4284,264,275,2,628,4,32,1442
47187050205,3596,3094,121,83,8,124,0,12,502
47187050206,3225,2730,129,60,3,209,0,13,495
47187050207,4391,3316,186,187,1,485,1,12,1075
47187050209,4250,3492,110,124,0,352,0,20,758
47187050210,2740,2355,65,60,9,160,0,8,385
47187050211,6641,3702,317,292,14,2075,3,48,2939
47187050212,2069,1644,82,66,0,192,1,0,425
47187050303,3067,2836,45,49,0,65,0,3,231
47187050304,2549,2237,74,65,2,111,0,7,312
47187050305,2799,2404,90,49,2,151,2,4,395
47187050306,2069,1573,90,66,2,262,1,2,496
47187050307,3858,2873,192,175,8,442,3,17,985
47187050403,2026,1831,52,30,2,37,1,0,195
47187050404,6890,6234,144,120,7,141,0,36,656
47187050405,2915,2696,57,35,6,33,2,15,219
47187050406,6094,5486,183,104,3,150,0,23,608
47187050502,4245,3782,161,65,18,41,0,26,463
47187050503,5735,5056,309,66,5,56,3,31,679
47187050504,4490,3925,245,63,12,30,1,15,565
47187050601,5903,4529,544,418,9,175,3,32,1374
47187050603,3185,2335,270,360,11,79,5,20,850
47187050604,9551,8506,358,287,8,99,2,21,1045
47187050701,4303,3675,209,84,7,119,1,12,628
47187050702,4561,4048,172,57,14,119,0,8,513
47187050801,4841,2199,1510,918,3,35,0,30,2642
47187050802,1225,1112,33,15,0,7,0,3,113
47187050904,5234,3091,1179,601,8,137,3,19,2143
47187050905,6483,4764,690,364,17,389,8,26,1719
47187050906,5487,4797,227,166,5,83,0,32,690
47187050907,5823,4798,278,142,15,347,5,40,1025
47187050908,4292,3810,159,71,9,84,0,22,482
47187050909,4630,4000,148,75,7,244,5,17,630
47187051001,8497,6591,353,234,3,967,4,33,1906
47187051002,11631,9295,513,288,24,1027,11,72,2336
47187051100,8608,7513,300,301,25,92,5,36,1095
47187051203,3531,3205,117,81,14,9,0,5,326
47187051204,6696,5627,345,257,21,143,7,28,1069
47187051205,9173,7739,538,231,21,178,3,31,1434
47187051206,8405,6548,852,412,9,221,4,49,1857
47187051207,7779,6094,644,492,10,157,10,35,1685
47187051208,8644,7176,563,367,17,170,4,33,1468
47189030102,7100,6046,406,285,22,22,1,33,1054
47189030103,3227,2879,145,66,2,16,2,18,348
47189030104,2301,2108,34,50,9,12,0,5,193
47189030105,4021,3381,153,274,12,40,0,13,640
47189030202,9411,8053,446,399,17,159,7,26,1358
47189030203,7379,5943,348,437,19,281,0,46,1436
47189030205,2152,1874,58,73,7,19,3,8,278
47189030206,5816,4836,203,323,12,128,6,26,980
47189030207,2300,1986,71,119,5,21,0,10,314
47189030303,4488,3995,121,117,16,38,1,14,493
47189030304,6975,5783,336,424,26,69,5,21,1192
47189030305,5247,4545,221,190,5,39,1,24,702
47189030308,5136,3952,298,442,15,155,0,21,1184
47189030309,6232,4830,448,534,21,137,3,13,1402
47189030310,7110,5469,325,591,16,382,3,30,1641
47189030311,3165,2495,400,127,5,22,2,14,670
47189030401,2927,2176,159,400,17,32,0,6,751
47189030402,4180,2475,820,549,19,124,0,21,1705
47189030500,7775,5534,750,949,25,64,1,31,2241
47189030600,4558,3362,537,438,12,21,0,26,1196
47189030700,3579,1961,307,1089,16,6,1,10,1618
47189030800,6948,5910,332,295,25,47,4,37,1038
47189030904,4295,3843,147,94,7,15,1,14,452
47189030905,4970,4291,195,227,5,50,0,11,679
47189030906,5315,4547,163,215,18,110,0,40,768
47189030907,5638,4694,234,293,10,199,0,23,944
47189030908,9351,6485,533,905,21,867,3,54,2866
47189031000,6141,5436,185,194,21,11,0,7,705
48001950100,4641,3752,310,312,20,15,2,11,889
48001950401,5782,1975,1610,2160,0,20,0,3,3807
48001950402,7115,2180,2002,2906,2,21,0,0,4935
48001950500,4479,1886,1631,785,13,27,3,8,2593
48001950600,6036,2772,1369,1589,28,53,0,16,3264
48001950700,2564,787,738,928,10,9,3,6,1777
48001950800,5427,2945,1064,1119,10,66,0,27,2482
48001950901,5281,3566,858,545,35,84,0,6,1715
48001950902,5090,3718,693,469,16,24,2,11,1372
48001951001,3618,3121,242,98,21,8,0,5,497
48001951002,3501,2854,298,201,23,9,2,9,647
48001951100,4388,3542,296,318,15,45,1,11,846
48003950100,2405,1283,1005,8,9,30,0,3,1122
48003950200,7710,3291,4045,100,61,44,0,28,4419
48003950300,4668,1282,3179,64,13,21,0,9,3386
48003950400,3827,1549,2171,20,13,7,0,9,2278
48005000102,4983,3818,745,190,22,44,0,11,1165
48005000103,3440,2404,782,159,1,13,0,8,1036
48005000104,2974,2456,350,66,2,2,0,8,518
48005000201,3138,2138,639,231,9,23,1,3,1000
48005000202,3558,1987,1045,388,6,16,0,21,1571
48005000301,5413,3518,1002,656,9,26,1,10,1895
48005000302,5319,3425,1081,534,28,72,5,12,1894
48005000400,5361,2102,1490,1484,2,70,0,17,3259
48005000500,3640,447,885,2205,5,3,0,5,3193
48005000600,5836,1213,2853,1622,3,30,4,14,4623
48005000700,3070,672,1538,750,9,27,0,10,2398
48005000800,6165,3179,1335,1270,6,146,3,9,2986
48005000902,3731,2392,487,518,1,193,4,18,1339
48005000903,3245,2072,371,506,15,141,1,11,1173
48005000904,3269,1606,779,742,8,35,1,7,1663
48005001001,5043,1920,2159,861,15,9,0,4,3123
48005001002,4035,2346,1237,316,9,18,6,6,1689
48005001101,3396,2776,345,181,12,5,2,3,620
48005001102,3056,2528,296,88,13,5,0,6,528
48005001200,2594,2348,94,22,12,1,0,0,246
48005001300,5129,4623,219,83,13,12,2,13,506
48007950101,1300,1030,180,1,14,13,5,0,270
48007950102,3424,2519,540,21,30,152,0,16,905
48007950103,1257,959,204,0,8,29,0,6,298
48007950200,1000,826,133,3,3,5,0,0,174
48007950301,3734,2079,1338,70,21,69,3,10,1655
48007950302,2768,2213,310,19,3,120,3,5,555
48007950400,3349,1843,1276,55,17,39,1,14,1506
48007950501,2614,1625,803,19,17,23,2,12,989
48007950502,1761,1041,602,32,12,7,0,6,720
48007950503,2623,1681,772,21,17,23,1,9,942
48007990000,0,0,0,0,0,0,0,0,0
48009020100,2897,2579,172,10,25,11,0,5,318
48009020200,2442,2147,143,2,20,5,0,7,295
48009020300,3221,2630,427,18,26,2,0,9,591
48011950100,1848,1593,144,6,17,10,0,2,255
48013960101,3474,1447,1898,18,11,8,4,12,2027
48013960102,3771,1384,2236,28,7,21,0,4,2387
48013960203,2906,781,2013,25,9,24,0,8,2125
48013960204,4153,1226,2755,34,22,11,0,33,2927
48013960205,6022,1402,4426,38,13,29,0,20,4620
48013960206,5493,1177,4154,45,2,7,7,12,4316
48013960300,3135,437,2644,19,8,1,0,1,2698
48013960401,2391,598,1726,14,1,5,0,10,1793
48013960403,4747,1799,2746,39,13,14,1,15,2948
48013960404,4063,2334,1543,20,17,29,1,8,1729
48013960500,2533,695,1762,25,1,3,0,16,1838
48013960601,2512,1008,1427,17,4,4,2,12,1504
48013960602,3781,1778,1848,18,8,14,0,26,2003
48015760100,2464,1334,783,257,8,7,0,10,1130
48015760201,2078,940,711,348,9,11,3,5,1138
48015760202,4450,2211,1749,312,4,25,2,18,2239
48015760301,2773,1826,662,122,7,41,0,11,947
48015760302,5043,2655,1819,324,19,60,2,2,2388
48015760400,3505,2867,360,122,6,1,1,37,638
48015760501,4543,3433,657,254,8,19,0,16,1110
48015760502,5311,3214,1311,613,17,37,0,8,2097
48017950101,4002,1089,2803,28,14,8,0,17,2913
48017950102,2902,1101,1737,21,10,0,0,10,1801
48019000101,4705,3491,939,20,19,25,3,15,1214
48019000103,3913,2852,828,22,11,15,0,17,1061
48019000104,1259,1019,163,2,5,6,0,2,240
48019000200,2394,1995,301,9,4,5,0,1,399
48019000301,3304,2309,761,24,23,17,3,13,995
48019000302,3067,2284,587,12,19,13,5,19,783
48019000400,2209,1645,431,13,20,14,0,4,564
48021950101,5554,2760,2355,179,10,25,0,32,2794
48021950102,6373,3048,2841,211,15,18,0,17,3325
48021950201,3299,957,1777,453,2,6,0,8,2342
48021950202,5631,1967,2609,830,8,23,0,19,3664
48021950301,5236,3264,1390,246,14,89,2,15,1972
48021950302,4729,2709,1235,410,21,115,10,34,2020
48021950303,7638,3365,3336,504,43,85,2,50,4273
48021950401,5226,2981,1314,608,29,59,1,26,2245
48021950402,2390,1753,409,66,5,34,7,7,637
48021950403,3159,1938,818,189,11,62,3,23,1221
48021950503,4028,2771,943,82,19,23,28,11,1257
48021950504,3923,2357,1254,72,26,27,0,24,1566
48021950505,5052,1751,2982,180,10,10,0,20,3301
48021950506,5340,1732,2961,450,22,20,3,35,3608
48021950601,4017,3058,671,91,7,16,4,26,959
48021950602,2323,1666,476,82,5,3,0,7,657
48021950700,4554,2902,934,483,7,48,1,15,1652
48021950803,3452,344,3028,46,2,6,0,3,3108
48021950804,5269,1857,3125,108,15,36,0,10,3412
48021950805,6745,1105,5458,69,29,10,2,17,5640
48021950806,3278,1466,1568,101,12,3,0,18,1812
48023950301,1403,1115,193,30,7,2,0,2,288
48023950302,2062,1682,246,22,4,7,0,6,380
48025950100,1712,837,802,4,6,6,0,2,875
48025950201,8083,1721,4488,1806,7,36,0,7,6362
48025950203,2088,717,1331,12,0,5,0,10,1371
48025950204,2910,1424,1340,49,10,25,0,7,1486
48025950300,5135,1304,3506,153,1,74,0,14,3831
48025950400,1907,367,1441,49,3,12,0,5,1540
48025950501,3394,754,2415,119,5,32,0,5,2640
48025950502,3545,521,2835,109,7,18,2,5,3024
48025950600,2273,955,1234,15,15,3,0,10,1318
48027020101,3037,2156,649,57,9,5,2,12,881
48027020102,4219,3211,718,75,22,7,1,8,1008
48027020201,8787,6428,1228,365,43,265,12,14,2359
48027020203,4549,3458,692,114,30,24,1,18,1091
48027020204,2741,1996,541,28,6,15,3,10,745
48027020301,9333,5658,2029,821,23,279,13,32,3675
48027020302,5641,3114,1513,442,10,201,6,47,2527
48027020401,3564,1553,977,799,8,50,0,14,2011
48027020402,2926,1181,1141,475,9,4,3,19,1745
48027020500,3825,1621,1363,607,22,17,9,14,2204
48027020600,2477,1334,742,270,9,20,0,12,1143
48027020701,1438,512,456,380,6,3,1,1,926
48027020702,1522,352,848,267,2,5,3,7,1170
48027020800,3169,562,1296,1185,8,4,1,8,2607
48027020900,3052,1176,943,736,10,25,17,15,1876
48027021000,4255,1627,1556,836,21,37,8,14,2628
48027021101,2585,1434,496,414,7,124,3,11,1151
48027021102,3233,1391,1323,352,14,13,1,8,1842
48027021201,3654,1845,906,572,12,97,12,17,1809
48027021202,3953,2177,904,587,8,55,9,19,1776
48027021203,4271,2714,876,349,29,94,2,17,1557
48027021301,4796,2956,930,550,27,132,14,20,1840
48027021302,2956,2202,421,150,1,56,6,9,754
48027021304,4955,2200,1143,1136,7,202,20,38,2755
48027021305,7313,4271,1262,830,30,484,22,37,3042
48027021400,4352,3192,819,73,25,48,2,9,1160
48027021501,3940,1549,1729,393,21,54,1,9,2391
48027021502,4594,2853,1082,315,11,39,7,22,1741
48027021601,6785,2685,3021,749,20,50,6,33,4100
48027021602,2653,1393,751,362,17,30,1,14,1260
48027021701,5673,4117,909,215,7,154,12,23,1556
48027021702,4454,3106,829,178,11,83,16,9,1348
48027021801,5635,2843,1445,760,41,94,43,20,2792
48027021802,5065,2564,1260,732,19,165,15,39,2501
48027021901,3442,1590,797,665,12,108,45,12,1852
48027021905,4749,2091,1005,943,6,289,64,32,2658
48027021906,5732,1980,1082,1724,11,340,35,53,3752
48027021907,4924,2348,986,926,27,142,58,25,2576
48027021908,7739,3373,1750,1458,43,364,141,27,4366
48027022001,4168,1468,1241,921,28,121,54,18,2700
48027022002,4769,2366,871,1037,19,83,44,16,2403
48027022101,4102,1120,1076,1363,25,149,55,23,2982
48027022103,5053,1277,1380,1765,16,129,98,38,3776
48027022104,4212,1046,938,1763,14,134,48,38,3166
48027022105,2216,635,607,673,5,72,27,15,1581
48027022200,3827,908,1080,1353,8,128,64,32,2919
48027022300,3811,1142,1063,1191,20,91,52,29,2669
48027022401,5741,1150,1563,2247,20,217,94,16,4591
48027022402,7003,1751,1615,2581,14,260,141,57,5252
48027022403,4597,1279,1207,1435,9,209,101,36,3318
48027022405,2183,658,541,656,7,100,41,6,1525
48027022406,3979,964,854,1469,9,240,52,30,3015
48027022407,3931,1089,1058,1267,15,139,28,26,2842
48027022501,3573,1147,1229,799,10,105,57,28,2426
48027022503,5434,1364,1443,1881,30,299,52,47,4070
48027022504,8790,2371,2133,2982,25,391,139,74,6419
48027022600,4242,1036,1650,1147,11,87,55,22,3206
48027022801,2653,601,732,1017,8,73,24,10,2052
48027022900,3649,951,1079,1205,17,125,40,33,2698
48027023001,6167,1414,1544,2186,27,326,125,60,4753
48027023002,4170,1399,1167,1132,10,171,40,22,2771
48027023103,4450,1135,1054,1589,19,232,74,43,3315
48027023104,3253,954,1000,941,15,87,61,16,2299
48027023109,3903,892,1002,1506,4,135,65,26,3011
48027023110,3832,582,914,1900,16,113,44,31,3250
48027023111,5279,1112,1297,2081,22,250,134,31,4167
48027023112,5062,953,1332,2095,25,143,94,43,4109
48027023113,5033,868,1583,1856,22,206,90,47,4165
48027023114,4350,944,1157,1685,27,160,43,36,3406
48027023115,4688,885,1222,1931,23,171,138,23,3803
48027023116,6188,1265,1846,2203,25,225,102,55,4923
48027023117,5553,1231,1498,2032,17,262,118,49,4322
48027023118,7404,1648,2086,2556,28,288,176,50,5756
48027023201,1781,1072,285,196,11,62,20,21,709
48027023202,4915,2265,1157,982,33,123,82,3,2650
48027023203,2607,1115,709,502,11,55,40,13,1492
48027023204,3731,1853,1008,427,27,174,17,2,1878
48027023301,5266,3345,915,527,26,104,24,40,1921
48027023302,4029,1779,949,746,37,119,53,22,2250
48027023402,4990,3508,1113,123,15,15,1,18,1482
48027023404,4376,3112,906,95,27,28,6,13,1264
48027023405,3225,2705,323,19,8,25,1,26,520
48027023406,3978,3011,700,74,4,27,1,13,967
48027023500,2149,414,842,694,11,34,22,18,1735
48027980001,346,183,80,39,4,19,2,0,163
48027980002,0,0,0,0,0,0,0,0,0
48027980003,1,0,0,0,0,0,0,0,1
48029110100,3812,1440,1758,285,37,148,3,27,2372
48029110300,2401,601,1589,102,5,32,0,10,1800
48029110500,2369,188,1982,134,1,42,0,4,2181
48029110600,7284,1625,4763,822,7,15,2,12,5659
48029110700,1210,196,933,50,0,7,2,10,1014
48029111000,2356,693,1403,119,7,58,3,19,1663
48029111100,4099,1850,1736,209,12,144,3,19,2249
48029120100,7464,3734,1576,1159,43,439,51,48,3730
48029120301,2989,2044,672,40,5,104,1,15,945
48029120302,4371,3358,772,23,3,61,0,20,1013
48029120401,2595,1753,599,76,3,49,4,11,842
48029120402,3365,2762,447,6,9,48,0,12,603
48029120502,5395,968,3345,768,13,151,4,15,4427
48029120503,3351,857,1754,460,4,135,3,23,2494
48029120504,4876,1216,2868,490,13,141,11,8,3660
48029120601,2719,931,1235,312,3,97,9,13,1788
48029120602,3927,2219,1254,131,10,123,0,22,1708
48029120701,5622,2026,3044,180,22,193,2,27,3596
48029120702,4699,2872,1304,156,8,168,5,25,1827
48029120800,7074,4810,1638,173,11,142,4,44,2264
48029120901,2079,949,879,132,7,73,2,2,1130
48029120902,6928,2713,2698,986,15,251,17,20,4215
48029121000,6926,2355,3732,459,10,133,6,20,4571
48029121110,5175,2206,2384,258,8,88,2,18,2969
48029121111,6739,2332,3635,411,12,110,9,33,4407
48029121112,3995,1619,1703,412,15,97,4,26,2376
48029121115,5100,2932,1654,184,7,95,2,22,2168
48029121116,4845,2415,1977,170,11,68,7,32,2430
48029121117,4482,2179,1705,258,6,122,16,22,2303
48029121118,5688,2665,2213,365,16,178,10,53,3023
48029121119,5325,2301,2336,273,12,134,10,32,3024
48029121120,5039,2160,2326,196,22,133,5,23,2879
48029121121,2843,1698,864,92,4,50,2,9,1145
48029121122,5165,2589,2052,208,11,107,3,33,2576
48029121123,4528,2134,1808,278,12,137,11,14,2394
48029121124,2664,1568,858,47,10,65,7,10,1096
48029121203,4769,1221,2918,381,22,70,6,16,3548
48029121204,8569,2418,3909,1726,27,130,17,53,6151
48029121205,3603,869,2030,511,10,61,7,7,2734
48029121206,7226,2299,4216,365,36,81,10,13,4927
48029121300,6483,2663,2697,682,16,190,6,27,3820
48029121402,9534,1493,5679,1462,15,566,28,32,8041
48029121403,5419,1002,2635,1190,12,348,12,38,4417
48029121404,5145,661,3055,1152,15,122,2,29,4484
48029121501,9828,3324,3988,1438,39,532,29,44,6504
48029121504,8233,2618,3558,1294,24,388,29,52,5615
48029121505,5372,1822,2588,542,9,140,37,17,3550
48029121506,5795,1659,3015,846,21,97,2,10,4136
48029121507,5413,1472,2796,789,21,119,12,22,3941
48029121508,5312,995,2941,1062,5,95,31,25,4317
48029121601,4694,1734,2047,460,28,154,13,18,2960
48029121604,9768,3075,4207,1488,38,335,73,46,6693
48029121605,2161,990,875,163,5,42,3,9,1171
48029121606,5210,2004,2167,580,11,161,27,16,3206
48029121701,3885,1799,1593,189,16,83,9,24,2086
48029121702,7093,3400,2485,542,17,244,35,36,3693
48029121802,10663,3203,5500,1036,32,443,31,37,7460
48029121803,4776,1500,2563,429,20,69,16,29,3276
48029121804,6844,2156,3489,749,12,119,9,33,4688
48029121808,3132,1172,1459,210,12,134,3,13,1960
48029121809,4942,1911,2400,265,14,177,8,36,3031
48029121810,4322,1723,2055,208,10,118,3,19,2599
48029121811,5543,2097,2479,484,16,210,9,25,3446
48029121812,6136,2506,2909,357,19,117,4,49,3630
48029121813,1745,749,824,74,5,20,0,4,996
48029121903,6040,3181,1986,242,11,292,19,36,2859
48029121904,3925,1930,1303,152,6,365,4,13,1995
48029121905,7517,3312,2421,494,18,927,20,24,4205
48029121906,7183,3261,2664,426,19,465,9,35,3922
48029121908,3410,2035,1028,109,6,114,2,11,1375
48029121909,8859,3079,3787,1082,29,470,35,28,5780
48029121910,8817,3794,3346,460,24,756,4,45,5023
48029121911,9375,4224,3135,736,35,763,22,56,5151
48029121912,12296,4857,4922,1024,16,874,30,61,7439
48029130200,1588,121,1242,173,1,12,0,13,1467
48029130300,2945,215,2357,315,9,4,4,7,2730
48029130401,3725,204,3071,390,5,19,0,5,3521
48029130402,3879,193,2713,894,9,4,0,9,3686
48029130500,4202,198,2893,983,5,13,0,24,4004
48029130600,4585,219,3118,1135,6,12,4,15,4366
48029130700,2342,129,1570,555,7,22,2,18,2213
48029130800,5220,228,2143,2605,37,42,18,12,4992
48029130900,5456,468,2741,1907,9,186,2,11,4988
48029131000,5599,481,2839,2104,7,29,14,16,5118
48029131100,2500,119,1519,793,11,5,2,1,2381
48029131200,3298,359,1971,895,4,4,3,0,2939
48029131300,5678,723,3406,1397,8,21,1,20,4955
48029131401,12055,1805,7981,1768,35,136,24,34,10250
48029131402,2964,406,1840,620,7,22,0,7,2558
48029131503,3169,935,1693,375,3,62,4,8,2234
48029131504,4213,810,2604,617,5,55,5,11,3403
48029131505,5179,699,2682,1316,11,203,16,19,4480
48029131506,5953,825,3393,1391,21,116,5,17,5128
48029131507,5998,794,4023,963,7,76,3,25,5204
48029131601,8623,2929,2750,2066,18,244,35,44,5694
48029131606,8086,1927,3670,1763,22,215,39,43,6159
48029131608,5956,1481,2260,1640,16,188,33,33,4475
48029131609,8531,1833,3766,2175,17,251,22,50,6698
48029131610,5469,1072,2748,1305,26,99,11,21,4397
48029131612,2306,451,1127,569,6,46,11,1,1855
48029131614,5012,913,2152,1555,18,117,7,32,4099
48029131615,12439,2328,5797,3204,19,399,79,72,10111
48029131616,7517,1623,3408,1901,33,257,5,28,5894
48029131700,1282,714,219,192,11,47,12,1,568
48029131801,2732,1908,662,44,3,12,1,2,824
48029131802,7232,3173,3124,585,23,45,4,29,4059
48029140100,1324,197,1063,31,4,3,2,5,1127
48029140200,2405,298,2008,43,13,12,2,3,2107
48029140300,2835,208,2532,33,13,27,0,0,2627
48029140400,3380,340,2925,46,7,11,3,16,3040
48029140500,3682,462,3065,84,11,16,2,12,3220
48029140600,2526,165,2215,108,10,9,0,10,2361
48029140700,4571,507,3778,204,10,19,0,17,4064
48029140800,4886,394,4383,39,15,13,3,12,4492
48029140900,1916,214,1630,44,1,0,0,13,1702
48029141000,3344,347,2704,213,7,16,2,5,2997
48029141101,4084,612,3010,389,10,19,1,8,3472
48029141102,3612,455,2748,346,9,7,0,9,3157
48029141200,6685,820,5486,262,4,16,0,30,5865
48029141300,6678,929,4418,1159,9,14,2,28,5749
48029141402,6236,786,4948,263,8,112,1,25,5450
48029141403,4773,878,3554,193,11,50,6,12,3895
48029141404,4929,786,3807,216,12,22,1,15,4143
48029141600,4525,268,4093,56,2,24,0,33,4257
48029141700,6440,1553,4554,155,11,22,9,24,4887
48029141800,4924,1476,3259,29,9,14,1,17,3448
48029141900,6234,3111,2607,195,19,60,5,24,3123
48029150100,5016,711,4084,69,8,67,5,18,4305
48029150300,3965,224,3672,36,2,2,1,4,3741
48029150400,3814,180,3585,7,9,3,0,18,3634
48029150501,4016,137,3802,20,13,10,1,9,3879
48029150502,3734,82,3583,20,2,0,3,20,3652
48029150600,4039,172,3821,16,7,1,0,9,3867
48029150700,5601,296,5214,25,4,12,6,9,5305
48029150800,3227,326,2723,112,11,20,1,3,2901
48029150900,5933,484,5351,26,12,15,3,15,5449
48029151000,3204,177,2984,10,7,8,0,6,3027
48029151100,6450,280,6111,16,11,3,0,16,6170
48029151200,10797,593,9883,153,27,49,7,29,10204
48029151301,5599,364,5133,51,4,10,0,13,5235
48029151302,3275,166,3044,32,3,0,0,18,3109
48029151400,4487,323,4076,35,8,10,0,19,4164
48029151500,2411,265,2082,14,0,18,0,11,2146
48029151600,7358,886,6294,73,12,25,0,14,6472
48029151700,7173,700,6319,47,15,22,4,21,6473
48029151900,8156,658,7159,191,5,56,2,22,7498
48029152000,4314,376,3607,237,4,41,3,14,3938
48029152100,6829,1264,5323,56,22,95,4,16,5565
48029152201,9868,1633,7878,115,39,42,1,35,8235
48029152202,5964,1041,4721,86,22,18,1,7,4923
48029160100,6217,219,5819,102,22,4,3,23,5998
48029160200,2490,107,2341,12,6,10,0,4,2383
48029160300,4928,206,4650,24,10,9,0,15,4722
48029160400,4682,155,4482,25,5,0,0,10,4527
48029160501,3936,72,3582,161,10,76,0,8,3864
48029160502,3950,128,3703,73,10,17,0,5,3822
48029160600,4440,142,4223,18,8,15,2,3,4298
48029160701,3187,78,3086,6,1,0,0,6,3109
48029160702,4972,233,4587,80,8,13,2,6,4739
48029160901,2951,83,2848,2,1,7,0,4,2868
48029160902,4144,157,3936,14,8,10,2,5,3987
48029161000,3474,128,3244,70,5,14,0,3,3346
48029161100,8449,287,8013,40,14,36,4,16,8162
48029161200,3934,297,3430,115,4,30,0,22,3637
48029161302,5409,261,4969,114,7,17,6,10,5148
48029161303,4167,167,3924,54,0,7,0,8,4000
48029161304,4738,278,4258,136,1,18,0,8,4460
48029161400,9755,5479,1620,1795,13,371,21,133,4276
48029161501,7717,829,6309,330,22,50,17,31,6888
48029161503,5515,412,4802,159,5,64,9,12,5103
48029161504,4724,412,4073,143,6,25,0,18,4312
48029161600,4809,576,3933,154,3,37,8,35,4233
48029161801,3895,540,2974,202,7,47,8,33,3355
48029161802,9710,1173,7404,615,41,190,17,36,8537
48029161901,1247,281,929,8,2,5,0,7,966
48029161902,15735,3143,10991,1029,35,168,20,67,12592
48029162001,2529,431,2037,11,14,5,0,10,2098
48029162003,5991,1054,4775,43,17,22,0,19,4937
48029162004,4477,565,3840,15,2,6,0,11,3912
48029170101,3426,159,3174,64,7,0,1,0,3267
48029170102,3316,122,3138,34,5,1,0,7,3194
48029170200,4757,144,4499,61,7,11,0,16,4613
48029170300,5546,193,5212,73,3,23,3,17,5353
48029170401,4324,155,3866,229,6,39,0,8,4169
48029170402,4639,143,4382,60,6,6,5,11,4496
48029170500,4099,336,3622,43,2,38,0,13,3763
48029170600,4189,264,3828,40,10,18,1,4,3925
48029170700,4460,154,4235,22,15,10,0,6,4306
48029170800,1521,55,1441,15,0,5,0,1,1466
48029170900,4249,241,3879,73,6,3,1,6,4008
48029171000,4890,119,4699,37,2,4,2,16,4771
48029171100,3438,136,3244,26,2,13,0,6,3302
48029171200,3949,118,3777,27,8,0,0,5,3831
48029171301,2659,107,2514,14,3,2,0,6,2552
48029171302,3841,326,3404,45,12,15,1,16,3515
48029171401,4319,195,3876,146,5,34,9,15,4124
48029171402,5556,158,5267,58,15,14,1,16,5398
48029171501,2563,73,2384,84,9,0,4,4,2490
48029171502,4914,150,4373,315,1,45,0,11,4764
48029171601,4284,183,3862,150,17,17,3,14,4101
48029171602,4456,173,3693,305,26,210,4,11,4283
48029171700,8091,931,6380,514,27,101,4,26,7160
48029171801,5301,553,4427,173,16,43,6,22,4748
48029171802,6092,591,5087,250,20,51,11,15,5501
48029171903,6750,803,5342,411,12,76,17,21,5947
48029171912,6855,1469,4391,519,8,250,4,18,5386
48029171913,5184,755,3814,333,8,114,16,24,4429
48029171914,5236,814,3803,322,6,138,9,9,4422
48029171915,2095,338,1500,140,6,41,2,10,1757
48029171916,10592,2233,6758,852,15,302,22,46,8359
48029171917,8501,1901,5487,603,20,184,15,37,6600
48029171918,7898,1826,4577,809,13,281,36,28,6072
48029171919,6377,949,4608,535,21,81,20,31,5428
48029171920,9214,1340,6859,608,17,164,4,32,7874
48029171921,5691,817,4397,266,13,79,4,32,4874
48029171922,5814,709,4168,583,10,133,13,28,5105
48029171923,9414,1735,5971,976,29,351,17,57,7679
48029171924,7460,1881,3911,923,12,414,21,57,5579
48029171926,3243,757,1771,387,16,170,4,27,2486
48029171927,12053,2119,7589,1427,46,431,29,73,9934
48029171928,5480,1258,3415,384,0,197,17,36,4222
48029171929,3785,714,2553,283,10,114,4,19,3071
48029172002,30199,8178,16203,3248,89,934,90,149,22021
48029172003,6416,1843,3514,582,19,180,16,21,4573
48029172004,10601,4348,4145,962,25,555,18,60,6253
48029172005,12319,3772,5771,1412,17,723,22,80,8547
48029172006,15271,4789,7568,1531,54,425,25,123,10482
48029172008,5744,1750,2849,591,10,284,2,19,3994
48029172009,10242,2870,5288,1042,18,438,22,57,7372
48029180101,4600,844,3612,43,14,30,0,6,3756
48029180102,1886,454,1354,40,0,7,0,4,1432
48029180201,4858,508,4109,139,11,32,1,20,4350
48029180202,5287,723,4233,205,9,46,2,16,4564
48029180300,4525,393,3997,69,5,7,9,15,4132
48029180400,4262,299,3760,130,15,24,0,7,3963
48029180501,4831,689,3728,256,17,26,1,20,4142
48029180503,4356,245,3892,136,8,29,1,18,4111
48029180504,4245,175,3861,143,9,15,0,12,4070
48029180602,2917,557,2228,72,3,27,0,2,2360
48029180603,2138,368,1460,167,3,71,2,8,1770
48029180604,5617,884,4306,215,6,79,3,18,4733
48029180701,4291,1312,2095,383,1,310,4,37,2979
48029180702,6786,1607,4216,519,22,190,13,55,5179
48029180800,2531,384,1751,293,17,27,1,12,2147
48029180901,5204,947,4053,89,3,38,5,18,4257
48029180902,7475,947,6224,165,14,25,2,26,6528
48029181001,3252,825,2164,133,13,55,0,8,2427
48029181003,6997,1520,2695,881,23,1540,9,31,5477
48029181004,5354,1397,2792,525,13,423,3,32,3957
48029181005,4251,721,2389,648,19,289,15,24,3530
48029181100,5818,2354,2935,164,10,178,10,29,3464
48029181200,4844,2226,2277,86,7,78,9,33,2618
48029181301,4290,1392,2235,351,23,101,14,17,2898
48029181302,6263,2082,3360,337,20,243,13,33,4181
48029181303,3764,703,1318,563,10,866,9,18,3061
48029181402,2894,876,1131,276,9,507,2,18,2018
48029181403,6182,1363,2698,616,23,1207,4,38,4819
48029181404,5223,1347,1761,400,14,1516,3,42,3876
48029181503,8457,2579,4180,770,20,622,16,41,5878
48029181504,6612,1803,3409,724,14,394,8,32,4809
48029181505,4388,1313,2746,124,10,84,5,13,3075
48029181506,3992,993,2502,257,13,99,0,32,2999
48029181601,3189,501,2489,133,1,24,0,9,2688
48029181602,5639,517,4601,351,4,70,4,13,5122
48029181703,7034,2876,3381,304,21,178,6,19,4158
48029181704,5904,1309,4022,213,19,209,0,15,4595
48029181705,6736,1493,3801,618,13,606,12,33,5243
48029181711,8400,2372,4746,482,25,410,13,42,6028
48029181712,3635,1155,2106,154,1,86,4,38,2480
48029181713,7155,2041,4414,344,13,119,6,23,5114
48029181715,5958,1224,4245,220,21,58,0,27,4734
48029181716,7167,1422,5144,306,16,75,8,20,5745
48029181718,5023,1828,2708,194,5,70,11,14,3195
48029181720,4324,1669,2235,146,11,110,1,15,2655
48029181721,3211,993,1861,153,2,75,2,13,2218
48029181722,4707,1410,2705,255,5,123,17,15,3297
48029181723,4084,1038,2580,218,11,90,8,16,3046
48029181724,5383,1799,3018,194,15,183,0,17,3584
48029181725,5641,936,3639,677,16,186,20,27,4705
48029181726,13282,3988,7405,795,18,559,13,50,9294
48029181727,3944,525,2896,265,18,141,0,22,3419
48029181729,13707,3913,7353,1161,29,616,33,69,9794
48029181730,3920,969,2564,183,13,80,4,17,2951
48029181731,7171,2032,4324,431,10,141,6,18,5139
48029181732,7668,1796,4630,607,11,330,27,43,5872
48029181733,6381,1329,4009,490,12,275,7,30,5052
48029181808,2200,797,850,103,4,354,0,10,1403
48029181809,6619,1634,4209,337,2,228,6,21,4985
48029181811,4265,1572,2090,157,3,265,1,13,2693
48029181813,7676,2030,3993,681,22,595,0,47,5646
48029181814,6314,2109,3010,381,22,535,9,25,4205
48029181815,2958,1164,1388,149,3,151,6,9,1794
48029181816,4067,1485,2072,107,9,251,5,18,2582
48029181817,3203,934,1772,180,9,211,0,7,2269
48029181818,5340,1762,2677,330,13,376,12,9,3578
48029181819,7354,2168,3329,475,12,1039,10,41,5186
48029181820,7739,2011,3696,1123,10,576,16,35,5728
48029181821,3396,1124,1789,161,9,199,1,9,2272
48029181822,4924,1551,2697,260,4,235,5,26,3373
48029181823,3137,980,1590,293,3,140,13,6,2157
48029181824,3309,1071,1793,157,2,181,0,8,2238
48029181825,5486,1699,2690,258,10,609,0,32,3787
48029181826,6892,2343,3433,320,12,481,5,21,4549
48029181901,5940,1997,2451,594,17,590,4,27,3943
48029181902,10935,5062,4109,479,25,738,15,52,5873
48029182001,5384,2058,2407,190,12,533,10,22,3326
48029182002,10116,4698,3619,351,24,996,11,38,5418
48029182003,4899,1852,2032,155,5,677,0,27,3047
48029182101,15049,9370,4014,342,33,576,7,101,5679
48029182102,12703,6963,4258,326,19,661,16,41,5740
48029182103,5481,2779,2162,106,16,196,0,18,2702
48029182105,12469,4091,6036,1233,26,480,47,44,8378
48029182106,10830,4470,4830,554,24,474,6,31,6360
48029190100,3314,674,2483,68,8,14,0,13,2640
48029190200,3652,1555,1859,86,4,47,2,16,2097
48029190400,4273,2578,1149,111,3,215,0,15,1695
48029190501,2554,333,2102,54,0,22,3,1,2221
48029190503,3123,831,2122,46,7,25,0,13,2292
48029190504,2385,484,1801,30,6,10,3,6,1901
48029190601,3665,242,3326,53,1,13,0,8,3423
48029190603,2661,288,2304,26,5,9,0,5,2373
48029190604,4167,269,3791,27,15,14,0,22,3898
48029190700,2957,748,2008,83,9,41,3,12,2209
48029190800,2176,1565,470,29,6,25,0,10,611
48029190901,5383,1274,3537,320,11,79,4,20,4109
48029190902,3601,1063,2361,64,9,41,0,11,2538
48029191003,7987,1078,6331,382,17,32,0,31,6909
48029191004,3688,431,2965,197,9,22,0,16,3257
48029191005,2123,257,1822,13,2,0,0,5,1866
48029191006,6311,502,5687,43,7,5,8,6,5809
48029191101,1788,935,740,20,1,36,0,9,853
48029191102,2190,894,1144,40,4,37,2,11,1296
48029191201,3143,1254,1686,68,2,41,2,14,1889
48029191202,4982,1632,2773,314,10,98,11,19,3350
48029191303,1624,794,686,39,4,41,8,7,830
48029191304,2840,500,2096,122,4,63,0,13,2340
48029191405,8293,4221,3205,322,18,236,7,31,4072
48029191406,6328,4107,1728,100,14,194,3,8,2221
48029191408,3014,723,1733,304,8,104,2,17,2291
48029191409,6243,1306,3842,554,14,302,6,32,4937
48029191410,5616,1487,3245,511,13,147,7,18,4129
48029191411,4500,2180,1770,226,10,127,4,11,2320
48029191412,2271,1425,632,31,4,115,1,4,846
48029191413,6185,3116,2413,223,9,184,1,26,3069
48029191503,5227,2654,1993,154,8,249,5,12,2573
48029191504,2708,1700,742,35,2,160,1,6,1008
48029191505,2107,1204,736,25,0,65,1,16,903
48029191506,5889,2638,2433,262,13,321,3,24,3251
48029191701,1533,1106,326,12,3,30,3,2,427
48029191702,7276,4395,2192,255,17,128,0,49,2881
48029191804,11588,6657,3734,428,37,226,14,66,4931
48029191806,9540,4871,2880,337,19,1055,3,31,4669
48029191807,11668,4723,4939,635,20,929,17,33,6945
48029191808,5933,2532,1962,469,13,661,25,23,3401
48029191809,8902,4360,2994,462,22,640,15,43,4542
48029191810,6170,2620,2355,383,14,496,12,28,3550
48029191811,5765,2769,1944,276,6,509,3,16,2996
48029191812,4304,2035,1470,177,9,447,0,11,2269
48029191813,7271,3452,2748,254,9,460,3,45,3819
48029191814,6143,2885,2540,214,12,237,10,25,3258
48029191815,5248,2045,2217,231,9,516,4,25,3203
48029191816,3184,1718,1046,116,4,157,2,31,1466
48029191818,4781,2042,1944,276,13,341,0,13,2739
48029191819,8972,3675,3490,568,14,855,10,34,5297
48029191900,4528,804,3014,502,12,62,2,21,3724
48029192000,5233,2159,2462,284,11,83,10,31,3074
48029192100,2724,1151,1361,75,3,48,2,11,1573
48029192200,3186,572,2247,171,8,123,5,11,2614
48029192300,5055,2550,1923,233,16,138,4,24,2505
48029980001,3,0,2,0,0,0,0,0,3
48029980002,0,0,0,0,0,0,0,0,0
48029980003,889,460,197,106,7,33,9,9,429
48029980004,1,0,1,0,0,0,0,0,1
48029980005,65,23,32,2,0,3,1,0,42
48029980100,1083,214,700,102,4,20,6,3,869
48031950101,2627,2038,454,8,6,11,0,14,589
48031950102,2396,2000,276,11,8,7,0,14,396
48031950201,3631,2715,738,30,21,3,0,22,916
48031950202,2720,1954,624,19,1,17,0,20,766
48033950100,631,528,86,1,0,0,0,1,103
48035950100,4197,3164,849,9,31,3,0,6,1033
48035950200,1421,881,390,66,6,21,0,0,540
48035950300,1792,1505,151,12,17,3,1,1,287
48035950400,3733,3060,423,23,10,24,0,6,673
48035950500,3004,1801,937,81,7,23,0,4,1203
48035950600,1694,1461,99,14,6,4,2,5,233
48035950700,2394,1749,472,39,6,2,0,7,645
48037010100,4945,2222,518,1874,24,28,6,24,2723
48037010400,3883,934,278,2430,21,2,0,39,2949
48037010500,2911,689,294,1812,9,11,2,0,2222
48037010600,2049,214,325,1437,5,1,3,14,1835
48037010700,4644,1985,494,1820,17,93,5,19,2659
48037010800,4500,1357,464,2338,18,50,7,23,3143
48037010903,3231,2280,194,499,16,83,0,15,951
48037010904,4307,3256,229,440,41,140,1,19,1051
48037010905,3037,1300,490,1027,14,31,4,18,1737
48037010906,5144,3663,267,627,29,287,2,18,1481
48037011001,3145,1842,338,740,12,27,0,18,1303
48037011002,4639,2776,312,1220,32,33,0,13,1863
48037011101,3616,2108,328,988,12,14,16,7,1508
48037011102,3130,1693,328,940,34,9,2,9,1437
48037011201,3832,3126,122,275,11,121,1,11,706
48037011202,2557,2206,126,83,19,11,0,4,351
48037011301,2967,2087,267,394,18,18,0,0,880
48037011302,2220,1672,83,338,4,4,1,9,548
48037011402,2118,1867,70,86,8,4,0,0,251
48037011403,3475,2621,216,407,31,10,0,19,854
48037011404,4525,3867,143,270,37,8,3,20,658
48037011501,7870,4656,1144,1574,36,39,12,22,3214
48037011502,2789,1612,171,748,22,25,0,0,1177
48037011601,2629,1800,234,468,20,16,0,4,829
48037011602,2387,1929,69,239,28,17,1,2,458
48037011700,2343,2093,98,10,36,0,3,5,250
48039660100,4445,2881,947,200,11,238,2,13,1564
48039660200,5897,3350,1482,406,20,405,9,19,2547
48039660301,3901,1879,1010,568,10,244,2,19,2022
48039660302,2844,1819,624,196,8,89,0,6,1025
48039660303,4243,2489,937,377,7,232,0,40,1754
48039660401,2853,1125,1052,253,7,280,0,5,1728
48039660402,4531,1956,1299,430,12,655,0,25,2575
48039660403,3883,1849,1049,421,14,368,4,17,2034
48039660501,2978,817,712,770,4,571,2,9,2161
48039660502,4294,1211,2467,317,11,167,0,8,3083
48039660503,2764,1307,1186,126,10,48,3,0,1457
48039660504,1548,613,760,100,4,26,0,3,935
48039660603,3279,612,493,1775,8,280,3,23,2667
48039660604,4179,858,651,1090,7,1405,7,18,3321
48039660605,6132,1306,1038,1707,12,1812,3,29,4826
48039660606,3208,1077,385,687,1,903,0,29,2131
48039660607,5677,974,952,2401,3,1114,3,9,4703
48039660608,2666,1503,307,357,4,376,2,14,1163
48039660609,4374,1416,1093,1037,6,596,1,16,2958
48039660610,5476,1423,1044,1239,9,1589,2,16,4053
48039660611,5633,1117,963,1437,7,1829,11,15,4516
48039660612,3523,925,583,1009,10,857,0,6,2598
48039660613,4347,571,1768,1501,6,389,0,21,3776
48039660614,6880,1078,2000,2974,14,560,3,46,5802
48039660615,5457,905,1613,2126,2,586,6,24,4552
48039660616,5234,1362,1043,1572,14,1025,0,21,3872
48039660703,5030,1596,676,1194,9,1267,4,35,3434
48039660704,5248,2077,811,935,3,1179,2,20,3171
48039660705,5890,1710,1606,1846,6,445,0,51,4180
48039660706,4955,1779,772,1132,9,1076,2,26,3176
48039660707,4457,1779,1247,651,10,561,5,18,2678
48039660708,7364,3203,1921,1351,15,601,1,18,4161
48039660803,4028,1602,1249,667,1,345,0,12,2426
48039660804,4314,1913,1594,468,5,158,5,17,2401
48039660805,5125,2424,1506,699,24,222,1,14,2701
48039660806,3009,1242,1143,332,8,128,0,28,1767
48039660901,2200,564,1549,18,4,22,4,1,1636
48039660902,6689,2437,3336,372,24,313,2,12,4252
48039661000,8562,4358,3474,240,22,122,0,36,4204
48039661100,3705,1816,1546,193,7,20,0,4,1889
48039661200,4310,2302,1528,212,25,75,0,5,2008
48039661300,2495,1166,1132,90,10,16,4,13,1329
48039661400,7187,4168,2414,217,15,77,0,27,3019
48039661501,4912,2592,1984,122,11,33,0,3,2320
48039661502,4825,2780,1621,116,23,58,1,27,2045
48039661601,6155,3677,2058,171,15,74,1,17,2478
48039661602,3428,1629,1629,55,2,20,0,9,1799
48039661700,3022,1981,820,69,17,17,0,9,1041
48039661800,8721,3535,2925,1152,31,744,2,48,5186
48039661901,8024,3075,2742,1989,9,49,0,15,4949
48039661902,10188,2199,3784,3581,11,309,2,16,7989
48039662000,6637,4349,1471,514,45,27,3,17,2288
48039662100,6575,3109,2285,901,22,50,5,14,3466
48039662200,6807,3776,1881,789,35,96,0,17,3031
48039662300,4688,2474,1546,391,11,28,2,17,2214
48039662400,5686,3518,1579,302,17,29,0,17,2168
48039662500,3149,1920,868,220,15,16,3,7,1229
48039662600,3207,2170,612,277,19,21,0,7,1037
48039662700,2502,1739,477,164,10,11,0,5,763
48039662800,6512,4224,1110,851,18,34,0,16,2288
48039662900,4757,3000,1179,344,12,33,1,14,1757
48039663000,4083,2325,898,739,15,12,1,8,1758
48039663100,7184,4110,1994,586,30,187,2,29,3074
48039663200,5049,2975,1472,262,16,119,0,21,2074
48039663300,2283,1115,931,98,3,19,2,5,1168
48039663400,8101,4275,2414,606,35,458,6,45,3826
48039663500,5611,3049,1879,319,15,95,0,26,2562
48039663600,5408,3768,1139,181,23,92,0,35,1640
48039663700,3941,1899,1517,284,19,98,0,22,2042
48039663800,6273,2264,3075,601,36,75,3,31,4009
48039663900,2013,471,1342,151,0,5,0,5,1542
48039664000,3277,1232,1614,314,12,19,0,10,2045
48039664100,6083,2740,2873,215,16,46,1,16,3343
48039664200,2222,1537,501,54,13,14,1,18,685
48039664300,5059,973,3300,619,13,16,0,13,4086
48039664400,5610,1414,3510,508,18,39,0,14,4196
48039664501,5225,3380,1210,430,17,17,0,13,1845
48039990000,0,0,0,0,0,0,0,0,0
48041000103,1953,1458,320,45,8,2,0,19,495
48041000104,4532,2316,1551,497,22,6,5,19,2216
48041000105,3722,2951,500,90,6,39,0,7,771
48041000106,3708,2584,846,72,18,34,1,20,1124
48041000107,4467,3083,768,314,6,90,1,25,1384
48041000108,1330,1039,196,35,6,3,0,0,291
48041000203,2863,1536,671,423,6,45,18,29,1327
48041000204,3706,1223,1228,1010,0,88,14,21,2483
48041000205,4486,1644,2210,510,9,10,0,22,2842
48041000206,2419,1236,790,238,3,55,0,8,1183
48041000207,2788,1634,642,343,4,73,0,3,1154
48041000301,3799,804,2251,621,4,10,0,16,2995
48041000302,3964,1034,2432,368,0,26,1,12,2930
48041000401,3811,874,1468,1347,7,36,0,10,2937
48041000402,1475,491,507,373,0,15,8,0,984
48041000501,4101,313,2020,1711,2,5,0,12,3788
48041000502,1307,91,875,320,1,0,1,0,1216
48041000603,4960,490,3626,736,7,21,0,16,4470
48041000605,4982,616,3455,798,2,13,0,10,4366
48041000606,1577,65,1319,128,3,2,0,46,1512
48041000700,2912,1018,1411,362,6,10,0,11,1894
48041000800,5017,2639,1679,440,12,36,8,35,2378
48041000900,2506,532,1458,406,6,31,7,7,1974
48041001001,3849,1138,1463,561,3,533,0,11,2711
48041001002,3576,1988,786,268,4,400,1,16,1588
48041001101,3098,1845,640,417,2,52,0,16,1253
48041001102,1618,687,460,340,1,38,4,13,931
48041001301,2255,1159,519,332,0,115,5,25,1096
48041001302,3450,1933,775,302,4,258,5,18,1517
48041001303,4896,2566,998,811,17,264,2,27,2330
48041001401,2944,1612,702,141,7,365,4,3,1332
48041001604,4917,2519,1149,561,0,454,5,30,2398
48041001605,3425,1458,729,787,8,255,4,9,1967
48041001606,2562,1228,527,350,0,344,6,8,1334
48041001607,1659,702,337,145,3,418,0,8,957
48041001608,2653,1659,403,451,11,69,1,7,994
48041001702,2353,943,744,342,9,200,0,9,1410
48041001703,3422,1681,625,335,3,654,0,10,1741
48041001704,1917,849,507,239,6,218,1,13,1068
48041001801,4684,2808,939,541,11,118,5,20,1876
48041001803,6021,3464,982,574,6,645,6,46,2557
48041001804,1314,735,250,109,8,138,8,3,579
48041001901,3248,2400,365,165,11,164,0,16,848
48041001902,2931,1878,626,240,5,50,3,10,1053
48041002001,4897,3748,573,69,15,258,0,33,1149
48041002006,1520,999,194,96,3,160,3,9,521
48041002009,5231,4050,345,67,7,572,1,31,1181
48041002010,3718,2888,446,62,23,122,1,37,830
48041002011,5898,4541,708,189,26,139,4,32,1357
48041002014,4381,2767,701,335,20,346,2,13,1614
48041002016,3581,2595,500,134,3,191,2,13,986
48041002017,6543,2856,1926,612,0,1077,1,2,3687
48041002018,3352,2012,597,313,0,275,7,23,1340
48041002019,3495,2105,542,227,13,427,4,20,1390
48041002020,2673,1768,550,179,9,46,1,9,905
48041002021,6914,4817,1356,234,16,232,18,23,2097
48041002022,5720,3771,1041,468,10,201,14,27,1949
48041002023,2448,1249,732,139,22,190,2,6,1199
48041002024,3793,2244,857,197,23,300,0,4,1549
48041002025,5470,3768,799,235,16,394,0,15,1702
48041002026,5792,3715,595,188,8,1049,2,6,2077
48041002100,15243,8218,3854,627,31,2240,24,40,7025
48041980000,3,1,2,0,0,0,0,0,2
48043950300,4764,2490,1881,127,10,80,8,26,2274
48043950400,1552,365,1125,23,1,2,0,8,1187
48043950500,3230,2093,957,12,19,12,3,22,1137
48045950200,1435,1008,368,17,4,0,0,3,427
48047950100,2236,409,1787,2,6,1,0,4,1827
48047950200,4840,315,4455,6,3,28,0,8,4525
48049950100,2127,1821,203,11,4,2,0,4,306
48049950201,1605,1305,198,29,3,1,0,1,300
48049950202,2331,1903,274,52,19,8,0,1,428
48049950300,2942,2512,314,7,15,8,0,9,430
48049950500,2858,2116,516,76,17,10,0,1,742
48049950600,2585,1446,838,145,2,19,0,10,1139
48049950700,1293,523,497,207,1,6,24,0,770
48049950800,2456,1173,1062,106,2,21,1,11,1283
48049950900,4693,3056,1222,165,10,54,2,23,1637
48049951000,2472,1596,665,82,6,20,0,13,876
48049951100,4376,3155,888,162,11,27,0,9,1221
48049951200,4652,3545,724,51,30,77,0,8,1107
48049951300,3705,2521,810,260,14,16,0,6,1184
48051970100,1399,1066,182,125,1,5,0,0,333
48051970201,1769,1331,276,99,2,7,0,0,438
48051970202,2535,1835,424,160,8,5,0,3,700
48051970300,4178,2238,1303,481,11,25,0,8,1940
48051970400,3502,2100,726,499,16,8,0,9,1402
48051970501,1904,1420,238,93,20,10,0,1,484
48051970502,2355,1268,563,395,7,10,0,13,1087
48053960101,4639,3224,1139,36,19,27,0,20,1415
48053960102,2316,1802,358,24,12,11,6,3,514
48053960200,3381,2900,309,9,5,18,1,16,481
48053960301,2809,1695,859,121,6,31,0,14,1114
48053960302,4356,3198,861,46,15,47,0,16,1158
48053960401,3469,2762,467,81,13,7,2,19,707
48053960402,2974,2388,389,16,17,20,3,16,586
48053960501,4168,1596,2407,29,10,11,0,11,2572
48053960502,2020,1581,327,13,8,7,0,1,439
48053960600,4356,3352,830,6,18,26,0,2,1004
48053960701,4007,2404,1277,82,16,89,0,2,1603
48053960702,3476,2477,674,59,11,68,1,10,999
48053960801,2793,1830,774,32,14,29,1,6,963
48053960802,2508,2114,282,13,9,17,0,2,394
48053960803,1858,1487,246,12,10,16,0,9,371
48055960102,5225,2557,2239,207,12,9,0,21,2668
48055960103,7993,1418,6323,95,19,24,0,31,6575
48055960104,2135,723,1287,50,12,14,0,8,1412
48055960200,5486,1919,2885,537,5,15,2,16,3567
48055960300,4732,2219,2118,152,13,43,0,24,2513
48055960400,4506,1362,2746,246,23,39,0,14,3144
48055960501,4201,1274,2388,390,13,17,1,11,2927
48055960502,2946,1154,1599,69,15,17,0,9,1792
48055960600,2874,1879,756,95,10,18,0,7,995
48055960701,2784,621,1809,270,3,5,0,22,2163
48055960702,3001,1434,1318,114,4,26,1,15,1567
48057000100,5389,1613,2820,81,11,776,0,10,3776
48057000200,3864,775,2846,152,0,57,0,2,3089
48057000300,1287,821,364,15,6,22,0,7,466
48057000401,3469,1497,1725,56,2,104,0,23,1972
48057000402,2984,1426,1407,46,3,74,0,8,1558
48057000501,1655,1226,367,10,4,8,0,6,429
48057000502,1458,1016,329,1,8,71,0,0,442
48057990000,0,0,0,0,0,0,0,0,0
48059030101,4966,4170,508,29,31,18,2,10,796
48059030102,4621,3822,428,89,16,23,5,33,799
48059030200,4121,3563,370,0,19,11,0,7,558
48061010101,3495,486,2979,3,7,4,0,1,3009
48061010102,1458,387,1050,5,0,13,0,0,1071
48061010103,2230,135,2075,6,0,4,0,4,2095
48061010201,2176,189,1934,0,0,22,4,11,1987
48061010204,4318,635,3446,44,6,140,0,2,3683
48061010205,3452,789,2608,14,0,13,0,5,2663
48061010301,4834,305,4492,2,2,6,0,2,4529
48061010303,4890,425,4347,23,18,22,3,25,4465
48061010304,4817,864,3838,21,5,35,5,13,3953
48061010403,3111,246,2820,15,5,8,3,9,2865
48061010404,3605,389,3151,16,0,14,0,12,3216
48061010405,4893,1305,3375,45,6,66,3,24,3588
48061010406,2271,313,1913,8,1,8,9,1,1958
48061010500,2707,123,2566,5,1,4,1,3,2584
48061010602,1748,390,1289,13,3,19,1,2,1358
48061010603,4691,427,4182,36,8,5,1,13,4264
48061010604,4556,566,3834,42,13,29,0,15,3990
48061010700,3303,523,2726,10,4,3,4,12,2780
48061010801,4665,697,3877,24,5,23,0,5,3968
48061010802,3679,596,2926,41,7,69,0,9,3083
48061010900,1540,106,1397,15,0,11,0,0,1434
48061011000,3240,75,3106,29,0,8,0,8,3165
48061011100,2657,148,2482,10,4,4,0,4,2509
48061011200,1757,176,1571,1,1,0,0,5,1581
48061011301,1688,448,1187,16,2,8,0,3,1240
48061011302,4381,1297,2761,88,24,132,4,10,3084
48061011401,3239,296,2904,9,0,10,0,1,2943
48061011402,3168,442,2613,18,13,47,0,1,2726
48061011500,5987,290,5624,20,10,4,0,12,5697
48061011601,3418,128,3262,4,0,2,1,9,3290
48061011602,3028,98,2911,3,2,3,0,7,2930
48061011701,3887,201,3601,23,3,26,0,11,3686
48061011702,3004,58,2933,4,0,3,0,5,2946
48061011801,6220,666,5329,65,1,113,0,7,5554
48061011802,3877,170,3581,21,4,85,0,11,3707
48061011903,2810,103,2685,1,3,0,0,8,2707
48061011904,2149,157,1977,0,0,8,1,4,1992
48061011905,1481,205,1258,5,1,4,0,1,1276
48061011906,2119,352,1737,6,5,4,0,5,1767
48061011907,1535,211,1309,0,0,7,0,3,1324
48061011908,2590,449,2084,12,7,12,2,4,2141
48061012002,5401,889,4430,31,4,10,0,8,4512
48061012003,4122,744,3219,38,6,86,1,8,3378
48061012004,2236,708,1475,0,6,18,2,2,1528
48061012103,943,493,427,0,6,7,1,0,450
48061012104,4579,622,3853,10,3,40,0,18,3957
48061012105,3378,168,3198,2,0,1,1,5,3210
48061012106,2543,81,2449,2,3,0,0,4,2462
48061012201,2979,224,2733,0,1,0,1,8,2755
48061012202,3519,328,3148,3,0,12,0,16,3191
48061012203,4431,130,4277,2,1,3,0,11,4301
48061012301,5159,1955,2931,41,12,112,0,22,3204
48061012304,3899,854,2967,9,7,13,5,13,3045
48061012305,3005,1969,824,27,7,74,0,6,1036
48061012402,5903,580,5245,10,6,23,1,13,5323
48061012403,3129,267,2819,15,11,1,1,1,2862
48061012404,3384,103,3250,6,3,7,1,5,3281
48061012506,4167,748,3246,34,5,84,0,5,3419
48061012508,4357,336,3990,0,4,10,0,13,4021
48061012509,3944,142,3694,16,4,51,2,18,3802
48061012510,5249,119,5095,3,0,9,0,15,5130
48061012511,5274,192,5030,8,7,5,0,15,5082
48061012512,3025,36,2983,2,0,0,0,0,2989
48061012513,4515,213,4216,8,0,46,2,20,4302
48061012514,4712,133,4530,15,2,26,0,3,4579
48061012515,2528,289,2177,20,4,25,2,2,2239
48061012516,3371,100,3250,0,0,13,0,6,3271
48061012517,5822,352,5355,18,3,69,0,9,5470
48061012607,2748,47,2671,4,0,12,0,9,2701
48061012608,5785,759,4928,24,1,34,0,3,5026
48061012613,5353,613,4564,21,0,122,1,4,4740
48061012614,3109,27,3071,0,0,4,0,7,3082
48061012615,3795,73,3698,6,4,4,0,0,3722
48061012616,3632,170,3413,11,5,11,0,10,3462
48061012617,2625,111,2462,21,4,19,0,1,2514
48061012700,5382,139,5201,5,4,1,1,15,5243
48061012800,4990,149,4800,0,4,10,0,14,4841
48061012900,4609,420,4121,11,5,18,2,12,4189
48061013002,4215,346,3759,22,4,54,1,4,3869
48061013003,2375,102,2257,3,0,2,0,4,2273
48061013004,2827,216,2580,4,0,8,0,4,2611
48061013102,4296,324,3921,0,1,29,0,8,3972
48061013104,3586,311,3218,8,0,26,0,8,3275
48061013106,4686,165,4494,3,0,11,0,6,4521
48061013203,2395,80,2294,4,2,1,0,5,2315
48061013204,2174,108,2048,0,0,6,2,0,2066
48061013205,3749,52,3683,5,3,0,0,5,3697
48061013206,2766,57,2700,0,0,0,0,9,2709
48061013207,3814,258,3516,6,4,0,0,14,3556
48061013303,4000,154,3805,5,0,12,1,10,3846
48061013305,4808,82,4713,1,0,0,0,0,4726
48061013306,2511,41,2464,0,0,0,0,5,2470
48061013307,2031,35,1984,0,6,1,0,2,1996
48061013308,3359,37,3313,0,0,0,0,2,3322
48061013309,2762,57,2689,6,0,0,0,2,2705
48061013401,2360,53,2291,6,0,1,0,8,2307
48061013402,1928,39,1883,0,0,0,0,2,1889
48061013500,1815,220,1575,1,0,1,0,7,1595
48061013600,3055,158,2870,7,0,11,0,7,2897
48061013700,3150,59,3062,0,4,3,2,4,3091
48061013801,2263,151,2089,12,0,2,1,0,2112
48061013802,3259,74,3152,13,4,2,0,10,3185
48061013901,2434,41,2368,0,0,0,1,17,2393
48061013902,4371,96,4263,1,0,1,2,2,4275
48061013903,3427,76,3344,0,0,1,0,4,3351
48061014001,2126,89,1995,10,2,20,0,0,2037
48061014002,2193,45,2134,2,2,0,0,6,2148
48061014101,4119,120,3979,4,6,0,0,6,3999
48061014102,3724,81,3613,1,2,7,0,13,3643
48061014103,3211,100,3090,4,0,0,0,8,3111
48061014201,1325,60,1243,0,7,7,0,7,1265
48061014202,2383,250,2101,4,1,7,0,0,2133
48061014300,4405,303,4045,15,0,25,0,0,4102
48061014401,7195,214,6876,40,0,44,0,5,6981
48061014402,6606,354,6038,20,8,141,4,16,6252
48061014403,3331,278,3015,12,0,6,0,12,3053
48061014404,4068,142,3894,0,0,15,0,2,3926
48061014501,4889,313,4394,17,5,134,0,9,4576
48061014502,4736,213,4440,22,1,40,0,5,4523
48061980001,0,0,0,0,0,0,0,0,0
48061980100,14,4,8,1,0,0,0,0,10
48061990000,0,0,0,0,0,0,0,0,0
48063950101,3611,2106,946,400,7,29,0,5,1505
48063950102,4093,2761,698,369,14,42,3,20,1332
48063950200,4760,1867,1578,1108,7,34,5,9,2893
48065950100,2223,1899,179,2,14,5,0,0,324
48065950200,3584,2974,379,17,32,14,1,7,610
48067950101,3799,3173,128,307,22,9,1,2,626
48067950102,2434,1994,51,253,18,10,1,8,440
48067950200,2496,1741,76,511,14,14,0,5,755
48067950300,1632,1171,65,309,19,14,0,4,461
48067950400,5175,3035,285,1594,15,37,3,24,2140
48067950500,2665,2272,102,139,18,3,0,3,393
48067950601,1827,1309,82,310,11,6,3,13,518
48067950602,3334,2434,210,502,17,12,0,17,900
48067950700,5092,3899,337,593,21,14,2,10,1193
48069950100,1088,703,366,2,4,0,0,0,385
48069950200,4407,972,3240,87,31,22,2,9,3435
48069950300,1876,653,1178,6,4,0,2,0,1223
48071710100,10655,8033,1557,338,56,207,0,46,2622
48071710201,10707,5248,3954,962,36,162,0,43,5459
48071710202,12163,8950,2157,462,38,96,0,58,3213
48071710300,3057,1790,421,660,12,15,0,21,1267
48071710401,6247,3726,1801,434,11,31,0,30,2521
48071710500,3742,2111,1062,292,8,111,0,17,1631
48071710600,0,0,0,0,0,0,0,0,0
48071990000,0,0,0,0,0,0,0,0,0
48073950100,4213,2601,1277,226,21,9,1,7,1612
48073950201,2820,2467,189,23,14,20,0,6,353
48073950202,4195,3359,342,210,18,18,2,8,836
48073950301,3204,2182,799,94,12,22,0,6,1022
48073950302,4133,2615,925,409,3,13,4,11,1518
48073950400,1502,248,572,645,2,4,0,2,1254
48073950500,3545,902,1688,848,3,10,3,14,2643
48073950600,6036,3023,2024,725,10,67,1,16,3013
48073950700,3888,1334,1760,594,12,27,1,15,2554
48073950801,3929,3121,306,346,12,7,0,8,808
48073950802,3798,2801,546,288,8,16,2,11,997
48073950900,4220,2227,680,1126,9,37,3,19,1993
48073951000,3173,1825,573,657,4,9,0,0,1348
48073951100,1756,1390,116,168,0,4,1,0,366
48075950100,2017,1017,562,376,0,21,0,3,1000
48075950200,4647,2835,1380,196,20,30,2,13,1812
48077030200,3208,2818,171,21,24,29,0,13,390
48077030301,4317,3650,346,5,46,16,0,13,667
48077030302,2693,2473,124,9,8,5,0,5,220
48079950100,2547,912,1527,62,6,0,0,0,1635
48081950100,1570,1226,283,0,4,1,3,2,344
48081950200,1715,1247,378,7,11,0,3,4,468
48083950300,4063,3006,777,91,17,19,0,20,1057
48083950600,1285,1123,102,7,11,10,0,4,162
48083950700,2336,1884,313,44,8,3,0,5,452
48085030101,3595,2510,782,41,29,41,1,13,1085
48085030102,4282,3139,832,48,25,24,0,16,1143
48085030201,6175,4074,905,593,55,200,7,30,2101
48085030202,6345,4317,850,513,24,289,8,31,2028
48085030204,7554,4332,1705,907,37,143,5,31,3222
48085030205,4869,2732,1119,583,35,97,4,37,2137
48085030206,4565,2873,672,487,39,209,1,16,1692
48085030207,14195,8778,2586,1563,104,363,13,74,5417
48085030301,9945,6066,1130,1108,34,1017,8,64,3879
48085030302,5812,4550,373,353,4,218,3,9,1262
48085030303,10198,6996,1015,874,37,754,4,21,3202
48085030304,7973,5661,888,451,59,484,2,53,2312
48085030306,11608,7690,2082,669,54,507,7,37,3918
48085030307,12663,9150,1579,699,67,479,7,47,3513
48085030403,5616,3400,1051,444,29,331,1,26,2216
48085030404,5535,3049,852,578,12,786,1,28,2486
48085030405,4546,2105,853,691,21,593,2,32,2441
48085030406,5622,2199,1521,742,36,827,1,44,3423
48085030407,3868,2586,369,226,24,447,0,29,1282
48085030409,3619,1493,1159,529,8,262,1,16,2126
48085030410,4349,2155,1236,497,9,212,7,19,2194
48085030504,4417,2552,518,581,10,530,0,25,1865
48085030505,5903,2519,771,770,34,1333,7,69,3384
48085030506,4543,2259,525,435,10,1074,5,20,2284
48085030507,1810,1123,191,84,3,296,0,16,687
48085030509,2507,1366,259,174,7,594,1,15,1141
48085030510,3107,1434,423,430,6,629,0,18,1673
48085030511,14451,4078,944,737,37,8155,7,60,10373
48085030512,4566,2404,321,165,13,1477,7,29,2162
48085030515,6444,3668,852,861,36,664,6,14,2776
48085030516,7412,3223,942,949,33,1874,2,37,4189
48085030517,9512,4956,1175,1256,34,1531,2,34,4556
48085030518,9638,2323,359,569,36,5993,1,43,7315
48085030519,8888,3545,1067,963,22,2721,5,68,5343
48085030520,6791,2714,856,1051,24,1729,7,36,4077
48085030521,5252,1396,540,695,19,2339,7,37,3856
48085030524,8990,3534,1152,1086,40,2742,11,43,5456
48085030525,5966,4635,494,298,11,262,3,15,1331
48085030529,3710,2332,443,376,4,325,6,17,1378
48085030531,6856,5152,607,336,27,419,4,29,1704
48085030532,3015,1770,293,141,10,643,10,14,1245
48085030533,3355,2197,415,130,11,395,5,19,1158
48085030534,3173,2432,315,181,6,89,0,7,741
48085030535,2786,2095,282,124,5,116,3,10,691
48085030536,7209,2297,790,971,23,2736,17,64,4912
48085030537,7579,3082,781,619,25,2661,2,45,4497
48085030538,5584,2100,633,1035,18,1499,0,12,3484
48085030539,5448,3007,706,875,19,568,1,38,2441
48085030540,4154,1549,549,1092,10,687,3,26,2605
48085030541,4468,1834,379,437,11,1574,6,16,2634
48085030542,8325,3717,897,1118,38,2122,12,23,4608
48085030543,3672,1137,430,612,10,1318,4,9,2535
48085030544,5510,3601,719,456,20,399,8,25,1909
48085030545,3034,2349,231,104,10,186,4,15,685
48085030546,5611,3614,596,596,10,525,0,15,1997
48085030547,5715,3856,650,541,25,358,0,18,1859
48085030548,4794,2863,684,636,20,338,4,24,1931
48085030549,2612,1419,514,354,5,158,6,13,1193
48085030550,4218,2411,627,543,12,391,2,13,1807
48085030604,3353,1825,569,656,8,158,2,5,1528
48085030605,6758,2972,1490,1495,23,364,3,33,3786
48085030606,5597,3011,855,1168,24,274,3,31,2586
48085030607,5200,4048,423,205,42,234,4,20,1152
48085030608,2508,1290,654,345,10,72,5,6,1218
48085030609,6776,3696,1123,934,29,656,7,36,3080
48085030701,3363,1380,1392,366,18,63,1,19,1983
48085030702,4874,2491,1800,343,12,34,2,14,2383
48085030801,4521,1899,1108,979,24,227,6,59,2622
48085030802,6099,2529,2383,810,29,74,6,23,3570
48085030901,2335,422,1100,659,5,59,2,13,1913
48085030902,6,6,0,0,0,0,0,0,0
48085030903,7763,2203,4314,908,23,140,6,16,5560
48085031003,12022,5532,3456,1894,63,455,5,59,6490
48085031005,3126,1753,1066,107,24,35,3,7,1373
48085031006,3460,1839,1331,83,13,32,5,19,1621
48085031007,6291,3105,2175,554,18,129,0,17,3186
48085031008,3229,1627,1415,35,40,27,0,11,1602
48085031101,5837,3756,1497,251,18,43,3,7,2081
48085031102,6507,3827,2089,127,52,63,1,30,2680
48085031201,7895,5310,1587,414,36,137,10,31,2585
48085031202,7224,4340,1804,537,63,172,5,31,2884
48085031308,6999,4080,1240,786,40,408,14,15,2919
48085031314,6001,3603,811,537,32,678,3,30,2398
48085031318,5832,3064,1098,830,24,472,1,37,2768
48085031319,4707,2217,887,917,28,375,1,11,2490
48085031320,6153,4006,1025,517,37,247,2,21,2147
48085031321,7121,4104,1175,931,33,554,3,28,3017
48085031322,8733,4739,1949,822,47,815,12,47,3994
48085031323,5369,3017,841,780,26,420,4,25,2352
48085031324,4567,2311,540,460,4,1021,1,37,2256
48085031325,2188,1399,324,171,5,179,0,11,789
48085031326,6305,3327,721,408,16,1519,1,26,2978
48085031327,4347,2182,309,290,1,1349,0,14,2165
48085031328,3830,1793,311,378,13,1166,1,4,2037
48085031329,6772,2869,600,845,17,2147,11,31,3903
48085031330,5905,3252,727,627,10,968,1,44,2653
48085031331,4990,1785,2013,486,14,552,6,22,3205
48085031332,5218,2080,763,1021,23,1074,0,20,3138
48085031333,3826,922,248,504,6,2035,1,7,2904
48085031334,2877,1528,216,220,8,738,1,16,1349
48085031335,6108,3341,568,679,15,1233,5,26,2767
48085031336,5486,2828,549,633,28,1177,0,18,2658
48085031408,3495,1969,354,381,10,615,0,0,1526
48085031411,6037,2995,617,715,18,1377,2,18,3042
48085031412,6555,4345,612,586,27,602,4,37,2210
48085031413,6839,3322,949,787,28,1436,8,22,3517
48085031414,6149,3628,568,461,17,1122,3,47,2521
48085031415,4945,3171,456,272,18,813,2,18,1774
48085031416,10717,4145,745,671,30,4592,4,52,6572
48085031417,6840,2897,565,588,16,2458,0,31,3943
48085031418,7110,3031,547,463,12,2715,7,20,4079
48085031419,4929,3765,391,142,29,319,0,18,1164
48085031420,3446,2974,282,22,10,57,0,15,472
48085031421,4573,1577,386,561,8,1843,3,29,2996
48085031422,4006,2407,649,340,12,370,0,10,1599
48085031423,2899,1536,370,332,4,469,5,1,1363
48085031424,2875,1720,365,315,12,332,0,16,1155
48085031425,5725,3171,817,654,33,675,3,21,2554
48085031504,7033,4535,993,559,42,565,7,41,2498
48085031507,7056,3736,922,790,13,1267,4,42,3320
48085031508,6124,3370,964,779,38,646,0,31,2754
48085031509,3873,1786,326,277,9,1268,3,20,2087
48085031510,6863,3685,708,449,11,1667,4,25,3178
48085031511,5447,2633,1483,839,14,212,0,18,2814
48085031512,3466,1528,1039,495,10,202,2,15,1938
48085031611,3919,1692,927,558,11,484,0,28,2227
48085031613,5612,4017,701,200,26,383,6,26,1595
48085031621,5624,3236,666,577,20,886,1,22,2388
48085031622,6089,3292,795,502,30,1189,2,17,2797
48085031623,2706,1308,520,231,7,545,3,8,1398
48085031624,3532,1375,1192,343,3,506,4,17,2157
48085031625,4339,3071,425,198,11,409,3,9,1268
48085031626,2342,1740,263,82,5,169,5,7,602
48085031627,4754,3047,871,259,24,304,3,16,1707
48085031628,3472,2009,769,284,14,185,2,15,1463
48085031629,3398,1784,952,299,9,178,0,13,1614
48085031630,4466,2625,520,342,6,748,0,10,1841
48085031631,4581,2070,872,679,21,643,4,44,2511
48085031632,5532,2668,527,859,24,1125,1,27,2864
48085031633,3636,1981,561,301,9,587,0,15,1655
48085031634,3022,1574,704,306,11,264,3,26,1448
48085031635,4493,1584,931,928,39,823,2,17,2909
48085031636,6554,3696,603,448,21,1436,13,39,2858
48085031639,7146,2465,524,653,27,3212,2,33,4681
48085031641,6306,1758,359,275,7,3641,0,34,4548
48085031642,4496,2489,425,264,8,1121,1,24,2007
48085031643,4518,2326,576,310,22,1041,1,22,2192
48085031645,2017,1429,130,39,1,344,0,9,588
48085031646,6402,3599,497,344,9,1624,2,24,2803
48085031647,3273,1716,382,372,23,635,0,12,1557
48085031649,5611,3556,648,374,5,741,7,26,2055
48085031654,3768,2225,243,113,4,1027,0,15,1543
48085031655,4731,2514,742,438,14,774,9,36,2217
48085031657,2935,1388,360,350,8,649,3,18,1547
48085031659,2121,641,176,194,13,992,0,21,1480
48085031660,5418,1029,194,263,16,3783,0,17,4389
48085031661,3695,1064,238,253,10,1999,0,14,2631
48085031662,4726,1783,316,328,13,2087,1,20,2943
48085031663,3846,1290,294,287,13,1829,2,9,2556
48085031664,3869,1947,243,180,8,1313,0,20,1922
48085031665,3414,1013,358,805,6,1112,0,19,2401
48085031666,5701,2181,557,557,29,2110,3,35,3520
48085031667,3340,1707,249,204,6,1050,3,6,1633
48085031668,3761,2415,235,133,11,804,0,6,1346
48085031669,2624,1125,323,247,1,826,0,1,1499
48085031670,1428,818,140,99,2,289,0,6,610
48085031671,2528,1247,422,277,12,438,1,16,1281
48085031672,2263,979,291,346,8,495,3,30,1284
48085031673,2817,828,143,196,14,1561,0,14,1989
48085031674,5277,2034,493,381,27,2083,4,28,3243
48085031675,3107,1347,364,271,13,965,0,7,1760
48085031676,4082,2222,392,449,8,774,0,41,1860
48085031677,3073,1508,202,106,7,1115,4,12,1565
48085031678,3607,2064,231,194,9,960,1,14,1543
48085031679,2883,653,125,137,2,1847,2,14,2230
48085031680,3828,1368,236,89,2,2047,1,15,2460
48085031681,2619,1928,244,103,1,197,0,5,691
48085031682,3662,2198,373,336,14,574,0,20,1464
48085031704,3625,2045,543,624,4,241,3,15,1580
48085031706,2253,1671,123,86,12,254,0,11,582
48085031708,3902,2366,501,494,13,354,0,24,1536
48085031709,4931,2396,450,458,7,1411,0,31,2535
48085031711,3265,1840,491,472,7,309,3,17,1425
48085031713,4572,1333,1163,1532,13,292,6,28,3239
48085031715,2703,1731,308,259,7,268,0,7,972
48085031716,2378,1397,312,264,6,266,0,10,981
48085031717,2037,886,278,387,2,375,2,14,1151
48085031718,2479,1784,250,135,4,192,1,14,695
48085031719,1717,1010,154,112,4,367,0,7,707
48085031720,3759,617,1159,696,3,1135,0,35,3142
48085031721,2303,1227,307,375,7,278,1,12,1076
48085031722,2994,867,545,1237,13,171,0,18,2127
48085031723,3777,806,1607,1033,2,163,0,32,2971
48085031724,3004,862,879,903,8,199,2,16,2142
48085031806,2454,741,206,182,3,1240,1,8,1713
48085031807,5034,3651,478,201,6,409,1,15,1383
48085031808,3273,2169,694,113,11,132,8,11,1104
48085031809,1970,541,666,413,0,257,0,12,1429
48085031810,1854,884,205,259,7,434,0,2,970
48085031811,1968,968,239,252,4,408,0,8,1000
48085031812,2055,1338,117,70,8,452,0,11,717
48085031813,5232,2210,586,332,21,1803,0,19,3022
48085031814,1875,1413,236,32,9,103,0,4,462
48085031815,3951,2608,440,260,2,414,3,19,1343
48085031816,3228,1834,339,263,3,622,0,28,1394
48085031901,2817,814,792,732,15,321,3,19,2003
48085031902,3724,1073,1634,599,8,281,2,20,2651
48085031903,1280,543,163,256,2,265,0,11,737
48085031904,3300,1289,431,628,6,767,1,14,2011
48085032003,6019,1471,3531,520,14,275,1,27,4548
48085032008,4377,2107,1114,360,20,559,1,16,2270
48085032010,5839,1763,1713,768,20,1324,5,26,4076
48085032012,3662,972,2039,346,6,176,0,24,2690
48085032013,6801,1531,2577,928,23,1542,0,21,5270
48085032014,5347,1178,3438,392,20,139,3,25,4169
48085032015,2380,1127,671,340,3,111,3,10,1253
48085032016,2716,783,158,183,4,1510,0,14,1933
48085032017,5026,2086,371,518,10,1832,1,13,2940
48085032018,3595,2032,397,354,8,659,0,5,1563
48085032019,2987,1253,186,202,7,1202,1,10,1734
48087950300,2652,1617,832,108,23,7,1,0,1035
48089750100,4585,1388,2266,843,4,9,0,11,3197
48089750200,1907,1204,472,153,0,4,0,3,703
48089750300,4773,3141,1125,377,5,13,0,5,1632
48089750400,4875,3795,708,223,4,16,0,14,1080
48089750500,4417,2233,1419,626,0,38,0,8,2184
48091310100,3034,1862,1060,17,3,14,0,7,1172
48091310200,2863,1547,1124,66,2,9,2,8,1316
48091310301,2916,2083,628,56,5,27,2,9,833
48091310302,4753,3658,847,47,17,24,5,14,1095
48091310401,5618,1499,3856,112,17,27,6,16,4119
48091310404,4180,2200,1691,101,13,19,1,23,1980
48091310405,3443,2061,1129,68,13,41,0,15,1382
48091310406,5334,2963,1763,227,17,123,7,15,2371
48091310501,4130,2124,1772,80,4,40,0,1,2006
48091310502,8264,4030,3443,239,30,196,10,25,4234
48091310503,5935,4017,1502,115,6,90,9,19,1918
48091310603,5451,4071,1002,42,24,45,2,40,1380
48091310604,3159,2512,467,15,10,14,2,26,647
48091310608,4741,3356,1056,37,35,26,6,34,1385
48091310609,4046,3123,623,62,20,29,4,24,923
48091310610,3254,2027,1023,18,14,16,2,14,1227
48091310611,3381,2655,479,18,11,22,3,19,726
48091310612,2230,1714,382,5,5,19,1,5,516
48091310613,3970,3080,618,52,4,21,0,8,890
48091310614,1599,1294,188,7,7,5,0,10,305
48091310702,6883,4842,1565,57,30,58,3,69,2041
48091310703,9528,6529,2243,178,51,96,6,36,2999
48091310705,3047,1941,949,22,5,12,0,14,1106
48091310706,4637,3240,1056,76,16,49,2,17,1397
48091310707,4260,3281,594,95,12,56,2,28,979
48091310708,3332,2580,565,22,8,22,3,10,752
48091310801,7233,4647,1499,559,23,153,5,45,2586
48091310803,5216,3533,1094,237,27,113,8,11,1683
48091310804,6762,2761,3254,391,18,85,2,22,4001
48091310901,9011,6772,1565,205,11,114,3,41,2239
48091310903,7241,5590,1167,74,13,108,5,33,1651
48091310904,8822,5049,2945,265,21,138,24,36,3773
48091310905,3228,2609,441,19,22,33,2,6,619
48093950101,1996,1219,687,15,6,0,1,4,777
48093950102,2485,2061,334,0,12,5,1,10,424
48093950200,3450,2688,612,6,9,9,0,2,762
48093950300,3948,2081,1711,15,18,23,1,4,1867
48093950400,1715,1148,523,3,4,1,0,4,567
48095950300,3303,2097,1033,69,9,19,1,16,1206
48097000100,6291,5183,627,87,74,18,1,13,1108
48097000200,5036,4552,230,15,50,20,0,12,484
48097000400,2092,1089,646,236,20,19,3,6,1003
48097000500,3438,1424,1557,249,23,37,1,8,2014
48097000600,4801,2669,1565,228,36,56,2,26,2132
48097000701,4746,4155,276,20,45,17,4,13,591
48097000702,2845,2166,460,25,27,6,1,18,679
48097000900,5313,3988,1003,33,26,37,0,21,1325
48097001100,7106,4178,2155,288,59,97,1,8,2928
48099010101,3856,3132,475,35,18,7,0,13,724
48099010102,4036,3280,474,37,38,27,1,8,756
48099010201,7311,3149,1960,2147,6,26,0,8,4162
48099010202,5725,4280,900,202,19,61,15,7,1445
48099010300,2577,1784,470,154,13,9,2,5,793
48099010400,4567,3528,670,87,27,25,2,5,1039
48099010501,4082,1671,1139,765,37,147,55,28,2411
48099010502,4400,1885,1017,928,24,155,65,31,2515
48099010503,4527,2466,1031,470,18,252,21,2,2061
48099010504,2724,1317,663,358,22,78,60,17,1407
48099010601,4528,1961,968,902,14,144,165,22,2567
48099010603,6598,3175,1390,1189,35,176,109,55,3423
48099010604,6971,3435,1337,1318,45,115,142,38,3536
48099010701,4890,2619,961,719,34,100,67,29,2271
48099010702,3233,1741,617,453,21,70,50,28,1492
48099010802,5893,3135,1116,832,22,201,113,24,2758
48099010803,2941,1566,498,442,12,100,55,27,1375
48099010804,4199,2070,787,721,9,123,117,42,2129
48099980000,35,19,9,1,0,0,2,0,16
48101950100,1380,902,327,96,2,0,1,0,478
48103950100,4675,1342,3158,70,14,22,0,1,3333
48105950100,3098,1080,1920,18,9,10,0,9,2018
48107950100,1926,892,947,51,1,3,0,5,1034
48107950200,1968,716,1168,25,7,9,0,1,1252
48107950300,1239,468,714,41,0,0,0,0,771
48109950300,2188,445,1645,20,11,28,0,3,1743
48111950100,1465,987,432,1,7,0,0,0,478
48111950300,5650,2132,3275,73,44,10,3,10,3518
48113000100,4473,3449,500,148,8,137,5,21,1024
48113000201,3173,2624,294,24,6,86,3,8,549
48113000202,3794,2907,498,61,4,140,0,22,887
48113000300,4592,3609,469,93,12,217,0,10,983
48113000401,4972,1186,2143,946,19,513,7,26,3786
48113000405,2231,544,724,739,8,109,0,16,1687
48113000407,2083,492,1093,163,10,278,0,7,1591
48113000408,2188,1184,498,224,12,164,2,10,1004
48113000409,3919,1411,678,552,9,1079,3,22,2508
48113000410,4854,246,4437,102,5,19,0,12,4608
48113000501,1950,1049,412,262,5,117,0,14,901
48113000502,2491,1977,219,76,4,133,0,16,514
48113000503,2752,1562,584,246,7,214,2,8,1190
48113000605,2404,1632,344,110,3,208,0,14,772
48113000606,3170,2619,243,75,14,114,3,5,551
48113000607,2144,1609,256,81,1,103,4,9,535
48113000608,2177,1390,347,155,12,158,0,21,787
48113000609,1878,1151,306,189,8,133,2,7,727
48113000610,1926,315,1259,255,3,46,0,1,1611
48113000611,2428,1013,815,345,6,167,0,16,1415
48113000703,3117,2256,358,130,10,213,5,12,861
48113000704,2971,2105,355,125,8,252,0,11,866
48113000705,1848,1388,238,64,6,79,1,7,460
48113000706,2252,1839,166,56,11,93,0,11,413
48113000801,3602,1069,1361,915,9,157,3,9,2533
48113000802,3294,1390,1168,373,9,239,3,8,1904
48113000901,2591,1924,348,101,11,119,0,10,667
48113000902,2812,1579,764,238,8,110,1,9,1233
48113001001,1910,1436,242,32,4,82,0,12,474
48113001002,2116,1321,607,25,5,71,4,6,795
48113001101,3812,2725,584,165,20,139,4,12,1087
48113001102,2405,1910,275,30,9,60,3,3,495
48113001202,3616,1797,1040,452,8,143,0,26,1819
48113001203,1370,582,712,11,5,12,2,4,788
48113001204,2284,153,2036,48,11,8,0,14,2131
48113001301,2715,1703,661,138,9,62,0,10,1012
48113001302,2608,1247,923,287,10,41,0,6,1361
48113001400,3377,1496,1164,459,13,82,0,19,1881
48113001502,2752,743,1494,366,15,48,0,1,2009
48113001503,1958,624,641,479,5,117,0,18,1334
48113001504,2494,1021,736,465,13,138,4,14,1473
48113001601,3249,895,491,1619,14,94,2,17,2354
48113001602,2446,1422,414,330,5,149,0,13,1024
48113001703,4555,3315,495,194,13,327,3,21,1240
48113001705,3113,2230,336,195,9,222,0,9,883
48113001801,2763,1883,419,144,2,198,1,16,880
48113001802,3390,2516,404,115,12,224,2,4,874
48113001901,4064,3104,335,197,14,252,0,14,960
48113001902,5978,3488,893,816,24,490,1,22,2490
48113002001,2726,781,1022,706,14,90,2,19,1945
48113002002,2473,195,1916,310,6,9,2,6,2278
48113002100,2720,1337,420,631,19,190,0,9,1383
48113002200,2860,1371,425,569,3,354,0,28,1489
48113002400,3477,309,2904,117,6,80,1,13,3168
48113002500,5701,189,4021,1357,7,28,1,16,5512
48113002703,5519,109,1669,3603,11,7,1,30,5410
48113003102,1286,725,204,214,5,73,3,1,561
48113003103,2508,1234,425,577,11,107,2,4,1274
48113003700,3607,79,939,2480,9,0,0,15,3528
48113004201,4501,1999,1958,283,8,101,0,20,2502
48113004202,2317,1020,1049,121,4,54,1,2,1297
48113004300,5459,1517,2291,1205,15,246,4,12,3942
48113004400,3272,2119,720,233,20,69,0,8,1153
48113004500,5409,946,4130,189,22,20,3,12,4463
48113004600,1877,947,620,206,6,24,0,8,930
48113004700,2551,324,2042,107,6,25,4,7,2227
48113004800,2461,112,2178,128,7,11,0,11,2349
48113005000,3395,215,3028,121,6,5,1,2,3180
48113005100,2551,283,2149,73,1,7,0,5,2268
48113005200,4051,621,3223,98,20,17,0,12,3430
48113005300,6579,693,5674,91,22,21,2,17,5886
48113005400,5402,328,3533,1418,2,19,3,16,5074
48113005500,4134,125,2393,1531,4,20,0,7,4009
48113005600,7020,73,5667,1179,12,16,4,14,6947
48113005700,5522,102,3209,2131,8,6,0,4,5420
48113005901,5704,106,2752,2724,3,6,4,12,5598
48113005902,4146,116,1542,2428,3,0,0,16,4030
48113006001,3790,123,2899,712,12,7,0,9,3667
48113006002,5669,514,1155,3361,9,217,0,167,5155
48113006100,4465,496,1734,2052,4,36,2,43,3969
48113006200,6217,603,3600,1854,7,35,0,6,5614
48113006301,5695,345,4931,350,19,15,0,13,5350
48113006302,4142,730,3216,107,17,18,0,10,3412
48113006401,2352,124,2196,16,8,0,0,2,2228
48113006402,4929,191,4670,32,8,4,3,10,4738
48113006501,5400,199,5091,70,11,12,0,10,5201
48113006502,3585,150,3338,47,19,7,0,6,3435
48113006701,4196,102,3985,62,5,10,0,16,4094
48113006702,2605,274,2212,74,8,14,0,5,2331
48113006800,5012,671,3593,596,25,44,0,13,4341
48113006900,3562,325,2720,428,12,21,2,5,3237
48113007101,2164,1792,149,31,5,124,0,7,372
48113007102,5441,1700,1929,1511,6,122,0,11,3741
48113007203,3144,126,2758,212,2,18,0,13,3018
48113007204,4485,147,4088,203,1,3,1,19,4338
48113007205,4421,91,4151,117,2,11,1,26,4330
48113007206,2325,77,2092,114,6,11,0,9,2248
48113007301,2108,1906,99,4,3,32,0,3,202
48113007302,3949,3009,451,132,5,166,0,13,940
48113007601,1894,1392,215,41,9,162,0,11,502
48113007604,3078,2451,237,40,12,221,0,17,627
48113007605,1501,1237,87,14,5,90,2,3,264
48113007701,2498,2132,164,31,3,109,0,5,366
48113007702,3546,3033,205,32,4,153,1,11,513
48113007801,2430,2063,195,44,4,73,0,1,367
48113007805,3225,1592,788,628,11,100,1,8,1633
48113007809,2847,1482,665,511,5,52,0,8,1365
48113007810,5286,2523,855,1318,22,357,1,13,2763
48113007812,3212,2696,236,63,0,82,0,1,516
48113007815,5080,572,1516,1086,10,1734,0,10,4508
48113007819,2275,540,1001,591,3,77,3,2,1735
48113007821,4095,401,2406,844,2,370,0,11,3694
48113007822,2110,1072,373,360,5,183,3,13,1038
48113007823,2976,1187,848,609,8,237,4,11,1789
48113007824,1969,1683,150,32,2,53,1,0,286
48113007825,4935,2292,1105,1202,7,180,0,13,2643
48113007826,1698,741,468,350,0,73,1,6,957
48113007827,2784,644,764,1172,10,56,2,13,2140
48113007828,4047,634,569,2457,8,198,4,24,3413
48113007829,2602,207,792,1475,0,47,0,6,2395
48113007830,2153,292,968,668,10,142,1,5,1861
48113007831,2946,236,1487,933,3,217,7,8,2710
48113007832,2677,155,1345,552,14,562,0,5,2522
48113007833,2539,264,1340,781,3,77,1,5,2275
48113007834,2916,273,602,1903,17,20,1,14,2643
48113007835,2881,675,679,1371,0,42,2,16,2206
48113007902,5433,4017,800,192,25,142,0,23,1416
48113007903,2175,1601,235,96,11,79,1,61,574
48113007906,2597,2300,128,22,5,75,2,8,297
48113007909,2179,1034,367,256,9,423,0,7,1145
48113007910,2953,1450,546,353,7,438,2,12,1503
48113007912,2112,1153,398,222,4,199,0,29,959
48113007913,3286,2149,479,295,2,234,1,13,1137
48113007914,3499,2136,510,290,7,383,4,19,1363
48113007915,2048,1147,359,224,1,241,2,6,901
48113007916,1244,840,171,80,1,99,1,2,404
48113008000,7652,6396,565,48,21,242,0,45,1256
48113008101,1841,1133,394,147,11,65,4,14,708
48113008102,4647,3738,518,77,7,93,2,19,909
48113008200,4156,2248,1213,447,17,58,1,14,1908
48113008401,5219,470,4434,216,6,2,2,39,4749
48113008402,4322,318,3789,172,2,15,0,10,4004
48113008500,4815,497,3680,557,12,13,6,5,4318
48113008604,3247,101,936,2123,16,7,0,13,3146
48113008701,5132,127,1078,3794,4,15,0,8,5005
48113008703,3479,55,1928,1416,2,16,0,15,3424
48113008704,3929,79,1015,2730,14,0,0,14,3850
48113008705,1715,39,724,933,1,0,0,3,1676
48113008801,2717,44,1024,1605,6,8,0,1,2673
48113008802,5736,77,2572,2969,21,1,0,24,5659
48113009001,4711,212,3455,972,18,18,4,11,4499
48113009002,4108,268,2807,955,7,13,0,19,3840
48113009101,5736,372,4183,1072,15,12,0,24,5364
48113009103,3641,102,2771,725,5,11,0,2,3539
48113009104,3529,166,2939,402,12,0,0,7,3363
48113009105,4038,174,3541,261,3,8,0,11,3864
48113009202,6115,372,5243,427,9,9,0,9,5743
48113009203,3609,259,2990,324,6,0,0,7,3350
48113009204,3038,210,2109,662,0,6,0,13,2828
48113009301,4786,215,4328,190,4,7,0,8,4571
48113009303,4054,119,3389,494,9,16,0,1,3935
48113009304,6749,137,2687,3805,9,7,2,12,6612
48113009401,3487,1317,1914,74,8,71,0,20,2170
48113009402,2660,2098,326,40,2,99,0,8,562
48113009500,2375,1864,259,26,3,117,0,3,511
48113009603,4454,3239,580,202,2,274,2,14,1215
48113009604,4809,2354,1700,458,3,180,0,23,2455
48113009605,3471,633,2392,243,4,136,0,13,2838
48113009607,3559,2059,1154,126,4,83,3,9,1500
48113009608,3218,2021,787,123,13,125,1,12,1197
48113009609,3184,2520,311,59,3,115,0,7,664
48113009610,4623,272,4140,126,19,39,0,4,4351
48113009611,3497,738,2297,215,3,152,0,9,2759
48113009701,4675,1049,3351,139,4,70,0,8,3626
48113009702,3245,2251,693,96,8,62,0,7,994
48113009802,5582,295,5112,99,13,9,1,18,5287
48113009803,2051,337,1519,117,8,28,0,14,1714
48113009804,7233,157,6869,133,8,36,4,14,7076
48113009900,6273,1298,2287,1146,10,1371,1,29,4975
48113010001,2600,287,955,1208,4,60,1,5,2313
48113010002,4174,1260,928,1966,0,16,0,3,2914
48113010003,3254,1637,571,688,6,194,0,13,1617
48113010101,5069,139,3178,1637,15,30,0,13,4930
48113010102,2679,71,2467,117,1,5,0,6,2608
48113010500,3201,96,2180,825,2,28,0,38,3105
48113010601,5540,106,5242,143,20,0,0,7,5434
48113010602,3135,109,2362,598,3,28,0,7,3026
48113010701,5543,349,4463,618,11,19,0,26,5194
48113010704,5242,215,3441,1427,12,94,0,2,5027
48113010804,4655,212,2858,1438,6,10,0,8,4443
48113010805,5578,260,3769,1423,14,47,0,20,5318
48113010806,3512,754,1639,1006,1,12,0,10,2758
48113010807,4074,315,2193,1424,8,55,0,7,3759
48113010808,3616,145,2829,554,4,29,17,6,3471
48113010809,5630,299,4324,728,21,186,1,12,5331
48113010903,3368,150,1185,1942,5,14,13,6,3218
48113010904,3714,92,828,2686,2,27,3,11,3622
48113010905,2501,72,219,2145,1,4,0,9,2429
48113010906,4528,130,1225,3037,4,9,0,12,4398
48113011002,3099,190,824,2018,2,5,2,6,2909
48113011003,4221,196,840,3078,5,6,2,17,4025
48113011004,2473,108,479,1810,2,1,1,9,2365
48113011101,4458,202,833,3300,6,27,0,2,4256
48113011103,3948,178,2288,1421,7,7,0,4,3770
48113011104,3844,73,1511,2192,2,7,0,4,3771
48113011105,4726,73,2159,2417,3,9,1,15,4653
48113011201,3990,117,1004,2726,14,27,0,28,3873
48113011202,2890,43,866,1929,1,10,0,10,2847
48113011300,5417,90,1003,4198,8,4,0,17,5327
48113011401,5935,90,1154,4517,4,11,0,39,5845
48113011500,4588,44,2735,1714,17,13,0,9,4544
48113011601,4492,178,2281,1953,4,10,1,6,4314
48113011603,3709,253,3190,191,0,51,1,1,3456
48113011604,3939,373,2910,560,28,15,3,14,3566
48113011701,6420,306,4873,1144,12,7,0,23,6114
48113011702,5704,549,4547,492,5,37,1,9,5155
48113011801,5632,343,3465,1688,15,8,8,19,5289
48113011802,4336,215,3579,495,3,5,0,4,4121
48113011901,4771,221,3316,1150,14,15,0,15,4550
48113011902,5165,289,3866,946,11,12,0,5,4876
48113012000,11383,511,6439,4221,23,18,0,40,10872
48113012101,3607,121,1436,1992,0,14,0,2,3486
48113012102,3274,159,2049,976,3,41,2,4,3115
48113012206,4830,984,1889,1759,15,54,0,12,3846
48113012207,7254,441,3616,2937,6,141,3,18,6813
48113012208,2530,93,1450,949,3,5,2,3,2437
48113012209,2704,1384,701,426,14,70,2,9,1320
48113012210,3930,689,1473,1608,14,32,1,10,3241
48113012211,4513,491,2328,1498,14,80,0,21,4022
48113012212,3462,909,1739,652,18,36,1,7,2553
48113012213,2404,1275,639,351,7,48,2,5,1129
48113012301,4748,728,3389,483,19,39,0,18,4020
48113012302,8092,738,3947,3025,15,189,0,23,7354
48113012400,5156,2590,2152,160,6,51,1,22,2566
48113012501,3674,808,2638,136,13,23,0,11,2866
48113012502,4111,767,3056,146,13,37,3,10,3344
48113012601,5783,652,3649,817,22,528,2,19,5131
48113012603,2020,591,1256,90,5,25,0,22,1429
48113012604,5626,1069,2151,2053,14,149,6,22,4557
48113012701,6462,1058,4776,297,22,207,6,12,5404
48113012702,3049,640,2153,159,8,17,0,13,2409
48113012801,2730,1492,993,70,3,67,1,11,1238
48113012802,5009,2377,2165,245,16,43,0,20,2632
48113012900,4828,3403,801,294,18,90,5,20,1425
48113013005,4295,3513,410,95,8,84,7,25,782
48113013007,3510,1496,894,320,0,679,2,18,2014
48113013008,3738,2351,752,321,9,194,0,2,1387
48113013009,4825,2311,908,1355,15,91,0,13,2514
48113013010,4691,874,2060,1492,18,113,2,21,3817
48113013011,4274,362,2265,1348,9,171,3,15,3912
48113013012,2602,1998,291,184,2,44,0,0,604
48113013013,4410,3766,287,98,10,61,0,14,644
48113013101,2757,2240,229,52,2,108,1,15,517
48113013102,1928,1560,163,42,5,77,1,5,368
48113013104,1641,1169,189,124,3,103,0,0,472
48113013106,1340,766,297,164,1,65,0,1,574
48113013107,4475,1600,1172,1243,13,246,4,23,2875
48113013201,2754,2160,246,82,2,153,0,10,594
48113013202,5342,2694,864,1111,12,462,3,19,2648
48113013300,2064,1661,138,28,11,148,0,0,403
48113013400,2068,1657,136,22,6,168,0,9,411
48113013500,2562,2136,154,41,2,133,0,4,426
48113013605,5709,4376,656,182,13,203,1,20,1333
48113013606,5434,2937,1423,613,8,211,0,29,2497
48113013607,3538,2492,596,174,19,119,2,15,1046
48113013608,2570,2080,169,50,3,151,0,15,490
48113013609,3993,1662,1536,537,12,124,0,27,2331
48113013610,4797,2095,2060,304,9,176,1,22,2702
48113013611,2887,2211,197,202,5,149,2,17,676
48113013615,5351,914,2955,1167,9,149,8,44,4437
48113013617,2953,2042,363,199,7,211,0,17,911
48113013618,3271,2006,489,225,1,396,0,17,1265
48113013619,5414,3988,691,184,8,304,0,18,1426
48113013620,6205,3287,981,1072,5,551,10,30,2918
48113013621,4423,1615,1392,1002,14,217,2,34,2808
48113013622,2672,1325,528,515,4,198,3,8,1347
48113013624,4106,1118,1049,1282,12,458,5,24,2988
48113013625,2860,556,1041,925,3,212,3,36,2304
48113013626,3003,715,1261,643,5,269,0,9,2288
48113013627,1585,642,333,369,7,122,2,15,943
48113013628,6306,3135,1410,825,27,592,7,27,3171
48113013629,2217,473,1019,545,6,111,0,10,1744
48113013630,2154,701,607,580,1,185,1,12,1453
48113013631,2097,211,1283,498,3,43,1,4,1886
48113013715,2338,363,1718,89,10,111,0,18,1975
48113013716,5078,1658,2232,353,17,662,1,25,3420
48113013717,2671,433,1950,96,2,134,0,9,2238
48113013718,4579,372,3696,229,7,221,0,8,4207
48113013719,4257,1283,837,379,18,1552,5,22,2974
48113013720,5613,1540,2903,456,20,511,0,19,4073
48113013721,5988,3205,1234,485,12,806,3,19,2783
48113013722,4640,1626,1314,1041,18,393,0,35,3014
48113013725,3748,1193,1599,627,11,144,0,25,2555
48113013726,2854,1369,956,242,6,185,0,10,1485
48113013727,3790,1799,653,902,10,273,0,18,1991
48113013728,5064,825,3834,194,10,98,0,11,4239
48113013729,7353,1193,5511,298,25,226,0,23,6160
48113013804,3404,1444,1477,167,11,189,0,8,1960
48113013805,4101,1397,1407,737,12,338,1,44,2704
48113013806,3628,1418,674,806,12,537,2,26,2210
48113013807,2778,1371,1174,42,8,98,0,11,1407
48113013808,2856,1942,541,147,16,83,0,16,914
48113013901,3283,469,2681,41,10,35,0,8,2814
48113013902,4278,1587,2440,69,10,61,2,13,2691
48113014001,4274,1989,1587,190,13,304,1,55,2285
48113014002,1985,754,375,332,7,426,1,13,1231
48113014119,4655,2809,683,166,8,743,0,17,1846
48113014120,5177,3184,616,151,13,993,0,14,1993
48113014121,5466,2059,1015,924,12,1195,7,26,3407
48113014123,6234,3299,616,171,19,1836,6,38,2935
48113014124,4971,1825,573,324,13,2014,0,30,3146
48113014126,6994,3449,1329,188,19,1708,3,20,3545
48113014128,4257,948,345,253,11,2539,0,30,3309
48113014130,5185,1283,489,609,10,2617,3,31,3902
48113014132,2628,652,237,699,3,915,0,25,1976
48113014134,4156,1744,564,169,8,1499,2,19,2412
48113014135,4809,2093,642,338,16,1482,0,28,2716
48113014138,4621,1076,397,406,19,2594,0,20,3545
48113014139,2949,419,760,1028,14,635,1,19,2530
48113014140,2329,322,433,620,3,875,2,9,2007
48113014141,2144,613,268,319,1,875,1,3,1531
48113014142,2320,570,357,649,6,651,0,7,1750
48113014143,4682,1047,454,463,13,2547,7,25,3635
48113014144,5471,1415,767,763,10,2365,2,15,4056
48113014145,1424,203,279,629,0,259,0,22,1221
48113014146,2257,219,469,523,1,993,0,11,2038
48113014147,2105,252,607,848,7,291,0,36,1853
48113014148,3367,458,678,885,6,1183,3,41,2909
48113014149,3647,525,341,449,12,2207,5,21,3122
48113014150,1676,132,79,88,7,1352,0,3,1544
48113014151,4424,399,292,312,17,3338,1,15,4025
48113014152,3369,558,465,468,18,1775,6,14,2811
48113014153,3982,867,2072,505,16,403,8,15,3115
48113014154,3525,686,1429,750,2,555,6,5,2839
48113014155,5437,871,479,625,18,3269,3,27,4566
48113014156,4158,517,190,136,6,3196,0,21,3641
48113014157,1914,612,253,341,5,638,7,12,1302
48113014158,3090,298,959,1233,6,475,21,22,2792
48113014159,3014,117,57,71,12,2724,0,9,2897
48113014160,2760,576,378,557,8,1112,4,18,2184
48113014161,3122,437,678,1522,2,360,20,25,2685
48113014203,3441,1309,1719,119,11,144,2,24,2132
48113014204,2905,654,1302,350,23,497,0,16,2251
48113014205,1925,1154,222,91,7,381,2,7,771
48113014207,2656,1060,460,494,2,510,6,14,1596
48113014208,2706,1207,482,455,7,411,0,25,1499
48113014209,4047,1608,750,788,9,697,3,27,2439
48113014306,5978,1171,4159,284,7,224,19,17,4807
48113014308,4275,639,2678,562,12,271,2,20,3636
48113014309,5000,385,2602,1239,6,624,19,33,4615
48113014310,4965,1195,1520,1489,23,542,11,25,3770
48113014313,3582,1054,497,597,25,1292,0,13,2528
48113014314,3103,1295,586,490,16,593,5,15,1808
48113014315,3166,746,2149,120,6,78,0,7,2420
48113014316,3918,1191,2346,142,17,108,4,9,2727
48113014317,1647,571,396,336,1,245,0,8,1076
48113014318,2817,1354,967,190,3,186,5,21,1463
48113014319,2664,248,321,468,5,1548,0,2,2416
48113014320,2747,257,261,352,15,1799,0,19,2490
48113014405,4038,712,2965,187,10,88,0,10,3326
48113014406,4686,1026,3261,178,21,80,0,27,3660
48113014407,5461,623,3444,979,29,277,0,15,4838
48113014408,4373,996,2096,705,11,406,5,24,3377
48113014409,2396,282,1055,840,6,118,7,23,2114
48113014410,2719,453,852,786,5,511,0,25,2266
48113014501,3471,1131,1942,156,13,71,10,47,2340
48113014502,4511,1128,2972,227,15,66,0,9,3383
48113014601,2483,649,1528,146,3,78,0,12,1834
48113014602,4883,500,3872,221,18,209,14,21,4383
48113014603,1890,194,1507,94,12,47,10,8,1696
48113014701,4669,454,3824,222,4,109,2,18,4215
48113014704,5742,1031,4304,164,13,130,1,19,4711
48113014903,3998,568,3101,129,11,121,0,16,3430
48113015001,5186,643,4193,151,9,119,1,9,4543
48113015002,3054,618,2033,101,9,248,4,0,2436
48113015101,4319,1043,2710,224,4,235,1,5,3276
48113015102,2417,327,1829,123,4,95,0,12,2090
48113015202,3525,571,2677,160,5,43,0,8,2954
48113015205,3983,533,3217,141,11,31,3,15,3450
48113015206,4205,1014,2752,190,14,119,9,12,3191
48113015207,4022,1319,1936,226,26,398,9,10,2703
48113015208,3747,903,2594,89,13,79,0,7,2844
48113015303,1973,285,1550,76,5,11,1,8,1688
48113015304,3986,701,2909,118,12,164,7,5,3285
48113015305,4460,979,2760,417,7,184,1,23,3481
48113015306,5559,1392,2338,466,19,1139,2,27,4167
48113015403,3551,688,2023,655,10,56,2,10,2863
48113015404,4446,491,2637,1169,17,38,5,15,3955
48113015405,2322,822,799,498,12,83,3,11,1500
48113015406,3505,1523,1140,594,18,87,3,14,1982
48113015500,3604,801,2366,299,16,36,0,11,2803
48113015600,5087,568,4378,84,7,7,0,13,4519
48113015700,2499,279,2125,29,11,22,1,0,2220
48113015900,3509,610,2230,526,1,59,0,10,2899
48113016001,4624,650,3655,188,33,24,0,15,3974
48113016002,2945,479,2094,299,3,15,0,9,2466
48113016100,3867,792,1835,1089,4,53,1,7,3075
48113016201,4564,784,3186,399,7,90,0,12,3780
48113016203,2189,207,1414,505,2,35,3,6,1982
48113016204,4156,843,2991,152,12,72,5,7,3313
48113016301,6801,714,4879,629,8,427,8,27,6087
48113016302,2123,242,1620,125,7,95,5,3,1881
48113016406,4919,628,3184,787,14,139,11,21,4291
48113016407,6796,1094,4433,890,52,154,6,21,5702
48113016409,3848,1227,1284,860,13,287,17,17,2621
48113016410,4264,1165,1515,900,24,490,1,8,3099
48113016412,4487,1239,1284,1108,8,627,3,19,3248
48113016414,2163,388,572,840,6,270,0,6,1775
48113016415,4858,1142,1650,1275,11,620,4,13,3716
48113016416,3116,531,896,1159,8,401,1,25,2585
48113016417,6213,1529,2636,1255,20,589,5,10,4684
48113016418,4724,772,1835,1487,11,482,14,29,3952
48113016419,5520,921,2796,1060,29,536,1,36,4599
48113016420,3168,608,1859,399,13,181,0,50,2560
48113016421,3824,999,2055,558,27,76,7,14,2825
48113016511,4335,429,1379,2313,8,57,1,18,3906
48113016513,5275,1667,1365,1903,10,134,1,32,3608
48113016516,5637,976,3051,1406,9,61,7,3,4661
48113016517,4602,832,2132,1490,19,40,0,12,3770
48113016518,5350,1100,2515,1545,20,46,3,7,4250
48113016519,2486,817,1161,391,5,28,0,7,1669
48113016521,7794,2109,2087,2995,17,243,10,72,5685
48113016522,3700,1376,833,1252,16,71,0,17,2324
48113016524,3078,1479,608,690,27,137,3,14,1599
48113016525,2452,669,465,1032,1,197,0,7,1783
48113016526,3710,385,1645,1523,7,42,0,20,3325
48113016527,4326,485,1855,1620,16,206,0,11,3841
48113016528,4893,694,1569,2195,6,253,0,37,4199
48113016529,3374,469,1058,1628,3,101,6,10,2905
48113016530,4276,823,1151,2032,13,112,1,20,3453
48113016531,3425,735,1256,1289,6,46,2,14,2690
48113016532,2493,782,1113,457,17,33,3,4,1711
48113016533,3862,442,2539,573,11,255,0,11,3420
48113016534,3588,181,1880,1363,10,92,1,9,3407
48113016535,3757,961,1502,1066,16,88,1,15,2796
48113016536,3193,440,2401,268,8,20,0,23,2753
48113016607,3643,113,425,3001,3,19,0,17,3530
48113016610,4790,338,577,3702,4,36,0,20,4452
48113016615,4218,413,1092,2545,7,53,3,5,3805
48113016616,6403,882,1843,3409,24,43,0,32,5521
48113016617,4514,813,529,2935,18,80,0,19,3701
48113016618,5290,693,953,3404,16,65,4,17,4597
48113016619,3731,368,718,2513,7,6,1,6,3363
48113016620,5688,811,995,3666,12,44,5,13,4877
48113016621,7560,577,2425,4279,16,38,1,50,6983
48113016622,3907,441,885,2456,15,15,0,13,3466
48113016623,8279,984,1925,5003,20,73,2,36,7295
48113016624,3436,382,713,2209,3,45,0,13,3054
48113016626,5019,640,1423,2715,31,68,1,21,4379
48113016627,1657,206,410,987,1,20,0,5,1451
48113016628,5131,429,776,3780,11,24,2,26,4702
48113016629,3158,457,805,1763,15,37,2,17,2701
48113016630,6288,490,1026,4454,4,95,5,25,5798
48113016631,5087,383,566,3887,10,52,1,22,4704
48113016632,3244,394,684,2059,1,16,0,14,2850
48113016633,6305,300,833,4943,17,60,0,25,6005
48113016634,3537,257,2490,709,12,13,1,6,3280
48113016635,4022,134,241,3523,5,13,2,13,3888
48113016636,2927,526,1121,1175,2,37,0,9,2401
48113016637,3186,184,1042,1819,2,69,0,0,3002
48113016638,1983,349,297,1256,0,31,0,8,1634
48113016704,4485,268,1185,2903,14,15,2,3,4217
48113016706,2513,179,643,1626,5,3,0,17,2334
48113016707,4521,180,694,3491,9,32,0,41,4341
48113016708,6654,162,940,5394,13,30,2,25,6492
48113016709,4532,331,2110,1961,10,9,2,20,4201
48113016710,4667,126,1117,3316,8,25,0,4,4541
48113016711,2421,64,528,1760,5,18,0,6,2357
48113016802,5465,787,1529,2933,12,29,0,34,4678
48113016803,6580,1040,2053,3257,17,17,2,24,5540
48113016805,2928,95,263,2500,1,7,2,4,2833
48113016806,5636,219,769,4486,0,12,0,19,5417
48113016902,7363,1507,2924,2802,13,21,1,7,5856
48113016903,6851,1179,3651,1812,30,17,7,13,5672
48113017005,4958,862,2956,984,16,15,0,22,4096
48113017006,5698,2756,1979,715,61,38,2,15,2942
48113017007,4983,1245,3054,537,14,3,5,1,3738
48113017008,8361,2006,4142,1898,24,57,9,19,6355
48113017009,5842,779,4702,237,18,9,2,11,5063
48113017010,6573,1087,4128,1160,9,24,7,17,5486
48113017101,5987,1024,4010,827,25,21,2,9,4963
48113017102,6070,811,4270,853,11,7,2,14,5259
48113017201,6268,914,4127,1111,15,18,0,5,5354
48113017203,4808,874,2201,1556,6,58,0,11,3934
48113017204,4532,659,2546,1198,9,36,0,7,3873
48113017307,4383,1152,1321,1406,15,357,3,5,3231
48113017308,4243,1116,1495,1362,22,146,2,6,3127
48113017309,3381,629,1020,1489,6,111,3,15,2752
48113017310,3603,902,1192,1217,7,145,2,13,2701
48113017311,3863,1259,1612,742,21,89,2,12,2604
48113017312,4073,1387,1650,791,16,107,0,13,2686
48113017313,3535,519,825,1887,3,180,0,12,3016
48113017314,8020,1519,3414,2651,24,207,0,30,6501
48113017315,7379,1156,4147,1805,24,91,7,16,6223
48113017400,5680,1994,2536,876,21,69,4,7,3686
48113017500,3823,1573,1337,714,15,67,0,10,2250
48113017602,4361,866,2633,725,6,44,0,7,3495
48113017604,3425,597,2252,488,4,6,0,13,2828
48113017605,3941,149,2495,1184,6,42,1,15,3792
48113017606,5211,754,3187,1077,24,71,3,6,4457
48113017703,4996,1072,2627,1083,16,50,5,11,3924
48113017704,6376,1380,3609,1067,13,80,5,10,4996
48113017705,3097,589,897,1388,11,82,0,16,2508
48113017706,5224,1535,1778,1330,6,424,2,17,3689
48113017805,6565,1486,2775,1975,23,98,3,7,5079
48113017806,5228,946,3424,712,8,48,4,10,4282
48113017808,5146,1908,1722,993,9,345,1,21,3238
48113017811,4688,1911,1583,846,13,193,0,16,2777
48113017812,2438,913,940,345,8,153,4,2,1525
48113017814,5527,1934,1730,873,27,758,2,31,3593
48113017815,3285,956,1223,989,9,21,4,13,2329
48113017816,4289,868,2539,750,9,15,0,17,3421
48113017817,3222,569,975,1456,21,100,1,12,2653
48113017818,3661,975,1296,1068,13,204,4,18,2686
48113017819,2551,497,811,1105,12,30,1,11,2054
48113017820,3215,755,1969,364,11,43,1,11,2460
48113017900,5412,996,3802,474,12,35,0,16,4416
48113018001,7529,1709,4274,1239,19,101,1,28,5820
48113018002,3745,735,2471,400,10,65,4,16,3010
48113018105,5880,1015,4037,560,13,99,1,18,4865
48113018110,5423,3187,1147,539,19,325,7,25,2236
48113018111,6879,1595,3376,1450,22,208,0,31,5284
48113018120,5142,1415,1436,912,15,1185,0,36,3727
48113018121,5764,1386,2658,967,20,578,7,13,4378
48113018126,6894,2045,3292,1081,29,214,2,27,4849
48113018127,3264,703,2095,280,8,110,2,7,2561
48113018128,5913,1252,2687,1475,24,289,2,21,4661
48113018129,4504,1869,1411,891,11,177,0,22,2635
48113018130,4532,972,1371,1872,20,141,3,15,3560
48113018132,5343,1910,1786,1036,17,400,0,11,3433
48113018133,3916,2020,1109,414,36,147,0,21,1896
48113018134,5570,2670,1298,1079,16,226,4,21,2900
48113018135,5182,2407,1333,911,28,261,3,9,2775
48113018137,4145,1237,960,1124,10,637,2,35,2908
48113018138,4985,1083,1221,1932,14,550,0,25,3902
48113018140,5572,2398,1120,1316,19,477,2,10,3174
48113018141,4245,1471,1056,1389,29,88,4,9,2774
48113018142,3916,1276,1237,741,9,487,5,22,2640
48113018143,6836,3270,1346,1295,20,533,8,27,3566
48113018144,4458,2136,918,918,13,295,0,20,2322
48113018145,4089,2332,759,453,23,325,0,11,1757
48113018146,3564,2251,511,415,14,232,1,12,1313
48113018147,3737,1087,728,799,9,988,2,19,2650
48113018148,5372,939,1922,1289,13,997,1,33,4433
48113018149,3970,1612,799,928,11,462,0,19,2358
48113018150,4248,1761,1129,800,11,326,0,22,2487
48113018151,3960,1337,682,811,6,923,0,16,2623
48113018152,6203,2259,1847,938,24,893,1,22,3944
48113018153,6044,2517,1076,764,14,1406,1,27,3527
48113018154,5595,3118,1061,553,42,505,18,19,2477
48113018155,5526,2482,1293,491,19,936,7,26,3044
48113018156,4744,1886,1121,820,19,666,5,19,2858
48113018157,3583,1381,664,679,13,729,0,13,2202
48113018158,4186,1605,1148,945,20,327,2,10,2581
48113018159,5199,2704,524,392,14,1352,7,37,2495
48113018203,6636,835,3618,1414,12,615,3,24,5801
48113018204,4504,163,3615,617,6,50,0,20,4341
48113018205,4355,528,2734,640,14,347,5,11,3827
48113018206,4700,579,3842,197,5,26,2,10,4121
48113018300,7632,1720,5347,297,26,65,1,20,5912
48113018401,5222,1091,3375,482,4,132,1,11,4131
48113018402,4417,1718,2132,343,21,79,1,8,2699
48113018403,1047,162,568,283,1,5,0,11,885
48113018501,3985,938,2551,277,14,92,0,4,3047
48113018505,3876,381,1067,2001,1,268,1,16,3495
48113018506,2771,218,508,1929,9,35,0,21,2553
48113018507,3934,291,807,2645,3,64,0,19,3643
48113018508,1429,169,292,785,1,128,1,9,1260
48113018600,3948,1554,1925,246,13,86,0,19,2394
48113018700,6720,1089,5141,292,9,61,1,19,5631
48113018801,4576,1175,2709,257,15,311,1,23,3401
48113018802,1566,544,627,298,4,24,0,16,1022
48113018900,6363,1306,3224,625,20,1018,2,16,5057
48113019013,5133,260,3709,811,1,289,2,12,4873
48113019016,2699,633,671,947,9,323,2,13,2066
48113019018,5157,1364,1148,1663,2,807,5,22,3793
48113019019,7113,1072,1670,3186,8,884,1,36,6041
48113019020,5611,1825,1126,806,3,1664,3,12,3786
48113019023,5028,2731,808,535,11,712,0,16,2297
48113019024,4164,1737,628,746,7,896,0,12,2427
48113019025,4912,2001,898,752,6,1064,3,8,2911
48113019026,5534,2428,1297,667,9,971,3,18,3106
48113019027,6375,1677,1305,1184,21,1918,0,43,4698
48113019028,3708,988,1195,541,7,845,0,9,2720
48113019029,6525,1787,1513,1281,7,1737,3,16,4738
48113019031,6345,3404,1180,627,11,786,0,22,2941
48113019032,4258,546,2741,234,7,657,2,3,3712
48113019033,4422,481,3071,300,8,489,0,12,3941
48113019034,4525,808,898,1809,10,828,0,22,3717
48113019035,5310,897,1539,2357,14,296,4,31,4413
48113019036,2847,2079,305,145,1,213,0,5,768
48113019037,3531,1941,612,275,22,501,1,22,1590
48113019039,6606,2843,2034,714,9,773,3,23,3763
48113019040,6968,1726,742,2272,24,1874,3,42,5242
48113019041,2363,1380,239,286,15,308,3,20,983
48113019042,8230,3316,1335,1583,18,1566,2,86,4914
48113019044,4066,919,1545,541,2,940,0,11,3147
48113019045,3153,590,1341,481,6,650,0,18,2563
48113019046,3691,511,2145,279,3,692,0,6,3180
48113019047,3543,607,1745,465,7,621,7,11,2936
48113019048,3299,989,1266,421,5,514,0,22,2310
48113019049,4092,1009,1826,536,12,594,0,19,3083
48113019050,2902,1705,286,158,9,632,0,9,1197
48113019051,5423,3388,653,374,28,732,0,20,2035
48113019052,1102,462,120,238,5,218,0,8,640
48113019053,1657,621,284,353,3,302,5,6,1036
48113019101,1438,490,199,394,0,273,2,10,948
48113019102,5008,2357,1110,513,13,753,4,32,2651
48113019202,4714,2345,1519,411,10,263,0,17,2369
48113019203,3957,2933,526,153,11,125,0,16,1024
48113019205,4588,3488,284,131,22,484,2,11,1100
48113019208,5932,820,4143,612,9,172,0,42,5112
48113019210,4338,3568,330,41,16,218,0,11,770
48113019211,5077,2903,1147,472,17,338,0,28,2174
48113019212,3044,77,2762,167,2,18,0,4,2967
48113019213,3232,557,1894,606,10,85,0,11,2675
48113019214,5284,810,3517,611,16,207,0,20,4474
48113019215,2880,1693,821,133,5,94,2,14,1187
48113019216,3992,2640,766,123,15,286,1,16,1352
48113019301,3098,2654,140,7,9,137,3,11,444
48113019302,6342,4352,502,262,16,837,0,57,1990
48113019400,4290,3340,308,35,6,402,0,26,950
48113019501,7096,6231,288,27,24,264,0,24,865
48113019502,4457,3757,186,19,13,297,1,18,700
48113019600,2369,1934,153,22,1,131,0,12,435
48113019700,1966,1686,97,7,0,115,0,2,280
48113019800,4529,3933,215,45,1,159,0,4,596
48113019900,3884,194,3577,55,5,10,1,22,3690
48113020000,5779,2305,749,148,7,2372,0,12,3474
48113020100,2428,509,1757,92,5,31,0,4,1919
48113020200,4416,103,1137,3002,13,81,0,10,4313
48113020300,2784,247,401,2028,5,16,0,6,2537
48113020401,2225,1276,327,353,20,109,1,37,949
48113020402,6079,2768,1110,1654,19,260,4,31,3311
48113020500,5259,270,1622,2906,8,293,3,28,4989
48113020600,2478,2006,210,10,4,154,2,2,472
48113020700,5178,2725,1491,436,10,276,5,11,2453
48113020800,6593,115,1686,4641,11,13,1,21,6478
48113020900,2751,208,628,1835,14,7,2,4,2543
48113021000,5547,165,2824,2462,0,17,0,5,5382
48113021100,4087,105,1921,1989,2,5,1,28,3982
48113021200,5716,596,4292,687,35,63,0,6,5120
48113980000,3,1,1,0,0,0,0,0,2
48113980100,40,0,39,0,0,0,0,0,40
48113980200,3858,2284,595,262,7,478,21,44,1574
48115950401,4008,1580,2237,97,6,25,0,0,2428
48115950402,3266,927,1704,600,7,3,0,6,2339
48115950500,3460,956,2258,148,8,27,0,11,2504
48115950600,1722,1127,568,2,2,1,4,0,595
48117950300,5849,1205,4530,44,13,20,0,15,4644
48117950400,5518,1108,4254,34,11,11,0,17,4410
48117950500,3700,429,3201,17,16,0,0,7,3271
48117950600,3516,1491,1940,12,7,13,0,1,2025
48119950100,3001,2524,218,48,35,14,1,18,477
48119950200,2229,1665,176,264,7,23,4,12,564
48121020109,8988,4222,983,855,23,2389,2,53,4766
48121020110,5733,3012,778,728,12,842,3,17,2721
48121020111,4402,3084,436,248,5,394,0,17,1318
48121020112,3049,1684,471,426,22,231,3,32,1365
48121020115,7156,3602,2677,385,30,130,5,26,3554
48121020116,5760,4184,840,340,44,79,5,16,1576
48121020117,2285,1746,359,24,13,9,0,8,539
48121020118,4568,2694,1383,136,37,18,7,9,1874
48121020119,4605,2005,1292,854,19,187,1,26,2600
48121020120,5925,2597,1575,1126,21,200,7,28,3328
48121020121,7156,4169,1199,1181,36,138,7,61,2987
48121020122,4277,2700,682,502,33,42,7,34,1577
48121020123,6134,3038,1251,1256,30,165,11,28,3096
48121020124,3061,1400,599,711,14,100,0,13,1661
48121020125,7979,4348,1263,1427,19,333,8,63,3631
48121020126,3779,1574,1195,643,24,151,0,11,2205
48121020127,7500,2524,2755,985,18,862,3,25,4976
48121020128,11727,6278,1545,1538,59,1557,13,59,5449
48121020129,4232,2480,1053,391,28,83,4,15,1752
48121020130,2265,1282,471,283,5,64,0,16,983
48121020131,8184,4512,1609,1333,12,137,12,52,3672
48121020132,5171,1942,669,843,19,1405,0,25,3229
48121020133,7591,3644,1233,1277,34,951,4,44,3947
48121020134,5500,1766,627,1108,22,1698,11,21,3734
48121020135,6385,2407,1070,2191,21,325,0,48,3978
48121020136,3648,1614,598,1001,11,206,2,17,2034
48121020137,3935,1530,715,1219,19,184,6,33,2405
48121020203,5936,4053,1228,213,42,41,4,52,1883
48121020204,5554,4279,801,114,20,70,0,8,1275
48121020205,1784,1363,276,21,7,10,2,9,421
48121020206,3311,2338,738,51,17,12,3,14,973
48121020207,3685,2789,636,59,20,2,4,5,896
48121020208,3397,2300,850,34,18,6,0,7,1097
48121020305,7960,6584,641,143,47,176,6,29,1376
48121020310,4808,4386,200,47,13,42,0,11,422
48121020311,3628,2195,765,164,20,331,4,13,1433
48121020312,7610,4992,975,532,29,661,9,27,2618
48121020313,5963,4560,991,83,44,30,2,15,1403
48121020314,11860,8809,1679,381,49,297,10,47,3051
48121020315,3424,2521,624,41,30,90,0,13,903
48121020316,3770,3270,281,16,8,41,1,7,500
48121020317,5098,3409,808,218,37,388,4,13,1689
48121020318,5862,4487,730,218,22,104,0,30,1375
48121020319,6920,4447,1529,383,50,88,15,19,2473
48121020320,11167,6992,2050,1065,64,338,7,42,4175
48121020321,6438,4665,575,212,17,632,2,8,1773
48121020322,7662,5321,1161,275,30,422,5,30,2341
48121020402,5379,3694,933,327,32,128,5,35,1685
48121020403,4142,2840,747,183,27,127,2,13,1302
48121020404,4822,2566,1155,613,26,154,7,34,2256
48121020405,4681,3030,1182,137,48,57,3,18,1651
48121020504,3959,1487,1905,374,16,29,2,4,2472
48121020505,7637,5415,1216,350,34,121,1,18,2222
48121020506,1964,1150,691,18,7,10,5,8,814
48121020507,3479,2134,870,238,35,51,7,2,1345
48121020508,2408,1319,579,282,9,60,3,9,1089
48121020601,5306,2399,1488,899,18,255,5,19,2907
48121020603,3469,945,2186,208,9,23,0,9,2524
48121020604,4055,2018,1292,463,11,94,0,13,2037
48121020605,2680,1255,871,310,7,49,1,21,1425
48121020700,3543,2049,642,305,12,362,2,14,1494
48121020800,6022,2678,1953,805,28,264,3,21,3344
48121020900,3717,1367,1120,563,21,483,14,11,2350
48121021000,5633,2521,1340,934,61,578,36,22,3112
48121021100,3468,1935,724,303,16,307,3,11,1533
48121021202,4060,1578,1318,991,11,38,4,6,2482
48121021203,3798,1366,946,1140,26,65,3,10,2432
48121021204,3626,1461,804,1026,12,113,8,6,2165
48121021301,3966,1683,891,955,6,211,1,17,2283
48121021304,6440,3977,1128,621,23,377,4,20,2463
48121021305,3801,2648,509,272,14,164,3,3,1153
48121021306,3116,1981,571,235,11,176,9,10,1135
48121021307,4922,3072,1125,303,18,170,7,9,1850
48121021410,4580,3254,630,221,21,239,2,17,1326
48121021411,7284,4119,2208,367,62,138,5,20,3165
48121021412,6183,4482,773,287,25,215,4,38,1701
48121021413,2841,1873,507,205,12,75,3,8,968
48121021414,4853,1756,2750,154,26,29,0,15,3097
48121021415,9881,4846,2493,1200,42,762,13,50,5035
48121021416,4491,1970,1619,449,16,212,2,14,2521
48121021417,2615,1876,296,115,11,132,1,7,739
48121021418,4187,3058,549,199,21,170,1,8,1129
48121021419,4699,2830,1003,336,24,188,1,22,1869
48121021420,3234,2091,555,225,19,156,6,9,1143
48121021421,3895,2376,767,325,21,128,0,21,1519
48121021422,5070,3272,938,328,22,284,3,27,1798
48121021423,3606,2126,755,350,7,146,0,15,1480
48121021502,4726,1748,2190,519,16,60,2,4,2978
48121021505,6135,3336,1347,650,36,459,6,20,2799
48121021512,4747,3788,376,140,23,241,1,17,959
48121021513,3739,3136,333,31,12,58,0,9,603
48121021514,4238,3404,481,81,13,92,0,13,834
48121021516,6585,3574,1700,604,26,283,6,32,3011
48121021517,4461,1502,679,896,17,1126,4,27,2959
48121021518,2884,1658,497,264,6,302,8,5,1226
48121021520,3527,1898,1120,247,16,85,1,20,1629
48121021521,4044,2220,1162,314,17,91,5,15,1824
48121021522,4364,1488,482,513,5,1678,0,21,2876
48121021526,8280,5293,803,551,23,1147,11,32,2987
48121021528,2635,1857,311,98,14,193,0,0,778
48121021529,4845,2857,675,349,4,735,1,21,1988
48121021530,3754,1685,1060,500,18,301,2,12,2069
48121021531,4887,2294,1153,495,14,684,3,23,2593
48121021532,4105,2093,703,493,20,596,3,15,2012
48121021533,6188,2994,1451,489,27,914,4,25,3194
48121021534,6302,3812,574,394,27,1180,3,14,2490
48121021535,3809,3496,104,57,12,67,0,2,313
48121021536,6529,2738,1430,1003,28,991,5,54,3791
48121021537,5374,2549,1137,720,19,673,0,16,2825
48121021538,6745,3456,651,626,24,1657,3,32,3289
48121021539,8624,4299,793,421,26,2677,0,54,4325
48121021540,7330,2904,702,600,16,2766,0,36,4426
48121021611,4424,1784,1162,393,9,833,13,19,2640
48121021612,3770,1755,850,260,25,708,2,11,2015
48121021613,5579,1285,2420,787,21,865,9,26,4294
48121021614,3650,1194,1708,273,8,339,0,13,2456
48121021615,4692,1501,2480,296,12,283,0,13,3191
48121021616,4626,1386,1386,1323,6,280,13,16,3240
48121021618,4351,1564,2190,325,17,94,1,17,2787
48121021619,3182,658,1959,387,13,80,0,4,2524
48121021620,3859,1315,830,1244,16,262,1,18,2544
48121021621,3634,1954,537,229,9,731,4,16,1680
48121021622,6092,2786,864,424,23,1684,13,34,3306
48121021626,2434,1636,186,109,4,396,0,6,798
48121021630,5457,1956,935,934,27,1368,1,37,3501
48121021631,5302,2712,896,318,18,1142,5,6,2590
48121021632,3548,2295,558,327,3,205,6,12,1253
48121021633,4261,2601,859,209,6,351,0,14,1660
48121021634,5215,1344,1510,1779,20,253,4,49,3871
48121021635,4550,1169,923,1971,6,226,0,48,3381
48121021637,4215,1076,1396,1140,20,421,3,25,3139
48121021638,4048,1101,1411,1068,10,267,3,31,2947
48121021639,3403,1919,649,264,14,400,1,1,1484
48121021640,3132,1378,720,397,4,480,4,19,1754
48121021641,3656,909,861,1494,14,204,1,24,2747
48121021642,3468,1003,780,1147,10,355,1,29,2465
48121021643,4919,2566,488,347,17,1266,5,35,2353
48121021644,2202,1216,298,109,10,454,0,10,986
48121021645,2083,210,1655,132,4,55,0,3,1873
48121021646,6426,2250,856,1400,24,1609,8,26,4176
48121021647,4670,2524,741,630,16,459,2,34,2146
48121021648,3104,2253,249,143,3,318,0,12,851
48121021649,3406,960,363,554,10,1386,2,18,2446
48121021650,5354,1090,475,646,8,2958,1,5,4264
48121021651,6584,3251,657,715,20,1585,1,32,3333
48121021652,4283,2000,317,157,6,1622,0,14,2283
48121021653,2824,808,359,371,9,1173,2,18,2016
48121021654,3855,974,388,446,23,1866,0,34,2881
48121021655,2323,1282,332,177,6,424,0,8,1041
48121021715,4722,2546,899,509,17,490,3,27,2176
48121021716,5550,2593,1075,983,12,621,1,22,2957
48121021717,5438,3370,1117,349,9,326,3,19,2068
48121021719,5240,3756,491,207,13,517,5,25,1484
48121021720,3187,1904,254,189,13,671,0,16,1283
48121021721,3680,2579,487,155,26,207,4,16,1101
48121021722,4150,2688,711,199,25,293,2,18,1462
48121021723,1476,637,367,157,6,229,0,7,839
48121021724,4250,2974,352,132,14,529,1,17,1276
48121021725,3565,2475,403,94,13,361,0,13,1090
48121021726,3107,2158,395,104,10,300,4,9,949
48121021727,5383,2993,482,207,15,1506,0,10,2390
48121021728,3693,1156,1675,464,13,207,8,24,2537
48121021729,3012,1833,433,186,11,374,0,7,1179
48121021730,3625,2200,538,279,3,399,1,13,1425
48121021731,3462,1635,634,413,10,584,3,27,1827
48121021732,2524,748,555,695,22,366,3,18,1776
48121021733,3244,1135,793,820,3,338,4,10,2109
48121021734,3569,1071,971,1149,10,156,9,22,2498
48121021735,3346,1020,773,1152,6,182,0,25,2326
48121021736,2527,731,545,717,11,342,1,17,1796
48121021737,4908,1802,728,913,7,1160,2,46,3106
48121021738,3382,1246,560,680,17,694,6,30,2136
48121021739,3596,707,1618,940,13,188,0,10,2889
48121021740,5195,1717,1719,1037,14,473,1,23,3478
48121021741,1948,803,520,223,1,333,0,13,1145
48121021742,6441,2503,2214,517,20,980,9,22,3938
48121021743,3689,1139,1766,369,13,265,1,17,2550
48121021744,3781,781,2195,166,10,505,0,13,3000
48121021745,5924,1399,3466,330,4,544,3,12,4525
48121021746,4365,3355,420,60,17,257,3,13,1010
48121021748,4254,3280,438,94,17,210,1,16,974
48121021749,3347,2626,282,65,12,213,1,8,721
48121021750,5127,3348,389,151,23,955,3,27,1779
48121021751,4734,2662,332,111,5,1409,0,23,2072
48121021752,4851,3048,471,135,5,972,1,17,1803
48121021754,4029,2945,458,165,14,226,2,13,1084
48121021755,9181,6866,911,329,48,587,2,38,2315
48121021756,4222,2727,386,120,7,769,1,29,1495
48121021757,3192,2402,282,56,7,294,3,5,790
48121021758,3580,2440,487,123,19,303,0,31,1140
48121021759,2164,1407,259,138,13,217,1,22,757
48121021800,4218,2726,415,306,9,565,4,12,1492
48121021900,5762,3476,455,321,14,1175,2,21,2286
48123970100,3937,2214,1406,197,7,23,0,4,1723
48123970201,1749,590,814,313,2,8,2,2,1159
48123970202,3235,1177,1393,569,0,15,0,13,2058
48123970300,4482,2663,1364,300,11,20,0,9,1819
48123970400,3870,2594,1086,119,7,1,0,5,1276
48123970500,2551,1616,827,59,5,3,0,2,935
48125950300,1770,1178,512,18,0,1,2,7,592
48127950201,4735,349,4221,56,8,51,5,12,4386
48127950202,2357,447,1859,10,0,17,2,0,1910
48127950400,1523,102,1407,6,0,0,3,0,1421
48129950200,1926,1417,231,158,13,8,1,4,509
48129950300,1332,1120,125,9,14,2,0,2,212
48131950100,4664,401,3519,138,4,16,0,5,4263
48131950200,2887,401,2333,7,6,24,0,3,2486
48131950500,2280,135,2110,0,3,5,0,0,2145
48133950100,2760,2016,534,105,25,23,1,5,744
48133950201,1064,843,171,12,3,1,1,5,221
48133950202,4723,3593,857,61,14,41,1,1,1130
48133950301,3605,2754,523,137,30,21,2,9,851
48133950302,1590,1366,138,5,7,1,0,3,224
48133950400,1770,1504,165,5,10,4,6,3,266
48133950500,2213,1577,546,10,7,4,5,0,636
48135000100,3790,1808,1772,57,21,25,13,11,1982
48135000300,1885,1033,718,55,15,10,2,0,852
48135000400,4394,1847,2161,143,27,70,27,8,2547
48135000500,4473,1589,2341,352,26,47,0,5,2884
48135000600,5518,1365,3714,251,8,51,13,20,4153
48135000700,4653,850,3262,296,9,114,38,19,3803
48135000800,3837,1356,2186,106,29,48,19,11,2481
48135001000,4465,1107,3142,114,1,26,5,5,3358
48135001100,6877,980,5469,322,22,20,0,10,5897
48135001300,4867,1359,3144,185,12,51,2,18,3508
48135001500,4548,730,3473,231,10,20,21,8,3818
48135001600,5869,2204,3165,276,18,50,4,18,3665
48135001700,5825,2791,2375,327,36,96,22,8,3034
48135001800,3666,223,2395,949,0,8,7,25,3443
48135001900,5164,205,4557,366,8,5,0,13,4959
48135002000,3337,209,2777,299,8,1,13,11,3128
48135002200,4705,1052,3576,17,9,4,0,13,3653
48135002300,3478,1597,1284,342,33,95,3,10,1881
48135002400,5117,2625,1887,303,28,93,20,18,2492
48135002501,10841,3780,5757,592,34,342,46,37,7061
48135002502,6442,2889,2820,308,36,211,11,20,3553
48135002503,5216,2058,2303,355,20,250,8,45,3158
48135002701,7484,2138,5092,80,24,17,9,16,5346
48135002702,6561,1520,4822,82,10,9,3,22,5041
48135002801,7027,1079,5793,30,24,9,22,9,5948
48135002803,5516,1614,3744,63,5,5,1,17,3902
48135002804,6752,1443,5151,32,20,3,0,17,5309
48135002900,3397,2042,1020,150,11,70,4,7,1355
48135003001,1240,863,318,15,4,0,0,1,377
48135003002,4672,2482,1689,173,22,163,3,21,2190
48135003003,4602,784,3593,129,19,7,0,18,3818
48135003004,5478,2831,1935,270,11,273,9,29,2647
48135003100,3475,570,2616,160,8,64,2,2,2905
48137950300,1422,651,718,2,5,11,1,2,771
48139060103,4681,1982,2063,423,5,34,0,11,2699
48139060104,3885,1257,2134,382,5,14,3,7,2628
48139060105,4310,2404,1565,141,20,8,2,6,1906
48139060106,3619,1535,1812,96,22,14,0,9,2084
48139060206,7461,2723,2114,2226,11,84,1,68,4738
48139060207,7247,3644,2105,1117,29,49,5,20,3603
48139060209,5901,3685,1103,750,28,78,2,11,2216
48139060211,4062,2933,613,316,19,26,0,17,1129
48139060212,7406,4044,1770,1036,17,119,7,69,3362
48139060215,3824,1713,975,928,20,25,0,19,2111
48139060216,7922,2747,1560,3242,10,59,6,37,5175
48139060217,8698,5554,1802,853,17,98,12,19,3144
48139060218,2768,1715,789,103,13,19,0,6,1053
48139060219,4929,2982,1252,419,15,37,3,8,1947
48139060220,3941,2515,639,536,20,47,2,5,1426
48139060221,7591,5690,904,537,23,56,7,19,1901
48139060300,4221,2289,1439,245,34,26,2,13,1932
48139060400,5272,1812,1347,1799,19,15,16,101,3460
48139060500,3350,1623,1170,402,17,10,6,8,1727
48139060601,5171,3111,1111,685,35,21,3,32,2060
48139060602,4603,2886,1093,362,17,16,6,31,1717
48139060702,5837,3861,1101,521,31,81,3,16,1976
48139060704,4815,2706,1283,509,13,94,1,38,2109
48139060801,10690,7608,1363,1083,56,107,5,36,3082
48139060802,8744,6258,1263,664,55,100,11,24,2486
48139060803,1903,916,741,162,12,13,0,3,987
48139060900,7884,5911,1264,219,51,65,2,18,1973
48139061000,4538,2793,993,549,18,18,6,2,1745
48139061100,5550,3020,2078,225,12,24,4,71,2530
48139061200,2173,1114,872,109,4,8,0,2,1059
48139061300,3627,2092,1201,160,22,36,3,3,1535
48139061401,2354,1577,560,117,6,14,8,8,777
48139061402,5747,2902,2235,326,4,41,13,17,2845
48139061500,5682,1549,3041,929,6,30,6,7,4133
48139061600,6928,2009,3233,1396,16,28,55,17,4919
48139061700,5121,3335,1444,171,8,11,2,12,1786
48141000106,5829,1388,3466,534,11,182,32,38,4441
48141000107,5256,754,4003,301,16,74,0,8,4502
48141000108,3405,602,2278,310,21,57,21,8,2803
48141000109,3562,413,2955,111,1,22,3,15,3149
48141000110,3441,553,2454,294,7,53,8,5,2888
48141000111,2664,704,1482,270,11,82,7,16,1960
48141000112,4222,629,3258,171,11,40,11,15,3593
48141000113,3544,735,2520,167,2,44,0,1,2809
48141000114,3693,610,2531,331,13,130,0,17,3083
48141000204,5359,833,3928,342,12,80,14,17,4526
48141000205,4033,649,2946,225,15,74,13,24,3384
48141000206,4565,506,3848,110,10,39,1,11,4059
48141000207,4791,498,3887,231,10,46,30,21,4293
48141000208,4315,571,3426,136,0,49,32,21,3744
48141000301,5743,440,5027,181,6,22,0,10,5303
48141000302,5388,328,4847,123,11,21,10,7,5060
48141000401,6261,1609,3935,325,4,135,23,32,4652
48141000403,3233,407,2508,168,14,35,22,14,2826
48141000404,3024,269,2508,143,12,39,4,7,2755
48141000600,4065,295,3540,134,4,26,9,21,3770
48141000800,5152,323,4575,156,6,33,1,10,4829
48141000901,4351,219,4062,23,12,7,2,10,4132
48141000902,2549,454,1796,159,18,39,10,0,2095
48141001001,2937,209,2686,13,4,4,0,5,2728
48141001002,3391,159,3155,32,13,3,0,4,3232
48141001107,6761,1832,4425,90,11,256,1,22,4929
48141001109,4826,1655,2892,64,9,94,0,28,3171
48141001110,4998,1322,3301,134,4,136,3,15,3676
48141001111,5120,1069,3531,178,6,195,13,27,4051
48141001112,4524,1082,3206,79,8,61,1,10,3442
48141001114,5179,838,3966,159,4,111,1,15,4341
48141001115,3870,559,2964,109,3,153,5,14,3311
48141001116,2714,518,1855,121,21,120,0,9,2196
48141001117,5877,1174,4329,141,7,134,1,18,4703
48141001118,2397,546,1692,33,11,68,1,13,1851
48141001119,3863,759,2909,84,13,33,3,12,3104
48141001202,4862,700,3964,54,8,69,3,10,4162
48141001204,5131,305,4710,55,14,12,2,21,4826
48141001301,3652,1121,2373,41,5,37,3,5,2531
48141001302,7087,2457,4351,50,16,68,0,17,4630
48141001400,2664,268,1919,231,9,166,2,15,2396
48141001501,4929,1154,3486,73,7,113,7,17,3775
48141001502,2627,760,1563,130,8,90,1,21,1867
48141001600,4088,440,3326,134,12,115,0,24,3648
48141001700,1165,332,779,40,1,3,3,2,833
48141001800,1156,19,1112,17,0,0,1,0,1137
48141001900,2387,63,2298,15,2,0,0,2,2324
48141002000,2312,57,2241,2,0,0,0,6,2255
48141002100,2084,190,1762,78,4,21,5,5,1894
48141002201,2984,335,2580,35,4,8,1,1,2649
48141002202,3832,294,3427,51,7,18,0,9,3538
48141002300,4154,305,3774,23,5,11,2,1,3849
48141002400,3052,270,2726,13,3,3,1,3,2782
48141002500,5676,468,5096,36,6,24,3,13,5208
48141002600,2838,96,2666,39,6,2,1,7,2742
48141002800,4387,114,4232,16,2,2,0,12,4273
48141002900,1406,29,1354,1,2,5,2,6,1377
48141003000,3547,94,3404,22,4,3,0,11,3453
48141003100,3114,82,3007,12,8,0,0,0,3032
48141003200,2371,48,2299,8,0,4,0,3,2323
48141003300,5338,297,4942,26,7,34,1,19,5041
48141003402,5689,378,4974,178,10,78,12,28,5311
48141003403,5484,649,4386,297,17,56,15,8,4835
48141003404,6263,998,4896,190,8,48,2,28,5265
48141003501,2658,131,2472,24,3,7,2,10,2527
48141003502,4153,153,3938,20,14,4,0,4,4000
48141003601,3878,106,3712,11,0,10,3,19,3772
48141003602,2825,105,2695,5,4,5,3,3,2720
48141003701,4088,116,3914,17,7,11,2,7,3972
48141003702,4132,123,3964,12,1,7,0,17,4009
48141003801,5095,113,4936,13,7,5,0,8,4982
48141003803,3009,105,2862,9,12,6,0,5,2904
48141003804,3393,123,3241,4,5,3,2,1,3270
48141003901,3338,118,3186,9,5,1,0,4,3220
48141003902,2285,58,2067,11,118,1,1,5,2227
48141003904,3193,54,3094,14,11,1,3,10,3139
48141003905,3221,50,3132,9,17,1,0,4,3171
48141004004,5536,128,5341,23,4,9,1,11,5408
48141004005,5785,130,5605,11,22,0,1,3,5655
48141004006,2680,73,2595,4,0,0,0,0,2607
48141004007,3166,68,3051,22,7,7,1,0,3098
48141004008,4469,110,4306,32,8,0,0,3,4359
48141004103,6692,234,6336,61,22,10,4,10,6458
48141004104,6147,221,5843,34,15,9,2,6,5926
48141004105,3305,112,3122,43,6,0,0,14,3193
48141004106,4936,205,4664,27,0,14,0,4,4731
48141004107,1391,69,1295,5,1,6,0,2,1322
48141004201,5583,149,5280,102,8,9,9,10,5434
48141004202,5235,191,4855,95,3,41,4,9,5044
48141004303,5726,844,4692,78,10,37,6,8,4882
48141004307,5378,836,4228,152,15,64,1,22,4542
48141004309,5274,522,4420,166,9,72,4,16,4752
48141004310,4952,620,4134,112,9,18,11,7,4332
48141004311,4490,607,3647,111,17,43,11,20,3883
48141004312,4918,783,3922,134,7,29,1,5,4135
48141004313,3173,496,2451,117,10,61,0,7,2677
48141004314,4841,324,4353,87,8,26,4,13,4517
48141004316,5432,320,4969,56,9,26,4,14,5112
48141004317,3955,626,2925,234,22,65,7,20,3329
48141004318,3569,541,2896,52,11,37,1,2,3028
48141004319,5114,394,4516,79,0,58,3,10,4720
48141004320,2905,120,2716,25,5,14,10,4,2785
48141010101,7514,3762,1628,730,100,555,129,50,3752
48141010102,3005,1017,863,393,94,417,78,4,1988
48141010103,4435,2154,1095,578,37,167,48,43,2281
48141010203,2858,174,2651,3,3,2,0,11,2684
48141010210,8205,1936,4593,909,80,294,49,38,6269
48141010211,2864,855,1440,289,11,133,5,14,2009
48141010212,7594,1538,4698,765,18,197,46,39,6056
48141010213,8446,2201,5083,314,16,589,5,34,6245
48141010214,6400,2065,3654,188,8,312,10,15,4335
48141010217,4921,927,3556,90,12,230,0,13,3994
48141010218,4227,778,3240,85,9,46,4,0,3449
48141010220,6941,693,5919,139,23,74,3,28,6248
48141010222,2026,311,1684,0,1,7,0,7,1715
48141010223,5010,844,3291,522,23,85,25,27,4166
48141010224,5755,1135,3843,390,26,105,41,14,4620
48141010225,4983,712,4017,79,7,91,0,11,4271
48141010226,4479,909,3149,128,11,182,0,9,3570
48141010227,3899,353,3412,38,6,41,0,6,3546
48141010228,5416,383,4854,68,14,35,5,14,5033
48141010229,7243,1654,5216,119,15,90,9,23,5589
48141010230,2299,307,1906,34,4,16,0,10,1992
48141010231,4053,411,3437,83,70,31,2,9,3642
48141010232,3842,243,3437,77,9,36,3,14,3599
48141010303,3970,444,3341,93,23,26,0,9,3526
48141010307,5952,536,5095,178,16,47,6,24,5416
48141010311,6237,598,5435,101,10,25,5,19,5639
48141010312,3775,435,3185,77,5,29,4,5,3340
48141010316,3835,386,3286,95,8,22,2,4,3449
48141010317,4042,379,3505,92,7,24,6,5,3663
48141010322,5544,517,4755,127,3,70,14,16,5027
48141010323,4255,345,3717,117,4,33,3,9,3910
48141010326,4537,559,3785,81,14,47,2,7,3978
48141010327,3474,233,3081,82,1,31,4,7,3241
48141010328,4183,456,3447,170,6,60,1,8,3727
48141010329,5419,269,4955,93,10,38,3,17,5150
48141010333,4850,84,4727,7,4,4,0,23,4766
48141010334,3958,57,3857,4,8,6,0,12,3901
48141010335,4080,110,3947,8,3,4,0,5,3970
48141010336,6219,378,5640,99,7,46,9,9,5841
48141010337,6502,373,5821,158,12,85,3,12,6129
48141010338,7538,560,6528,220,15,140,1,22,6978
48141010344,3123,59,3043,11,3,0,0,6,3064
48141010346,5431,131,5230,21,9,10,5,5,5300
48141010347,4135,181,3918,12,6,0,2,12,3954
48141010348,4574,223,4139,104,7,41,7,11,4351
48141010349,3438,200,3122,44,3,31,0,12,3238
48141010350,4412,191,4059,108,6,15,0,11,4221
48141010351,3222,196,2902,57,7,21,0,8,3026
48141010352,5819,472,5031,149,11,50,25,20,5347
48141010353,5166,513,4095,334,11,94,10,19,4653
48141010354,6383,736,5109,255,21,107,7,21,5647
48141010355,5156,377,4484,152,7,58,15,17,4779
48141010356,3776,162,3548,29,4,6,0,11,3614
48141010357,7994,374,7424,119,12,13,3,20,7620
48141010358,10351,1656,7528,748,48,148,45,38,8695
48141010359,2577,272,2245,17,9,7,1,2,2305
48141010360,3802,608,3051,58,11,14,7,8,3194
48141010361,3177,230,2839,64,2,7,6,4,2947
48141010362,7823,220,7466,54,16,31,3,4,7603
48141010363,5315,395,4710,125,7,25,3,13,4920
48141010364,2707,302,2353,20,2,5,4,9,2405
48141010365,4465,119,4315,6,2,10,0,5,4346
48141010366,8263,671,7071,257,15,130,13,21,7592
48141010367,10634,1131,8551,538,19,110,41,39,9503
48141010368,13644,1463,10983,674,36,180,31,51,12181
48141010369,14413,1723,11023,872,45,230,78,56,12690
48141010370,20548,1513,17746,658,45,238,70,67,19035
48141010371,6126,356,5587,99,12,20,5,7,5770
48141010372,3266,225,2883,90,4,13,5,10,3041
48141010401,6750,154,6519,12,15,19,0,20,6596
48141010404,5191,188,4955,11,14,0,1,8,5003
48141010406,3919,54,3837,8,8,0,0,7,3865
48141010408,3824,67,3721,8,10,2,0,2,3757
48141010409,5721,111,5574,12,11,0,1,8,5610
48141010410,4335,81,4225,8,5,2,0,9,4254
48141010411,3269,65,3013,13,160,4,0,0,3204
48141010412,4817,73,4717,4,10,0,0,1,4744
48141010413,1882,28,1845,2,0,0,0,2,1854
48141010501,5814,142,5628,11,1,4,0,14,5672
48141010502,2645,131,2496,3,1,0,2,4,2514
48141010504,1619,41,1569,0,1,1,0,0,1578
48141010505,3258,109,3129,6,0,2,0,2,3149
48141010506,3732,62,3656,0,4,0,0,6,3670
48141010601,825,428,207,88,0,41,18,6,397
48141010602,4425,1789,1318,662,44,127,144,49,2636
48141980000,5,4,1,0,0,0,0,0,1
48143950100,3694,3166,298,8,40,11,0,6,528
48143950201,3888,3080,611,11,22,15,0,12,808
48143950203,4348,3191,924,27,9,44,2,20,1157
48143950204,2707,2150,437,10,7,22,0,5,557
48143950301,2329,1466,776,8,9,8,0,8,863
48143950302,3531,1798,1609,15,9,15,3,9,1733
48143950401,4605,2682,1130,595,11,24,0,0,1923
48143950402,4157,3259,566,110,17,63,0,3,898
48143950501,3557,2492,751,84,9,74,4,16,1065
48143950502,4135,2631,990,235,43,51,0,11,1504
48143950600,3666,2529,885,90,18,16,3,6,1137
48143950700,1928,1562,277,1,21,5,1,8,366
48145000200,2968,1722,899,249,4,3,5,11,1246
48145000300,3551,1000,1121,1290,6,18,3,2,2551
48145000400,1772,409,319,1007,11,5,0,3,1363
48145000500,2048,1538,260,170,8,1,0,4,510
48145000700,2559,1573,597,270,11,15,0,15,986
48145000800,4070,2465,769,722,15,9,0,7,1605
48147950100,2988,2169,375,227,25,7,0,13,819
48147950300,3142,2701,197,32,23,9,5,8,441
48147950401,4988,2657,1115,1039,17,24,3,4,2331
48147950402,6240,4751,701,393,64,60,5,15,1489
48147950500,2574,2051,120,229,26,6,0,11,523
48147950600,2515,1969,303,93,19,10,2,4,546
48147950701,4649,3631,547,86,55,12,1,41,1018
48147950702,4119,3188,602,63,42,10,3,1,931
48147950800,4447,3925,258,37,38,7,1,15,522
48149970100,2007,1685,201,41,3,0,0,17,322
48149970200,2478,1985,321,64,7,1,2,14,493
48149970301,1062,832,135,32,8,22,0,2,230
48149970302,4581,2601,1369,446,4,11,4,8,1980
48149970400,3665,2559,753,243,9,0,0,5,1106
48149970500,3930,2563,1161,108,14,8,0,2,1367
48149970601,903,801,86,4,1,1,0,3,102
48149970602,3904,2434,955,420,4,19,0,15,1470
48149970700,1905,1581,235,25,0,5,0,6,324
48151950300,1721,1315,346,15,6,0,0,4,406
48151950400,1951,1181,627,77,9,13,2,7,770
48153950500,2106,887,1123,41,1,6,1,6,1219
48153950600,3296,1192,1944,84,6,6,0,7,2104
48155950100,1095,845,197,19,0,3,1,2,250
48157670101,6587,164,4078,2212,4,46,0,25,6423
48157670102,3552,63,1410,1994,3,28,0,5,3489
48157670201,1662,22,530,1074,5,0,0,4,1640
48157670202,6295,213,3203,2711,5,44,0,26,6082
48157670300,3825,88,1216,2427,2,19,1,10,3737
48157670400,4986,114,1144,3576,11,27,2,26,4872
48157670500,4940,318,1218,3031,1,250,3,16,4622
48157670602,1949,57,626,1219,1,20,2,4,1892
48157670603,4865,102,823,3800,3,35,0,25,4763
48157670604,4223,98,725,3226,3,92,0,15,4125
48157670700,8401,1186,1630,3838,7,1456,0,53,7215
48157670801,3589,116,3249,192,1,8,0,8,3473
48157670802,4856,168,1413,3093,7,42,1,12,4688
48157670803,3960,146,1548,2124,8,27,0,22,3814
48157670804,3992,157,540,3054,10,115,0,13,3835
48157670902,9000,337,2577,5641,6,178,10,36,8663
48157670903,8097,990,955,3582,7,2297,5,51,7107
48157670904,5451,1548,764,1555,6,1347,1,28,3903
48157671001,5736,2834,895,1369,16,382,1,26,2902
48157671002,6682,1593,1634,2929,13,255,0,35,5089
48157671101,2565,166,445,1749,11,121,0,19,2399
48157671102,6253,816,3243,1300,9,745,1,26,5437
48157671200,6299,436,2127,3144,6,393,9,41,5863
48157671300,3706,474,1287,1412,7,431,4,12,3232
48157671401,2210,192,846,494,13,602,0,5,2018
48157671402,6813,598,1067,2039,9,2937,0,14,6215
48157671501,7923,1767,911,1991,8,2947,4,24,6156
48157671502,1836,267,177,467,4,868,0,4,1569
48157671601,6262,2377,1016,572,8,2012,3,30,3885
48157671602,3386,1333,353,320,2,1239,2,28,2053
48157671700,4858,2932,526,284,6,936,1,24,1926
48157671800,3565,630,1255,1098,0,452,2,38,2935
48157671900,4094,1862,1108,311,7,622,0,17,2232
48157672002,6589,1330,1202,1943,0,1853,9,42,5259
48157672003,1812,361,197,207,5,990,0,10,1451
48157672004,6272,1030,1365,995,4,2692,0,42,5242
48157672100,4436,2412,353,200,2,1266,0,27,2024
48157672201,1944,556,164,173,2,971,0,18,1388
48157672202,2746,1518,634,246,2,226,0,16,1228
48157672303,3524,490,360,595,7,1983,3,11,3034
48157672304,4260,671,1324,532,6,1595,6,15,3589
48157672305,5175,1607,875,401,20,2100,1,8,3568
48157672306,3635,2126,788,172,3,374,5,19,1509
48157672401,2424,260,708,563,2,833,0,4,2164
48157672402,6401,973,3292,985,4,1007,4,25,5428
48157672500,7370,833,2930,1944,17,1450,4,38,6537
48157672602,6468,434,2176,2525,9,1211,0,19,6034
48157672603,2596,175,1247,663,1,452,2,9,2421
48157672604,7478,807,4448,1514,15,520,0,33,6671
48157672701,5708,308,1674,2080,9,1518,1,39,5400
48157672702,6850,1856,1387,1348,14,1969,2,47,4994
48157672703,8241,983,1959,1939,24,3131,0,49,7258
48157672801,4752,1027,667,841,14,2034,0,36,3725
48157672802,2361,273,180,508,0,1274,3,35,2088
48157672901,17341,2251,1124,2071,19,11362,2,119,15090
48157672902,8709,2020,1847,2506,10,2021,9,37,6689
48157672903,16195,3717,3275,5143,18,3401,4,96,12478
48157672904,8766,486,1458,3521,8,3051,5,40,8280
48157672905,7897,842,2528,2634,10,1658,0,35,7055
48157672906,6416,1324,1550,2040,4,1301,3,26,5092
48157672907,8609,1141,1646,3020,5,2533,6,42,7468
48157673004,2631,1649,348,74,3,424,4,10,982
48157673005,4855,3292,757,88,10,441,2,25,1563
48157673006,5749,2819,1194,426,5,1013,1,44,2930
48157673007,2948,1072,796,434,3,511,0,19,1876
48157673008,3951,2327,626,137,6,672,4,12,1624
48157673009,6233,2518,1145,493,5,1780,0,36,3715
48157673010,4059,1755,556,263,2,1288,5,18,2304
48157673103,3769,2578,518,169,5,315,4,40,1191
48157673104,7624,2901,1851,545,12,1966,0,41,4723
48157673105,4493,1349,949,175,6,1782,0,33,3144
48157673106,5868,3249,852,234,21,1210,2,45,2619
48157673107,7505,3467,1869,410,17,1339,1,40,4038
48157673108,18333,7455,3459,1665,37,4983,0,81,10878
48157673109,10762,3478,2591,1023,13,3135,12,89,7284
48157673110,6767,2730,1344,346,10,2054,0,50,4037
48157673111,11557,3857,2301,877,19,4008,2,58,7700
48157673112,9225,4098,1697,494,8,2440,1,39,5127
48157673113,7846,2677,2003,670,18,2160,0,28,5169
48157673201,11027,6168,2186,1101,27,1024,6,62,4859
48157673202,24651,11984,5667,2377,42,3443,2,132,12667
48157673300,8025,6175,948,368,19,179,2,35,1850
48157673401,8979,4383,2260,1513,19,405,14,59,4596
48157673402,8037,3246,1704,1767,15,917,0,36,4791
48157673403,8359,2755,1857,1903,14,1488,0,42,5604
48157673404,10708,6654,1694,1105,24,715,11,38,4054
48157673501,8831,3348,1541,1495,10,2014,1,61,5483
48157673502,4374,2902,814,367,9,110,0,21,1472
48157673600,6873,4624,1343,399,7,192,2,27,2249
48157673700,2203,829,597,766,0,6,0,1,1374
48157673801,3023,700,893,190,2,1139,0,9,2323
48157673802,5534,1650,773,621,5,2229,2,45,3884
48157673902,11431,1496,670,460,15,8494,1,59,9935
48157673903,3094,1109,235,172,8,1445,0,17,1985
48157673904,5106,2089,536,252,6,1959,1,34,3017
48157674001,2884,1014,317,93,3,1320,3,14,1870
48157674002,4717,1628,644,306,10,1915,0,27,3089
48157674100,6732,3049,1124,442,9,1783,5,34,3683
48157674200,5202,2392,382,148,8,2049,0,24,2810
48157674301,3362,836,371,301,6,1727,0,18,2526
48157674302,7174,1919,617,863,8,3537,1,17,5255
48157674401,7316,2175,466,206,4,4170,0,24,5141
48157674402,5750,610,253,364,8,4389,0,18,5140
48157674403,4528,859,315,385,1,2811,2,16,3669
48157674404,7343,1197,442,627,12,4834,2,29,6146
48157674503,4971,2451,564,914,6,791,1,23,2520
48157674504,8887,4395,987,1768,22,1262,4,45,4492
48157674505,7144,3184,1154,1369,21,1004,3,42,3960
48157674506,6878,922,3070,2409,7,314,1,18,5956
48157674507,11654,2984,1257,2227,20,4674,7,45,8670
48157674508,4049,906,452,1867,4,673,0,18,3143
48157674601,3688,2438,454,207,3,416,0,5,1250
48157674602,7878,4746,1240,692,13,857,0,28,3132
48157674603,5817,2488,1827,925,19,320,8,22,3329
48157674604,4975,1078,1071,1538,6,1090,0,14,3897
48157674701,4316,780,640,1081,15,1596,0,43,3536
48157674702,12732,4949,2499,2481,24,2423,8,53,7783
48157674800,5397,1295,2728,1170,4,68,0,11,4102
48157674900,5229,335,4049,775,1,22,0,13,4894
48157675000,3200,204,2349,590,4,21,3,7,2996
48157675101,7449,1712,3169,1759,8,581,0,52,5737
48157675102,4098,1126,2510,347,2,30,0,16,2972
48157675200,5484,1215,3728,385,22,19,0,29,4269
48157675300,6339,1220,4596,377,23,42,0,15,5119
48157675401,7790,2348,3736,1216,15,239,0,26,5442
48157675402,1983,577,1297,76,2,4,0,4,1406
48157675501,7013,1450,3613,1520,23,183,2,64,5563
48157675502,15080,4496,3947,3370,32,2576,14,94,10584
48157675503,5692,1860,1421,1496,16,615,10,33,3832
48157675600,7262,4181,2648,125,9,61,0,27,3081
48157675701,3994,2007,1628,197,4,18,0,22,1987
48157675702,3438,2034,997,265,7,23,0,5,1404
48157675800,3511,1308,1547,567,3,36,1,15,2203
48159950101,3207,2608,426,16,11,14,3,14,599
48159950102,2171,1787,223,44,8,19,1,2,384
48159950200,2443,1533,452,302,11,13,0,28,910
48159950300,2538,1948,354,32,9,22,2,17,590
48161000101,3147,2273,579,199,17,11,0,5,874
48161000102,2333,1530,397,271,17,15,0,11,803
48161000200,1301,992,154,111,0,10,0,1,309
48161000300,1069,483,165,364,3,8,0,2,586
48161000400,2263,1667,229,266,9,4,2,6,596
48161000600,4789,3281,814,562,10,16,2,14,1508
48161000700,2995,1642,731,521,4,1,7,2,1353
48161000900,1538,949,86,446,4,1,0,5,589
48163950101,3131,1218,1799,29,3,14,4,6,1913
48163950102,3199,579,2564,14,8,8,2,10,2620
48163950201,2629,154,2167,138,8,146,1,9,2475
48163950202,3694,305,3321,17,23,0,2,17,3389
48163950301,3789,610,2592,507,4,29,0,30,3179
48163950302,1943,187,1728,0,3,2,0,9,1756
48165950100,3358,1132,2080,113,5,2,0,4,2226
48165950201,6121,4583,1413,19,7,13,0,23,1538
48165950202,6586,4221,2216,24,9,21,2,15,2365
48165950300,5533,2618,2692,85,21,36,1,4,2915
48167720100,6183,4461,1042,121,6,310,4,12,1722
48167720200,4821,3724,562,86,23,212,4,16,1097
48167720301,2455,1823,387,62,6,86,1,4,632
48167720302,7211,5480,1022,138,16,235,1,37,1731
48167720400,9833,7063,1144,239,25,956,4,37,2770
48167720501,4239,2790,783,235,14,211,1,11,1449
48167720504,2311,1315,427,175,4,292,0,9,996
48167720505,4731,2882,831,263,11,475,8,22,1849
48167720506,5316,3445,1012,279,10,277,3,27,1871
48167720507,5142,3434,847,261,9,355,2,29,1708
48167720508,2721,1513,661,192,3,219,2,7,1208
48167720509,2692,1660,617,186,16,68,7,15,1032
48167720510,3121,1702,999,199,6,112,0,8,1419
48167720511,3456,2135,837,99,11,211,2,14,1321
48167720512,3243,1933,601,245,3,298,0,17,1310
48167720601,3651,1926,810,561,8,219,2,9,1725
48167720602,3628,1867,925,461,7,199,3,17,1761
48167720603,4952,2485,1386,608,18,235,0,28,2467
48167720604,3592,1817,901,473,9,257,7,9,1775
48167720605,1408,984,326,29,3,16,1,3,424
48167720701,2775,1504,947,136,5,90,0,6,1271
48167720702,4730,2599,999,465,10,388,4,64,2131
48167720703,4340,2317,828,460,2,479,12,84,2023
48167720800,4064,1605,1237,975,4,90,2,7,2459
48167720900,4973,2449,1691,517,11,90,2,27,2524
48167721000,2124,1282,605,77,5,34,6,13,842
48167721101,2317,660,1274,278,4,35,2,6,1657
48167721102,6119,1779,3614,459,21,40,0,22,4340
48167721103,2878,1293,1069,286,23,93,0,8,1585
48167721203,2695,1769,398,309,3,105,3,10,926
48167721204,3317,1689,1175,259,0,66,0,21,1628
48167721205,4573,3022,856,330,24,142,0,12,1551
48167721206,4776,3136,760,282,20,360,0,26,1640
48167721207,4493,2923,788,314,17,226,0,10,1570
48167721208,1129,749,196,50,1,71,1,7,380
48167721209,2392,1144,714,295,1,132,0,13,1248
48167721210,5390,3465,986,296,15,328,2,43,1925
48167721211,3145,1953,487,283,9,269,0,13,1192
48167721301,3957,2284,1315,118,18,59,1,24,1673
48167721302,1409,1013,194,91,2,41,0,3,396
48167721401,2450,1922,254,83,3,93,0,13,528
48167721402,742,463,178,49,1,11,1,7,279
48167721403,5226,3638,889,283,13,141,0,12,1588
48167721501,3432,2398,459,263,8,168,0,11,1034
48167721502,2904,2181,407,83,13,88,5,11,723
48167721503,1608,1301,192,18,6,23,0,8,307
48167721600,1725,994,584,21,2,58,0,1,731
48167721701,3090,1492,1348,58,22,56,0,3,1598
48167721702,2100,699,1245,65,3,28,0,8,1401
48167721703,3858,2183,1021,352,18,110,0,6,1675
48167721800,5607,3138,1962,108,24,150,0,18,2469
48167721901,5706,2073,1620,1603,12,151,3,39,3633
48167721902,5840,2038,1670,1852,26,92,7,28,3802
48167722001,5966,3168,1844,581,23,102,8,34,2798
48167722002,3487,1537,1178,594,8,21,1,7,1950
48167722100,6671,3368,2288,669,18,46,9,25,3303
48167722200,3016,839,1001,1048,15,20,0,2,2177
48167722300,6942,2376,3111,1166,21,28,5,33,4566
48167722600,2206,557,590,983,7,18,0,3,1649
48167722700,5221,572,769,3664,10,27,0,22,4649
48167722800,2593,827,936,738,2,11,2,4,1766
48167722900,2928,1057,988,723,10,39,0,23,1871
48167723000,3540,663,897,1832,10,33,7,2,2877
48167723100,3531,1035,835,1469,14,45,0,19,2496
48167723200,5282,2155,1616,1180,10,116,3,21,3127
48167723300,9672,6020,2191,747,28,250,26,20,3652
48167723401,1594,1099,402,1,3,8,1,10,495
48167723402,2064,1702,255,6,6,15,1,6,362
48167723403,3539,2720,641,12,14,18,0,20,819
48167723501,2283,1840,338,10,5,7,2,12,443
48167723503,2389,1823,466,9,0,3,2,1,566
48167723504,2551,1966,461,6,5,4,2,8,585
48167723505,2789,2144,451,22,21,11,0,17,645
48167723600,4723,2827,1096,569,12,27,4,8,1896
48167723700,2420,665,601,1077,4,6,2,4,1755
48167723800,4467,3426,511,279,19,77,0,20,1041
48167723900,2770,2289,321,16,19,27,4,8,481
48167724000,3006,1777,417,731,0,42,0,4,1229
48167724101,1345,896,201,159,3,37,0,1,449
48167724200,3139,1507,667,360,11,447,4,7,1632
48167724300,3305,1769,737,458,15,176,0,18,1536
48167724400,3301,1535,963,600,29,45,4,10,1766
48167724500,1270,789,185,211,1,27,2,11,481
48167724600,2096,258,734,1019,12,23,0,0,1838
48167724700,2096,598,660,737,15,11,1,9,1498
48167724800,1474,715,377,298,13,9,0,17,759
48167724900,1603,711,565,214,2,31,14,2,892
48167725000,2025,770,913,239,12,27,0,8,1255
48167725100,1830,477,687,578,8,16,7,3,1353
48167725200,2108,389,1219,442,0,18,0,9,1719
48167725300,2357,989,991,239,6,47,0,11,1368
48167725400,4028,1292,2156,385,3,43,0,19,2736
48167725500,1192,830,234,49,6,27,0,7,362
48167725600,4191,2080,1143,549,12,232,3,19,2111
48167725700,2577,1579,633,135,5,135,0,5,998
48167725800,4914,1929,1520,1181,11,124,1,18,2985
48167725900,2447,1704,407,159,1,84,3,11,743
48167726000,1534,1199,206,25,7,46,0,6,335
48167726101,1854,1604,158,7,7,22,0,6,250
48167726102,1082,929,90,14,12,14,0,0,153
48167726200,2674,763,904,900,7,10,2,10,1911
48167990000,0,0,0,0,0,0,0,0,0
48167990100,0,0,0,0,0,0,0,0,0
48169950101,1147,313,682,99,14,1,0,7,834
48169950102,2901,1789,974,71,13,5,0,3,1112
48169980000,1768,60,1616,60,1,19,0,0,1708
48171950100,4282,3332,802,10,7,3,0,14,950
48171950200,4578,3902,507,10,16,7,1,18,676
48171950301,2288,1541,641,6,6,2,0,19,747
48171950302,4605,3525,912,12,9,26,0,10,1080
48171950401,3019,2487,400,13,9,20,0,8,532
48171950402,3877,2224,1461,19,9,42,0,14,1653
48171950500,4076,2873,1043,14,13,27,0,17,1203
48173950100,1116,710,387,8,0,0,3,0,406
48175960100,4054,2532,1198,170,13,5,0,10,1522
48175960200,2958,1714,1090,65,5,19,0,6,1244
48177000100,3012,1210,1523,194,2,10,0,14,1802
48177000200,5152,2850,1938,232,13,16,0,9,2302
48177000300,3399,978,1861,454,18,16,0,9,2421
48177000400,2037,569,1323,95,0,11,0,4,1468
48177000500,3745,1235,2337,90,5,9,0,6,2510
48177000600,2308,1317,915,10,3,1,6,3,991
48179950100,4299,2910,840,399,29,14,0,0,1389
48179950300,4357,3369,676,65,17,39,0,7,988
48179950400,4864,3344,1157,103,24,53,0,9,1520
48179950500,2400,1256,998,42,24,9,0,8,1144
48179950600,2015,814,1078,34,11,0,0,0,1201
48179950700,1686,814,736,22,20,9,0,10,872
48179950800,1606,518,862,170,16,3,0,3,1088
48181000101,5207,4285,409,51,86,20,7,25,922
48181000102,3323,2622,328,173,27,17,0,3,701
48181000200,2235,1508,303,184,44,6,0,7,727
48181000302,5211,4330,288,93,116,58,2,12,881
48181000304,3673,3221,208,8,66,10,0,1,452
48181000305,1762,1541,68,10,32,4,0,1,221
48181000306,2945,2598,117,9,51,9,3,11,347
48181000400,2806,1890,446,173,65,19,1,8,916
48181000501,3497,2004,463,630,53,30,0,15,1493
48181000502,1430,953,205,106,26,12,0,5,477
48181000600,3675,2825,364,117,72,16,2,8,850
48181000700,4174,2635,841,310,75,18,0,6,1539
48181000800,6038,4716,480,239,128,57,3,7,1322
48181000901,4759,3613,397,252,96,47,3,25,1146
48181000903,3414,1985,576,452,36,157,5,9,1429
48181000904,4583,3399,419,231,74,180,6,12,1184
48181001101,5102,3579,579,210,74,312,1,37,1523
48181001103,4689,3743,522,33,47,32,0,8,946
48181001104,2789,2378,235,7,30,9,2,1,411
48181001200,6292,4056,1065,626,78,73,1,18,2236
48181001300,4206,2652,542,406,48,338,1,6,1554
48181001400,5532,2212,2198,686,47,149,0,30,3320
48181001500,6809,3054,2563,696,81,44,0,10,3755
48181001700,5864,3419,1280,591,74,129,11,14,2445
48181001801,7108,5335,1124,174,89,36,6,17,1773
48181001802,4991,4053,481,59,70,20,2,18,938
48181001803,7408,5756,962,191,58,60,1,9,1652
48181001901,7316,5627,993,138,76,57,1,10,1689
48181001902,5287,4127,815,30,43,16,0,7,1160
48181002000,3418,1095,1597,563,14,23,0,8,2323
48183000201,3502,1857,815,636,10,55,6,7,1645
48183000202,3602,2679,265,411,3,110,2,14,923
48183000300,5698,3740,688,925,17,71,0,20,1958
48183000401,3807,2153,612,742,15,107,3,14,1654
48183000402,3343,2078,364,677,8,58,0,7,1265
48183000501,5206,3867,378,618,19,145,1,20,1339
48183000502,4725,2410,689,1343,15,78,3,7,2315
48183000601,4633,3327,430,541,11,101,0,12,1306
48183000602,3820,2595,255,530,23,228,0,8,1225
48183000700,5427,3161,792,1059,11,61,1,23,2266
48183000800,6720,2845,2003,1505,21,42,1,20,3875
48183000900,3123,1322,1011,648,9,16,0,10,1801
48183001000,2546,746,1064,634,8,11,1,5,1800
48183001100,3563,1081,944,1409,13,16,1,10,2482
48183001200,2604,163,1330,1033,3,16,2,7,2441
48183001300,4142,592,2027,1404,15,25,0,8,3550
48183001400,3672,499,1227,1786,3,18,6,7,3173
48183001500,4813,1001,1082,2518,10,72,3,9,3812
48183010100,6396,4836,653,536,21,81,1,12,1560
48183010201,4069,2698,319,806,17,29,3,1,1371
48183010202,3619,2809,372,200,20,18,4,5,810
48183010301,5350,3510,648,822,31,85,2,9,1840
48183010302,5388,3916,958,171,33,17,0,15,1472
48183010401,3531,2003,1043,304,18,15,1,13,1528
48183010402,5325,4047,688,349,20,20,2,16,1278
48183010501,2492,1086,489,834,6,0,1,2,1406
48183010502,2675,1175,434,910,18,29,1,3,1500
48183010600,5827,4170,684,650,16,79,0,5,1657
48183010700,4569,1652,1765,972,10,11,2,9,2917
48183980000,52,32,11,1,0,0,0,0,20
48185180101,5246,1763,2201,1140,8,11,1,18,3483
48185180102,5235,3600,1214,129,32,12,0,15,1635
48185180201,3983,1377,1459,1018,5,13,5,5,2606
48185180202,2974,1966,601,290,10,7,0,10,1008
48185180302,3339,2298,559,274,12,26,2,16,1041
48185180303,3120,2546,350,68,11,12,0,7,574
48185180304,2703,2152,296,143,7,10,0,13,551
48185180400,2668,1208,681,762,0,11,0,0,1460
48187210100,4351,1188,2798,222,7,21,3,11,3163
48187210200,4236,509,3313,353,8,6,0,8,3727
48187210300,5629,1464,3585,441,11,14,9,30,4165
48187210400,4482,2099,1943,247,13,62,2,3,2383
48187210505,4823,711,3989,37,6,21,0,2,4112
48187210506,3131,1818,1158,25,8,11,0,17,1313
48187210508,3081,1754,1154,43,4,24,2,8,1327
48187210509,5696,3176,2023,194,12,60,17,28,2520
48187210510,3603,2154,1226,75,4,27,3,27,1449
48187210511,2742,1406,1162,58,12,6,0,14,1336
48187210512,3646,1891,1297,214,1,101,4,15,1755
48187210513,1583,913,555,51,9,1,0,23,670
48187210603,2257,1202,865,67,4,19,4,18,1055
48187210606,3303,1967,1135,63,14,16,0,20,1336
48187210608,7322,3498,3269,175,23,76,8,36,3824
48187210609,3148,2114,753,75,8,46,1,12,1034
48187210610,4902,2842,1660,116,16,63,22,23,2060
48187210611,5241,2982,1756,117,17,120,19,35,2259
48187210612,7832,3602,2390,1071,28,176,30,37,4230
48187210613,5245,2032,1844,823,16,165,23,20,3213
48187210614,2810,1366,916,276,7,66,9,25,1444
48187210705,3063,1496,990,264,10,79,5,15,1567
48187210706,5145,2331,2142,281,10,99,10,20,2814
48187210707,6675,3202,2068,741,21,275,15,27,3473
48187210709,4360,2554,1187,280,12,108,15,16,1806
48187210710,3901,2075,1102,376,13,124,2,15,1826
48187210711,3288,1521,1010,484,3,98,11,11,1767
48187210712,4722,2439,1266,589,13,149,12,33,2283
48187210713,9253,3792,2880,1465,38,359,55,70,5461
48187210715,2885,1484,816,338,4,74,5,15,1401
48187210716,3344,1818,866,368,7,98,1,20,1526
48187210717,2656,1266,790,298,13,89,14,7,1390
48187210718,7499,3190,2527,1032,24,247,30,28,4309
48187210803,4842,3198,1289,152,19,13,4,14,1644
48187210804,4481,2984,1277,50,16,17,1,8,1497
48187210805,2631,1632,843,60,9,14,0,6,999
48187210806,2548,1241,1132,101,4,14,0,7,1307
48187210902,5809,3251,2061,180,12,90,12,23,2558
48187210903,1672,1169,389,33,3,2,0,16,503
48187210904,1760,734,936,39,12,1,0,3,1026
48187210905,3109,1998,871,73,5,15,5,8,1111
48189950100,4364,686,3419,162,13,0,10,2,3678
48189950200,3813,343,3176,232,12,12,1,4,3470
48189950300,6755,3027,3232,230,23,66,8,13,3728
48189950400,4190,1176,2659,226,9,29,4,10,3014
48189950500,2810,656,1944,109,18,8,3,12,2154
48189950600,3956,1986,1534,331,7,18,3,18,1970
48189950700,2729,1023,1588,35,11,7,1,5,1706
48189950800,1230,438,756,5,3,7,0,2,792
48189950900,2675,1358,1181,51,3,2,0,3,1317
48191950500,2825,1589,950,190,7,9,0,3,1236
48193950100,2611,2100,362,11,21,12,1,3,511
48193950200,2365,2024,228,9,6,11,0,6,341
48193950300,3246,2681,455,12,10,13,1,8,565
48195950100,1644,931,677,1,3,0,1,9,713
48195950300,3641,1621,1938,11,13,9,2,9,2020
48197950100,3549,2441,818,130,14,18,1,7,1108
48199030100,3098,2872,108,14,9,7,0,2,226
48199030200,5734,4892,356,158,18,39,6,13,842
48199030301,4067,3623,197,98,20,2,2,17,444
48199030302,7810,6790,556,34,45,75,11,19,1020
48199030400,2241,1545,114,466,8,21,1,11,696
48199030501,4268,3804,236,14,15,29,0,9,464
48199030503,3728,3096,364,27,17,54,4,16,632
48199030504,5082,4366,375,37,10,75,3,13,716
48199030600,3527,3109,241,17,7,4,3,5,418
48199030700,4087,2870,242,778,10,35,2,3,1217
48199030800,4688,2979,215,1278,7,25,1,11,1709
48199030900,3986,3489,257,46,9,19,0,12,497
48199031000,3915,3499,156,70,15,14,1,18,416
48201100001,6543,3216,1374,1157,19,512,1,21,3327
48201210400,4167,419,2775,823,3,30,1,25,3748
48201210500,5370,463,4284,483,5,38,5,11,4907
48201210600,5165,1124,3738,110,8,83,0,15,4041
48201210700,2293,166,1752,327,1,16,0,3,2127
48201210800,2623,120,1622,827,5,4,0,5,2503
48201210900,1616,33,539,976,3,21,0,8,1583
48201211000,1973,41,881,997,1,11,0,5,1932
48201211101,3047,83,1710,1197,8,4,2,5,2964
48201211102,2477,54,1492,886,1,1,0,3,2423
48201211200,2988,54,1365,1490,2,1,2,2,2934
48201211301,2680,88,855,1630,11,7,0,5,2592
48201211302,2594,105,924,1476,10,8,1,5,2489
48201211400,4257,590,1305,2110,3,130,2,15,3667
48201211501,3164,72,3054,13,1,2,1,7,3092
48201211502,2799,70,2439,255,11,2,0,7,2729
48201211600,2845,124,2213,455,0,19,0,0,2721
48201211700,3732,57,1586,1988,6,2,0,16,3675
48201211900,4717,118,4525,31,6,9,0,5,4599
48201212300,5027,518,3824,529,6,67,0,18,4509
48201212400,2947,79,2684,144,23,0,0,0,2868
48201212500,3792,68,1665,2005,4,7,0,2,3724
48201220100,2052,41,1120,855,2,5,0,6,2011
48201220200,2625,187,2344,51,7,11,0,1,2438
48201220300,3972,256,3589,53,7,15,0,32,3716
48201220400,4667,203,4244,169,3,10,2,4,4464
48201220500,4470,456,3155,723,14,33,0,19,4014
48201220600,3733,175,2750,755,9,15,0,6,3558
48201220701,3241,139,2154,919,0,4,0,3,3102
48201220702,3165,62,2600,464,5,10,0,2,3103
48201220800,3198,82,1759,1302,2,19,0,4,3116
48201220900,1907,110,1448,291,0,20,2,6,1797
48201221000,4288,188,3441,570,4,2,0,40,4100
48201221100,3718,232,3407,50,0,5,0,6,3486
48201221200,6124,438,5495,119,10,7,1,21,5686
48201221301,4486,289,4088,48,5,8,1,26,4197
48201221302,3684,165,3394,77,4,12,0,10,3519
48201221400,5902,445,4975,393,7,18,1,25,5457
48201221501,4941,299,4383,172,9,55,0,7,4642
48201221502,2859,46,1903,824,5,29,0,2,2813
48201221601,3313,237,3003,27,5,11,0,6,3076
48201221602,5886,602,5066,118,4,52,0,9,5284
48201221701,4086,232,3774,49,7,5,0,6,3854
48201221702,3574,170,3250,25,0,98,1,9,3404
48201221800,4371,218,4073,43,5,7,2,7,4153
48201221900,4684,265,4307,66,1,9,0,18,4419
48201222000,2290,246,1906,107,6,5,0,9,2044
48201222100,5487,305,5014,119,2,7,0,21,5182
48201222200,3812,236,3190,319,2,23,0,14,3576
48201222300,4846,401,4249,104,2,35,0,14,4445
48201222401,3777,253,3391,32,12,67,1,5,3524
48201222402,5758,459,4957,237,3,42,0,14,5299
48201222501,3620,129,3318,93,9,46,5,8,3491
48201222502,4395,359,3852,120,2,36,0,10,4036
48201222504,3345,82,2984,203,3,23,1,18,3263
48201222505,2986,144,2715,92,0,14,0,3,2842
48201222601,2322,93,1862,261,2,66,3,18,2229
48201222602,2694,122,1353,1117,2,29,13,13,2572
48201222701,2360,85,550,1679,0,1,0,3,2275
48201222702,3532,134,712,2578,1,22,1,21,3398
48201222800,3320,301,2877,27,11,74,1,3,3019
48201222900,8030,474,6705,662,16,81,13,26,7556
48201223001,3885,231,3321,290,0,9,0,4,3654
48201223002,4004,169,3418,352,3,37,1,5,3835
48201223100,2233,208,1864,113,1,16,0,12,2025
48201230100,1824,13,542,1235,1,2,0,6,1811
48201230200,5380,131,1505,3618,3,11,0,15,5249
48201230300,2298,50,987,1223,1,1,0,1,2248
48201230400,3824,99,2115,1557,1,4,0,7,3725
48201230500,4099,119,3399,491,3,18,1,21,3980
48201230600,2690,24,1338,1253,4,17,0,12,2666
48201230700,2963,46,1087,1774,2,12,0,2,2917
48201230800,2662,59,970,1582,1,7,0,2,2603
48201230900,4947,87,1969,2815,1,9,4,12,4860
48201231000,4727,91,2178,2348,10,12,0,16,4636
48201231100,4920,173,3247,1436,3,9,0,5,4747
48201231200,6800,92,2461,4136,0,7,3,17,6708
48201231300,4796,115,1512,3052,8,10,0,13,4681
48201231400,3347,47,928,2294,11,11,0,15,3300
48201231500,2863,41,669,2081,2,2,0,8,2822
48201231600,2915,42,937,1875,0,8,0,3,2873
48201231700,4509,161,4152,130,16,9,0,13,4348
48201231800,3066,83,1882,1052,0,14,0,15,2983
48201231900,6633,139,2583,3762,7,24,1,30,6494
48201232000,4371,126,2638,1505,2,39,1,12,4245
48201232100,3803,263,2416,1037,3,15,4,14,3540
48201232201,5754,772,3679,1099,13,86,8,18,4982
48201232202,5698,2218,1735,833,17,605,3,43,3480
48201232203,5924,1429,1376,2341,19,476,13,48,4495
48201232303,6451,274,3641,2372,5,27,23,22,6177
48201232304,7774,644,4658,2323,17,23,0,22,7130
48201232305,10957,567,6493,3586,5,104,7,47,10390
48201232306,3644,288,2101,1155,8,25,2,23,3356
48201232402,3820,166,2125,1364,5,76,0,18,3654
48201232403,4575,228,2990,1193,3,74,4,18,4347
48201232404,3652,752,2594,184,5,48,0,27,2900
48201232405,5832,331,3256,1798,6,351,0,21,5501
48201232500,3157,467,2153,475,3,16,3,8,2690
48201232600,2892,327,2339,173,4,17,0,3,2565
48201232701,7066,234,5171,1515,4,60,0,19,6832
48201232703,2740,95,2074,509,1,22,0,16,2645
48201232704,2009,310,1121,522,2,7,0,8,1699
48201232801,2621,195,1343,974,7,70,0,7,2426
48201232802,2715,134,1625,822,3,66,0,14,2581
48201232901,3992,413,1673,1681,1,121,1,6,3579
48201232902,4380,383,2096,1694,10,101,7,8,3997
48201233001,4163,596,1905,1549,0,27,2,18,3567
48201233002,4040,492,2151,1166,19,122,0,20,3548
48201233003,2470,630,1603,174,5,20,2,4,1840
48201233101,4640,401,3915,235,2,37,0,2,4239
48201233103,5475,373,4879,114,5,58,0,6,5102
48201233104,3110,212,2833,47,5,2,0,1,2898
48201233105,3734,373,3268,62,5,2,0,9,3361
48201233200,6461,850,5313,217,2,30,0,11,5611
48201233300,4468,236,4096,80,17,18,1,0,4232
48201233400,2566,179,2112,235,3,4,0,1,2387
48201233501,3702,353,3232,49,6,16,0,8,3349
48201233502,3346,281,3013,22,3,2,0,6,3065
48201233600,2424,62,1121,1178,0,10,1,8,2362
48201233701,5171,417,4113,581,12,3,2,16,4754
48201233702,2932,183,2688,23,0,4,0,11,2749
48201233703,2655,258,2352,18,2,2,0,4,2397
48201240101,1991,80,1664,197,1,19,1,10,1911
48201240102,1835,145,859,764,14,13,0,1,1690
48201240400,7984,1013,4320,2227,11,222,34,24,6971
48201240503,1922,53,1122,674,1,7,2,13,1869
48201240504,3321,132,1557,1521,3,45,7,11,3189
48201240505,1483,45,777,604,0,9,2,6,1438
48201240506,5074,184,2959,1816,8,18,0,25,4890
48201240600,2458,101,1456,838,3,13,2,6,2357
48201240703,5144,288,2796,1792,0,127,2,21,4856
48201240704,5092,320,2641,1896,9,135,4,25,4772
48201240705,6099,197,3927,1770,8,81,2,15,5902
48201240706,9971,427,6161,2996,12,188,4,42,9544
48201240707,6501,309,3749,2013,6,276,13,33,6192
48201240802,7540,816,2732,3588,8,131,33,13,6724
48201240803,2806,594,1202,856,11,51,13,15,2212
48201240804,3287,245,1678,1231,7,40,3,22,3042
48201240903,6490,741,2716,2579,16,178,80,37,5749
48201240904,9274,1489,4047,3088,32,327,59,27,7785
48201240905,3875,545,1899,1173,8,126,40,22,3330
48201240906,8223,750,3505,3380,6,250,93,37,7473
48201241001,4729,1352,1990,1081,9,103,10,22,3377
48201241002,4105,1412,1672,715,7,84,7,35,2693
48201241101,5037,1647,2079,978,9,95,17,25,3390
48201241103,4376,1045,1762,1254,13,93,15,24,3331
48201241104,9294,1939,3797,2942,14,219,33,60,7355
48201241105,4813,1298,2141,1116,9,61,14,20,3515
48201241201,3369,1056,1304,803,16,45,20,9,2313
48201241202,5445,1238,2074,1724,4,165,17,29,4207
48201241301,5476,1670,1779,1506,15,284,8,32,3806
48201241302,6895,2132,2179,1741,20,516,26,47,4763
48201241400,9821,3834,3136,1923,20,350,63,71,5987
48201241501,4732,575,2117,1709,6,154,39,18,4157
48201241502,2349,110,858,1281,9,27,26,4,2239
48201241503,2720,232,1770,631,0,42,2,16,2488
48201250101,4361,914,2054,1168,2,100,22,9,3447
48201250102,5569,612,3155,1496,12,108,29,32,4957
48201250201,8046,738,4237,2709,11,154,32,36,7308
48201250202,2205,186,1051,802,2,27,88,11,2019
48201250303,3360,391,835,1851,15,182,2,25,2969
48201250304,9244,1533,3753,3518,20,171,34,27,7711
48201250305,6059,1561,2315,1800,12,116,14,52,4498
48201250306,4666,748,1760,1773,5,222,1,9,3918
48201250403,5125,2554,1238,882,26,203,14,22,2571
48201250404,5540,2961,1134,957,28,182,18,33,2579
48201250405,7326,2970,2401,1338,13,270,16,50,4356
48201250406,4779,2124,1322,948,6,163,16,25,2655
48201250407,10435,5186,2821,1605,12,329,15,43,5249
48201250408,9128,2088,2943,3297,22,364,3,69,7040
48201250500,5771,2147,1724,1488,11,178,11,15,3624
48201250601,3898,1046,1438,1047,10,115,89,15,2852
48201250602,4792,1065,1614,1755,18,68,91,40,3727
48201250701,6613,2732,2185,1061,31,292,30,28,3881
48201250702,4879,2617,1236,659,13,141,8,24,2262
48201250801,3981,2622,757,283,14,91,4,23,1359
48201250802,4453,3175,709,144,13,164,8,14,1278
48201250901,3548,2458,560,253,3,80,0,9,1090
48201250902,6027,4938,521,108,24,159,1,21,1089
48201251000,3093,2058,523,211,1,152,2,18,1035
48201251100,7365,4935,1510,373,30,201,0,42,2430
48201251200,5987,3820,1467,278,5,166,11,29,2167
48201251300,7298,5408,1190,201,21,116,0,39,1890
48201251401,3011,1897,664,141,16,135,0,2,1114
48201251402,5914,3788,1401,305,1,122,9,27,2126
48201251501,6469,4286,1011,249,22,547,6,41,2183
48201251503,2255,1550,407,66,15,90,5,6,705
48201251504,5289,3958,737,120,13,172,4,28,1331
48201251505,3870,3054,480,81,12,76,5,10,816
48201251600,7271,5612,1082,162,33,72,0,40,1659
48201251701,4892,3485,996,91,25,42,1,15,1407
48201251702,4300,2930,883,257,9,42,2,11,1370
48201251800,2096,1272,643,78,0,6,0,6,824
48201251902,7828,4783,1834,815,20,71,0,25,3045
48201251903,4505,3135,1007,104,15,24,1,10,1370
48201251904,6790,4439,1540,408,32,64,1,42,2351
48201252001,7086,2010,2008,2375,13,379,4,30,5076
48201252002,5426,1799,1816,1269,6,301,6,26,3627
48201252003,11081,4164,3270,2541,12,654,8,47,6917
48201252100,3246,796,1994,354,1,12,2,7,2450
48201252201,4838,376,3005,1223,11,116,4,32,4462
48201252202,7192,888,5036,858,10,247,0,43,6304
48201252303,5132,238,3372,1333,5,121,0,9,4894
48201252304,3563,305,2118,1004,4,66,1,17,3258
48201252305,7800,662,5177,1619,3,198,4,21,7138
48201252306,8943,553,6831,1291,4,151,0,30,8390
48201252400,7763,1792,5564,222,17,33,1,31,5971
48201252500,5051,952,3896,68,17,35,0,41,4099
48201252601,4895,1000,3729,85,3,9,10,4,3895
48201252602,3721,927,2661,37,6,33,0,6,2794
48201252700,5007,2597,1851,339,5,21,4,18,2410
48201252800,8024,1775,3536,2485,23,31,0,29,6249
48201252901,3263,1914,1065,128,10,20,1,7,1349
48201252902,7173,3050,3226,559,27,47,0,33,4123
48201253000,4637,1142,1865,1480,17,31,0,15,3495
48201253101,6624,1696,3110,1382,15,240,4,10,4928
48201253102,7051,1652,3228,1335,14,588,5,49,5399
48201253201,6342,3550,1909,583,19,43,2,14,2792
48201253202,5341,1309,2523,1214,0,99,0,46,4032
48201253300,3836,1968,1481,221,11,37,2,12,1868
48201253501,6552,1844,2593,1544,11,340,0,32,4708
48201253502,3799,687,1976,992,2,31,0,28,3112
48201253601,4187,1681,1529,622,9,218,0,35,2506
48201253602,4735,727,2341,1319,30,98,6,92,4008
48201253700,5580,1634,2552,1054,8,132,4,43,3946
48201253800,8862,2298,5047,1170,41,85,7,38,6564
48201253900,4634,1779,1819,790,4,59,2,25,2855
48201254000,3935,1268,1779,679,17,38,4,20,2667
48201254100,5466,1164,3385,727,11,57,2,23,4302
48201254200,2922,422,2249,171,7,4,4,18,2500
48201254300,5340,1046,3297,772,21,22,4,46,4294
48201254400,3116,347,2330,353,1,3,0,19,2769
48201254600,3691,538,2585,388,15,33,1,25,3153
48201254700,2428,1084,917,270,3,35,4,12,1344
48201254800,2705,523,1712,380,10,5,0,23,2182
48201310101,3655,1350,1393,549,12,212,3,18,2305
48201310102,2455,542,773,967,6,90,0,19,1913
48201310200,2361,948,509,512,9,251,0,13,1413
48201310300,5026,1207,2954,533,17,158,1,19,3819
48201310400,3316,344,2780,97,5,38,0,9,2972
48201310500,3755,336,3165,161,7,40,1,6,3419
48201310600,4961,702,3929,157,9,86,6,12,4259
48201310700,3699,625,2833,72,17,87,0,9,3074
48201310800,2663,250,2233,103,2,38,0,14,2413
48201310900,5334,257,4840,123,18,44,0,10,5077
48201311001,3040,85,2883,38,6,12,0,6,2955
48201311002,3299,146,3085,41,9,7,2,7,3153
48201311100,5238,205,4926,63,1,15,0,8,5033
48201311200,4588,350,3999,175,5,18,0,9,4238
48201311300,4912,203,4613,29,2,17,3,13,4709
48201311400,1546,69,1299,157,2,0,0,2,1477
48201311501,2966,88,2742,93,5,18,0,4,2878
48201311502,3723,109,3402,56,0,130,0,9,3614
48201311600,3628,50,3257,236,2,42,0,16,3578
48201311701,3506,145,3062,255,0,11,0,10,3361
48201311702,1890,83,1347,413,1,16,0,4,1807
48201311800,4325,199,3834,196,10,47,0,15,4126
48201311900,2145,155,1832,92,9,27,0,3,1990
48201312000,5759,1651,1024,1513,4,1443,0,7,4108
48201312200,2351,160,408,1654,14,54,2,8,2191
48201312300,2410,381,452,1324,7,159,0,10,2029
48201312400,1981,159,286,1435,2,34,0,5,1822
48201312501,2484,1033,453,461,3,395,0,29,1451
48201312502,2384,914,446,793,14,127,1,15,1470
48201312601,2797,1530,376,311,10,430,2,18,1267
48201312602,2453,1206,405,392,2,323,1,19,1247
48201312603,3082,1105,659,673,5,484,0,15,1977
48201312700,1859,283,258,1201,8,47,0,10,1576
48201312800,5476,1204,742,2146,2,1248,2,11,4272
48201312901,1505,76,118,1228,1,63,0,1,1429
48201312902,1801,205,140,1357,5,30,4,9,1596
48201313000,2462,393,308,1576,5,77,3,10,2069
48201313101,2297,1069,417,337,3,381,0,2,1228
48201313102,2011,968,226,181,3,543,4,7,1043
48201313201,1610,145,97,1230,0,57,1,23,1465
48201313202,2790,424,317,1854,0,86,5,4,2366
48201313300,3156,201,458,2340,2,64,0,11,2955
48201313400,3603,192,813,2465,16,52,0,8,3411
48201313500,2649,71,622,1888,4,10,0,7,2578
48201313600,4871,128,1414,3181,17,23,0,8,4743
48201313700,2256,64,250,1856,6,13,1,8,2192
48201313801,2035,48,214,1717,4,12,0,1,1987
48201313802,2797,54,430,2216,0,25,3,11,2743
48201313901,2211,552,349,778,0,388,1,12,1659
48201313902,2592,601,331,922,5,583,3,27,1991
48201314001,3104,1022,410,478,2,1058,0,17,2082
48201314003,2591,558,246,193,4,1547,0,6,2033
48201314004,1668,343,282,592,0,391,0,14,1325
48201314005,2468,668,307,615,5,791,0,28,1800
48201314301,2363,121,259,1815,5,79,0,11,2242
48201314302,2440,136,220,1861,4,160,0,15,2304
48201314401,1545,538,205,108,0,645,0,5,1007
48201314402,1717,469,206,196,2,787,0,3,1248
48201320100,2408,148,2077,112,1,35,0,10,2260
48201320201,2461,111,2174,61,8,84,0,9,2350
48201320202,3648,244,2578,104,1,688,0,12,3404
48201320500,4300,248,3931,61,14,8,0,0,4052
48201320601,2474,162,2161,64,13,41,0,9,2312
48201320602,4460,181,3975,237,5,33,0,15,4279
48201320700,4550,411,3102,665,11,320,0,16,4139
48201320800,5023,299,4631,26,0,49,0,8,4724
48201320901,3758,223,2587,835,9,53,0,14,3535
48201320902,3722,296,3264,71,2,53,0,14,3426
48201321001,2776,175,2161,369,0,32,0,10,2601
48201321002,5450,557,4601,153,4,77,0,7,4893
48201321101,4008,507,2083,894,2,444,1,15,3501
48201321102,4098,504,3157,165,9,211,5,1,3594
48201321200,4512,335,3815,228,2,68,2,14,4177
48201321301,3364,186,2589,494,6,36,0,21,3178
48201321302,1892,271,1510,74,6,9,0,6,1621
48201321401,4336,300,3921,45,10,12,0,10,4036
48201321402,4077,366,3580,66,6,21,1,6,3711
48201321500,2717,163,2319,193,2,17,1,8,2554
48201321600,6792,774,5805,131,11,31,0,0,6018
48201321700,3108,393,2617,38,0,39,1,8,2715
48201321800,3927,262,3594,36,3,13,0,0,3665
48201321900,5657,489,5051,38,6,30,0,18,5168
48201322000,3771,227,3294,181,4,33,1,19,3544
48201322100,4142,480,3431,140,5,22,2,11,3662
48201322200,1831,140,1636,17,0,12,0,6,1691
48201322600,5237,1287,3711,123,3,34,2,13,3950
48201322701,2807,483,2204,45,9,7,1,10,2324
48201322702,4336,735,3461,41,4,16,0,16,3601
48201322800,6246,763,5384,55,3,4,0,7,5483
48201322900,4072,371,3560,97,2,7,7,7,3701
48201323000,5821,571,4950,211,10,4,0,38,5250
48201323100,3492,354,2823,249,4,14,0,11,3138
48201323200,5595,871,4414,146,12,39,3,22,4724
48201323300,3397,405,2794,141,0,6,4,3,2992
48201323400,7275,924,6120,122,8,20,0,16,6351
48201323500,5349,669,3775,722,22,76,0,18,4680
48201323601,4068,1189,2488,235,21,59,8,15,2879
48201323602,4963,1543,2954,95,11,276,2,14,3420
48201323701,4420,1591,2230,300,20,150,0,12,2829
48201323702,3252,1109,1825,162,4,61,2,7,2143
48201323801,4068,831,3099,48,5,27,5,20,3237
48201323802,5005,1014,3757,144,9,19,1,20,3991
48201323900,3710,1077,2278,220,9,17,3,11,2633
48201324000,5817,1996,3152,167,8,353,1,28,3821
48201324101,5279,495,4613,72,3,22,0,15,4784
48201324102,0,0,0,0,0,0,0,0,0
48201324200,1279,33,1226,0,2,1,0,10,1246
48201330101,5091,49,3177,1763,1,46,0,5,5042
48201330102,2703,51,1626,963,3,24,2,8,2652
48201330200,4290,149,2535,1484,0,48,0,14,4141
48201330301,7941,234,5460,1830,3,314,0,32,7707
48201330302,5713,160,3692,1746,9,45,4,8,5553
48201330303,4515,199,2244,1961,0,49,0,23,4316
48201330400,4863,119,2926,1727,10,27,1,10,4744
48201330500,4745,151,2739,1641,12,115,0,17,4594
48201330600,7139,208,3292,3448,3,84,4,23,6931
48201330700,8797,247,6105,2246,12,88,1,23,8550
48201330801,6136,337,2922,2507,5,262,2,13,5799
48201330802,9471,551,2166,6121,16,354,0,34,8920
48201330901,9527,698,2352,5456,13,713,4,66,8829
48201330902,3823,156,3356,279,0,5,4,8,3667
48201331100,4610,114,1054,3305,12,20,2,13,4496
48201331200,4441,121,630,3549,16,12,2,15,4320
48201331300,5032,58,902,3974,5,13,0,8,4974
48201331400,2538,19,124,2324,10,19,0,2,2519
48201331501,3908,43,557,3227,4,6,0,5,3865
48201331502,5359,238,1277,3539,0,160,1,25,5121
48201331602,3604,83,841,2564,11,31,0,21,3521
48201331603,4199,33,703,3367,5,26,3,15,4166
48201331604,2542,30,314,2148,7,3,2,5,2512
48201331700,4055,39,876,3051,5,11,1,12,4016
48201331800,3868,54,914,2816,7,14,0,17,3814
48201331900,3354,45,729,2512,5,6,0,7,3309
48201332000,6034,58,1810,4019,1,36,1,27,5976
48201332100,2954,26,1744,1144,0,5,2,5,2928
48201332200,4921,53,2668,2069,9,24,0,14,4868
48201332300,2999,31,1044,1873,0,12,0,5,2968
48201332400,4060,80,914,2992,5,3,0,16,3980
48201332500,3190,82,1726,1316,3,11,0,10,3108
48201332600,6577,202,4326,1937,3,23,3,16,6375
48201332700,2473,135,2201,92,6,12,0,5,2338
48201332800,3962,219,3139,546,3,12,0,18,3743
48201332900,4885,396,4133,258,4,43,0,26,4489
48201333000,3290,225,2875,95,0,35,0,24,3065
48201333100,3793,354,1760,612,7,1002,1,20,3439
48201333201,4818,242,3208,1192,19,116,0,9,4576
48201333203,2163,202,1425,437,5,51,0,9,1961
48201333204,1280,40,719,485,0,8,1,14,1240
48201333205,1515,59,768,649,2,18,0,4,1456
48201333301,5693,257,3191,1968,24,124,1,25,5436
48201333302,3661,218,3079,201,4,124,5,3,3443
48201333501,3443,126,2668,556,3,48,1,8,3317
48201333502,2621,177,1990,399,5,26,0,0,2444
48201333600,3215,619,2228,279,7,35,0,16,2596
48201333700,3442,221,2849,215,3,125,0,10,3221
48201333801,4188,180,3643,260,1,66,0,5,4008
48201333802,5797,409,3905,1268,6,140,2,13,5388
48201333903,3689,299,2364,678,1,281,2,10,3390
48201333904,5058,560,2809,1151,14,388,0,30,4498
48201333905,4159,224,2629,458,1,781,2,20,3935
48201333906,5147,242,3257,530,6,1020,0,34,4905
48201334001,3707,288,1506,1064,11,762,0,19,3419
48201334002,2240,406,832,809,7,108,0,16,1834
48201334003,6349,1207,3519,973,1,489,0,24,5142
48201334101,7291,1062,1078,3793,5,1046,5,46,6229
48201334102,7351,406,3017,3487,7,286,3,30,6945
48201340101,1879,330,500,621,4,320,0,22,1549
48201340102,5395,919,2687,778,3,846,2,10,4476
48201340201,0,0,0,0,0,0,0,0,0
48201340202,7911,4001,1326,287,7,1928,4,32,3910
48201340203,4434,2813,539,140,5,735,0,8,1621
48201340301,3906,2462,363,99,3,794,0,21,1444
48201340302,6761,4515,1047,132,14,702,0,30,2246
48201340400,1306,927,150,21,2,125,2,14,379
48201340501,3904,2155,988,296,12,228,0,23,1749
48201340502,2878,811,1550,312,2,101,0,5,2067
48201340600,2563,1717,481,93,1,112,11,33,846
48201340701,4055,1885,1315,205,12,463,5,25,2170
48201340702,2961,1562,704,228,14,281,3,21,1399
48201340800,5580,3185,1084,195,17,803,2,35,2395
48201340900,4537,1577,1486,824,10,405,7,21,2960
48201341001,3957,1661,1088,693,17,335,2,30,2296
48201341002,3695,1732,1045,513,12,239,2,18,1963
48201341101,1480,495,653,197,1,68,0,5,985
48201341102,2641,1029,965,348,2,178,1,17,1612
48201341201,5326,2032,1784,860,21,404,1,45,3294
48201341203,2355,1503,492,177,4,54,2,10,852
48201341204,3843,2400,777,283,15,195,2,14,1443
48201341302,3467,1365,989,597,2,356,3,21,2102
48201341303,3304,1798,779,282,12,260,1,28,1506
48201341304,2036,1108,336,193,10,327,0,2,928
48201341400,5664,4176,721,198,19,275,0,19,1488
48201341501,6736,4669,1227,281,21,193,1,49,2067
48201341502,4393,2931,722,284,15,182,5,36,1462
48201341600,6711,4613,1276,214,29,225,1,25,2098
48201341700,2723,1878,597,83,30,27,0,20,845
48201341800,2489,1509,665,159,11,29,1,12,980
48201342001,6812,4287,1907,69,17,313,7,30,2525
48201342002,4436,2023,1784,160,9,356,2,25,2413
48201342100,4292,1665,2309,65,0,145,4,6,2627
48201342200,3918,1265,2262,148,18,86,0,11,2653
48201342300,7213,2593,3928,377,12,93,0,42,4620
48201342400,4007,1172,2488,179,7,51,1,6,2835
48201342500,6240,3824,2034,92,23,71,0,38,2416
48201342700,5145,3084,1712,95,10,34,4,19,2061
48201342801,4867,2949,1556,60,19,94,8,22,1918
48201342802,3988,2658,1069,24,15,73,0,24,1330
48201342900,7084,4151,2433,110,19,81,9,20,2933
48201343000,7460,3385,3262,400,20,117,5,37,4075
48201343100,4556,2582,1495,228,20,54,1,16,1974
48201343200,5089,2787,1883,188,6,34,1,25,2302
48201343301,4400,2319,1745,101,19,37,0,14,2081
48201343302,4876,2743,1634,219,19,51,6,21,2133
48201343601,11,0,4,0,0,0,0,0,11
48201343602,3341,1781,1196,188,18,32,0,25,1560
48201343700,3860,1405,1711,552,5,41,2,15,2455
48201350101,5269,655,1441,631,3,2402,0,13,4614
48201350102,4830,2353,1093,356,11,877,2,31,2477
48201350103,7487,1685,3424,898,18,1312,4,22,5802
48201350104,4850,834,1764,1155,8,954,0,24,4016
48201350201,3740,634,2414,486,1,121,0,21,3106
48201350202,4684,1022,2705,467,14,358,1,19,3662
48201350300,6002,1850,2853,753,12,398,1,16,4152
48201350400,6235,930,3544,1078,11,521,8,20,5305
48201350500,7117,1097,3594,881,5,1389,2,38,6020
48201350601,4372,2168,1234,502,19,276,3,24,2204
48201350603,4631,2070,1197,463,8,680,12,26,2561
48201350604,3941,1950,984,404,14,376,6,21,1991
48201350700,2326,1475,616,107,2,35,2,3,851
48201350801,5098,2501,1609,518,16,215,12,27,2597
48201350803,3181,1409,1015,467,9,142,3,10,1772
48201350804,5648,2781,902,527,3,1217,4,15,2867
48201410101,2159,777,533,539,4,186,0,16,1382
48201410102,4007,1644,641,1193,2,334,3,34,2363
48201410201,2176,1355,396,112,1,204,0,14,821
48201410202,3361,2103,618,103,15,355,7,21,1258
48201410300,3722,2520,559,157,2,327,1,19,1202
48201410401,3985,2706,627,77,10,349,1,25,1279
48201410402,2623,1757,417,75,1,246,5,17,866
48201410501,1746,1124,335,51,2,137,1,9,622
48201410502,3070,1882,591,120,4,299,30,24,1188
48201410601,3444,1786,682,370,6,429,0,38,1658
48201410602,2508,1384,496,217,7,187,96,17,1124
48201410703,2179,1439,331,107,5,199,0,3,740
48201410704,1895,1280,306,110,3,119,0,2,615
48201410705,916,473,270,47,1,79,0,1,443
48201410706,1738,866,304,324,5,145,0,13,872
48201410801,2578,1495,512,112,4,305,0,16,1083
48201410802,1631,1010,360,65,1,112,0,7,621
48201410900,3535,2165,609,187,2,380,3,15,1370
48201411001,1986,1317,248,137,0,192,0,18,669
48201411002,2186,1391,316,79,1,292,0,10,795
48201411003,1614,1004,253,79,6,188,0,12,610
48201411100,3420,2343,431,103,4,411,0,13,1077
48201411200,1759,1443,147,21,0,103,4,6,316
48201411301,2119,1226,394,197,5,200,0,9,893
48201411302,3217,1821,526,324,2,361,1,47,1396
48201411400,2774,2276,223,29,6,162,0,7,498
48201411503,3478,1994,624,197,2,494,0,20,1484
48201411504,2329,1300,413,189,5,301,0,2,1029
48201411505,2826,1688,433,163,0,358,1,17,1138
48201411506,2273,1329,338,181,2,338,0,10,944
48201411507,2093,1121,442,182,0,269,1,6,972
48201411600,2933,2003,342,185,0,292,0,6,930
48201411700,3793,1602,760,461,6,778,4,24,2191
48201411801,3257,1737,445,171,1,741,4,12,1520
48201411802,2758,1606,413,145,3,426,3,21,1152
48201411901,2079,1560,259,43,4,112,1,8,519
48201411902,2135,1413,278,148,3,220,0,7,722
48201412000,3744,2846,324,61,6,354,1,19,898
48201412201,2882,1654,307,134,4,635,0,14,1228
48201412202,3093,1783,315,99,5,662,0,34,1310
48201412300,6837,4950,625,61,12,866,0,19,1887
48201412400,4503,3345,385,24,7,508,3,21,1158
48201412500,1835,1230,201,63,0,238,0,3,605
48201412600,3885,2632,438,38,4,556,0,20,1253
48201412700,3370,1874,440,77,5,830,0,17,1496
48201412800,4905,2795,468,43,13,1367,4,18,2110
48201412901,1577,564,291,428,0,237,0,3,1013
48201412902,3126,1393,484,518,2,631,5,5,1733
48201413000,3507,2042,482,193,2,615,2,25,1465
48201413100,3088,2094,394,69,6,376,1,13,994
48201413203,1547,775,240,102,1,400,0,0,772
48201413204,1077,329,214,210,2,287,1,3,748
48201413205,1458,635,272,123,5,359,0,6,823
48201413206,2813,1178,426,266,1,813,5,14,1635
48201413301,4489,1807,684,861,7,948,3,31,2682
48201413302,3209,1778,503,167,9,578,5,24,1431
48201420100,2773,411,836,1113,7,310,0,15,2362
48201420200,2430,665,972,416,1,288,0,7,1765
48201420300,3557,1951,590,584,4,248,1,28,1606
48201420400,3487,2145,820,144,5,217,0,9,1342
48201420500,3845,223,2821,508,12,241,0,7,3622
48201420600,2279,1158,634,183,0,191,4,13,1121
48201420700,3039,2017,352,104,6,375,1,28,1022
48201420800,2274,1381,273,51,1,450,2,12,893
48201420900,6386,4079,567,104,1,1336,0,34,2307
48201421000,2567,1447,359,65,9,542,5,21,1120
48201421101,3257,568,1323,791,4,477,0,12,2689
48201421103,1473,119,320,798,3,189,0,11,1354
48201421104,4376,135,3881,290,2,14,0,22,4241
48201421203,1805,146,1058,393,8,151,0,8,1659
48201421204,2428,115,1818,407,1,47,1,17,2313
48201421205,2315,101,1879,255,10,31,1,11,2214
48201421206,2054,68,1847,84,6,11,0,9,1986
48201421301,3576,132,2652,639,6,98,0,8,3444
48201421302,4423,547,1003,835,9,1915,1,37,3876
48201421401,3517,122,1951,526,9,755,7,34,3395
48201421402,3284,47,2733,284,0,151,0,20,3237
48201421403,4597,169,3549,661,5,150,0,19,4428
48201421501,3528,462,2211,547,7,215,0,32,3066
48201421502,2838,183,776,1509,4,312,0,8,2655
48201421601,3112,80,2729,216,0,38,0,20,3032
48201421602,3409,472,2377,118,3,344,2,16,2937
48201421700,4594,1909,1649,242,10,632,3,29,2685
48201421801,3072,472,926,1408,6,126,1,23,2600
48201421802,2467,1083,434,422,0,388,3,22,1384
48201421900,2899,2127,364,105,1,165,0,10,772
48201422000,2597,1754,387,140,4,185,0,12,843
48201422100,5115,1707,2344,621,18,252,0,23,3408
48201422200,6024,136,1860,3835,8,70,2,18,5888
48201422302,2289,355,743,981,3,104,2,14,1934
48201422303,3550,76,1037,2297,9,42,0,18,3474
48201422304,3810,83,2175,1296,2,172,0,31,3727
48201422403,2783,838,1281,446,0,98,0,22,1945
48201422404,2966,268,2378,192,5,55,1,28,2698
48201422405,1589,132,427,748,0,259,0,1,1457
48201422406,2473,199,1341,826,3,48,0,5,2274
48201422501,3381,640,1548,895,3,173,0,53,2741
48201422502,3458,903,1522,851,7,82,0,38,2555
48201422601,4607,823,3055,536,3,97,0,23,3784
48201422602,2338,1061,1000,114,1,74,0,21,1277
48201422701,5107,568,3796,445,6,209,0,18,4539
48201422702,3257,654,2167,138,3,214,0,19,2603
48201422800,5138,835,3227,668,6,280,2,59,4303
48201422900,4874,396,3514,644,6,167,0,107,4478
48201423001,3019,202,1553,385,1,696,1,8,2817
48201423002,3072,359,2289,290,3,50,0,50,2713
48201423100,2775,62,1882,731,3,28,0,28,2713
48201423201,3252,590,1797,641,1,157,0,12,2662
48201423203,2567,213,1032,1080,1,186,0,13,2354
48201423204,4062,126,2623,1196,2,32,0,30,3936
48201423301,4393,1105,1276,1604,8,264,0,21,3288
48201423303,1809,256,313,1132,7,40,0,19,1553
48201423304,3605,791,802,1645,6,248,0,33,2814
48201423401,5329,1099,1292,2513,4,271,3,51,4230
48201423402,3944,126,1030,2061,0,638,3,18,3818
48201423500,1995,558,616,478,0,289,0,15,1437
48201423600,6943,482,3240,2697,7,389,0,38,6461
48201430101,2990,1804,623,193,6,250,0,17,1186
48201430102,2847,1828,471,192,7,249,0,9,1019
48201430200,1518,924,325,59,0,139,0,10,594
48201430300,4385,3508,336,37,7,350,0,18,877
48201430400,3118,2259,254,30,4,417,0,18,859
48201430500,2380,1571,316,36,11,322,0,10,809
48201430600,3832,2741,309,23,5,579,0,5,1091
48201430700,4191,2532,452,143,12,901,0,13,1659
48201430800,6091,3525,652,171,2,1393,3,84,2566
48201430900,6406,3758,702,164,5,1519,4,32,2648
48201431001,2616,1656,414,147,2,279,1,10,960
48201431002,2929,2110,350,104,3,246,0,9,819
48201431101,4023,1663,1008,868,9,293,0,16,2360
48201431102,3912,1376,1214,892,9,302,1,23,2536
48201431203,2117,596,834,343,14,253,2,10,1521
48201431204,3185,1388,454,210,14,1039,0,18,1797
48201431205,3207,763,1163,942,2,192,3,26,2444
48201431206,1985,745,425,354,2,391,1,12,1240
48201431302,4662,3180,669,314,5,298,0,34,1482
48201431303,2019,690,600,429,5,211,0,7,1329
48201431304,3195,1239,967,508,9,292,0,28,1956
48201431401,2270,1095,495,306,10,235,3,11,1175
48201431403,1504,772,271,120,8,277,0,18,732
48201431404,2166,1183,326,160,2,380,2,18,983
48201431503,1591,894,209,144,4,281,0,7,697
48201431504,2396,1946,199,34,3,125,0,17,450
48201431505,1603,1149,194,60,8,122,0,5,454
48201431506,2822,1723,464,157,2,339,1,20,1099
48201431600,3493,2897,314,56,10,114,0,13,596
48201431701,2473,1710,324,185,4,168,1,7,763
48201431702,2847,2248,327,36,4,160,0,6,599
48201431801,3531,1980,545,272,6,576,4,11,1551
48201431803,2597,1235,541,354,3,344,1,14,1362
48201431804,2690,1397,496,264,1,393,0,39,1293
48201431901,2390,1009,449,363,3,428,0,41,1381
48201431902,2963,1325,493,373,7,588,1,45,1638
48201432003,2066,532,853,439,0,123,0,54,1534
48201432004,2273,1050,407,168,7,525,5,20,1223
48201432005,2740,491,1265,685,7,170,2,21,2249
48201432006,2025,234,1229,461,5,46,0,8,1791
48201432101,2907,592,1170,566,7,450,1,12,2315
48201432102,3704,1168,1173,724,15,507,1,16,2536
48201432200,4232,1546,1402,710,9,390,0,27,2686
48201432301,2858,332,1354,902,8,169,1,20,2526
48201432302,2241,156,970,989,1,50,2,8,2085
48201432303,2221,421,688,793,5,226,0,10,1800
48201432401,3632,571,1475,1048,5,379,1,41,3061
48201432402,2482,294,996,879,6,232,1,25,2188
48201432501,3801,769,1641,667,6,479,1,12,3032
48201432502,1765,311,956,334,3,103,0,8,1454
48201432600,1867,838,487,390,2,91,2,6,1029
48201432703,2057,929,536,258,5,228,0,6,1128
48201432704,1724,266,1167,164,2,67,0,13,1458
48201432705,4271,122,3929,159,3,25,0,13,4149
48201432706,1962,353,1342,153,10,58,0,13,1609
48201432803,3174,232,2099,578,1,182,0,35,2942
48201432804,1955,251,1125,271,2,254,1,19,1704
48201432805,2017,76,1589,240,2,44,0,16,1941
48201432806,4345,443,2894,598,14,331,1,18,3902
48201432901,3161,262,2287,397,1,140,1,27,2899
48201432903,2196,122,1785,110,2,119,2,33,2074
48201432904,3797,379,2150,523,2,662,0,18,3418
48201433003,5580,92,3003,540,2,1825,3,94,5488
48201433004,3390,74,2900,236,1,165,0,7,3316
48201433005,2409,44,907,151,2,1262,0,5,2365
48201433006,2401,58,1571,630,1,91,0,32,2343
48201433007,1507,13,827,27,3,623,0,9,1494
48201433100,3398,74,2618,507,7,148,1,29,3324
48201433201,4801,519,2069,534,0,1597,0,18,4282
48201433202,4367,432,2760,180,9,925,3,28,3935
48201433300,5351,1086,2682,322,13,1103,4,16,4265
48201433400,4276,402,2614,818,12,369,0,20,3874
48201433503,1783,55,1210,457,2,24,0,23,1728
48201433504,3739,114,2899,515,10,57,0,116,3625
48201433505,2898,73,2381,253,0,157,0,14,2825
48201433506,2145,28,1573,469,0,46,0,14,2117
48201433507,3145,99,1851,931,3,190,0,31,3046
48201433601,2837,130,1953,600,3,101,0,20,2707
48201433602,3707,121,1677,1644,6,175,4,8,3586
48201440101,2269,111,1895,90,8,140,0,8,2158
48201440102,4556,711,1430,1933,12,363,0,14,3845
48201450100,1908,1245,245,22,2,313,1,8,663
48201450200,5749,4131,560,164,4,640,0,36,1618
48201450301,2944,1285,818,403,2,273,0,31,1659
48201450302,5318,1863,1551,1163,9,478,0,47,3455
48201450401,2180,942,461,381,2,296,0,9,1238
48201450402,2299,1098,541,296,4,220,0,14,1201
48201450500,3386,2155,495,188,8,405,2,11,1231
48201450600,5294,2864,1061,652,15,476,0,18,2430
48201450700,6765,5498,524,40,7,409,0,33,1267
48201450801,2069,782,442,632,4,123,1,15,1287
48201450803,4657,1554,1388,1344,12,222,1,41,3103
48201450804,3023,514,1432,795,5,166,0,29,2509
48201450900,2885,1596,570,376,5,234,0,13,1289
48201451003,3115,356,825,1707,6,110,0,20,2759
48201451004,2305,436,564,1101,6,113,0,11,1869
48201451005,1897,207,604,921,5,65,0,23,1690
48201451006,2478,1126,509,423,1,286,2,9,1352
48201451100,4383,2061,1043,725,1,355,8,31,2322
48201451200,2686,1915,423,71,6,166,0,13,771
48201451301,4296,1526,962,1266,8,341,0,34,2770
48201451302,2877,1855,512,142,3,198,1,12,1022
48201451401,3707,1439,875,852,10,361,1,16,2268
48201451404,4269,830,1141,1545,8,572,1,18,3439
48201451405,2369,644,562,741,9,324,1,11,1725
48201451406,2986,798,744,1134,4,181,2,19,2188
48201451407,1672,308,618,645,3,44,0,13,1364
48201451501,3046,814,635,893,14,544,2,14,2232
48201451502,2683,1080,596,556,5,316,0,16,1603
48201451603,3672,1359,614,566,11,988,0,15,2313
48201451604,4292,2426,631,297,5,756,0,19,1866
48201451605,4317,974,843,1253,7,1040,1,45,3343
48201451606,5883,2241,1380,651,11,1342,2,25,3642
48201451700,4263,699,1021,1890,13,462,3,63,3564
48201451800,5319,907,2009,1578,12,633,2,39,4412
48201451902,2517,772,277,253,1,1131,1,11,1745
48201451903,4153,184,1021,2588,3,132,1,125,3969
48201451904,3966,719,1347,1075,8,691,2,39,3247
48201452001,4678,761,1294,1999,8,451,4,41,3917
48201452002,3875,833,769,1773,5,308,4,45,3042
48201452101,6357,2346,1112,1608,6,1049,3,64,4011
48201452102,1896,351,540,768,0,178,0,21,1545
48201452103,2165,192,637,1177,1,89,0,21,1973
48201452202,3451,461,934,1621,1,308,2,16,2990
48201452203,3100,419,1051,1317,4,169,2,42,2681
48201452204,2617,341,888,1099,5,176,0,30,2276
48201452300,2226,107,1130,262,1,702,0,3,2119
48201452401,3976,224,1974,755,4,929,3,26,3752
48201452402,4048,261,2235,303,2,1191,0,31,3787
48201452501,2485,132,1434,299,1,570,0,21,2353
48201452502,4912,291,2084,1152,4,1338,0,11,4621
48201452601,4427,169,1667,2027,5,449,0,12,4258
48201452602,3367,184,902,545,0,1674,4,3,3183
48201452701,4557,194,1620,845,0,1832,2,16,4363
48201452702,3911,114,743,967,0,2044,0,5,3797
48201452703,3897,146,817,1661,0,1198,0,22,3751
48201452801,5751,459,1904,1796,0,1505,3,22,5292
48201452802,5928,191,2720,1603,3,1136,3,203,5737
48201452900,4274,291,2544,448,4,850,12,71,3983
48201453001,2455,78,1664,281,2,351,0,60,2377
48201453002,5141,274,3583,227,13,956,0,36,4867
48201453100,4304,150,2678,855,0,520,0,44,4154
48201453201,3546,137,2027,978,4,247,0,101,3409
48201453202,4228,271,2288,978,7,583,6,34,3957
48201453300,3485,101,1148,1552,16,595,2,18,3384
48201453401,3042,338,1666,569,5,379,2,22,2704
48201453403,4107,109,1847,1447,3,602,2,55,3998
48201453404,4379,271,2377,917,3,733,1,24,4108
48201453405,3962,230,1362,962,15,1247,5,65,3732
48201453501,6357,396,2779,1759,3,1279,1,45,5961
48201453502,3926,299,2254,919,1,380,7,18,3627
48201453601,2161,110,1115,522,3,290,0,97,2051
48201453603,3291,229,1532,846,0,617,0,21,3062
48201453604,4147,141,2589,699,3,616,0,57,4006
48201453701,4531,283,2363,801,0,994,0,24,4248
48201453702,4221,218,1896,1378,4,527,1,137,4003
48201453800,3668,353,2055,747,1,461,0,7,3315
48201453901,5961,284,1466,1593,13,2499,2,18,5677
48201453902,4140,303,1892,799,4,1069,0,14,3837
48201454000,5261,498,2116,1249,5,1287,0,12,4763
48201454100,3667,435,1362,1155,2,631,0,9,3232
48201454200,3977,489,2360,749,7,274,0,27,3488
48201454302,6792,1116,3067,1397,13,1025,0,29,5676
48201454303,3471,433,1819,819,2,317,3,6,3038
48201454304,4830,423,988,2743,3,508,1,18,4407
48201454305,4288,453,873,2083,6,757,3,12,3835
48201454400,1046,125,303,535,1,39,3,7,921
48201454502,2672,1296,343,153,0,729,0,7,1376
48201454503,2575,1718,310,39,15,386,2,9,857
48201454504,5913,2876,1078,484,5,1189,6,23,3037
48201454505,2606,1167,308,68,0,939,0,28,1439
48201454600,5937,2500,2000,812,12,347,11,25,3437
48201454700,6910,4774,1016,294,13,492,5,50,2136
48201454801,3539,1553,1204,351,10,235,2,17,1986
48201454802,4535,2203,1401,389,11,320,0,14,2332
48201454901,3105,1640,513,153,8,650,0,15,1465
48201454902,8752,3449,2139,756,10,2024,2,55,5303
48201455000,2756,1557,668,146,0,247,1,25,1199
48201455102,3235,1911,764,175,9,198,0,26,1324
48201455103,3857,1943,1304,233,11,181,0,23,1914
48201455104,3108,1741,916,212,7,97,2,7,1367
48201455200,4431,2533,1246,247,15,164,0,9,1898
48201455300,12979,3762,5539,1983,30,1100,3,88,9217
48201510100,2849,1469,732,245,3,274,0,13,1380
48201510201,2972,1762,659,193,3,229,1,15,1210
48201510202,4494,2191,1053,332,15,696,3,20,2303
48201510301,2855,1880,599,111,4,125,0,18,975
48201510302,2868,2154,416,26,0,89,2,19,714
48201510400,4173,2827,824,91,3,176,0,10,1346
48201510500,4675,3127,764,213,1,328,0,20,1548
48201510601,3158,1621,665,247,0,460,2,16,1537
48201510602,4380,2545,916,251,4,426,1,20,1835
48201510701,2347,1280,560,141,1,259,2,15,1067
48201510702,1956,1201,305,67,4,275,2,5,755
48201510801,4404,2907,676,164,3,462,0,28,1497
48201510802,2207,1525,353,53,1,158,0,11,682
48201510803,2444,1740,314,105,4,172,0,13,704
48201510901,5293,2726,1305,258,9,753,4,14,2567
48201510902,3867,2236,959,231,6,289,0,13,1631
48201511001,2962,1884,691,142,4,118,0,10,1078
48201511003,2535,1551,623,168,0,106,0,10,984
48201511004,1764,1148,410,35,4,88,1,2,616
48201511100,4100,2341,927,236,6,353,0,20,1759
48201511201,2856,1855,569,73,6,211,2,13,1001
48201511202,3575,2139,755,179,8,354,0,11,1436
48201511301,4208,2806,862,129,11,172,1,26,1402
48201511302,4012,2937,675,94,6,107,0,32,1075
48201511400,2986,1820,947,31,5,67,1,12,1166
48201511501,3158,1989,709,92,11,190,5,11,1169
48201511502,4852,2912,1396,115,14,207,0,14,1940
48201511600,3759,1262,2161,110,20,88,2,3,2497
48201520100,2600,1133,888,182,4,252,0,7,1467
48201520200,3495,1995,883,192,0,298,1,15,1500
48201520301,1976,614,1064,121,0,113,0,5,1362
48201520302,2391,769,1298,105,6,161,1,8,1622
48201520400,3402,470,2482,342,10,45,2,10,2932
48201520501,3641,478,3000,62,7,56,0,11,3163
48201520502,4643,397,3887,242,1,53,0,21,4246
48201520601,2328,194,1860,27,8,196,0,11,2134
48201520603,2463,153,2027,215,0,14,0,15,2310
48201520604,3068,596,2202,99,8,91,3,12,2472
48201520700,4429,2356,1261,84,4,556,0,13,2073
48201521000,2289,657,1350,159,0,75,1,10,1632
48201521100,2263,344,1803,58,2,35,0,8,1919
48201521201,2371,301,1800,124,0,95,0,11,2070
48201521202,4003,948,2448,255,3,249,0,20,3055
48201521300,6033,1317,3676,324,11,555,6,26,4716
48201521401,3497,61,3355,61,0,4,1,7,3436
48201521402,3612,340,3109,53,16,46,0,24,3272
48201521501,2619,308,2161,62,5,57,0,4,2311
48201521502,2917,997,1587,73,10,160,0,14,1920
48201521600,3531,380,2586,417,11,78,0,13,3151
48201521701,3620,390,2015,1038,13,60,0,22,3230
48201521702,3765,356,2140,1090,1,66,0,11,3409
48201521800,5258,753,2858,469,6,1103,0,10,4505
48201521900,6596,2500,2781,336,17,753,0,30,4096
48201522001,2002,931,700,134,2,180,1,8,1071
48201522002,2322,527,1618,58,8,69,2,3,1795
48201522101,3549,901,2031,287,15,217,0,6,2648
48201522102,4186,1215,2319,419,3,121,2,17,2971
48201522201,4016,886,2707,164,5,182,0,16,3130
48201522202,3855,836,2633,128,14,138,0,13,3019
48201522301,3792,983,2324,180,9,225,0,6,2809
48201522302,3641,868,2339,135,14,216,0,13,2773
48201522401,5813,2081,2944,280,25,283,3,24,3732
48201522402,3781,1202,2273,68,15,101,1,24,2579
48201522500,5045,3841,518,48,12,439,0,30,1204
48201530101,3938,881,2511,429,2,39,2,15,3057
48201530102,1690,273,1194,170,0,31,0,6,1417
48201530200,3766,2057,1154,127,3,239,0,25,1709
48201530300,2680,390,1013,1196,0,28,1,4,2290
48201530400,2781,149,1307,1259,0,15,2,14,2632
48201530501,1941,75,1080,711,1,32,0,0,1866
48201530502,2490,100,1424,916,1,13,0,5,2390
48201530600,3351,615,1802,772,7,70,0,18,2736
48201530701,1557,136,766,623,0,15,9,0,1421
48201530702,4422,265,3157,920,8,17,0,20,4157
48201530800,4133,323,1132,2524,15,23,2,21,3810
48201530900,4466,2423,1464,361,1,65,0,8,2043
48201531000,4296,2701,1058,117,4,189,0,24,1595
48201531100,3377,2143,796,69,3,189,5,13,1234
48201531200,3381,1733,1067,324,15,88,0,55,1648
48201531300,4817,1208,2487,872,6,100,0,28,3609
48201531400,2017,1000,777,114,4,43,0,6,1017
48201531500,3050,1408,1129,368,2,57,2,12,1642
48201531600,3007,1727,964,109,6,65,2,24,1280
48201531700,3516,2406,626,65,12,183,1,10,1110
48201531800,2709,152,839,1610,3,15,2,13,2557
48201531900,5152,214,1837,2909,1,56,0,38,4938
48201532003,3054,283,1766,880,0,56,0,17,2771
48201532004,5195,780,2975,1288,10,37,1,9,4415
48201532101,3623,1043,1753,642,4,96,0,14,2580
48201532102,3104,126,2469,472,7,12,0,2,2978
48201532200,3827,353,2566,791,1,46,1,20,3474
48201532301,2988,369,1364,1084,8,95,3,15,2619
48201532302,3476,807,1423,985,6,146,0,6,2669
48201532400,6963,1312,4177,1039,3,249,0,51,5651
48201532502,5299,461,4313,349,8,86,0,24,4838
48201532503,5206,761,2908,443,14,977,1,27,4445
48201532504,4716,533,3189,314,4,622,1,11,4183
48201532600,6483,395,3468,1955,8,578,0,26,6088
48201532700,5087,696,2224,1940,11,91,2,23,4391
48201532800,1893,310,1086,392,5,56,0,7,1583
48201532900,5297,235,2789,1919,15,253,2,11,5062
48201533000,2715,76,673,1861,2,38,2,10,2639
48201533100,6919,490,2569,3635,17,76,2,27,6429
48201533200,4148,214,1804,1979,13,49,3,18,3934
48201533301,2763,25,752,1945,3,0,0,6,2738
48201533302,3514,62,1046,2258,8,48,3,22,3452
48201533401,5268,174,3358,1594,4,79,0,9,5094
48201533402,6233,173,3419,2385,0,166,4,16,6060
48201533500,4358,336,3461,400,3,131,0,5,4022
48201533600,5480,280,3640,1351,4,122,0,17,5200
48201533701,5885,193,4286,1201,12,102,1,24,5692
48201533702,3351,167,2806,241,11,99,1,2,3184
48201533802,7281,406,5150,775,6,868,0,18,6875
48201533803,6639,301,4453,1167,8,635,2,25,6338
48201533804,4703,102,2781,1142,0,645,0,0,4601
48201533902,5159,166,2766,1902,6,253,1,16,4993
48201533903,4586,259,2828,1045,5,391,0,14,4327
48201533904,4543,294,2900,1065,15,212,6,11,4249
48201534001,3493,261,2221,318,3,657,5,7,3232
48201534002,5653,388,4306,685,13,185,6,22,5265
48201534003,2710,108,1637,559,1,379,1,9,2602
48201534101,2909,416,1105,333,0,966,3,17,2493
48201534102,4960,500,3528,528,6,310,0,25,4460
48201534201,3035,304,2018,211,2,449,9,2,2731
48201534203,2067,314,1350,159,8,205,0,9,1753
48201534204,5302,1866,1904,865,11,512,0,9,3436
48201534205,4591,2080,1430,311,11,594,0,19,2511
48201540101,6790,3375,1302,293,6,1494,3,42,3415
48201540102,5296,858,2771,364,7,1164,0,39,4438
48201540200,2438,586,1374,230,2,203,0,6,1852
48201540502,5417,1988,2466,558,19,179,3,29,3429
48201540503,2594,211,1832,432,1,46,0,20,2383
48201540504,3432,620,2030,550,10,114,0,25,2812
48201540601,4626,1216,1989,707,11,562,6,39,3410
48201540602,7197,1319,3779,1155,13,733,3,42,5878
48201540700,7315,1951,3535,552,16,1047,0,23,5364
48201540800,7669,1302,4503,933,17,673,3,31,6367
48201540901,2810,1516,554,403,8,204,1,7,1294
48201540903,2813,657,801,909,0,326,0,13,2156
48201540904,5060,2086,1505,936,5,352,6,18,2974
48201541004,6236,1686,1641,1272,19,1404,1,38,4550
48201541005,4888,1127,1662,1615,3,288,3,20,3761
48201541006,5899,2279,1686,826,12,849,1,55,3620
48201541007,7529,2840,1729,1285,16,1345,0,42,4689
48201541008,3871,1616,725,548,3,813,1,14,2255
48201541009,5467,1846,1673,954,8,714,4,28,3621
48201541100,6719,3493,1924,627,15,390,0,27,3226
48201541203,2607,1672,531,138,0,154,0,6,935
48201541204,5676,1623,3043,615,14,220,5,18,4053
48201541205,3168,1619,920,277,5,184,1,10,1549
48201541206,4603,1850,1399,649,9,515,3,30,2753
48201541207,4470,2343,979,445,3,495,0,29,2127
48201541301,6610,1082,3092,1392,22,780,2,47,5528
48201541302,6877,1011,4517,834,20,345,4,27,5866
48201541401,4347,646,1227,834,4,1479,10,28,3701
48201541402,3401,630,2198,334,16,138,0,20,2771
48201541403,2834,415,1548,552,5,233,0,11,2419
48201541404,4168,517,1381,1322,7,805,9,22,3651
48201541500,5616,1222,2695,846,10,639,2,38,4394
48201541603,7741,1235,5401,608,5,264,15,41,6506
48201541604,9554,3609,2639,1324,5,1614,5,43,5945
48201541701,5802,957,2733,1166,6,775,1,22,4845
48201541702,2458,489,757,947,0,184,0,10,1969
48201541703,3633,967,1292,952,11,258,4,13,2666
48201541801,3656,960,1773,632,8,137,1,22,2696
48201541802,4277,1009,1729,1004,13,367,0,20,3268
48201541901,2705,782,973,492,4,364,2,9,1923
48201541902,4884,1668,1969,594,19,463,0,25,3216
48201542001,4661,1419,2320,574,3,181,11,19,3242
48201542002,3102,609,1469,672,2,265,2,4,2493
48201542003,4315,843,1939,778,10,614,2,23,3472
48201542004,3164,967,1610,335,4,118,2,10,2197
48201542103,10308,1221,4962,3387,6,389,11,54,9087
48201542104,7584,1082,4753,1200,15,343,13,48,6502
48201542105,10506,1197,4769,3452,16,721,7,76,9309
48201542106,8799,1331,4426,2238,25,505,0,30,7468
48201542107,3938,694,2095,783,13,251,0,22,3244
48201542108,3568,426,1737,927,2,352,2,18,3142
48201542201,7199,1085,3724,1795,16,361,0,32,6114
48201542202,9767,1406,4271,2609,19,1125,0,65,8361
48201542203,10747,1853,5654,2233,37,610,0,75,8894
48201542302,7400,1613,3461,1533,27,492,4,53,5787
48201542303,3278,979,1489,431,15,237,0,13,2299
48201542304,5695,1256,3136,683,9,402,2,49,4439
48201542305,6245,1219,2885,1430,5,470,0,46,5026
48201542401,4682,901,2504,891,6,234,2,34,3781
48201542402,6535,1283,3645,1014,11,381,3,40,5252
48201542500,3904,2080,969,444,16,239,1,11,1824
48201542600,6081,2299,2258,812,6,425,3,48,3782
48201542700,3953,2314,1246,179,2,60,2,5,1639
48201542800,8010,4155,3045,292,22,163,9,35,3855
48201542901,10080,3357,4130,1573,20,645,2,46,6723
48201542902,27220,8247,10166,4954,63,2596,19,158,18973
48201543004,14783,6896,2748,1394,32,2929,23,85,7887
48201543005,8628,2464,3121,2148,17,591,2,40,6164
48201543006,16766,5404,3829,3493,21,3303,13,79,11362
48201543007,20530,8583,4000,2764,66,4159,1,97,11947
48201543008,6225,1499,2579,1082,27,789,3,29,4726
48201543009,4224,474,2245,1101,5,266,5,35,3750
48201543010,4992,561,3083,1000,4,219,0,12,4431
48201543011,5175,706,2671,1410,12,213,2,31,4469
48201543100,2979,921,1692,268,3,13,0,4,2058
48201543201,5709,1772,2365,668,22,696,0,18,3937
48201543202,3585,1599,904,438,14,514,0,11,1986
48201550101,2926,69,2102,722,3,11,0,7,2857
48201550102,2592,82,976,1482,1,5,0,9,2510
48201550201,1775,112,942,638,3,30,1,13,1663
48201550202,2161,99,993,1001,5,21,0,6,2062
48201550303,4137,129,1018,2872,1,11,4,26,4008
48201550304,2192,167,341,1539,5,54,3,18,2025
48201550305,3512,462,1495,1359,5,83,9,36,3050
48201550306,4780,277,1584,2556,5,232,7,28,4503
48201550307,2444,222,629,1448,5,49,10,6,2222
48201550308,3511,174,897,2268,11,39,3,23,3337
48201550403,3869,166,1097,2475,0,28,19,14,3703
48201550404,6266,206,1730,3618,0,591,5,29,6060
48201550405,6564,514,2991,2703,26,158,9,35,6050
48201550406,3689,192,1897,1403,8,100,6,24,3497
48201550407,4945,135,1674,2137,4,876,4,20,4810
48201550500,6104,258,3172,1978,12,571,12,39,5846
48201550601,6673,265,3759,2156,0,387,4,17,6408
48201550602,2986,97,1681,903,5,222,10,28,2889
48201550603,5708,156,3647,1482,6,313,2,39,5552
48201550700,3864,233,1881,1206,0,449,0,22,3631
48201550800,3523,123,1608,1542,4,165,2,31,3400
48201550901,5215,353,3269,877,4,571,0,42,4862
48201550902,4211,217,1931,1039,13,878,1,47,3994
48201551000,3275,133,2282,524,5,259,0,23,3142
48201551101,4492,409,1683,1728,7,542,8,29,4083
48201551102,6590,415,3419,1682,10,894,2,54,6175
48201551201,4538,839,2073,964,16,421,4,16,3699
48201551202,3082,868,1077,726,8,291,4,6,2214
48201551300,3957,727,1560,776,3,771,0,27,3230
48201551400,5163,1214,1717,1349,8,698,6,26,3949
48201551501,4129,433,2224,1177,4,185,2,18,3696
48201551502,4573,469,1299,1255,6,1432,5,17,4104
48201551601,3094,646,1539,480,9,318,0,11,2448
48201551602,5225,1087,2534,1060,8,367,5,37,4138
48201551702,3724,1661,651,230,3,1013,0,13,2063
48201551703,7832,2529,2614,1182,21,1229,0,50,5303
48201551704,3870,1717,830,417,12,702,0,27,2153
48201551705,5562,1827,2098,821,22,608,0,33,3735
48201551800,4285,2907,787,120,7,260,0,16,1378
48201551901,2065,436,754,708,1,103,0,7,1629
48201551902,4033,877,1198,1537,5,234,1,35,3156
48201552002,1591,549,384,433,0,165,0,7,1042
48201552003,4379,1605,1096,646,10,865,7,18,2774
48201552004,4260,1327,1531,934,4,286,18,12,2933
48201552101,4285,1145,1363,1014,5,582,1,28,3140
48201552102,5999,2741,1593,512,9,878,0,21,3258
48201552103,3260,1246,1210,453,5,219,0,16,2014
48201552200,8098,2803,2726,1500,17,708,12,40,5295
48201552301,4360,2734,925,324,14,132,5,33,1626
48201552303,3151,1007,867,851,2,242,8,31,2144
48201552304,1960,1177,441,115,5,139,0,12,783
48201552401,4314,904,1530,1151,12,590,0,18,3410
48201552402,2562,1218,895,184,7,148,2,20,1344
48201552501,3904,1233,1427,832,5,220,1,23,2671
48201552502,6907,1946,2809,994,8,926,3,19,4961
48201552602,7960,3221,1877,1504,24,1023,8,49,4739
48201552603,3633,560,1158,1580,2,219,0,19,3073
48201552604,2361,630,826,335,13,469,1,11,1731
48201552701,3506,1172,893,789,4,509,0,23,2334
48201552702,5071,2251,1523,861,11,211,3,19,2820
48201552801,5049,3205,790,588,21,258,3,27,1844
48201552802,4343,1934,816,1102,4,296,5,26,2409
48201552901,5041,1521,1354,1451,5,521,2,44,3520
48201552902,4038,2344,661,590,13,246,2,32,1694
48201553001,6399,1718,1979,1942,6,502,0,43,4681
48201553002,4570,1219,1771,936,11,505,1,33,3351
48201553101,3479,843,1098,1283,3,131,2,16,2636
48201553102,3667,773,1256,1353,9,132,14,38,2894
48201553201,2873,650,1339,718,7,72,0,17,2223
48201553202,4460,663,1180,2350,20,70,1,24,3797
48201553300,5415,515,1066,3556,19,89,8,28,4900
48201553401,4556,2638,960,435,10,316,1,18,1918
48201553403,8289,3183,2213,1402,13,1118,5,28,5106
48201553404,3188,2031,571,221,12,201,0,16,1157
48201553405,5610,2238,1451,1047,14,635,4,26,3372
48201553500,7453,3641,2315,847,14,324,1,33,3812
48201553601,4673,2844,908,377,4,367,0,24,1829
48201553602,2884,715,1000,754,3,283,1,20,2169
48201553700,4384,1969,1158,636,4,424,4,19,2415
48201553801,2956,1803,579,251,8,176,3,6,1153
48201553803,4621,2379,903,507,10,612,0,29,2242
48201553804,6314,2485,2063,811,19,703,4,55,3829
48201553901,5709,3066,944,661,18,715,8,5,2643
48201554001,3555,1796,977,407,1,216,3,18,1759
48201554002,4356,3042,548,196,6,357,0,10,1314
48201554103,5886,2988,1533,524,5,552,0,16,2898
48201554104,3576,1913,670,281,10,552,0,9,1663
48201554201,5409,2052,1589,743,15,764,2,56,3357
48201554202,3668,1795,975,406,4,344,3,27,1873
48201554301,7275,5266,1125,295,10,224,0,30,2009
48201554302,4768,2147,982,825,6,575,9,26,2621
48201554404,5037,3135,868,297,7,493,0,33,1902
48201554405,8176,3748,2084,1038,25,862,5,67,4428
48201554406,5838,2365,1630,774,16,803,0,25,3473
48201554407,6712,3360,1437,770,6,842,0,31,3352
48201554408,9004,5256,1971,689,9,636,9,58,3748
48201554409,6559,4470,827,249,16,723,0,36,2089
48201554410,3600,2437,618,101,7,282,1,14,1163
48201554501,7183,4009,1877,563,29,478,1,6,3174
48201554502,6266,4351,1072,266,14,239,1,39,1915
48201554600,4649,3385,673,195,13,162,2,25,1264
48201554701,2918,1348,811,270,9,352,7,10,1570
48201554702,4857,3232,752,215,5,407,0,12,1625
48201554803,6935,4060,1703,545,26,286,11,31,2875
48201554804,4903,2602,1224,274,8,612,0,22,2301
48201554805,8302,2969,2480,936,29,1524,11,32,5333
48201554806,2208,922,799,240,8,134,1,14,1286
48201554807,7270,2960,2735,836,16,449,3,20,4310
48201554808,2940,1894,401,118,10,358,2,19,1046
48201554809,10405,5290,2924,1006,20,729,10,45,5115
48201554902,10035,5621,2210,1103,16,581,11,57,4414
48201554904,3818,1805,994,428,8,376,6,18,2013
48201554905,6847,3651,1088,734,8,1020,2,73,3196
48201554906,4026,1909,1008,476,7,447,0,14,2117
48201554907,4533,1401,1405,791,6,764,8,21,3132
48201554908,7508,3140,2876,760,20,378,6,45,4368
48201555001,2442,824,715,444,2,333,7,11,1618
48201555002,5234,2745,1645,449,21,142,6,15,2489
48201555101,5029,1874,1733,657,9,539,7,16,3155
48201555102,5860,2563,1738,838,5,419,1,28,3297
48201555200,10466,4768,3533,1087,30,589,4,61,5698
48201555301,4749,2709,1012,462,15,331,2,40,2040
48201555303,13821,7652,3548,1006,32,894,5,90,6169
48201555304,8682,5112,2041,382,29,719,0,26,3570
48201555305,12491,6966,2992,504,37,1310,7,67,5525
48201555401,3032,2002,685,220,3,20,10,6,1030
48201555403,4424,3251,748,185,10,64,1,15,1173
48201555404,4101,2620,864,363,12,63,0,25,1481
48201555501,5497,3523,1488,171,6,65,2,27,1974
48201555503,15093,8135,3729,1101,28,1419,5,64,6958
48201555504,7443,4051,1803,441,7,788,2,36,3392
48201555505,11289,6051,2082,819,12,1906,3,79,5238
48201555600,6732,4526,1544,197,27,167,0,44,2206
48201555701,11147,5998,2413,1331,37,871,16,44,5149
48201555703,6793,4552,1146,457,22,257,5,31,2241
48201555704,7868,4922,1400,613,12,624,0,23,2946
48201556000,12481,4448,5834,1562,20,240,3,40,8033
48201556100,3767,2453,650,291,4,167,0,21,1314
48201980000,20,5,5,7,0,0,0,0,15
48201980100,5,2,0,1,0,0,0,1,3
48201980200,8296,2045,2244,3946,3,39,0,3,6251
48201980300,2849,982,520,221,0,977,1,136,1867
48201980400,3751,1297,659,364,1,1362,0,6,2454
48201980700,2299,1416,308,318,7,122,0,20,883
48203020103,4523,3229,366,740,16,15,0,18,1294
48203020104,3543,2052,574,756,14,19,3,12,1491
48203020105,1460,872,166,345,19,2,0,1,588
48203020106,3854,2512,613,546,21,7,0,11,1342
48203020201,3552,3133,179,102,7,12,1,12,419
48203020202,3758,2620,348,591,14,10,4,14,1138
48203020301,4403,2610,600,941,18,77,0,15,1793
48203020302,3245,1173,1073,875,15,7,1,7,2072
48203020401,4417,1405,1024,1844,16,15,3,44,3012
48203020402,4793,1057,831,2747,15,11,1,34,3736
48203020501,3003,884,927,1081,10,12,0,2,2119
48203020502,4818,2687,822,1053,17,89,1,16,2131
48203020603,7247,5495,717,553,40,41,6,16,1752
48203020604,3927,2548,561,548,32,20,0,17,1379
48203020605,6323,5004,489,442,21,56,7,32,1319
48203020606,5973,4758,549,284,19,90,1,16,1215
48205950200,5382,3403,1631,191,15,24,5,1,1979
48207950300,3681,2428,959,159,11,22,3,15,1253
48207950400,1735,1200,418,22,17,0,2,9,535
48209010100,2809,1677,761,192,6,48,0,17,1132
48209010200,6908,1733,2115,438,15,373,0,29,5175
48209010302,4956,1597,2782,306,28,70,2,16,3359
48209010305,5983,2453,2523,556,28,125,5,25,3530
48209010306,4273,1364,2194,339,8,158,10,28,2909
48209010307,2337,920,960,233,5,94,1,13,1417
48209010308,1960,669,749,174,4,57,7,13,1291
48209010309,6041,2408,2585,630,2,141,1,25,3633
48209010401,3914,1175,2359,198,7,48,1,10,2739
48209010402,7672,2882,3876,426,6,164,0,31,4790
48209010500,4343,1330,2564,251,6,44,10,7,3013
48209010601,3584,2068,1212,117,16,24,2,8,1516
48209010602,5271,3687,1153,78,19,123,0,23,1584
48209010603,4055,2587,1135,108,10,43,2,8,1468
48209010702,3354,1986,975,140,16,73,3,30,1368
48209010703,5707,3385,1519,231,14,277,12,16,2322
48209010704,2348,1363,748,97,13,16,0,18,985
48209010806,4652,3728,611,32,8,51,1,28,924
48209010807,3264,2504,513,25,7,26,3,16,760
48209010809,7814,6085,1121,56,27,175,4,35,1729
48209010810,3011,2179,650,7,3,7,0,15,832
48209010811,2096,1735,239,6,14,7,2,11,361
48209010812,5494,4432,732,27,15,32,2,37,1062
48209010813,2399,1954,287,7,10,17,0,7,445
48209010814,2898,2472,277,2,14,15,0,15,426
48209010815,1794,1447,201,13,4,27,0,7,347
48209010816,9464,7119,1319,125,20,366,6,30,2345
48209010817,4964,3831,777,44,14,44,0,20,1133
48209010818,2079,1695,250,6,8,20,0,15,384
48209010905,10047,5028,4112,316,35,185,10,24,5019
48209010909,9678,5311,3374,377,22,157,6,40,4367
48209010911,3307,2400,696,37,0,25,0,16,907
48209010912,8414,6013,1418,124,8,416,3,48,2401
48209010913,7199,3352,3209,256,15,118,0,26,3847
48209010914,3115,2196,772,19,19,13,10,7,919
48209010915,8166,5101,2362,164,14,125,7,34,3065
48209010916,8012,2139,5079,357,27,121,6,35,5873
48209010917,5689,1888,3218,340,8,74,5,28,3801
48209010918,5653,2100,2897,309,14,88,6,22,3553
48209010919,6688,2115,3954,318,15,111,2,32,4573
48209010920,2507,631,1740,64,2,7,2,8,1876
48209010921,6106,468,5528,42,0,7,1,13,5638
48209010922,12746,4211,7149,594,16,298,5,43,8535
48209010923,8125,2620,4607,332,18,288,5,19,5505
48209010924,4434,1620,2337,240,10,45,1,36,2814
48209010925,5737,1910,3232,251,29,79,1,25,3827
48211950300,3382,2090,1137,4,18,10,0,4,1292
48213950101,3754,3026,229,332,13,45,0,10,728
48213950102,3811,3179,298,92,17,15,0,10,632
48213950201,2274,1697,387,109,17,4,0,5,577
48213950202,3441,2862,366,94,15,7,0,8,579
48213950301,3208,2486,490,74,18,12,0,6,722
48213950302,2314,1645,382,169,10,13,0,8,669
48213950303,2418,1860,303,139,11,5,0,9,558
48213950400,4215,3114,712,131,16,22,6,15,1101
48213950500,2893,2553,219,27,10,2,3,0,340
48213950601,3505,2926,376,44,20,12,0,11,579
48213950603,2389,1977,271,16,17,14,0,6,412
48213950604,3350,2723,270,89,21,85,2,19,627
48213950700,4487,3460,756,34,27,4,0,7,1027
48213950801,2391,2016,203,24,17,26,0,2,375
48213950802,2397,2086,169,10,13,12,4,3,311
48213950902,2058,1626,154,163,6,17,2,3,432
48213950903,2354,1970,156,63,19,5,0,2,384
48213950904,2962,2540,202,44,19,9,1,2,422
48213950905,2566,2084,332,9,19,10,2,5,482
48213951000,1917,1009,406,422,4,4,2,6,908
48213951101,1554,1331,130,16,14,4,0,3,223
48213951102,2639,2267,189,36,21,6,0,5,372
48213951201,3538,1793,1070,463,17,36,2,18,1745
48213951202,2821,459,1532,760,0,8,1,6,2362
48213951300,5993,3788,1167,687,18,104,6,18,2205
48213951401,2421,1681,127,461,11,15,0,17,740
48213951402,2421,2086,147,83,15,1,0,4,335
48213951403,2059,1610,199,114,9,13,0,3,449
48215020103,2704,43,2648,1,3,2,0,3,2661
48215020104,1608,164,1425,0,4,7,0,6,1444
48215020105,1704,34,1654,2,4,1,0,7,1670
48215020106,1539,626,882,0,4,1,0,7,913
48215020107,4346,59,4251,5,7,4,1,12,4287
48215020108,2946,586,2299,17,4,23,0,0,2360
48215020205,5108,221,4826,15,0,7,5,22,4887
48215020206,4541,80,4438,5,2,4,0,7,4461
48215020207,3106,103,2985,4,1,5,0,6,3003
48215020208,4081,103,3955,5,4,2,0,10,3978
48215020209,2959,69,2879,1,0,4,0,0,2890
48215020210,4577,433,4106,8,2,1,0,10,4144
48215020211,4383,116,4230,5,2,15,0,6,4267
48215020303,4707,631,3865,25,2,133,0,9,4076
48215020304,2887,316,2507,24,1,24,1,4,2571
48215020305,3730,480,3142,9,0,72,0,10,3250
48215020306,3883,521,3281,14,3,39,0,3,3362
48215020307,5887,353,5436,28,7,29,3,9,5534
48215020403,4712,236,4446,3,0,5,0,10,4476
48215020405,3080,248,2729,31,0,52,0,7,2832
48215020406,6752,572,5561,88,4,453,3,24,6180
48215020407,2400,441,1870,5,0,45,0,5,1959
48215020408,2592,595,1976,2,0,5,0,2,1997
48215020409,1560,829,697,2,0,10,0,0,731
48215020505,2350,89,2239,7,3,6,0,0,2261
48215020506,2408,130,2209,4,6,41,0,10,2278
48215020507,2698,41,2640,1,1,8,0,5,2657
48215020508,2771,47,2702,0,11,4,0,5,2724
48215020509,3119,64,3022,8,3,11,0,3,3055
48215020510,3022,204,2637,25,5,132,0,3,2818
48215020511,3666,175,3278,18,0,167,0,10,3491
48215020512,2247,47,2190,0,1,3,0,4,2200
48215020513,2378,30,2312,2,7,15,0,6,2348
48215020600,2393,63,2307,5,4,0,0,3,2330
48215020724,4352,277,3865,21,2,159,0,15,4075
48215020725,3814,169,3604,9,5,10,0,6,3645
48215020727,4503,209,4134,12,1,113,2,8,4294
48215020728,2529,146,2238,29,5,82,0,3,2383
48215020729,2393,63,2319,6,2,2,0,0,2330
48215020730,2486,46,2429,5,0,4,0,1,2440
48215020731,2807,128,2640,8,0,6,0,9,2679
48215020732,3945,535,3280,20,5,77,0,5,3410
48215020733,2746,234,2366,19,2,100,0,10,2512
48215020734,3245,292,2813,5,5,99,1,9,2953
48215020735,2539,141,2291,9,0,86,0,5,2398
48215020736,2364,98,1953,14,1,279,2,8,2266
48215020804,3695,646,2910,24,5,54,0,16,3049
48215020805,3072,343,2676,2,0,28,0,5,2729
48215020806,3703,599,2991,25,0,45,0,13,3104
48215020807,2387,329,1960,18,4,46,0,17,2058
48215020808,2544,330,2120,29,0,46,1,6,2214
48215020905,3544,767,2464,52,2,197,0,18,2777
48215020906,2579,561,1802,40,4,122,0,11,2018
48215020907,3178,297,2665,49,6,116,3,17,2881
48215020908,2408,197,2151,18,4,28,0,3,2211
48215020909,2261,357,1810,10,12,40,0,0,1904
48215020910,2766,475,2117,39,6,79,1,16,2291
48215021001,1811,74,1717,8,0,4,0,5,1737
48215021002,1959,278,1641,2,0,28,0,5,1681
48215021003,1899,157,1710,6,4,9,0,0,1742
48215021100,2971,161,2762,7,3,10,0,10,2810
48215021201,3055,347,2618,6,2,62,0,3,2708
48215021203,4284,361,3780,14,0,90,0,16,3923
48215021204,2846,475,2249,11,4,78,0,5,2371
48215021306,4186,85,4095,0,0,2,1,1,4101
48215021307,6219,92,6098,9,1,4,0,14,6127
48215021308,2786,59,2711,3,0,0,1,5,2727
48215021309,3463,65,3385,7,0,0,0,3,3398
48215021310,3215,52,3154,1,1,3,0,0,3163
48215021311,4816,94,4700,2,6,1,1,12,4722
48215021312,5254,91,5138,3,2,1,0,16,5163
48215021313,3431,65,3344,8,2,1,0,6,3366
48215021314,3924,43,3855,2,0,3,0,14,3881
48215021315,3766,60,3699,0,0,2,0,2,3706
48215021401,5282,203,5030,19,1,8,1,8,5079
48215021405,3277,353,2879,12,4,21,1,0,2924
48215021406,2412,72,2313,1,0,9,0,8,2340
48215021407,2778,486,2242,5,1,32,0,4,2292
48215021408,5958,392,5455,15,2,37,0,32,5566
48215021409,2787,378,2351,9,5,25,0,1,2409
48215021500,3355,62,3284,2,1,3,0,1,3293
48215021600,3852,84,3754,0,0,5,0,9,3768
48215021703,4752,181,4502,11,1,44,0,10,4571
48215021704,6584,557,5893,24,3,73,0,19,6027
48215021705,6235,157,6044,7,0,5,0,6,6078
48215021706,3680,109,3506,8,2,16,1,19,3571
48215021707,2459,282,2162,0,0,5,0,5,2177
48215021803,5328,105,5177,18,5,0,0,2,5223
48215021804,3881,88,3774,4,5,0,0,5,3793
48215021807,3687,70,3585,7,5,3,0,12,3617
48215021808,5133,134,4954,7,2,0,0,13,4999
48215021809,4331,100,4191,0,4,3,0,27,4231
48215021810,4361,64,4282,1,3,2,1,6,4297
48215021903,4596,165,4392,1,7,19,0,7,4431
48215021904,4408,843,3513,5,4,5,0,15,3565
48215021905,4702,568,4100,8,0,2,0,7,4134
48215021906,5598,299,5264,7,4,6,0,9,5299
48215022005,4193,163,4004,8,4,4,1,2,4030
48215022006,6431,277,6067,5,4,49,0,10,6154
48215022007,2030,85,1936,0,0,8,0,0,1945
48215022008,3461,371,3050,14,3,1,1,9,3090
48215022009,3944,259,3660,1,0,0,0,14,3685
48215022010,5500,474,4973,5,1,4,0,10,5026
48215022011,3585,128,3423,3,0,8,3,10,3457
48215022105,3438,115,3302,6,2,0,0,5,3323
48215022107,4311,552,3718,6,1,4,0,15,3759
48215022108,1312,101,1192,0,3,1,0,2,1211
48215022109,3567,119,3438,1,4,1,0,0,3448
48215022110,3268,69,3193,0,0,1,0,2,3199
48215022111,7243,128,7087,1,1,0,0,16,7115
48215022112,3441,36,3393,0,0,0,0,8,3405
48215022113,3557,327,3201,4,11,1,0,10,3230
48215022203,4918,191,4683,10,0,7,5,9,4727
48215022204,6431,142,6261,1,0,19,0,5,6289
48215022205,4258,403,3831,2,1,0,0,7,3855
48215022206,2565,56,2494,0,2,2,0,10,2509
48215022301,6111,759,5192,26,11,75,1,12,5352
48215022302,5541,471,4904,10,1,102,0,20,5070
48215022401,4895,269,4557,13,8,37,0,1,4626
48215022402,6999,271,6631,42,3,39,0,6,6728
48215022502,5643,308,5251,15,13,32,0,8,5335
48215022503,3626,51,3567,0,2,2,0,4,3575
48215022504,3144,74,3056,1,2,3,0,3,3070
48215022600,2037,54,1975,0,4,0,0,1,1983
48215022703,1942,265,1640,5,3,10,0,2,1677
48215022704,3066,809,2211,9,3,30,0,2,2257
48215022705,2913,396,2503,0,0,2,0,8,2517
48215022706,2947,533,2385,2,0,21,0,0,2414
48215022801,4371,93,4249,3,0,13,0,10,4278
48215022802,4062,187,3838,8,5,16,0,3,3875
48215022900,4826,716,4041,11,9,4,10,15,4110
48215023000,5811,268,5496,15,7,14,0,0,5543
48215023103,7751,197,7487,13,2,10,4,25,7554
48215023104,4573,168,4361,12,0,5,0,18,4405
48215023105,4598,123,4453,1,0,6,0,5,4475
48215023106,2954,67,2883,2,0,0,0,0,2887
48215023516,4657,164,4473,5,2,4,0,2,4493
48215023517,4345,310,3999,11,2,12,0,3,4035
48215023518,8064,377,7408,57,3,162,0,12,7687
48215023519,2693,233,2382,16,1,50,0,7,2460
48215023520,3757,111,3591,0,0,19,0,25,3646
48215023521,5506,224,5231,14,0,12,1,14,5282
48215023522,4025,373,3407,39,8,126,5,21,3652
48215023523,7605,142,7423,2,15,0,0,23,7463
48215023524,6858,203,6542,62,3,15,0,24,6655
48215023525,4390,106,4251,9,0,17,3,4,4284
48215023526,4333,63,4257,1,0,0,0,6,4270
48215023527,6425,114,6257,6,1,3,0,28,6311
48215023528,5636,115,5423,3,14,40,0,27,5521
48215023529,9994,206,9689,0,25,30,0,35,9788
48215023530,9528,733,8218,526,3,13,0,29,8795
48215023531,2503,312,2083,16,0,49,0,21,2191
48215023532,2184,261,1785,21,0,81,2,4,1923
48215023533,3354,199,2937,37,0,157,0,10,3155
48215023534,5274,520,4469,77,1,155,0,26,4754
48215023535,3321,587,2398,33,0,236,4,14,2734
48215023536,3229,458,2423,53,6,248,0,16,2771
48215023601,3041,123,2888,6,1,9,0,11,2918
48215023602,6391,381,5916,25,0,53,0,1,6010
48215023700,4554,135,4399,3,3,5,0,6,4419
48215023803,10046,365,9435,45,23,116,0,42,9681
48215023804,4188,201,3938,10,3,5,0,14,3987
48215023805,3114,310,2704,2,1,55,0,21,2804
48215023806,6736,330,6136,46,11,177,0,9,6406
48215023903,4575,260,4216,21,16,28,0,13,4315
48215023905,6196,862,4921,49,12,274,2,14,5334
48215023906,9627,750,7916,135,2,718,1,24,8877
48215023907,3911,297,3452,37,4,84,0,11,3614
48215023908,6833,571,5616,80,13,497,0,18,6262
48215024001,2940,162,2672,52,4,27,0,15,2778
48215024002,5933,493,4975,155,3,235,0,20,5440
48215024003,3867,173,3608,32,11,23,0,8,3694
48215024004,6151,305,5640,73,3,89,0,14,5846
48215024107,4374,188,4159,0,0,5,2,10,4186
48215024108,6652,71,6553,5,0,0,0,14,6581
48215024109,8009,135,7843,12,2,0,0,13,7874
48215024115,6523,446,5792,64,3,168,0,5,6077
48215024116,4053,422,3513,23,0,77,0,6,3631
48215024117,2774,180,2570,7,4,7,1,2,2594
48215024118,4786,79,4678,5,1,5,0,4,4707
48215024119,5440,138,5250,4,4,11,0,24,5302
48215024120,3877,67,3802,0,2,0,0,1,3810
48215024121,4470,76,4376,1,2,3,0,5,4394
48215024122,4642,90,4532,2,7,3,0,0,4552
48215024123,3742,77,3654,1,0,3,0,4,3665
48215024124,3680,66,3609,2,0,0,0,2,3614
48215024125,3267,86,3171,1,2,1,0,5,3181
48215024126,4982,100,4863,1,0,8,0,10,4882
48215024127,5079,49,5001,0,0,9,0,8,5030
48215024128,8033,235,7760,15,1,6,0,13,7798
48215024129,2705,339,2316,9,2,21,0,0,2366
48215024130,1808,63,1723,8,0,9,0,1,1745
48215024131,970,155,690,18,3,84,0,3,815
48215024132,2765,179,2544,5,2,3,0,16,2586
48215024204,4460,308,4134,1,0,2,0,5,4152
48215024206,4533,60,4441,2,14,1,0,12,4473
48215024207,2893,905,1969,5,1,0,0,0,1988
48215024208,3933,757,3144,5,1,7,0,7,3176
48215024209,3767,42,3709,4,1,0,0,6,3725
48215024210,4791,113,4634,3,6,8,0,21,4678
48215024211,7105,72,7008,4,2,2,0,10,7033
48215024212,6000,84,5906,1,0,2,2,2,5916
48215024301,1602,262,1323,11,0,0,0,0,1340
48215024302,2381,116,2250,0,9,2,0,2,2265
48215024403,5049,97,4890,5,7,4,0,10,4952
48215024404,4148,141,3963,0,3,11,0,17,4007
48215024405,4328,167,4141,5,0,8,0,2,4161
48215024406,4986,79,4878,5,0,1,0,9,4907
48215024501,4220,81,4122,3,1,0,0,10,4139
48215024502,3647,73,3558,7,1,0,0,0,3574
48215024600,7235,837,6343,14,0,9,0,6,6398
48215980000,0,0,0,0,0,0,0,0,0
48217960100,4236,2630,1120,238,21,29,2,10,1606
48217960200,4674,4028,389,37,28,13,4,4,646
48217960400,2080,1752,187,12,9,21,1,0,328
48217960501,3898,3065,550,60,11,4,0,22,833
48217960502,2571,2095,297,55,6,12,0,2,476
48217960600,1203,852,193,98,3,13,1,5,351
48217960700,2201,1638,379,75,8,5,0,11,563
48217960800,3641,1990,1093,346,16,54,0,9,1651
48217960900,1932,293,1238,349,1,7,1,4,1639
48217961000,1866,478,1005,312,1,11,2,1,1388
48217961100,3629,2519,826,120,7,10,4,13,1110
48217961400,3943,2783,607,353,26,9,0,6,1160
48219950100,1209,595,544,27,11,0,0,0,614
48219950200,4036,2474,1400,41,23,7,4,13,1562
48219950300,4225,1652,2353,113,11,16,0,9,2573
48219950400,4133,881,2976,183,12,7,0,11,3252
48219950500,4780,2375,2085,174,13,17,0,16,2405
48219950600,1595,1024,509,10,7,2,0,6,571
48219950700,1559,751,757,17,5,0,0,4,808
48221160100,4813,3985,539,61,29,34,0,7,828
48221160204,3432,2841,385,20,14,13,16,3,591
48221160206,5093,4270,536,21,27,64,0,17,823
48221160210,6036,5484,280,11,21,42,5,21,552
48221160211,4172,3326,614,22,23,22,0,10,846
48221160212,3644,2783,604,23,30,29,2,23,861
48221160213,3783,3270,312,13,17,22,0,5,513
48221160214,4259,3358,702,18,24,20,8,15,901
48221160215,3145,1798,1164,27,18,11,0,9,1347
48221160216,3442,2691,473,31,29,33,1,13,751
48221160217,4748,3531,712,161,26,82,6,14,1217
48221160218,4642,3867,492,36,16,48,7,6,775
48221160302,4349,3682,428,26,27,6,5,18,667
48221160303,6040,4929,717,25,39,42,3,19,1111
48223950100,3075,2538,339,43,43,9,0,3,537
48223950200,4493,3769,439,41,25,5,0,23,724
48223950301,2778,2020,591,76,8,16,0,4,758
48223950302,4011,2947,744,125,4,47,0,13,1064
48223950401,3899,2416,867,356,23,29,0,4,1483
48223950402,3820,2549,776,257,31,32,4,16,1271
48223950500,3066,1978,567,381,12,18,0,2,1088
48223950600,3829,2210,585,819,17,45,0,8,1619
48223950700,4810,3261,1149,104,14,59,0,10,1549
48223950800,3006,2288,427,171,21,17,0,2,718
48225950101,2318,1558,96,538,11,23,2,10,760
48225950102,2370,1998,131,100,15,20,3,13,372
48225950200,1315,896,154,221,6,1,0,2,419
48225950300,2884,1111,614,1018,10,20,1,8,1773
48225950400,3006,701,636,1568,15,39,1,8,2305
48225950500,3943,3058,386,370,15,13,0,9,885
48225950600,1343,1017,71,203,1,0,0,6,326
48225950700,4887,2618,983,1145,21,22,1,2,2269
48227950100,2350,1498,734,21,14,16,2,2,852
48227950200,2130,1397,626,10,11,15,0,7,733
48227950300,1683,303,1144,195,12,4,0,3,1380
48227950400,3276,1545,1433,162,12,38,0,8,1731
48227950500,3058,1047,1764,127,11,24,0,4,2011
48227950600,4190,2219,1609,144,21,77,4,9,1971
48227950700,3550,1474,1722,180,21,21,2,6,2076
48227950801,4125,1942,1724,238,24,70,0,8,2183
48227950802,6242,1092,4586,385,64,61,1,10,5150
48227950900,4256,3155,832,58,21,60,3,11,1101
48229950300,3202,1094,2036,6,6,10,0,7,2108
48231960100,3130,1937,427,535,28,24,10,11,1193
48231960200,2480,1929,262,149,22,7,0,6,551
48231960300,4602,3561,674,73,35,3,0,11,1041
48231960400,5104,2921,1583,347,26,17,8,13,2183
48231960500,3981,2243,471,911,11,64,45,15,1738
48231960600,4229,2075,442,1078,59,172,23,20,2154
48231960700,6091,4954,684,87,46,38,2,28,1137
48231960800,3785,925,1918,796,14,4,1,9,2860
48231960900,5296,1823,2085,1128,20,53,8,12,3473
48231961000,4291,2146,1308,560,28,10,22,8,2145
48231961101,5132,3747,678,243,34,85,4,9,1385
48231961102,3391,2778,271,95,28,24,1,18,613
48231961200,5475,4013,627,416,31,121,2,35,1462
48231961300,7047,4636,1294,560,48,106,3,40,2411
48231961401,7127,4515,1671,435,56,114,3,8,2612
48231961402,5323,3761,1199,74,26,18,0,10,1562
48231961501,3180,2540,486,20,20,10,1,6,640
48231961502,6242,4373,1373,160,55,30,8,14,1869
48231961503,4398,3342,723,72,43,25,2,7,1056
48231961600,6841,5061,1213,57,76,34,8,16,1780
48231961700,2811,2318,284,16,16,20,0,5,493
48233950200,2458,1959,307,15,32,4,0,2,499
48233950501,3094,2578,260,12,32,9,0,3,516
48233950502,1305,1089,117,4,25,5,0,9,216
48233950600,3578,1734,1465,161,53,13,0,21,1844
48233950700,1743,767,783,73,18,22,0,3,976
48233950800,727,355,307,10,12,3,1,2,372
48233950900,4221,2697,1150,95,59,18,1,4,1524
48233951000,3491,2604,572,46,42,31,0,8,887
48235950100,1513,1112,349,6,9,0,1,1,401
48237950100,2766,2021,437,246,3,9,2,0,745
48237950300,3099,2073,847,47,9,26,2,5,1026
48237950500,2607,2264,237,1,23,6,1,4,343
48239950100,5529,3387,1859,78,20,23,0,25,2142
48239950200,4254,1959,1450,609,7,76,1,14,2295
48239950300,5205,3164,1520,250,9,59,4,63,2041
48241950101,2696,2367,86,138,11,8,3,7,329
48241950102,2571,1668,62,740,7,5,0,3,903
48241950200,3188,1445,315,1275,5,28,4,6,1743
48241950300,3187,932,570,1544,6,13,4,16,2255
48241950400,4548,3076,500,812,16,31,2,12,1472
48241950500,4418,3650,187,378,18,6,0,7,768
48241950600,2182,1531,140,384,16,1,1,5,651
48241950701,3838,3526,130,16,13,12,2,1,312
48241950702,3856,3549,101,56,30,4,0,10,307
48241950800,2496,2051,107,229,5,6,0,5,445
48243950100,1996,1282,613,0,6,14,0,15,714
48245000101,5408,1959,637,2334,14,283,0,22,3449
48245000102,2322,512,343,1379,2,19,0,4,1810
48245000103,3021,137,195,2571,6,2,4,11,2884
48245000200,5025,893,772,3186,14,54,0,16,4132
48245000304,6343,2167,1236,2532,16,195,0,18,4176
48245000306,3768,2509,419,535,5,120,1,21,1259
48245000307,4422,1649,568,1707,15,317,1,22,2773
48245000309,2778,1304,313,829,7,227,1,16,1474
48245000310,5919,3124,557,1695,8,307,0,31,2795
48245000311,3429,2508,331,330,0,121,3,22,921
48245000312,4277,2071,348,879,12,831,2,18,2206
48245000313,3529,1112,434,1663,3,201,0,12,2417
48245000314,2910,1814,312,430,9,252,0,14,1096
48245000400,4819,2465,502,1564,12,102,0,19,2354
48245000500,2171,370,745,974,3,22,0,6,1801
48245000600,5571,340,1797,3329,4,11,0,15,5231
48245000700,2690,97,187,2305,4,5,0,17,2593
48245000900,1549,109,233,1141,0,10,1,5,1440
48245001100,2696,921,580,1047,4,25,2,29,1775
48245001200,2221,414,709,1012,3,31,0,7,1807
48245001301,5472,1582,1180,2438,0,87,0,12,3890
48245001302,3331,1020,498,1544,13,128,0,29,2311
48245001303,3353,1346,410,1166,9,300,0,36,2007
48245001700,1543,69,165,1267,2,3,0,5,1474
48245001900,2590,114,1194,1058,4,158,1,8,2476
48245002000,2176,128,1018,924,1,68,0,3,2048
48245002100,2983,97,851,1940,6,23,1,13,2886
48245002200,2955,130,197,2544,0,10,4,4,2825
48245002300,3435,132,380,2826,7,15,3,3,3303
48245002400,2642,175,877,1508,5,18,0,8,2467
48245002500,3591,215,1029,2200,5,66,1,12,3376
48245002600,4276,532,858,2481,16,274,2,19,3744
48245005100,835,77,64,672,3,2,0,0,758
48245005400,1363,68,322,930,0,15,0,0,1295
48245005500,2594,158,1050,1077,0,274,0,9,2436
48245005600,3159,169,2070,625,7,249,0,16,2990
48245005900,1188,23,92,1045,0,4,0,7,1165
48245006100,1055,25,107,874,9,6,0,0,1030
48245006300,1300,21,202,1041,0,13,0,2,1279
48245006400,1843,69,858,814,0,62,0,9,1774
48245006500,3638,429,2111,865,9,142,2,8,3209
48245006600,4303,768,1820,1360,9,225,0,29,3535
48245006700,2726,247,1878,489,5,63,3,11,2479
48245006800,1949,233,963,574,0,141,0,0,1716
48245006900,4174,1050,595,2064,17,333,0,16,3124
48245007002,4855,1124,1039,1643,9,912,0,33,3731
48245007003,3675,821,659,1812,9,253,0,3,2854
48245007004,3256,869,491,1573,6,255,0,9,2387
48245007100,3891,1787,1312,664,4,30,2,10,2104
48245010100,2942,128,2206,491,7,72,1,13,2814
48245010200,2087,377,1093,531,3,54,3,5,1710
48245010300,3188,446,2020,531,4,137,3,6,2742
48245010400,3247,2146,760,145,11,110,2,3,1101
48245010500,4382,1454,2034,578,0,233,0,11,2928
48245010600,6243,3841,1743,260,22,179,1,11,2402
48245010700,3407,2541,610,60,8,71,0,14,866
48245010800,5227,4061,784,71,24,89,0,5,1166
48245010901,3695,2736,571,127,11,133,0,7,959
48245010902,4853,3756,633,89,7,240,0,12,1097
48245011001,5429,3394,1145,331,8,353,1,12,2035
48245011002,3756,2779,619,128,24,74,1,10,977
48245011101,4898,3687,773,139,10,118,2,15,1211
48245011102,2621,1914,415,122,22,63,2,5,707
48245011204,5323,3776,875,182,11,319,5,20,1547
48245011205,2396,1796,393,82,6,34,0,4,600
48245011303,2855,2317,327,71,3,19,3,3,538
48245011304,3779,2631,471,428,17,94,0,13,1148
48245011401,3808,2664,405,554,12,37,2,1,1144
48245011402,4369,2269,577,1232,15,134,2,33,2100
48245011500,2487,2042,242,116,8,14,0,7,445
48245011600,2100,1542,401,60,1,27,1,7,558
48245011700,1793,481,674,575,0,9,1,8,1312
48245011800,1624,50,192,1357,3,7,0,3,1574
48245980000,5,0,3,0,0,0,1,0,5
48245980200,6169,2209,1547,2390,4,18,1,0,3960
48245980300,4824,1057,1894,1746,85,41,0,0,3767
48245990000,0,0,0,0,0,0,0,0,0
48247950200,2092,178,1865,4,5,5,0,3,1914
48247950400,2746,236,2416,1,10,21,5,5,2510
48249950101,3719,1436,2165,24,10,4,6,10,2283
48249950102,4464,1829,2468,18,21,8,0,7,2635
48249950201,3917,618,3083,10,11,4,0,14,3299
48249950202,3693,441,3155,11,6,3,0,4,3252
48249950301,2811,181,2565,21,0,15,1,8,2630
48249950302,2061,414,1598,7,0,18,1,7,1647
48249950303,1946,532,1334,6,0,33,2,6,1414
48249950400,3469,506,2880,20,5,19,2,8,2963
48249950500,5670,476,5084,36,2,18,0,19,5194
48249950600,3759,159,3542,23,3,7,1,3,3600
48249950700,3382,371,2961,4,0,11,2,9,3011
48251130100,5661,4550,708,94,31,19,2,7,1111
48251130205,3701,2859,525,62,6,43,0,16,842
48251130210,5949,4638,877,65,40,32,16,11,1311
48251130211,7138,5477,1159,94,34,51,8,27,1661
48251130212,5888,3621,1813,87,36,29,2,17,2267
48251130213,5456,3393,1744,70,35,3,1,12,2063
48251130214,6306,4463,1240,138,45,81,9,25,1843
48251130215,7212,5149,1225,323,44,81,0,12,2063
48251130216,4535,3066,827,327,18,91,1,6,1469
48251130217,3243,2455,518,62,21,55,0,12,788
48251130218,3261,2527,471,64,13,21,3,16,734
48251130219,2722,2114,395,53,9,6,1,8,608
48251130220,5759,4385,794,233,28,64,8,13,1374
48251130221,3420,2359,621,185,20,55,2,29,1061
48251130222,3342,2615,451,33,14,9,11,21,727
48251130302,5595,3661,1342,216,36,45,69,16,1934
48251130303,4540,2394,1343,135,20,44,377,32,2146
48251130304,5487,3358,1472,173,23,79,63,39,2129
48251130405,6564,4910,1201,110,24,31,5,30,1654
48251130406,6095,4980,733,81,31,27,2,6,1115
48251130411,4766,1582,2956,33,25,17,3,19,3184
48251130412,5690,2526,2312,533,34,60,2,27,3164
48251130413,4007,2042,1334,371,9,121,3,31,1965
48251130414,2438,1911,354,25,17,8,2,3,527
48251130415,4646,3256,999,90,18,22,1,20,1390
48251130416,3988,2183,1562,50,12,19,2,12,1805
48251130417,5221,2851,1675,297,20,151,3,17,2370
48251130418,3004,993,777,857,12,212,3,18,2011
48251130419,3307,1681,986,401,13,83,3,5,1626
48251130501,3614,2942,408,63,6,15,0,16,672
48251130502,4267,3472,514,67,23,14,6,20,795
48251130602,2860,2134,513,61,11,21,11,8,726
48251130603,4235,3239,713,48,33,4,0,7,996
48251130604,3353,2586,498,71,6,22,20,14,767
48251130700,4615,2427,1786,142,17,13,37,6,2188
48251130800,4614,2097,2071,238,5,20,42,0,2517
48251130900,3122,1073,1600,235,6,10,92,12,2049
48251131000,4915,3876,631,112,20,28,28,15,1039
48251131100,5391,3381,1465,147,25,20,91,7,2010
48253020101,1499,1252,171,15,9,11,0,6,247
48253020102,4822,1352,1914,1525,3,23,0,0,3470
48253020200,2708,1393,1112,64,11,32,2,4,1315
48253020300,2123,1285,646,110,9,15,0,6,838
48253020400,3250,1747,1141,236,14,7,1,6,1503
48253020500,5261,4456,520,28,20,23,1,19,805
48255970100,1909,1510,338,8,0,0,0,1,399
48255970200,4832,1580,2720,319,20,68,0,50,3252
48255970301,2971,911,1321,693,4,14,0,0,2060
48255970302,3678,972,2493,87,2,63,1,10,2706
48255970400,1320,415,862,9,0,0,0,0,905
48257050204,9513,3559,2171,3080,33,206,2,48,5954
48257050207,8412,3368,1902,2274,26,442,20,17,5044
48257050208,4034,2658,790,325,14,37,5,0,1376
48257050209,10849,4883,2353,2616,34,392,8,46,5966
48257050210,2246,1549,398,170,25,24,0,13,697
48257050211,9427,2937,2644,3286,29,111,6,59,6490
48257050212,5166,3572,873,479,22,46,0,8,1594
48257050213,6733,3953,1307,928,25,189,1,20,2780
48257050214,2839,1555,726,395,13,15,0,4,1284
48257050215,7163,4011,1597,1119,26,141,7,15,3152
48257050300,4259,2002,1542,508,13,35,0,6,2257
48257050401,3267,1069,1601,466,4,16,0,7,2198
48257050402,4496,2523,1213,471,29,45,3,19,1973
48257050500,5524,1082,1207,3013,10,36,0,9,4442
48257050601,3895,2314,1204,93,26,86,0,15,1581
48257050602,4629,3175,912,247,29,13,1,11,1454
48257050701,5571,3688,1345,248,22,52,2,18,1883
48257050703,3116,1652,1305,38,12,9,0,10,1464
48257050704,6300,3592,2175,266,44,17,1,20,2708
48257050801,4421,2478,1705,56,16,15,0,6,1943
48257050802,7372,5523,1221,265,53,31,5,20,1849
48257051000,1565,532,760,207,5,7,3,6,1033
48257051100,5138,2626,1898,350,14,38,1,3,2512
48257051201,3817,2459,946,200,7,13,0,6,1358
48257051202,5890,4366,1002,201,24,29,4,13,1524
48257051301,6469,5123,769,177,37,43,1,30,1346
48257051302,3199,2377,599,63,31,19,0,6,822
48259970101,1862,1296,450,5,12,11,0,11,566
48259970102,4754,3065,1452,17,22,17,1,42,1689
48259970301,5970,4146,1492,34,19,61,5,20,1824
48259970302,4809,3655,945,18,15,25,3,10,1154
48259970403,5407,4405,699,35,9,42,5,29,1002
48259970404,4358,3158,866,43,10,41,3,37,1200
48259970405,2494,1898,466,39,2,27,3,4,596
48259970406,8666,6204,1942,80,28,86,11,25,2462
48259970500,5959,3940,1717,44,21,45,5,24,2019
48261950100,350,73,261,0,7,0,1,2,277
48261990000,0,0,0,0,0,0,0,0,0
48263950100,753,657,81,2,3,0,0,3,96
48265960101,2564,1920,524,12,6,19,0,9,644
48265960102,3337,2465,685,31,11,53,0,8,872
48265960200,3757,3034,506,26,6,50,5,9,723
48265960301,3582,2688,741,12,8,7,8,6,894
48265960303,4017,2564,1231,35,17,32,1,4,1453
48265960304,4202,3440,570,12,22,30,0,22,762
48265960401,1870,1141,610,11,7,45,0,4,729
48265960403,3735,2487,985,89,15,49,9,20,1248
48265960404,2326,1700,511,15,5,16,1,3,626
48265960500,5413,3019,1916,205,18,83,1,15,2394
48265960601,5557,2888,2169,169,12,112,7,20,2669
48265960602,2516,1478,886,30,7,17,4,12,1038
48265960700,5413,4385,737,31,11,47,1,38,1028
48265960800,4309,2582,1527,12,11,16,2,17,1727
48267950100,2132,1748,313,6,7,1,2,0,384
48267950200,2154,1388,673,2,7,32,1,8,766
48269950100,265,230,25,0,0,0,4,0,35
48271950100,3129,1489,1470,36,21,10,2,15,1640
48273020101,3130,1242,1790,12,8,19,0,13,1888
48273020102,2714,639,2008,22,7,12,0,2,2075
48273020200,4688,329,4259,46,5,18,0,11,4359
48273020301,2826,346,2059,113,7,266,0,3,2480
48273020302,4330,1018,2733,339,20,163,0,9,3312
48273020401,3470,905,2279,128,8,86,0,18,2565
48273020402,2628,465,1886,184,6,30,0,4,2163
48273020501,3579,1168,1981,106,16,165,1,20,2411
48273020502,3675,616,2925,45,6,25,0,17,3059
48273990000,0,0,0,0,0,0,0,0,0
48275950100,1614,1005,475,65,5,11,3,0,609
48275950200,1739,930,655,81,3,13,0,5,809
48277000101,4639,3912,199,116,92,7,0,9,727
48277000102,5082,4347,320,96,98,10,5,12,735
48277000200,3563,2948,264,143,32,2,0,9,615
48277000301,3117,2715,179,23,60,6,0,12,402
48277000302,3290,2854,140,88,51,9,0,9,436
48277000401,3397,1946,315,856,38,79,8,9,1451
48277000402,6784,5126,531,420,111,228,1,16,1658
48277000500,3648,1539,466,1416,47,12,0,6,2109
48277000600,1990,849,302,625,58,14,6,4,1141
48277000700,2994,1773,463,509,29,21,0,7,1221
48277000800,3307,1761,393,924,26,13,2,14,1546
48277000900,4728,3633,281,429,54,42,0,6,1095
48277001000,3549,1951,559,733,55,31,3,6,1598
48279950100,2552,803,1712,15,3,0,2,0,1749
48279950200,1518,649,834,14,0,0,1,2,869
48279950300,2179,937,1133,62,4,0,0,8,1242
48279950500,3078,796,2042,189,6,1,0,6,2282
48279950600,3718,1796,1728,112,2,3,2,8,1922
48281950100,2656,1922,563,34,22,15,0,12,734
48281950302,3652,2864,503,36,20,25,17,11,788
48281950303,3783,2516,589,324,19,83,23,17,1267
48281950304,3470,2344,521,203,22,57,39,24,1126
48281950400,3911,2432,1222,56,16,25,4,14,1479
48281950500,4155,3054,781,47,16,37,3,22,1101
48283950301,2959,353,2563,9,0,4,0,5,2606
48283950302,3705,1114,2345,212,3,0,0,0,2591
48285000100,3808,3145,365,167,6,16,1,5,663
48285000200,3665,2698,462,411,0,23,0,4,967
48285000300,2509,1926,477,28,5,5,3,0,583
48285000400,3801,3064,409,188,9,9,0,7,737
48285000500,3553,2582,738,140,6,5,0,6,971
48285000600,3001,1149,1485,239,4,16,1,9,1852
48287000100,5344,4099,721,218,20,11,1,10,1245
48287000200,2931,1875,421,529,10,3,0,6,1056
48287000300,3144,2241,677,118,5,8,0,11,903
48287000400,6059,2397,2660,766,12,35,0,10,3662
48289950101,3383,1904,1207,151,6,34,3,3,1479
48289950102,2558,1778,352,313,13,16,1,4,780
48289950201,1646,1328,196,28,6,21,0,19,318
48289950202,3522,2981,270,91,16,13,2,9,541
48289950301,1617,1254,155,148,6,5,0,2,363
48289950302,2993,2414,266,190,7,22,0,10,579
48291700100,4451,2204,1957,95,8,25,0,17,2247
48291700200,2963,990,646,1154,16,45,1,4,1973
48291700301,4297,2289,1695,78,23,27,0,25,2008
48291700302,13573,1923,11389,72,26,11,0,27,11650
48291700303,3068,1624,940,376,5,20,1,6,1444
48291700400,7201,6241,644,69,12,17,0,29,960
48291700500,2654,2248,238,69,11,2,2,4,406
48291700600,2630,2115,303,71,13,9,0,13,515
48291700700,2539,2065,248,128,17,9,1,0,474
48291700801,3924,2842,808,67,16,5,0,17,1082
48291700802,6194,4218,1011,594,14,50,1,41,1976
48291700900,6236,3269,1810,1020,23,29,0,2,2967
48291701000,7682,2758,4202,443,22,60,3,16,4924
48291701100,7814,5330,1607,481,42,38,2,14,2484
48291701200,6248,4014,1205,704,19,51,1,29,2234
48291701300,3242,2622,276,153,13,7,0,24,620
48291701400,6912,3292,1818,1450,11,61,0,61,3620
48293970100,1955,1068,556,258,18,7,0,0,887
48293970200,4137,2471,797,683,6,15,10,15,1666
48293970300,2227,730,754,664,7,20,0,0,1497
48293970400,1695,436,619,592,3,2,2,7,1259
48293970500,1936,595,782,496,11,2,0,0,1341
48293970600,5546,3269,1183,821,13,90,0,10,2277
48293970700,1719,1482,126,37,1,3,3,6,237
48293970800,2931,2479,196,85,13,21,3,22,452
48295950200,1979,931,981,3,14,1,0,3,1048
48295950300,1080,855,142,1,15,1,0,1,225
48297950100,4539,1926,2281,177,27,7,2,25,2613
48297950200,1812,619,1153,10,1,8,0,2,1193
48297950300,2593,1716,789,6,12,8,1,1,877
48297950400,2391,1707,567,12,9,12,0,17,684
48299970100,2822,2463,168,5,29,4,0,20,359
48299970200,3592,2903,481,6,8,45,0,7,689
48299970300,1915,1721,84,3,8,7,0,12,194
48299970401,1813,1673,88,2,18,0,0,3,140
48299970402,2291,1986,186,15,9,25,0,2,305
48299970501,2826,2297,348,29,12,20,4,6,529
48299970502,4202,2931,1024,33,25,8,0,7,1271
48299970600,1782,1556,129,4,6,12,0,4,226
48301950100,64,56,1,0,1,0,0,1,8
48303000100,2594,697,1678,134,15,18,0,4,1897
48303000201,2055,901,960,147,7,12,1,7,1154
48303000202,1641,137,1370,100,7,8,0,0,1504
48303000301,3482,716,1717,330,6,610,6,26,2766
48303000303,3402,1127,1456,486,13,202,10,11,2275
48303000304,4211,294,3774,85,19,6,0,14,3917
48303000402,4729,2293,1771,341,25,133,0,12,2436
48303000403,3742,2461,882,124,7,103,8,26,1281
48303000406,2045,1175,640,82,5,77,0,1,870
48303000407,2595,1325,907,147,13,89,0,11,1270
48303000408,2823,1217,1148,279,11,73,1,17,1606
48303000409,6452,2459,2621,710,17,400,5,30,3993
48303000410,2503,1174,876,275,18,74,9,7,1329
48303000411,4179,2228,1265,280,21,190,10,22,1951
48303000501,1546,850,252,227,16,160,0,7,696
48303000502,103,59,25,4,0,6,0,0,44
48303000503,6374,593,124,3568,293,1789,4,0,5781
48303000603,3697,1956,886,326,21,328,8,28,1741
48303000605,882,538,149,109,2,66,0,0,344
48303000607,1976,803,697,230,16,131,0,15,1173
48303000700,2243,592,1286,318,14,4,0,12,1651
48303000901,873,67,340,449,0,0,0,2,806
48303000902,3678,172,1351,2060,9,7,1,0,3506
48303001000,3146,233,1476,1344,9,12,0,8,2913
48303001200,2153,103,513,1491,5,3,1,2,2050
48303001300,2839,386,2171,226,9,8,0,7,2453
48303001401,2211,940,1002,158,20,21,0,7,1271
48303001402,2350,822,1200,208,21,11,1,13,1528
48303001501,2109,1598,286,35,5,77,0,2,511
48303001502,2098,1419,454,47,2,54,0,9,679
48303001601,2535,1429,767,190,11,64,0,7,1106
48303001602,2809,1433,1078,142,23,37,2,4,1376
48303001708,2758,1055,1138,278,13,189,0,7,1703
48303001709,4468,1664,1985,606,12,49,5,23,2804
48303001710,3116,1343,1255,316,8,63,0,4,1773
48303001711,2529,1653,641,112,6,30,0,6,876
48303001712,2917,1797,764,113,13,121,4,7,1120
48303001713,2972,2254,515,60,11,36,0,2,718
48303001714,5921,2846,2345,300,25,201,7,10,3075
48303001715,1730,797,730,57,10,71,0,6,933
48303001716,4098,2501,905,257,19,283,1,12,1597
48303001717,2666,1741,669,66,0,97,3,8,925
48303001804,3927,2602,914,157,13,107,3,11,1325
48303001805,2066,848,983,128,17,12,6,5,1218
48303001806,3264,1339,1550,238,10,41,0,10,1925
48303001807,2645,1184,1044,219,17,71,0,16,1461
48303001808,2551,1462,785,150,13,48,2,5,1089
48303001904,1481,1142,235,20,6,29,0,0,339
48303001905,2194,992,897,194,12,13,0,7,1202
48303001906,2479,1386,820,128,13,18,5,17,1093
48303001907,2929,1739,924,123,7,29,0,15,1190
48303001908,2870,2278,419,49,9,26,1,7,592
48303002001,2041,1158,635,138,4,24,3,11,883
48303002002,2844,1020,1362,317,10,33,0,14,1824
48303002102,2704,1807,596,154,9,36,6,8,897
48303002103,2622,1559,657,131,22,151,2,12,1063
48303002104,2978,1468,1200,174,10,28,0,14,1510
48303002203,3056,1272,1357,290,8,23,5,8,1784
48303002205,1796,731,808,194,4,11,0,2,1065
48303002206,3680,1321,1782,317,8,134,4,12,2359
48303002207,2864,644,1707,403,14,21,5,11,2220
48303002208,1740,460,1006,227,0,6,0,3,1280
48303002301,2177,492,1319,276,3,8,5,11,1685
48303002302,2036,369,1397,210,9,8,3,9,1667
48303002401,3159,334,2273,468,8,14,0,10,2825
48303002402,3055,253,2439,319,5,7,0,9,2802
48303002500,2406,469,1617,242,11,13,0,9,1937
48303010101,1542,1093,375,1,9,5,3,4,449
48303010102,2387,1297,1023,17,1,6,0,0,1090
48303010201,2090,1279,692,38,1,10,2,12,811
48303010202,1293,701,551,19,1,2,0,4,592
48303010203,1322,752,481,52,2,3,1,1,570
48303010204,2331,993,1222,43,18,2,0,2,1338
48303010301,4137,2936,988,21,14,11,0,18,1201
48303010302,2996,2003,852,11,27,4,0,27,993
48303010402,2457,1067,1138,130,16,15,2,5,1390
48303010404,3165,2026,929,64,24,16,0,2,1139
48303010409,1542,1124,280,41,5,45,0,4,418
48303010410,2389,1682,522,43,6,43,0,7,707
48303010411,1397,832,397,45,4,54,0,6,565
48303010412,1401,1031,235,37,6,31,5,6,370
48303010413,3229,1890,919,125,4,177,0,14,1339
48303010414,2630,1490,766,103,15,177,0,1,1140
48303010415,4108,2898,693,122,3,256,0,10,1210
48303010416,1353,776,519,10,7,5,1,3,577
48303010417,4318,2870,942,115,18,217,6,14,1448
48303010418,1855,918,820,9,9,12,0,9,937
48303010419,6784,4552,1470,207,18,284,2,21,2232
48303010420,1081,614,422,15,1,0,0,2,467
48303010421,5472,3811,1183,96,18,201,0,24,1661
48303010422,2659,2114,413,18,16,35,0,0,545
48303010423,1444,1078,297,4,9,2,0,3,366
48303010502,3202,2402,429,89,11,149,0,18,800
48303010504,3828,3020,559,84,9,43,0,9,808
48303010505,4325,2244,1559,310,16,44,1,9,2081
48303010506,4048,1989,1618,237,18,46,1,9,2059
48303010509,6653,4854,1138,140,7,317,0,23,1799
48303010510,2865,2262,388,62,8,60,3,7,603
48303010511,7138,3954,2343,349,33,212,6,14,3184
48303010512,9155,6431,2003,243,24,152,5,12,2724
48303010513,2309,1012,928,325,8,1,1,3,1297
48303010514,3348,1935,1285,10,10,11,0,4,1413
48303010601,3837,1849,1737,119,4,1,0,14,1988
48303010602,1976,310,1429,182,0,9,4,7,1666
48303010700,3759,2728,830,44,17,8,0,8,1031
48303980000,0,0,0,0,0,0,0,0,0
48305950400,2178,1442,659,11,1,2,0,6,736
48305950500,2360,1008,1174,85,14,8,4,6,1352
48305950600,1058,510,519,9,0,0,0,0,548
48307950300,4924,2791,1880,82,7,36,0,10,2133
48307950400,1545,1168,320,9,0,3,0,1,377
48307950500,1161,945,169,1,0,0,0,1,216
48309000100,1638,729,457,324,5,49,0,20,909
48309000200,4640,2706,712,435,19,422,3,165,1934
48309000300,4040,2325,658,257,22,567,5,4,1715
48309000401,1759,353,823,479,5,13,0,22,1406
48309000402,4905,2851,791,572,20,490,1,18,2054
48309000598,4886,413,4102,292,9,15,1,13,4473
48309000700,2945,913,1310,595,4,20,2,20,2032
48309000800,2854,790,1503,460,6,14,0,0,2064
48309000900,4961,1397,2513,883,11,15,0,14,3564
48309001000,2703,473,1515,611,15,12,0,10,2230
48309001100,5807,809,3641,1205,10,26,1,19,4998
48309001200,3565,339,1409,1704,6,5,0,9,3226
48309001300,2269,646,1028,483,9,11,0,23,1623
48309001401,2832,327,406,1972,11,3,0,23,2505
48309001402,4556,741,1069,2557,24,0,2,11,3815
48309001500,2272,273,508,1371,17,41,0,8,1999
48309001600,6307,2057,2671,1331,21,44,1,16,4250
48309001700,6087,2194,2343,1291,24,26,0,8,3893
48309001800,2619,1113,754,670,2,14,2,7,1506
48309001900,4685,1896,1208,1228,8,118,13,6,2789
48309002000,4313,3062,873,149,20,31,0,21,1251
48309002100,5275,1576,2105,1285,22,68,0,44,3699
48309002302,5518,1898,1866,1434,18,100,7,17,3620
48309002498,5393,2480,1778,901,25,31,0,16,2913
48309002501,5089,2383,1272,1215,9,33,4,8,2706
48309002503,5587,4198,714,364,10,88,0,10,1389
48309002504,4151,3290,406,100,11,139,1,2,861
48309002600,5910,3968,1177,452,13,73,0,32,1942
48309002700,4070,989,2005,938,9,25,4,13,3081
48309002800,3963,2686,567,480,9,54,0,35,1277
48309002900,4471,3398,652,105,17,130,3,14,1073
48309003000,3906,2037,925,721,5,45,4,11,1869
48309003200,5182,2134,1478,1259,14,38,0,12,3048
48309003300,1928,1115,397,288,7,10,11,7,813
48309003401,1411,1012,241,91,14,1,0,6,399
48309003402,5262,3858,835,306,16,34,3,26,1404
48309003500,4348,3426,544,100,16,5,2,15,922
48309003601,2939,1803,389,582,17,2,2,8,1136
48309003602,2751,2096,387,130,13,5,0,18,655
48309003701,3270,2245,669,177,5,18,0,14,1025
48309003703,6248,4508,1010,319,28,62,10,22,1740
48309003708,9924,6204,1856,979,27,410,10,28,3720
48309003709,6449,3634,1333,840,13,362,0,35,2815
48309003710,4882,3410,749,358,17,151,6,4,1472
48309003711,7247,4333,1271,912,47,382,11,29,2914
48309003712,3136,2248,344,219,22,171,2,15,888
48309003801,7332,5980,875,90,43,58,2,30,1352
48309003802,5923,4270,1161,153,24,28,0,12,1653
48309003901,3511,2408,641,283,14,37,5,7,1103
48309003902,6943,4136,2128,295,23,63,5,20,2807
48309004000,5483,4650,479,73,23,24,0,6,833
48309004102,5900,4829,694,53,21,19,9,27,1071
48309004104,4342,3223,691,204,2,53,0,12,1119
48309004105,6351,4429,945,544,17,119,4,28,1922
48309004201,3588,2885,458,79,14,2,2,5,703
48309004202,4177,3419,454,102,30,9,2,12,758
48309004300,8059,2128,4789,830,18,88,6,28,5931
48309980000,17,0,8,0,0,0,0,0,17
48311950100,600,353,224,1,1,3,5,0,247
48313000100,3447,1240,957,1199,5,16,0,0,2207
48313000200,2238,1735,329,87,16,17,0,1,503
48313000300,2750,2320,235,46,8,39,0,8,430
48313000400,5020,1689,1894,1255,19,29,0,2,3331
48315950100,2097,1434,51,499,13,10,0,2,663
48315950200,2808,1930,146,522,17,14,0,16,878
48315950300,2768,2266,142,173,26,7,0,21,502
48315950400,2052,1239,50,652,13,17,0,6,813
48317950100,1521,949,535,1,4,0,0,1,572
48317950200,3716,1831,1720,80,18,9,1,18,1885
48319950100,2169,1435,672,3,0,0,0,8,734
48319950200,1784,1513,211,1,0,2,0,8,271
48321730100,2513,718,1529,224,8,9,0,2,1795
48321730202,1586,967,448,106,6,9,0,5,619
48321730203,2678,1432,889,242,7,8,0,13,1246
48321730204,4257,1461,2441,187,9,41,0,19,2796
48321730301,3744,1664,1771,196,20,20,3,10,2080
48321730302,4957,1494,2179,1070,5,70,0,7,3463
48321730303,847,482,231,102,4,7,0,6,365
48321730400,2948,741,961,1134,14,31,1,7,2207
48321730502,1274,1021,191,24,0,5,0,0,253
48321730503,1773,1332,135,214,15,9,0,8,441
48321730600,5501,1627,3169,134,2,481,3,8,3874
48321730700,4177,2416,1511,101,9,10,0,18,1761
48321990000,0,0,0,0,0,0,0,0,0
48323950204,4774,39,4720,0,3,2,1,0,4735
48323950206,4909,41,4739,9,96,13,2,5,4868
48323950207,4614,84,3862,3,655,0,0,1,4530
48323950208,3959,70,3849,1,8,19,0,7,3889
48323950209,4642,50,4559,0,7,3,0,15,4592
48323950301,4404,127,4223,19,3,14,0,15,4277
48323950302,3378,176,3158,4,4,19,1,5,3202
48323950400,3422,69,3306,4,17,18,0,1,3353
48323950500,5747,219,5488,0,2,15,0,13,5528
48323950601,2305,49,2234,0,9,2,0,10,2256
48323950602,4760,82,4637,5,7,9,0,8,4678
48323950701,5574,299,5083,82,14,63,0,19,5275
48323950702,5399,269,5078,2,10,5,0,11,5130
48325000101,7003,3286,3380,39,41,23,3,20,3717
48325000103,8031,3709,3525,388,29,81,15,30,4322
48325000104,2885,1685,1028,54,12,11,4,13,1200
48325000200,1686,1116,516,2,1,3,0,12,570
48325000301,2464,1723,625,3,12,14,1,16,741
48325000302,5998,1917,3371,611,8,26,2,5,4081
48325000401,5857,1493,4142,55,20,10,4,18,4364
48325000402,4799,2213,2404,28,15,12,7,17,2586
48325000500,4790,2053,2594,22,1,23,1,18,2737
48325000801,2755,1323,1348,17,4,0,1,13,1432
48325000802,4480,1806,2522,33,15,12,0,26,2674
48327950300,1962,1231,662,12,7,5,3,8,731
48329000100,6056,1047,3463,1325,17,68,0,8,5009
48329000200,4693,2753,1299,424,33,41,6,15,1940
48329000302,5258,2665,1624,336,7,431,3,28,2593
48329000303,4426,3240,892,56,19,41,0,12,1186
48329000304,3850,2417,953,173,38,136,13,20,1433
48329000305,5000,3085,1388,244,28,96,5,17,1915
48329000401,3428,1330,1603,196,26,144,4,7,2098
48329000402,4953,2386,1821,362,27,169,7,20,2567
48329000500,4514,2543,1455,262,24,50,2,28,1971
48329000600,4032,2170,1502,189,18,32,2,17,1862
48329001100,4783,1217,3207,202,14,40,5,17,3566
48329001200,6001,1839,3497,280,46,171,14,24,4162
48329001300,6690,2167,3760,372,30,178,12,19,4523
48329001400,5537,611,4258,563,9,18,2,27,4926
48329001500,5723,533,3699,1299,27,70,2,30,5190
48329001700,4528,282,3347,775,8,55,0,19,4246
48329010105,2470,1281,805,181,13,104,2,4,1189
48329010106,5268,2823,1479,432,14,312,13,26,2445
48329010107,4830,2740,1464,291,18,131,18,15,2090
48329010108,3497,2472,691,156,9,51,0,18,1025
48329010115,2794,1246,1176,220,6,89,2,4,1548
48329010116,4998,3514,998,111,20,140,1,21,1484
48329010117,3178,738,2331,32,7,5,1,9,2440
48329010118,3268,646,2498,25,4,9,0,25,2622
48329010119,4284,1680,2386,70,10,17,8,13,2604
48329010120,6176,4463,1139,76,17,267,0,15,1713
48329010121,5332,4143,801,86,7,122,1,13,1189
48329010122,1629,585,853,136,9,5,2,0,1044
48329010123,12127,5374,5509,574,68,182,4,56,6753
48329010124,2914,1066,1741,31,6,9,1,2,1848
48329010125,4669,2603,1404,157,34,324,3,25,2066
48329010126,8928,4183,3525,520,29,345,16,32,4745
48329010127,2531,983,1443,15,10,5,0,8,1548
48329010128,3866,2395,1304,11,11,10,0,16,1471
48329010129,4491,2989,1374,15,10,5,0,10,1502
48329010200,3261,278,2642,268,13,19,3,1,2983
48329980000,0,0,0,0,0,0,0,0,0
48331950100,2258,1534,560,100,9,6,1,8,724
48331950300,4099,2947,892,80,5,10,1,21,1152
48331950401,3284,1816,995,340,6,16,0,6,1468
48331950402,3595,1614,1198,696,6,9,6,7,1981
48331950500,2780,2176,309,155,11,22,0,3,604
48331950700,5718,3012,1773,662,18,38,3,31,2706
48331950800,3020,2268,537,64,12,10,0,8,752
48333950100,1752,1456,180,19,3,2,0,3,296
48333950200,2704,2042,548,6,7,2,0,3,662
48335950200,7041,2983,2964,887,26,54,0,11,4058
48335950400,1949,1345,490,38,8,0,1,0,604
48337950100,2309,1990,155,6,14,5,2,4,319
48337950200,1799,1554,131,3,21,3,0,2,245
48337950300,2801,1963,652,13,18,27,0,2,838
48337950401,2148,1806,247,8,18,5,0,2,342
48337950402,3415,2980,242,10,25,10,0,17,435
48337950501,3241,2536,493,14,28,17,0,3,705
48337950502,2254,1773,289,19,17,17,2,3,481
48337950600,1998,1740,152,0,14,0,0,1,258
48339690101,4716,3691,738,47,16,31,0,20,1025
48339690102,6955,3589,2945,81,23,39,2,18,3366
48339690203,4551,3245,943,112,13,30,2,20,1306
48339690204,4963,3792,769,94,26,35,1,26,1171
48339690205,3336,2652,425,43,27,29,0,13,684
48339690206,3214,2197,835,48,5,16,5,3,1017
48339690207,5498,3993,1114,89,21,70,1,6,1505
48339690300,5790,3252,2073,226,23,21,0,22,2538
48339690403,2999,2414,319,109,9,37,2,2,585
48339690404,5264,3826,830,136,27,148,9,34,1438
48339690405,5056,3579,1004,167,14,78,0,12,1477
48339690406,4406,3455,594,77,8,96,1,3,951
48339690407,4682,2011,2277,160,23,42,3,9,2671
48339690408,4705,2852,1528,57,15,60,0,17,1853
48339690501,5089,3994,670,163,16,55,0,23,1095
48339690502,3748,2611,562,171,12,217,10,15,1137
48339690503,7517,4662,1361,383,14,652,11,57,2855
48339690603,4469,2767,858,154,10,435,0,16,1702
48339690604,8692,4520,2287,576,15,819,3,47,4172
48339690605,4344,2780,675,120,6,559,3,14,1564
48339690606,6212,3797,1217,210,3,728,0,18,2415
48339690607,5022,3460,823,108,5,364,6,23,1562
48339690608,4806,3188,878,122,9,374,2,26,1618
48339690609,5015,3652,665,123,12,286,2,24,1363
48339690610,8009,5182,1369,398,16,668,11,33,2827
48339690701,6467,4151,1034,534,11,436,2,32,2316
48339690702,4545,3107,685,129,7,363,5,28,1438
48339690800,4175,2881,633,114,4,316,0,30,1294
48339690900,4287,3157,568,68,10,300,3,22,1130
48339691000,4035,3227,402,39,1,182,1,22,808
48339691100,4179,2864,798,50,17,210,0,31,1315
48339691201,3148,2550,298,34,4,149,1,13,598
48339691202,3920,2715,634,179,2,200,2,24,1205
48339691301,4395,3167,654,100,14,261,0,20,1228
48339691302,5584,3521,1115,426,15,203,7,23,2063
48339691401,2361,1442,591,129,15,64,0,10,919
48339691402,4236,2350,798,389,14,449,6,26,1886
48339691403,3911,1715,984,559,6,406,7,18,2196
48339691500,4654,2575,1183,368,24,252,5,29,2079
48339691601,3776,2520,620,110,7,286,7,19,1256
48339691602,5402,2527,1845,372,11,360,30,36,2875
48339691700,2926,2079,382,89,6,250,1,14,847
48339691801,5616,2397,2091,591,9,303,15,19,3219
48339691802,3312,2203,442,471,2,46,0,15,1109
48339691900,6377,3507,1828,604,17,121,0,21,2870
48339692003,4648,2964,920,294,12,210,3,18,1684
48339692004,4851,3402,865,201,25,129,1,20,1449
48339692005,4801,2931,810,503,8,318,0,21,1870
48339692006,7302,3441,2019,1000,27,407,21,24,3861
48339692007,6315,3194,1873,723,17,235,21,24,3121
48339692008,12488,6872,2620,1533,26,663,53,93,5616
48339692009,13287,7069,2736,1624,43,1109,25,68,6218
48339692010,7481,4907,1049,561,13,505,7,35,2574
48339692101,7688,3578,2207,972,24,515,9,44,4110
48339692102,4212,2620,827,226,12,291,5,18,1592
48339692103,5481,2822,1441,462,16,452,9,51,2659
48339692201,4816,2754,1722,120,20,40,8,7,2062
48339692202,4782,2772,1746,60,17,39,0,14,2010
48339692301,3973,2241,1398,108,14,45,7,9,1732
48339692302,5080,1460,3166,184,10,80,1,43,3620
48339692303,4990,2692,1205,619,13,272,16,16,2298
48339692304,8344,4711,2443,469,25,387,5,29,3633
48339692401,4036,2237,1427,102,20,47,10,1,1799
48339692402,10290,5199,2563,1199,16,875,25,43,5091
48339692501,6921,3180,3275,174,15,37,6,16,3741
48339692502,4166,2059,1745,112,19,59,3,25,2107
48339692601,4572,1955,2368,54,16,31,0,19,2617
48339692603,3604,1662,1688,90,8,25,14,18,1942
48339692604,9601,3938,4932,292,20,128,16,27,5663
48339692605,5023,2126,2399,181,26,78,8,9,2897
48339692701,2957,1865,898,24,4,38,2,9,1092
48339692702,4851,3027,1411,100,26,16,0,10,1824
48339692802,9739,3834,4996,434,28,106,16,40,5905
48339692803,5562,3439,1796,39,27,31,0,12,2123
48339692804,4145,2833,1044,42,12,27,0,6,1312
48339692900,5235,3590,1381,68,9,12,2,15,1645
48339693001,6338,2315,3750,74,11,53,2,15,4023
48339693002,7133,3007,3803,103,7,20,8,10,4126
48339693102,6348,2228,3124,625,18,120,2,23,4120
48339693103,3607,229,2359,943,3,2,2,17,3378
48339693104,2304,717,1403,93,13,11,3,5,1587
48339693201,4009,2281,1104,216,16,211,4,28,1728
48339693202,4918,3631,792,139,17,96,7,33,1287
48339693301,2832,1825,553,221,11,100,0,9,1007
48339693302,1758,472,919,280,4,23,1,6,1286
48339693303,3499,2283,606,262,24,133,3,16,1216
48339693304,1770,1161,289,103,6,135,0,3,609
48339693401,2474,396,1404,590,10,14,3,15,2078
48339693402,1502,266,661,466,11,27,11,1,1236
48339693501,1668,959,402,217,3,27,0,4,709
48339693502,1761,950,629,80,2,27,0,11,811
48339693503,2409,1046,1004,216,6,37,2,6,1363
48339693600,3878,2302,841,430,35,110,1,13,1576
48339693701,2636,1939,403,72,10,70,2,9,697
48339693702,6066,4040,982,518,14,238,9,11,2026
48339693703,5471,3671,888,417,16,212,9,29,1800
48339693800,4557,1867,1679,715,9,89,14,19,2690
48339693901,4169,1752,1879,246,3,134,6,26,2417
48339693902,4063,1398,2001,432,3,109,1,6,2665
48339693903,3868,205,3391,221,10,3,0,13,3663
48339693904,1767,696,706,263,0,83,0,10,1071
48339694001,5974,3977,1553,165,21,31,0,28,1997
48339694002,6899,4077,2456,72,32,50,2,23,2822
48339694103,2928,1551,1077,144,24,11,3,11,1377
48339694104,3251,1955,1065,81,10,6,2,10,1296
48339694105,5205,2097,2003,834,8,21,2,21,3108
48339694106,5214,2692,1988,271,15,22,15,17,2522
48339694107,3465,2710,524,50,19,12,0,17,755
48339694203,2407,1300,705,262,5,35,0,11,1107
48339694204,4617,3288,914,122,24,18,1,14,1329
48339694205,1355,1167,105,21,2,2,0,8,188
48339694206,3943,3225,391,98,28,28,0,10,718
48339694207,1291,1060,109,24,14,11,2,5,231
48339694208,4199,3075,621,250,7,64,0,27,1124
48339694209,2166,1628,363,40,8,26,4,7,538
48339694210,2173,1855,160,31,6,25,3,10,318
48339694303,3957,3164,409,91,12,85,0,13,793
48339694304,4507,3927,302,54,18,58,3,14,580
48339694305,3891,3251,338,75,9,27,8,26,640
48339694306,5137,4252,500,94,24,56,4,7,885
48339694307,2125,1786,182,34,8,28,2,8,339
48339694308,2818,2289,292,30,10,53,9,8,529
48339694309,3423,2924,300,27,11,42,0,11,499
48339694401,3388,2205,769,200,15,51,0,7,1183
48339694402,3960,2969,656,97,29,34,8,14,991
48339694403,3051,2017,733,105,6,44,5,12,1034
48339694501,2004,1634,208,47,11,8,2,5,370
48339694502,4750,3758,603,67,20,41,2,23,992
48339694503,11356,9116,1316,217,32,160,3,37,2240
48339694601,2569,1915,237,281,10,11,0,20,654
48339694602,1599,1291,139,97,5,5,0,3,308
48339694603,4171,3091,708,111,25,25,0,7,1080
48339694700,4240,3331,477,244,22,9,5,13,909
48341950100,1858,938,851,5,11,5,0,0,920
48341950201,3084,124,2250,363,2,316,0,15,2960
48341950202,4125,1923,1849,100,32,85,0,15,2202
48341950301,3303,658,2323,45,11,199,0,9,2645
48341950302,4347,1698,2372,43,19,104,0,32,2649
48341950400,4641,1158,3002,98,22,273,1,12,3483
48343950100,4390,3039,351,720,38,13,5,15,1351
48343950200,5043,3446,453,929,17,20,3,12,1597
48343950300,2540,1231,378,799,15,2,1,3,1309
48345950100,1063,858,153,7,0,0,0,2,205
48347950100,2553,1978,219,238,3,10,0,3,575
48347950200,5123,4047,532,256,20,28,6,16,1076
48347950303,3714,2170,1022,384,7,15,1,11,1544
48347950304,3918,2414,1109,245,26,14,0,17,1504
48347950305,3742,1063,2153,440,4,27,0,5,2679
48347950306,3753,1693,1533,394,2,19,0,2,2060
48347950401,4696,3541,522,322,11,123,0,4,1155
48347950402,3522,2547,457,322,11,46,0,3,975
48347950501,2426,1556,208,458,6,85,0,4,870
48347950502,4657,3491,370,437,13,146,3,18,1166
48347950600,5662,3253,1116,995,23,44,0,16,2409
48347950700,4215,1239,1080,1709,9,62,0,9,2976
48347950800,3685,1239,1573,701,14,36,0,14,2446
48347950900,2486,232,398,1763,5,9,0,12,2254
48347951001,2040,1243,296,409,7,29,0,9,797
48347951002,3690,1518,544,1350,13,59,0,34,2172
48347951100,4771,3934,465,144,17,8,0,13,837
48349970100,4771,1975,2454,165,14,5,7,9,2796
48349970200,6468,3082,1852,1143,20,86,122,21,3386
48349970301,3876,2065,1319,300,12,36,35,6,1811
48349970302,5005,2448,1674,538,11,67,101,22,2557
48349970400,4671,3494,751,167,21,13,7,10,1177
48349970500,4388,2254,1134,743,8,29,58,13,2134
48349970600,3506,2082,544,649,14,34,9,10,1424
48349970701,6376,3862,879,1204,26,31,55,15,2514
48349970800,1777,672,711,268,1,13,60,11,1105
48349970901,4294,2111,1052,635,14,47,197,14,2183
48349970902,3931,491,3000,277,6,5,76,6,3440
48349971000,3561,2460,679,197,16,27,7,0,1101
48351950100,1806,1398,47,258,11,4,0,8,408
48351950201,2543,1434,75,937,12,5,0,8,1109
48351950202,2506,2051,59,253,8,5,0,8,455
48351950300,2495,1771,48,584,11,2,0,1,724
48351950400,2867,2595,115,43,17,8,0,2,272
48353950100,1880,1526,257,30,9,5,0,0,354
48353950200,4088,2504,1251,128,14,28,0,7,1584
48353950300,2100,751,1083,188,5,13,1,4,1349
48353950400,4067,1628,2022,255,4,50,1,11,2439
48353950500,2603,1729,741,24,21,7,0,9,874
48355000500,463,49,256,147,0,0,2,2,414
48355000601,4094,355,3531,153,6,6,6,28,3739
48355000602,2010,183,1646,148,4,6,0,2,1827
48355000700,4653,755,3521,236,23,31,2,15,3898
48355000800,3525,615,2668,188,2,25,0,2,2910
48355000900,3848,189,3588,43,5,2,4,11,3659
48355001000,2751,234,2391,83,3,3,4,7,2517
48355001100,2317,410,1574,241,32,11,0,10,1907
48355001201,1504,631,736,67,10,31,0,2,873
48355001202,2297,489,1648,73,13,24,2,5,1808
48355001300,3628,271,3239,66,2,7,0,25,3357
48355001400,4452,1988,2157,96,15,60,0,21,2464
48355001500,4580,449,3744,276,15,30,0,11,4131
48355001601,4308,171,3836,264,6,1,3,4,4137
48355001602,3578,158,3349,37,4,5,0,3,3420
48355001702,2214,233,1857,70,9,8,0,14,1981
48355001703,3312,178,2480,610,2,9,3,10,3134
48355001704,2733,120,2463,114,2,3,1,15,2613
48355001801,5478,231,4938,235,9,30,4,12,5247
48355001802,2197,134,1911,103,5,11,2,4,2063
48355001903,3195,282,2775,88,3,3,3,12,2913
48355001904,4051,383,3525,84,4,13,0,11,3668
48355001905,2889,222,2492,89,8,51,0,0,2667
48355001906,5480,752,4268,252,13,117,11,14,4728
48355002001,3788,482,3178,63,8,9,0,21,3306
48355002002,3691,360,3223,69,0,3,0,15,3331
48355002101,3658,856,2480,159,4,67,0,7,2802
48355002102,3184,1671,1310,54,1,55,2,23,1513
48355002200,5547,998,4247,172,13,27,1,19,4549
48355002301,4083,595,3341,87,5,21,2,3,3488
48355002303,4327,663,3204,253,3,100,8,9,3664
48355002304,4492,876,3252,248,6,41,3,10,3616
48355002400,6019,1477,4232,148,14,47,2,16,4542
48355002500,4448,2282,1887,99,15,30,0,17,2166
48355002601,2544,1166,1166,88,11,32,0,18,1378
48355002602,1844,488,1251,26,3,19,0,16,1356
48355002603,2946,1055,1724,46,15,23,0,4,1891
48355002703,4881,1514,2993,141,17,81,8,19,3367
48355002705,5179,2644,2122,98,9,127,4,17,2535
48355002706,1660,281,734,590,0,42,0,3,1379
48355002707,1778,687,798,118,0,84,12,9,1091
48355002708,5082,1996,2221,424,12,224,6,28,3086
48355002900,773,461,164,65,1,19,14,4,312
48355003002,4665,2412,1627,165,17,238,3,21,2253
48355003003,1940,941,697,98,5,58,14,13,999
48355003004,2904,1517,1094,71,26,62,4,12,1387
48355003101,5638,3614,1514,65,37,109,6,23,2024
48355003102,6052,3110,2228,184,17,237,5,21,2942
48355003202,8872,3132,4530,326,20,540,6,40,5740
48355003204,4293,1453,2399,126,19,179,9,8,2840
48355003205,1362,393,801,42,6,75,1,3,969
48355003206,4302,1112,2651,228,16,172,5,16,3190
48355003303,1240,204,978,18,1,18,4,0,1036
48355003304,5399,1878,2962,239,47,93,12,24,3521
48355003305,4458,832,3122,266,5,108,2,28,3626
48355003306,4691,1525,2553,225,22,189,9,15,3166
48355003401,4143,922,2865,201,4,60,1,25,3221
48355003402,5783,1690,3556,315,17,64,4,23,4093
48355003500,2179,453,1638,33,1,12,0,2,1726
48355003601,6523,2402,3801,106,13,59,1,13,4121
48355003602,6094,2072,3757,96,9,27,8,18,4022
48355003603,5859,1906,3639,101,17,33,4,26,3953
48355003700,3220,1241,1877,29,5,3,3,5,1979
48355005103,1610,1388,109,4,9,18,2,17,222
48355005104,1103,931,99,0,3,18,0,5,172
48355005404,5618,2281,2757,210,1,229,1,24,3337
48355005406,4585,1982,2237,57,26,169,7,15,2603
48355005407,3371,930,2085,164,4,126,0,13,2441
48355005408,4392,1268,2722,182,16,89,0,20,3124
48355005409,3965,1415,2090,120,16,216,9,21,2550
48355005410,3723,1089,2319,139,13,87,3,14,2634
48355005411,3828,1234,2048,267,21,136,11,13,2594
48355005412,5126,1870,2607,167,30,272,6,15,3256
48355005413,2892,921,1468,175,4,203,7,23,1971
48355005414,4333,1351,2272,218,8,377,5,18,2982
48355005415,6695,2264,3350,275,10,553,2,31,4431
48355005416,3933,1800,1445,137,6,407,3,20,2133
48355005417,7502,2525,3984,314,4,470,0,27,4977
48355005603,2839,130,2675,16,1,1,0,4,2709
48355005604,2997,204,2705,64,0,8,3,2,2793
48355005605,4631,194,4379,25,3,12,0,13,4437
48355005606,953,83,833,10,4,1,3,7,870
48355005801,7270,4039,2859,79,10,90,3,17,3231
48355005803,4210,1629,2462,13,0,0,0,9,2581
48355005804,2874,1057,1694,12,8,38,2,17,1817
48355005900,4091,1051,2972,12,7,3,0,10,3040
48355006000,2679,496,2110,28,1,11,0,9,2183
48355006100,3217,789,2312,27,15,21,0,11,2428
48355006201,3110,2315,534,25,14,56,4,16,795
48355006202,1981,1533,293,8,3,39,0,2,448
48355006203,1732,1359,266,9,2,28,0,10,373
48355006204,2715,2113,408,30,6,68,0,7,602
48355006205,1148,923,151,10,4,26,0,4,225
48355006300,2654,894,1576,68,10,40,0,15,1760
48355006400,2303,1264,822,141,12,26,0,1,1039
48355980000,0,0,0,0,0,0,0,0,0
48355990000,0,0,0,0,0,0,0,0,0
48357950100,1701,1156,483,0,5,0,0,5,545
48357950300,3515,874,2570,8,5,7,1,2,2641
48357950400,4799,2215,2417,6,21,21,1,14,2584
48359950100,1758,1325,313,33,6,10,0,0,433
48361020200,4019,734,378,2731,6,26,0,9,3285
48361020300,2559,1822,248,354,11,27,3,5,737
48361020500,3184,2008,550,431,18,38,0,5,1176
48361020700,4850,2990,552,990,13,115,0,27,1860
48361020800,1894,1133,297,332,10,30,1,14,761
48361020900,3584,1379,332,1664,10,42,2,14,2205
48361021000,2215,1868,153,72,18,13,0,5,347
48361021100,1794,1550,108,19,8,15,0,3,244
48361021200,4822,4211,320,65,18,31,1,16,611
48361021300,6081,4143,450,1056,16,169,4,12,1938
48361021400,3898,3433,221,39,12,18,0,19,465
48361021501,1989,1700,191,14,12,0,0,0,289
48361021503,3404,3038,219,0,12,14,0,5,366
48361021504,3606,3171,203,14,13,48,1,0,435
48361021600,3845,3496,194,18,15,14,1,9,349
48361021700,2109,1826,151,8,11,51,0,0,283
48361021800,2504,2225,159,6,8,5,0,1,279
48361021901,2406,2167,140,10,9,13,0,0,239
48361021902,3886,3489,205,13,25,11,0,8,397
48361022000,3544,3132,279,9,31,10,0,9,412
48361022200,4101,3520,334,17,14,57,0,10,581
48361022301,4541,3688,584,33,25,65,0,10,853
48361022302,3852,3286,298,16,11,104,0,4,566
48361022400,6121,4926,699,70,17,192,0,11,1195
48363000100,2740,2316,274,2,24,6,0,10,424
48363000200,1974,1580,293,5,8,7,0,6,394
48363000300,3894,3355,339,8,27,26,2,14,539
48363000401,2396,1977,272,12,8,9,1,4,419
48363000402,3819,3063,558,20,21,12,0,2,756
48363000500,1624,1246,262,32,12,8,3,6,378
48363000600,3464,2365,734,98,14,95,0,9,1099
48363000700,3213,2051,911,134,8,28,0,4,1162
48363000800,2928,1407,1202,180,16,17,0,3,1521
48363000900,2357,1418,769,61,11,3,6,11,939
48365950100,4212,3127,188,740,15,8,0,1,1085
48365950200,2916,2195,277,330,3,6,0,1,721
48365950300,4151,2870,479,657,13,15,2,3,1281
48365950401,2596,1572,483,412,9,20,0,7,1024
48365950402,4017,2485,517,853,12,35,2,3,1532
48365950500,2413,2072,82,153,22,0,3,0,341
48365950600,2186,1777,164,99,22,15,0,11,409
48367140101,4503,3279,710,154,31,62,16,19,1224
48367140102,4623,3282,1030,67,37,21,2,28,1341
48367140201,3193,2399,533,76,11,33,0,0,794
48367140202,4622,3779,435,104,19,75,3,7,843
48367140300,6254,4651,1110,94,52,22,0,35,1603
48367140403,7954,6345,1083,55,59,21,0,12,1609
48367140408,5820,4617,781,56,26,38,5,27,1203
48367140409,4233,2875,1046,25,38,10,10,11,1358
48367140410,4093,3209,534,24,32,25,3,14,884
48367140411,5451,4254,786,59,21,30,7,21,1197
48367140412,4185,3176,631,49,28,24,0,12,1009
48367140413,3380,2698,443,33,21,25,2,17,682
48367140414,3498,2851,410,39,17,17,2,3,647
48367140415,4063,3300,473,37,22,24,2,10,763
48367140416,4595,3587,660,82,12,43,9,15,1008
48367140502,5344,4470,525,47,36,28,3,34,874
48367140503,5058,4053,656,48,51,12,4,14,1005
48367140504,3994,3223,495,30,32,7,0,19,771
48367140601,9040,7610,914,48,34,29,3,30,1430
48367140603,10166,7889,1683,63,80,35,4,34,2277
48367140604,3965,3120,591,36,17,12,1,8,845
48367140707,4100,3309,519,22,20,49,7,2,791
48367140708,4580,3924,314,38,26,55,1,8,656
48367140709,6416,5464,505,45,29,42,6,22,952
48367140710,4328,3559,503,57,13,20,1,10,769
48367140711,7048,5725,872,69,32,55,0,17,1323
48367140712,2527,1926,420,23,18,17,3,11,601
48367140713,5565,4432,638,115,26,112,3,8,1133
48367140714,5624,4741,519,41,38,47,0,22,883
48369950200,4941,1142,3692,26,5,11,0,26,3799
48369950300,4928,2045,2812,27,6,3,0,13,2883
48371950100,2093,779,1223,16,9,30,0,0,1314
48371950300,3352,292,2948,43,2,25,0,10,3060
48371950400,4323,1020,3144,34,5,60,0,9,3303
48371950500,4821,1198,3288,245,17,22,0,14,3623
48371980000,604,184,242,167,0,6,0,2,420
48373210103,1645,1213,303,36,7,17,0,0,432
48373210104,2622,2256,154,27,85,5,0,2,366
48373210105,4525,3489,641,180,40,28,0,5,1036
48373210106,6049,5344,335,47,38,26,0,27,705
48373210203,6611,2753,1965,1669,18,74,0,14,3858
48373210204,4059,2618,727,453,15,54,0,25,1441
48373210205,2513,2108,181,116,6,7,0,0,405
48373210206,3742,3099,287,137,27,43,0,17,643
48373210301,4056,3535,223,47,24,15,0,7,521
48373210302,4818,3126,598,838,26,38,0,15,1692
48373210401,2743,1348,806,500,2,16,0,7,1395
48373210402,1758,921,352,416,5,12,0,0,837
48373210500,4982,2998,773,403,621,5,0,16,1984
48375010100,1815,1195,343,126,6,48,1,11,620
48375010200,2168,1608,354,45,9,58,0,9,560
48375010300,1036,412,252,165,10,140,0,8,624
48375010400,3307,2324,572,92,9,71,1,87,983
48375010600,2067,308,1528,141,0,48,0,2,1759
48375010700,3343,1134,2016,79,12,18,1,11,2209
48375011000,2190,441,1613,61,17,14,0,17,1749
48375011500,3926,2373,1008,225,26,81,0,47,1553
48375011600,4327,2048,985,369,25,650,0,108,2279
48375011700,4567,2561,1039,539,22,173,4,32,2006
48375011800,3871,2298,1054,212,27,113,0,3,1573
48375011900,2944,1597,859,275,33,23,1,21,1347
48375012000,1425,536,636,170,12,8,0,9,889
48375012200,3441,507,2634,188,5,48,0,3,2934
48375012600,2952,480,2050,255,14,105,0,2,2472
48375012800,3907,659,2593,409,25,142,0,10,3248
48375013000,1532,131,428,884,13,15,0,9,1401
48375013200,1726,1325,229,102,20,12,0,1,401
48375013300,6094,4565,736,238,26,312,0,26,1529
48375013400,3230,2414,575,59,23,22,3,8,816
48375013900,3906,709,1388,1471,17,173,1,21,3197
48375014100,2852,908,1510,203,14,90,0,16,1944
48375014300,6427,5102,840,55,52,35,2,15,1325
48375014401,7773,2938,2632,1958,24,92,0,5,4835
48375014500,5574,1213,3972,167,17,69,0,18,4361
48375014701,2294,1446,589,103,28,12,0,9,848
48375014702,1933,1084,622,67,11,14,0,26,849
48375014800,1975,207,964,677,5,58,0,5,1768
48375014900,5806,635,1832,549,12,2611,2,9,5171
48375015000,7234,1066,3987,1308,19,675,0,29,6168
48375015100,3219,2181,753,47,30,59,0,1,1038
48375015200,2826,1817,793,49,29,2,1,8,1009
48375015300,4462,1575,1990,588,35,26,3,16,2887
48375015400,2372,354,1816,123,9,19,0,11,2018
48375980000,4,2,1,0,0,0,0,0,2
48377950100,2289,839,1371,16,10,16,0,4,1450
48377950200,3842,122,3620,9,6,69,0,5,3720
48379950101,4712,3799,494,148,19,22,0,18,913
48379950102,2605,2233,223,20,26,6,1,2,372
48379950200,4847,4098,392,96,40,27,0,13,749
48381020100,2158,1699,286,49,6,11,0,6,459
48381020200,2529,1657,600,117,4,38,1,0,872
48381020300,2092,1259,509,148,13,42,2,7,833
48381020400,1952,1421,371,52,4,28,2,5,531
48381020500,3623,1943,1337,142,24,14,5,15,1680
48381020600,3850,1419,2117,103,24,34,2,12,2431
48381020800,6360,3686,1980,272,39,133,0,19,2674
48381020900,2833,1532,887,231,8,40,3,18,1301
48381021000,2337,1579,554,64,10,15,0,9,758
48381021101,4040,2832,806,160,30,38,4,5,1208
48381021102,1994,1139,483,262,13,35,0,3,855
48381021200,5267,3606,1159,183,32,20,0,18,1661
48381021300,5089,3555,1047,202,34,32,3,15,1534
48381021500,4867,3679,822,67,21,56,0,8,1188
48381021602,5123,3861,794,148,29,85,1,13,1262
48381021603,1939,1419,328,47,16,56,1,4,520
48381021604,4503,3538,562,84,21,170,0,2,965
48381021605,1955,1450,307,55,13,57,0,6,505
48381021606,5214,4033,749,132,35,39,2,14,1181
48381021609,5264,4015,672,108,13,283,0,22,1249
48381021610,3335,2433,651,76,15,28,0,4,902
48381021611,7718,5368,1511,281,43,226,8,10,2350
48381021702,4716,3579,868,18,30,23,2,19,1137
48381021705,3137,2133,763,31,19,7,0,10,1004
48381021706,3656,2754,644,113,25,8,2,2,902
48381021707,5089,3980,768,38,19,82,6,26,1109
48381021708,5350,4242,768,37,38,36,0,24,1108
48381021802,5797,3720,1308,401,64,94,1,19,2077
48381021803,2576,1800,562,49,18,22,3,9,776
48381021804,3540,2593,683,63,19,18,0,22,947
48381021900,6051,5130,617,29,44,24,1,16,921
48381022001,8672,5183,2430,397,39,247,5,26,3489
48381022002,8127,3220,3640,408,32,563,0,24,4907
48383950100,3385,968,2283,33,12,19,1,6,2417
48385950100,2758,1940,692,22,8,12,3,2,818
48387950100,2174,1760,154,171,13,9,0,3,414
48387950501,2189,912,245,892,19,20,0,4,1277
48387950502,2178,1448,131,522,9,7,0,0,730
48387950600,2648,2297,143,48,36,6,0,2,351
48387950700,2398,2082,93,105,25,9,0,4,316
48389950200,2655,155,2429,27,5,20,0,4,2500
48389950300,1996,151,1775,45,0,2,2,9,1845
48389950400,4820,862,3713,87,12,102,0,21,3958
48389950600,5277,529,4593,65,10,41,1,5,4748
48391950200,3483,1239,1828,328,11,11,0,4,2244
48391950400,3258,1625,1478,72,7,16,0,8,1633
48393950100,827,717,50,2,2,0,0,1,110
48395960100,1910,1371,140,285,6,23,1,15,539
48395960200,1232,514,155,496,3,15,2,4,718
48395960300,4592,3680,412,330,2,50,5,5,912
48395960400,3265,2253,723,175,10,1,5,3,1012
48395960501,3199,809,1051,1245,5,9,7,6,2390
48395960502,2559,878,1047,564,3,6,1,4,1681
48397040101,7516,5530,849,361,33,344,3,24,1986
48397040103,4483,3576,391,140,22,116,0,13,907
48397040104,3882,2096,868,552,19,144,8,19,1786
48397040201,1832,1473,193,38,9,34,0,8,359
48397040202,5788,4244,754,245,17,229,3,12,1544
48397040203,1670,1238,165,116,5,79,0,1,432
48397040301,5438,3332,974,623,19,248,8,24,2106
48397040303,3844,3022,428,92,21,93,4,10,822
48397040304,2380,1399,409,317,15,134,3,10,981
48397040305,3370,2171,571,416,9,88,4,3,1199
48397040403,2681,1676,741,121,10,22,0,9,1005
48397040404,2835,1689,679,224,17,83,1,11,1146
48397040405,2810,1393,927,298,10,53,3,7,1417
48397040406,4055,2587,745,372,15,120,3,15,1468
48397040407,2912,1992,504,169,19,78,6,10,920
48397040408,3054,1742,715,313,4,134,7,9,1312
48397040409,4871,2510,1585,438,28,137,0,6,2361
48397040410,4135,2422,1024,402,21,66,2,9,1713
48397040411,2091,1516,297,139,3,24,3,1,575
48397040412,1265,827,281,71,0,16,2,4,438
48397040503,6943,2414,3222,769,25,261,8,8,4529
48397040507,4755,3871,424,135,25,114,2,5,884
48397040508,3245,2657,239,98,8,64,0,14,588
48397040509,2468,1744,342,144,17,55,1,19,724
48397040510,4453,3425,475,171,21,145,0,30,1028
48397040511,3000,2323,257,161,28,70,0,17,677
48397040512,4888,2491,1071,867,21,199,1,24,2397
48397040513,4435,2983,804,297,17,134,3,9,1452
48397040514,2720,1855,626,90,21,22,0,13,865
48399950100,1320,1056,194,6,11,4,0,0,264
48399950200,2095,943,1047,38,6,3,1,2,1152
48399950500,1893,1280,568,3,4,1,0,0,613
48399950600,4592,2783,1545,85,18,16,5,13,1809
48401950101,2711,1529,664,392,2,6,0,3,1182
48401950102,2824,2014,327,325,25,4,3,14,810
48401950200,2916,1962,370,409,22,8,0,16,954
48401950300,6272,4208,1087,538,20,32,4,27,2064
48401950400,4985,3383,663,685,25,23,2,11,1602
48401950501,5198,3375,1072,523,24,24,1,16,1823
48401950502,4510,2619,748,1024,12,12,2,14,1891
48401950600,2326,1969,193,88,7,2,3,2,357
48401950700,5301,2384,1266,1515,8,24,0,12,2917
48401950800,4176,2055,1017,912,10,39,2,13,2121
48401950900,3295,1811,793,529,8,37,0,9,1484
48401951000,2306,1225,782,192,9,2,0,11,1081
48401951100,2866,1882,410,479,9,1,1,5,984
48401951200,2528,1606,187,629,14,17,0,9,922
48403950100,2243,1876,89,162,11,13,0,9,367
48403950200,3000,2503,118,265,14,2,0,0,497
48403950300,4651,3928,186,307,26,37,0,26,723
48405950100,2956,2077,228,555,6,10,0,0,879
48405950200,2530,949,337,1182,1,18,0,0,1581
48405950300,2432,2244,74,31,12,8,0,0,188
48407200103,2430,1786,331,182,13,5,0,2,644
48407200104,3974,2500,973,306,16,9,1,3,1474
48407200105,3887,2556,1104,57,9,21,5,13,1331
48407200106,4087,2179,1581,145,24,13,0,13,1908
48407200107,2695,2082,195,314,6,1,7,3,613
48407200201,3543,2642,256,474,16,9,1,22,901
48407200202,1446,1223,95,56,11,0,1,0,223
48407200301,2982,2369,131,300,13,11,0,6,613
48407200302,2358,1833,156,249,15,17,0,12,525
48409010201,3439,1998,1250,42,8,20,0,11,1441
48409010202,4867,2424,2052,162,21,53,8,11,2443
48409010301,5167,2439,2360,67,23,68,9,30,2728
48409010302,4788,2386,2113,65,13,60,0,16,2402
48409010500,1920,204,1672,14,5,5,1,4,1716
48409010601,7033,2938,3519,126,46,135,19,24,4095
48409010602,4095,1900,1871,83,11,83,12,16,2195
48409010603,3704,2316,951,67,9,229,6,10,1388
48409010604,2871,1751,881,38,12,45,2,6,1120
48409010700,4679,2218,2177,52,17,86,0,27,2461
48409010800,4152,637,3408,47,2,2,0,8,3515
48409010900,5228,1976,3082,28,12,9,0,21,3252
48409011000,6634,1203,5197,119,4,29,8,20,5431
48409011100,2530,484,1985,15,3,4,0,1,2046
48409011200,3169,1368,1690,11,8,17,0,7,1801
48409011300,4479,371,4012,58,4,0,1,15,4108
48411950100,2560,1286,1196,0,13,11,1,0,1274
48411950200,3170,2404,553,106,16,5,0,10,766
48413950300,2451,1102,1275,15,4,7,2,10,1349
48415950100,4385,1795,2263,228,19,12,0,3,2590
48415950200,1334,1030,252,1,4,0,1,0,304
48415950300,6094,3509,2220,127,21,38,2,11,2585
48415950600,5119,2303,2404,243,16,32,2,13,2816
48417950300,3105,2612,363,20,6,14,0,2,493
48419950100,4819,3270,816,558,15,14,0,5,1549
48419950200,3392,2411,329,473,8,7,0,9,981
48419950300,4522,2602,1419,371,8,24,2,4,1920
48419950401,3274,1053,740,1204,4,178,4,10,2221
48419950402,2511,895,810,613,2,136,8,17,1616
48419950500,2694,2106,424,83,8,1,0,4,588
48419950600,2810,2079,147,503,5,4,0,0,731
48421950200,2782,1362,1315,10,5,2,0,6,1420
48423000100,6074,539,3115,2309,6,7,0,16,5535
48423000201,4063,182,898,2837,12,10,0,10,3881
48423000202,2003,66,1010,886,0,4,1,4,1937
48423000300,6066,616,3983,1322,2,17,0,12,5450
48423000400,2335,122,1158,999,1,9,0,2,2213
48423000500,2980,1191,1017,689,11,10,0,5,1789
48423000600,1848,183,1292,331,5,15,0,0,1665
48423000700,4346,575,992,2658,9,9,0,21,3771
48423000800,5655,2424,1683,1303,15,32,2,21,3231
48423000900,4892,2052,1558,1062,4,65,1,15,2840
48423001000,5308,3068,1111,825,23,79,6,15,2240
48423001101,3884,2864,411,388,10,48,2,12,1020
48423001102,2644,1946,304,211,10,50,0,19,698
48423001200,3606,2083,776,532,8,64,0,6,1523
48423001300,2377,1295,528,357,4,64,0,12,1082
48423001404,7268,5519,783,503,42,68,3,17,1749
48423001405,3753,3089,259,140,16,14,0,16,664
48423001406,5880,5064,404,121,21,57,0,21,816
48423001407,5697,4413,712,264,16,60,0,29,1284
48423001408,2523,1784,316,273,24,25,2,14,739
48423001501,2141,1582,248,225,1,10,2,1,559
48423001502,3734,2536,577,432,19,14,1,7,1198
48423001602,5286,2821,882,1252,18,104,2,15,2465
48423001605,3051,974,1406,569,4,20,2,4,2077
48423001606,4351,1557,1597,1033,10,26,0,4,2794
48423001607,4401,1805,1139,1230,5,51,2,19,2596
48423001608,2708,564,1352,706,2,17,0,7,2144
48423001701,5062,1731,2363,757,19,42,5,6,3331
48423001702,4440,1252,2515,545,17,4,0,7,3188
48423001803,4854,3326,532,592,15,156,1,19,1528
48423001804,4188,1469,1205,1370,18,13,0,7,2719
48423001805,2586,1559,410,497,14,12,4,12,1027
48423001806,5375,3136,1256,665,28,80,0,14,2239
48423001807,3898,2628,670,358,6,92,0,13,1270
48423001906,6201,4791,617,438,24,69,0,23,1410
48423001909,3291,2415,285,301,11,150,8,14,876
48423001910,2417,1350,313,536,1,94,3,4,1067
48423001911,3371,2350,323,423,10,149,0,6,1021
48423001912,3005,2702,143,45,8,15,0,0,303
48423001913,3704,2938,318,207,20,32,0,14,766
48423001914,5001,3518,420,722,18,83,0,13,1483
48423001915,7266,5770,604,475,37,57,1,32,1496
48423001916,6258,4695,414,542,13,343,1,24,1563
48423001917,2401,1789,158,207,8,154,0,3,612
48423002003,3899,1673,500,1320,11,197,3,21,2226
48423002004,2689,2025,248,223,6,77,8,9,664
48423002006,3773,2839,331,277,2,160,0,12,934
48423002009,7832,6082,746,491,20,161,2,22,1750
48423002010,6327,3608,722,1126,30,507,3,27,2719
48423002011,3195,2295,356,279,17,119,1,2,900
48423002012,3616,2375,316,541,9,213,0,19,1241
48423002013,2939,2277,226,187,10,100,0,14,662
48423002101,4198,2875,434,689,18,26,0,6,1323
48423002102,5870,4871,563,146,39,24,6,13,999
48423002200,6949,5199,782,587,19,51,5,15,1750
48423980000,0,0,0,0,0,0,0,0,0
48425000101,4124,2921,946,20,28,43,0,11,1203
48425000102,3344,2814,379,7,9,1,0,16,530
48425000200,1737,1276,362,12,12,11,0,6,461
48427950101,1040,48,980,2,0,1,0,2,992
48427950104,5382,108,5210,7,2,34,0,14,5274
48427950105,4058,44,4000,2,0,0,0,8,4014
48427950106,3451,57,3378,3,0,0,0,2,3394
48427950107,4682,60,4597,6,0,12,0,6,4622
48427950108,4027,105,3895,1,1,4,0,12,3922
48427950202,2620,68,2540,0,2,0,0,1,2552
48427950203,4347,78,4261,0,0,1,0,4,4269
48427950204,5765,59,5694,0,0,0,0,7,5706
48427950402,5916,60,5840,0,0,3,0,7,5856
48427950403,1999,31,1953,0,0,0,0,8,1968
48427950404,3873,66,3793,5,0,0,0,0,3807
48427950500,4086,119,3917,4,0,23,0,11,3967
48427950601,4111,71,4011,0,0,12,0,7,4040
48427950602,3160,112,3032,0,1,7,0,1,3048
48427950701,3912,58,3842,1,2,0,0,5,3854
48427950702,3491,27,3450,0,0,3,0,3,3464
48429950200,3792,2384,1198,48,10,31,0,11,1408
48429950300,2042,1250,637,42,10,18,1,14,792
48429950500,3267,2622,369,147,16,11,0,2,645
48431950100,1372,867,449,3,4,1,2,2,505
48433950300,1245,958,226,18,3,5,0,2,287
48435950300,3372,1200,2093,6,5,6,0,14,2172
48437950200,1816,1162,484,146,3,8,0,0,654
48437950300,4037,1539,2138,232,10,0,0,8,2498
48437950400,1118,518,525,29,5,2,0,0,600
48439100101,6019,1132,4259,119,15,386,0,11,4887
48439100102,4618,1584,2603,149,16,118,2,19,3034
48439100201,4922,270,4310,243,10,41,4,7,4652
48439100202,5428,294,5030,56,5,13,0,10,5134
48439100300,5705,451,4372,784,9,36,1,4,5254
48439100401,2064,112,1884,55,1,5,0,0,1952
48439100402,4920,210,4590,52,7,16,0,5,4710
48439100503,2541,174,2239,80,1,5,3,12,2367
48439100504,4781,840,3804,42,15,14,0,2,3941
48439100505,5070,1032,2575,1164,15,128,6,27,4038
48439100506,5599,282,4629,528,5,73,4,8,5317
48439100601,2703,1950,453,73,10,66,1,21,753
48439100602,4754,2173,1840,470,77,62,13,7,2581
48439100700,5077,1849,2928,92,17,43,3,13,3228
48439100800,5523,460,4952,59,8,5,0,14,5063
48439100900,1854,95,1697,33,2,3,1,10,1759
48439101201,2021,609,1164,98,7,87,0,4,1412
48439101202,4975,873,3607,309,14,76,2,12,4102
48439101301,5498,1580,2183,1423,20,111,3,7,3918
48439101302,3074,626,1359,922,11,47,7,6,2448
48439101401,5307,1703,1929,1291,10,162,3,28,3604
48439101402,3874,397,2842,521,15,35,2,12,3477
48439101403,5146,671,2664,1529,33,125,0,17,4475
48439101500,4549,1149,2568,623,17,73,0,4,3400
48439101700,2347,628,633,951,38,14,7,7,1719
48439102000,4824,3374,642,226,14,315,4,31,1450
48439102101,2328,1941,177,25,7,75,3,9,387
48439102102,2931,1677,601,428,10,82,0,17,1254
48439102201,3487,2519,732,60,12,35,2,10,968
48439102202,2812,2376,226,63,13,43,2,6,436
48439102301,3388,1237,1433,498,8,47,6,13,2151
48439102302,5741,2097,3099,268,23,40,5,16,3644
48439102401,4409,2606,633,823,8,154,6,13,1803
48439102402,4668,3623,567,184,6,77,0,21,1045
48439102500,4287,275,1623,2249,2,42,0,10,4012
48439102601,3886,1584,1442,594,10,114,4,13,2302
48439102602,3508,1635,1541,180,8,46,0,6,1873
48439102700,3279,2537,410,77,16,83,3,6,742
48439103500,5838,481,4459,715,3,71,6,22,5357
48439103601,2536,98,1142,1230,2,5,2,15,2438
48439103602,2373,101,875,1318,0,20,0,5,2272
48439103701,4308,143,3479,635,9,6,3,2,4165
48439103702,2911,72,1853,943,3,3,0,10,2839
48439103800,4101,228,1614,2070,6,111,5,13,3873
48439104100,3326,1985,990,82,7,110,5,14,1341
48439104202,3231,2353,522,76,10,85,0,30,878
48439104203,4129,1694,454,1066,2,842,0,22,2435
48439104204,2388,2093,163,6,16,20,1,9,295
48439104301,3148,2151,545,150,42,131,2,20,997
48439104302,3024,2161,567,78,6,87,0,7,863
48439104400,5241,1855,3006,164,10,77,0,10,3386
48439104502,2873,155,2196,435,16,24,0,11,2718
48439104503,2667,70,2541,37,3,15,0,0,2597
48439104504,3159,290,2606,190,7,45,3,1,2869
48439104505,4868,239,2414,2129,8,25,0,4,4629
48439104601,3814,122,2306,1329,1,5,0,4,3692
48439104602,5043,226,3796,937,2,15,0,9,4817
48439104603,3980,277,3141,512,1,7,1,2,3703
48439104604,3468,123,1468,1768,1,36,0,9,3345
48439104605,4887,368,2078,2222,10,93,6,5,4519
48439104701,4544,273,4144,40,4,45,0,11,4271
48439104702,3281,223,2887,143,1,1,0,6,3058
48439104802,5262,802,3737,402,6,202,1,22,4460
48439104803,6112,744,4495,155,8,635,1,4,5368
48439104804,2776,329,2305,58,1,49,0,2,2447
48439104900,3252,490,2362,103,4,242,0,4,2762
48439105007,6209,3004,1341,1007,45,482,15,39,3205
48439105008,8379,2976,2724,1346,48,952,12,44,5403
48439105009,7205,761,5592,589,34,96,10,8,6444
48439105201,6753,1619,2415,2234,43,152,4,19,5134
48439105203,2410,1229,840,179,11,29,0,19,1181
48439105204,3430,1106,799,1296,13,85,5,9,2324
48439105206,2288,838,669,670,6,24,4,18,1450
48439105207,3199,685,695,1603,21,46,5,15,2514
48439105403,6281,4628,572,284,21,485,0,31,1653
48439105404,4257,3521,344,95,7,123,4,7,736
48439105405,5964,3891,860,744,18,191,11,28,2073
48439105407,2552,1691,412,223,7,123,7,9,861
48439105408,2659,2083,286,131,0,77,0,11,576
48439105502,5849,2846,1627,947,37,119,4,41,3003
48439105503,6249,3286,1519,1037,10,106,10,16,2963
48439105505,4911,2039,1214,1104,23,296,3,30,2872
48439105511,5976,1540,2058,2024,13,128,3,22,4436
48439105512,4547,2088,1243,931,13,103,9,5,2459
48439105513,3008,1182,552,1090,4,80,0,7,1826
48439105514,2734,956,619,894,12,112,5,12,1778
48439105515,5981,1699,1191,2527,7,315,9,23,4282
48439105516,2486,915,516,748,5,174,3,2,1571
48439105517,3470,1188,674,1336,6,156,6,11,2282
48439105518,3379,2022,483,545,12,204,0,9,1357
48439105519,4440,2806,582,628,19,200,1,16,1634
48439105520,2514,1971,144,52,10,247,0,9,543
48439105600,5344,1920,3036,205,14,19,0,18,3424
48439105701,4026,1498,1811,470,24,77,3,12,2528
48439105703,3814,1199,1319,1031,12,133,2,12,2615
48439105705,5295,749,2309,1849,6,174,1,12,4546
48439105706,3799,483,1900,1095,2,209,1,8,3316
48439105800,4538,634,3501,272,8,54,0,8,3904
48439105901,4087,284,2867,831,5,33,7,3,3803
48439105902,7360,925,1975,2853,29,1425,7,18,6435
48439106002,3949,190,1757,1889,14,15,0,13,3759
48439106004,8354,1164,3940,2901,27,88,3,25,7190
48439106005,3854,549,2089,1024,26,52,3,12,3305
48439106006,4815,928,1796,1660,12,241,0,10,3887
48439106101,1946,133,941,819,4,9,0,2,1813
48439106102,5415,889,2408,1878,9,108,0,15,4526
48439106201,3894,99,1460,2248,4,7,0,4,3795
48439106202,4869,193,1224,3302,12,22,3,19,4676
48439106300,3448,125,1055,2166,7,19,4,6,3323
48439106400,3913,959,1999,739,24,84,5,3,2954
48439106502,3140,1058,716,1127,14,78,0,17,2082
48439106503,5483,1136,1356,2610,17,145,7,12,4347
48439106507,1943,992,301,486,6,71,5,16,951
48439106509,5704,1748,1023,1867,12,785,14,24,3956
48439106512,4759,1028,661,2673,7,157,16,20,3731
48439106513,2994,619,713,1405,7,142,0,12,2375
48439106514,6076,1394,1128,2892,13,383,2,50,4682
48439106515,4370,1060,665,2325,16,121,0,20,3310
48439106518,5524,1328,1049,2152,10,696,18,66,4196
48439106519,2046,308,367,1224,5,51,1,6,1738
48439106520,3717,456,910,2113,12,84,11,8,3261
48439106521,4853,1303,991,1889,16,446,0,27,3550
48439106522,4195,791,1347,1769,10,130,2,26,3404
48439106523,4691,833,738,2589,10,260,39,68,3858
48439106524,4584,1414,898,746,7,1281,17,31,3170
48439106525,2077,970,379,278,8,303,36,0,1107
48439106526,7121,3484,1277,1038,18,888,62,29,3637
48439106600,3291,1215,1064,769,14,77,0,12,2076
48439106700,2166,1200,752,85,7,18,14,17,966
48439110102,4659,1638,2372,284,18,188,18,23,3021
48439110103,4269,1679,1647,493,9,288,6,10,2590
48439110104,3859,1690,936,643,20,421,6,13,2169
48439110202,4108,1176,2530,42,10,267,0,7,2932
48439110204,7560,2589,3623,355,13,770,16,13,4971
48439110205,5490,2177,1384,946,35,677,16,23,3313
48439110206,3513,1192,1784,173,7,243,1,7,2321
48439110301,3828,1204,1973,175,10,352,0,11,2624
48439110302,5308,1187,3647,79,26,251,0,0,4121
48439110401,4711,2671,1722,70,29,43,8,15,2040
48439110402,5454,1589,3461,224,21,37,2,8,3865
48439110500,7646,2961,4334,92,17,57,2,19,4685
48439110600,2585,1514,725,123,38,48,7,11,1071
48439110703,5894,2996,1840,459,32,198,53,28,2898
48439110704,4653,2418,1467,397,51,95,0,16,2235
48439110705,3966,2239,1269,164,18,39,3,7,1727
48439110706,3761,1862,1366,271,12,61,12,15,1899
48439110805,6959,3976,1806,642,17,151,11,40,2983
48439110806,5684,3642,1226,285,25,179,0,23,2042
48439110807,7063,3709,1905,898,37,159,5,36,3354
48439110808,4752,3700,518,160,12,192,0,6,1052
48439110809,2521,1958,255,77,6,71,0,0,563
48439110901,5326,3793,878,297,18,92,4,6,1533
48439110903,1793,1277,232,152,1,47,1,11,516
48439110905,4380,3281,627,163,16,66,0,20,1099
48439110906,4429,3251,795,107,26,42,2,13,1178
48439110907,3687,2684,475,208,25,116,5,11,1003
48439111003,3788,1354,1468,587,4,250,2,8,2434
48439111010,4246,3117,707,137,19,99,6,0,1129
48439111015,3047,1648,731,500,6,23,0,15,1399
48439111018,2245,1366,496,233,14,55,2,10,879
48439111019,5466,781,2375,1958,10,213,5,18,4685
48439111020,4764,776,1439,2182,19,180,2,11,3988
48439111021,4174,1536,1378,938,12,112,7,5,2638
48439111022,6628,2812,1649,1684,16,121,7,41,3816
48439111023,7168,942,2265,3408,26,248,8,28,6226
48439111024,4265,1158,1234,1421,13,296,1,19,3107
48439111025,3571,647,1406,1219,7,183,0,20,2924
48439111026,5680,817,1836,2589,13,229,8,14,4863
48439111027,4482,934,1181,1951,9,237,3,30,3548
48439111028,7923,2783,2186,2285,26,241,7,44,5140
48439111029,7673,4676,1477,819,35,235,19,30,2997
48439111030,4313,2923,761,335,24,63,4,7,1390
48439111031,2906,921,439,1134,3,273,0,6,1985
48439111032,7330,2721,1484,1987,18,707,8,43,4609
48439111033,5135,1707,1048,1575,6,566,4,23,3428
48439111102,6799,528,2919,3127,8,78,0,16,6271
48439111103,4238,444,2654,1055,0,29,0,10,3794
48439111104,3011,292,1321,1310,5,44,0,5,2719
48439111202,6154,1125,3655,1203,8,29,0,18,5029
48439111203,7033,3463,1990,1054,34,94,3,53,3570
48439111204,5727,4192,972,205,29,63,2,16,1535
48439111304,7225,4834,970,664,25,289,6,12,2391
48439111306,6298,2996,1757,1075,18,129,0,24,3302
48439111307,3540,1496,951,781,14,114,3,14,2044
48439111308,1717,1064,329,211,8,32,0,4,653
48439111309,4360,1669,1850,575,25,42,3,19,2691
48439111311,7553,3952,1073,1563,24,525,13,40,3601
48439111312,3452,2715,267,207,11,87,2,2,737
48439111314,7064,2640,1207,2328,21,473,5,33,4424
48439111315,4575,1193,1029,1653,10,457,1,34,3382
48439111316,7163,1223,1687,2773,19,1139,5,45,5940
48439111317,5000,3239,1236,256,33,55,3,20,1761
48439111318,5282,3247,1094,547,19,92,2,23,2035
48439111319,8585,3876,1174,2517,41,569,4,55,4709
48439111320,6068,1514,980,2426,7,836,4,16,4554
48439111402,6045,3574,1134,846,22,156,12,22,2471
48439111405,2725,1630,700,196,9,40,1,7,1095
48439111406,4466,2596,587,765,11,231,6,27,1870
48439111407,3894,2191,564,554,3,365,0,26,1703
48439111408,4936,2515,940,980,34,240,11,14,2421
48439111409,5573,3371,743,695,17,485,4,16,2202
48439111410,3957,1422,779,1410,15,144,7,20,2535
48439111411,5789,3223,894,945,37,393,3,15,2566
48439111505,4226,2729,839,362,16,90,3,9,1497
48439111506,6500,3760,981,1184,31,173,0,33,2740
48439111513,4157,978,1466,1056,11,480,9,27,3179
48439111514,6890,1509,2658,1726,9,735,25,16,5381
48439111516,6595,1826,2089,1789,18,583,16,35,4769
48439111522,7933,1435,4655,950,19,665,24,29,6498
48439111525,6425,1543,2798,1201,12,663,2,25,4882
48439111526,4454,2057,1281,759,36,115,3,20,2397
48439111529,4000,2780,560,291,18,185,4,14,1220
48439111530,6188,4076,730,662,20,435,4,20,2112
48439111531,4585,2921,799,438,23,179,1,20,1664
48439111532,7258,4237,1148,1195,15,331,0,24,3021
48439111533,5066,2762,1195,574,22,278,6,36,2304
48439111534,6441,3904,1200,787,43,152,15,29,2537
48439111536,3392,438,1200,1451,10,213,1,6,2954
48439111538,6329,1374,2054,2381,34,286,5,32,4955
48439111540,6403,1531,1902,1825,8,868,10,25,4872
48439111541,4153,971,1545,1176,7,285,5,23,3182
48439111542,6330,1556,1758,1887,21,857,4,14,4774
48439111543,7433,1667,1643,3228,15,532,5,29,5766
48439111544,7438,2066,2238,2185,16,580,8,47,5372
48439111545,2528,1839,207,173,7,194,4,10,689
48439111546,6375,3877,1091,642,15,455,13,17,2498
48439111551,7440,3290,1081,1797,22,900,8,25,4150
48439111552,3614,2267,639,375,17,139,1,12,1347
48439111553,4280,1665,945,1247,14,251,4,22,2615
48439111554,4971,1118,1671,1321,12,676,1,25,3853
48439111555,4960,989,1044,1704,19,989,0,35,3971
48439111556,5797,738,2515,1927,14,460,10,34,5059
48439111557,3054,552,1298,582,13,506,6,8,2502
48439111558,5889,1080,2520,1478,23,581,0,23,4809
48439111559,2616,544,901,958,3,121,8,6,2072
48439111560,5694,1205,1532,1867,15,864,3,19,4489
48439111561,4909,914,1253,1367,2,1167,7,10,3995
48439111562,5194,975,1371,1871,5,746,6,30,4219
48439111563,5127,712,998,1588,12,1588,4,31,4415
48439111564,5533,1217,956,2586,4,577,1,30,4316
48439111565,6070,1869,921,2344,14,580,4,52,4201
48439111566,6264,1765,955,2263,11,966,0,37,4499
48439111567,5831,1155,2034,1953,23,455,3,20,4676
48439111568,7295,1733,1626,2456,18,1084,15,41,5562
48439111569,4327,686,1246,1482,4,766,2,26,3641
48439111570,4720,524,1776,2042,8,226,10,15,4196
48439111571,4736,880,1337,1733,8,634,12,20,3856
48439111572,3478,413,1062,1193,6,689,0,7,3065
48439113003,2204,688,367,909,11,129,9,14,1516
48439113004,2385,1310,519,239,17,166,8,8,1075
48439113005,2387,303,1212,714,37,47,0,4,2084
48439113006,1818,113,507,982,3,161,0,18,1705
48439113007,3243,461,1760,884,12,51,0,6,2782
48439113102,4787,2253,850,1249,23,158,5,33,2534
48439113104,3993,1180,701,1681,14,242,6,26,2813
48439113107,2356,1696,311,133,8,110,0,18,660
48439113108,4582,3078,674,302,13,319,0,13,1504
48439113109,4193,1359,735,1625,17,268,5,18,2834
48439113110,5153,1665,940,2123,26,193,5,31,3488
48439113112,2127,1071,413,401,2,120,1,13,1056
48439113115,3948,1012,1493,1106,23,151,5,27,2936
48439113116,4400,840,776,2303,8,275,5,18,3560
48439113117,2441,566,491,1211,7,69,2,7,1875
48439113118,3006,445,923,1455,11,34,4,3,2561
48439113119,4348,1535,713,1528,20,318,4,32,2813
48439113120,4423,2000,519,602,8,1070,8,30,2423
48439113121,1774,308,326,958,4,71,8,11,1466
48439113122,3144,680,521,1698,11,115,2,10,2464
48439113206,5609,2920,1796,305,17,311,19,20,2689
48439113207,4194,3209,550,101,6,102,2,14,985
48439113210,7622,5738,947,264,30,298,4,15,1884
48439113212,4343,3080,640,240,19,130,2,26,1263
48439113213,3786,2452,782,248,21,97,1,17,1334
48439113214,5756,3494,1280,395,22,282,6,31,2262
48439113215,4742,3259,860,215,15,128,18,24,1483
48439113216,6000,3450,1257,550,26,422,19,19,2550
48439113217,4516,2532,1071,418,24,211,29,20,1984
48439113218,3327,2532,392,117,17,123,0,8,795
48439113221,6021,3988,912,483,36,230,32,29,2033
48439113222,3098,1262,968,492,6,168,27,14,1836
48439113223,3413,1834,899,370,8,116,10,9,1579
48439113301,4317,2728,1047,161,16,99,16,8,1589
48439113302,4297,2241,1509,233,17,60,30,17,2056
48439113403,2676,1594,713,166,4,45,12,11,1082
48439113404,6182,3462,1575,649,27,123,50,15,2720
48439113407,5684,1810,2435,967,14,199,51,16,3874
48439113408,5862,3231,1774,478,30,54,47,4,2631
48439113409,2519,1662,399,184,15,118,14,8,857
48439113410,4515,1935,1420,768,29,104,32,28,2580
48439113509,4784,1956,1379,488,9,452,228,29,2828
48439113510,6617,2086,1097,1073,17,1970,50,54,4531
48439113511,4091,1439,870,647,13,824,110,20,2652
48439113512,6249,3221,974,1066,28,456,107,33,3028
48439113513,6508,2591,1487,904,22,962,222,22,3917
48439113514,5183,1516,1413,880,25,814,275,87,3667
48439113516,4280,2542,894,363,11,231,50,11,1738
48439113517,4264,1901,849,612,22,603,55,23,2363
48439113519,6824,3677,1024,583,12,1152,16,33,3147
48439113520,5339,2554,861,784,14,824,36,33,2785
48439113521,3981,1309,765,1161,11,480,25,18,2672
48439113522,2073,886,372,529,7,147,11,13,1187
48439113607,4688,2303,1300,651,21,108,57,18,2385
48439113611,4600,3577,453,106,21,188,7,4,1023
48439113612,4520,3518,475,104,7,187,8,13,1002
48439113613,4246,3111,587,167,25,128,11,6,1135
48439113618,6244,3639,1226,713,31,235,98,26,2605
48439113619,5939,2162,1145,2063,22,147,101,46,3777
48439113622,8244,5624,728,362,18,1133,0,29,2620
48439113623,3520,2715,436,98,15,113,0,11,805
48439113624,4211,2715,735,220,20,265,23,25,1496
48439113625,3461,2661,350,104,11,138,1,10,800
48439113626,3823,2799,504,122,14,195,11,11,1024
48439113628,4994,2064,975,1107,16,516,47,17,2930
48439113629,4284,2860,530,515,10,173,15,15,1424
48439113630,3769,2186,672,446,14,216,44,11,1583
48439113632,5037,4000,404,107,17,273,9,16,1037
48439113633,4291,2907,427,90,12,636,3,34,1384
48439113634,5084,3956,322,104,12,444,3,13,1128
48439113635,3976,1838,1652,222,9,128,4,8,2138
48439113636,2505,1268,698,279,8,128,0,6,1237
48439113637,4355,2300,814,671,3,290,62,20,2055
48439113638,1823,984,284,265,13,160,13,9,839
48439113639,7247,5601,576,155,34,556,3,16,1646
48439113640,6108,4481,377,210,16,748,4,32,1627
48439113707,4811,3716,443,45,16,310,0,35,1095
48439113709,5527,3847,530,186,18,664,9,25,1680
48439113710,3688,2320,781,213,15,196,3,13,1368
48439113711,4228,3045,623,130,5,222,6,14,1183
48439113712,5003,3102,1361,150,22,152,9,21,1901
48439113713,1877,413,1188,138,0,76,0,6,1464
48439113714,3651,2413,903,51,17,112,1,6,1238
48439113715,4967,2792,921,497,22,444,17,26,2175
48439113716,3334,2330,589,150,12,116,3,4,1004
48439113803,5489,3425,1228,237,33,222,39,51,2064
48439113808,6404,3975,1385,295,26,357,21,23,2429
48439113809,4731,2742,1333,137,16,221,9,21,1989
48439113810,4808,2589,1525,221,30,210,31,15,2219
48439113811,3871,1858,1206,414,6,224,21,16,2013
48439113812,5517,3749,829,272,26,366,4,36,1768
48439113813,5111,3942,464,132,17,315,8,19,1169
48439113814,4509,3543,430,138,16,146,2,19,966
48439113815,6181,4982,515,138,17,224,4,25,1199
48439113816,5515,4359,454,113,23,296,3,15,1156
48439113906,7587,5080,574,204,18,1324,0,33,2507
48439113908,5930,3920,434,135,13,1045,2,39,2010
48439113912,6662,5174,628,138,17,397,6,43,1488
48439113916,4617,2188,1314,525,30,294,13,24,2429
48439113917,7570,3201,1925,1047,24,1010,13,30,4369
48439113918,5115,2304,1472,566,21,472,4,41,2811
48439113919,7407,4541,1279,467,32,651,4,28,2866
48439113920,5474,3088,985,487,7,591,6,25,2386
48439113923,4254,1868,906,636,25,612,5,24,2386
48439113924,5527,2340,1482,675,3,756,20,23,3187
48439113925,3987,2036,1101,303,9,328,6,20,1951
48439113930,11980,5135,3061,1374,43,1725,19,79,6845
48439113931,12771,5353,3056,1630,36,2038,8,56,7418
48439113932,8209,3954,1367,1119,14,1385,0,33,4255
48439113933,2722,1607,448,356,14,192,3,9,1115
48439113934,7215,4110,1416,574,34,620,5,22,3105
48439113935,3920,2170,785,485,11,290,2,14,1750
48439113936,6682,3642,1232,663,34,741,8,24,3040
48439113937,8,5,1,1,0,0,0,0,3
48439113938,2280,1039,541,358,2,224,0,7,1241
48439113939,4202,2040,1166,452,12,262,2,29,2162
48439113940,7765,4853,1340,558,33,514,20,40,2912
48439113941,6046,3627,1137,560,28,311,8,26,2419
48439113942,6038,3669,1175,498,26,327,14,22,2369
48439113943,5611,2954,885,532,22,901,15,23,2657
48439113944,5191,3353,841,354,16,281,0,25,1838
48439113945,3743,2498,543,264,16,165,0,16,1245
48439113946,5565,2995,1010,523,27,718,23,45,2570
48439113947,3963,2511,644,207,6,368,2,14,1452
48439113948,5402,2479,1093,870,16,632,9,20,2923
48439113949,3121,1921,425,219,3,360,5,14,1200
48439113950,7052,3939,1514,601,17,562,14,38,3113
48439113951,3291,2506,388,96,16,119,0,5,785
48439113952,5462,3671,687,281,32,508,10,24,1791
48439113953,7238,5174,655,262,21,744,0,30,2064
48439113954,3963,3227,280,54,15,139,0,10,736
48439113955,3512,2532,238,107,4,418,6,17,980
48439113956,5121,3079,349,137,10,1312,0,24,2042
48439113957,4853,3429,418,79,8,647,1,10,1424
48439113958,2479,1851,171,46,1,296,1,9,628
48439114003,9398,4103,3477,872,17,444,21,39,5295
48439114006,6775,3924,2128,279,21,100,1,28,2851
48439114009,7464,2538,2440,962,26,1149,10,25,4926
48439114010,6860,3366,1756,906,32,385,8,29,3494
48439114011,7156,3522,2106,883,34,248,16,33,3634
48439114012,9715,4332,3177,1299,36,427,19,11,5383
48439114013,7178,2871,2576,975,34,384,4,50,4307
48439114014,6576,3879,1846,368,20,174,7,23,2697
48439114015,2521,1295,944,88,14,81,3,8,1226
48439114105,4099,3263,472,71,18,68,10,11,836
48439114106,6768,3904,1657,613,29,219,7,36,2864
48439114107,4428,3006,736,285,20,146,3,22,1422
48439114108,5028,4044,589,72,21,69,3,17,984
48439114109,13840,7166,3139,1930,62,788,45,58,6674
48439114110,8809,5551,1714,680,22,320,6,41,3258
48439114111,2680,1824,356,282,17,46,0,22,856
48439114112,5902,4154,977,301,27,127,4,41,1748
48439114113,4878,2880,961,656,14,72,6,7,1998
48439114203,6674,5295,898,76,42,42,8,16,1379
48439114204,7228,5796,833,125,37,64,4,10,1432
48439114205,3634,2928,466,23,18,21,0,4,706
48439114206,4362,3170,891,47,16,59,0,24,1192
48439114207,7302,4585,1570,514,22,201,7,27,2717
48439121605,2958,1809,774,200,6,38,11,13,1149
48439121606,3381,2228,383,275,9,306,5,7,1153
48439121608,5120,3479,753,374,17,201,0,11,1641
48439121609,6092,3974,731,475,17,573,3,24,2118
48439121610,2533,1580,418,247,15,150,6,9,953
48439121611,4589,2435,902,712,18,295,0,9,2154
48439121612,3514,1990,1020,210,3,134,0,13,1524
48439121613,4332,1945,1225,827,6,129,13,24,2387
48439121614,2863,531,1443,734,9,52,0,4,2332
48439121615,3859,1882,866,841,12,106,2,3,1977
48439121702,2221,743,616,671,9,66,0,6,1478
48439121703,5150,765,3199,841,23,210,7,8,4385
48439121704,3165,628,1886,448,7,95,2,4,2537
48439121904,4724,433,3143,1004,8,40,0,19,4291
48439121905,5403,604,1858,2029,21,730,3,17,4799
48439121906,4283,376,2874,777,4,154,2,23,3907
48439121907,4071,221,2248,1277,5,236,6,19,3850
48439121908,1321,104,754,400,4,22,0,2,1217
48439122001,4132,506,3248,232,10,61,1,5,3626
48439122002,4479,619,2981,671,15,97,9,13,3860
48439122100,7072,1337,5180,309,23,106,11,24,5735
48439122200,2095,440,1195,360,3,36,0,12,1655
48439122300,5642,1866,918,1248,10,1385,0,43,3776
48439122401,2387,722,856,341,7,345,0,14,1665
48439122402,5731,2309,943,1010,9,1194,5,55,3422
48439122500,4176,2528,849,468,18,104,3,24,1648
48439122600,4071,2519,833,386,24,108,6,16,1552
48439122701,2558,857,956,525,2,112,0,13,1701
48439122702,2772,1620,639,319,11,49,0,19,1152
48439122801,3404,561,1639,943,2,147,2,13,2843
48439122802,4585,1248,2306,687,30,191,4,12,3337
48439122901,3979,632,3063,146,22,46,5,9,3347
48439122902,3583,443,2291,526,23,215,0,10,3140
48439123001,3415,1841,831,485,9,108,0,15,1574
48439123002,3109,2007,526,367,19,72,1,17,1102
48439123100,3886,696,1592,1461,28,33,0,5,3190
48439123200,3121,1393,1064,473,12,80,2,17,1728
48439123301,2511,1826,318,163,12,87,0,10,685
48439123302,6345,3142,1102,1897,12,66,5,11,3203
48439123500,3598,201,1941,1154,10,220,0,10,3397
48439123600,3558,1413,1236,718,5,47,1,10,2145
48439123700,3623,2284,671,364,12,140,0,7,1339
48439980000,14,1,12,0,0,0,0,0,13
48441010100,6461,4522,934,540,24,125,4,30,1939
48441010200,2755,1516,709,403,14,26,5,2,1239
48441010300,2097,791,727,484,8,6,0,0,1306
48441010400,2002,486,1329,99,16,5,0,11,1516
48441010500,3335,1421,1281,450,2,40,7,10,1914
48441010600,3990,2118,1277,363,28,21,0,4,1872
48441010700,3564,983,2265,197,7,6,0,16,2581
48441010800,1581,556,809,135,8,9,0,7,1025
48441010900,6057,3280,1218,1140,18,131,0,26,2777
48441011000,1116,479,460,119,1,16,0,5,637
48441011200,2645,1039,1204,278,10,11,0,5,1606
48441011300,4093,1792,1391,660,14,40,5,2,2301
48441011400,4665,2626,1328,412,32,52,9,15,2039
48441011500,2884,1854,746,110,13,38,0,8,1030
48441011600,2563,1635,683,111,13,8,0,8,928
48441011700,2193,1040,889,164,5,12,0,5,1153
48441011900,2060,792,1036,101,12,5,0,19,1268
48441012000,2069,1767,175,32,5,34,0,2,302
48441012100,341,246,53,29,0,1,0,2,95
48441012200,2783,1481,913,278,12,16,3,10,1302
48441012300,4416,2474,1225,406,21,89,3,11,1942
48441012400,2610,1677,589,168,8,58,0,3,933
48441012500,3401,2431,612,156,9,43,1,13,970
48441012600,3281,2639,370,109,7,34,1,16,642
48441012701,4696,3606,569,152,14,145,2,5,1090
48441012702,3759,2739,566,166,8,99,2,16,1020
48441012801,3435,1916,691,313,24,287,10,13,1519
48441012802,4026,2054,915,522,14,273,11,19,1972
48441012900,2380,1253,557,282,7,65,16,8,1127
48441013000,603,383,85,84,5,14,4,0,220
48441013100,6031,2607,2193,787,35,76,15,21,3424
48441013200,1962,1399,390,57,7,8,0,10,563
48441013300,3430,2127,764,248,27,102,8,10,1303
48441013401,3851,2045,875,481,20,156,3,33,1806
48441013402,9849,7040,1506,403,19,379,20,22,2809
48441013404,11223,8165,1612,429,49,332,28,36,3058
48441013501,2389,2050,211,5,13,2,0,11,339
48441013502,7032,5903,711,58,37,44,3,27,1129
48441013601,2999,2235,622,28,9,5,1,2,764
48441013602,2581,2149,266,21,14,2,0,5,432
48441980000,0,0,0,0,0,0,0,0,0
48443950100,760,352,370,8,0,5,0,2,408
48445950100,2404,1346,1009,5,4,0,0,0,1058
48445950300,2076,425,1459,161,0,4,0,5,1651
48445950400,7351,2828,4101,223,25,33,0,19,4523
48447950300,1440,1248,145,1,3,3,0,0,192
48449950100,2106,1249,495,241,17,6,0,4,857
48449950200,2507,1425,937,36,12,15,1,4,1082
48449950301,3938,2283,1337,162,5,27,0,11,1655
48449950302,4066,2129,1462,303,7,48,1,7,1937
48449950400,5463,3330,1616,266,23,31,0,11,2133
48449950500,2779,437,1947,322,8,7,0,2,2342
48449950600,4070,709,2596,651,5,38,1,18,3361
48449950700,1429,194,800,389,1,6,0,4,1235
48449950800,4889,1654,2490,514,23,84,0,12,3235
48451000100,2508,1345,982,60,11,6,0,5,1163
48451000200,4506,1852,2368,95,14,30,12,8,2654
48451000300,6514,2583,3271,274,17,101,5,36,3931
48451000400,5738,1285,4131,177,24,11,0,15,4453
48451000700,4213,1093,2786,162,14,20,11,11,3120
48451000801,4703,2522,1751,151,14,66,5,13,2181
48451000802,4742,1574,2677,194,12,77,13,18,3168
48451000900,2498,846,1540,47,6,11,0,4,1652
48451001000,5160,3391,1435,85,16,34,7,27,1769
48451001101,5978,3089,2255,231,12,159,6,19,2889
48451001102,4735,2189,2249,91,8,31,1,28,2546
48451001200,7557,2804,4121,356,27,49,1,13,4753
48451001301,6451,3555,2096,319,11,153,32,25,2896
48451001303,4475,2426,1490,170,14,171,0,29,2049
48451001304,3222,2013,796,153,11,90,0,21,1209
48451001401,3832,2091,1297,187,15,94,2,3,1741
48451001402,1781,148,1557,37,0,9,1,4,1633
48451001500,1776,1057,345,179,6,72,6,2,719
48451001600,5653,4060,1365,10,14,22,6,20,1593
48451001702,3594,2399,964,28,25,7,1,13,1195
48451001706,3776,2553,893,113,12,68,9,2,1223
48451001707,7210,4612,1781,249,19,240,11,13,2598
48451001708,7023,5267,1256,135,23,95,12,15,1756
48451001709,5224,3488,1384,92,25,23,0,9,1736
48451001710,4561,3527,783,50,6,47,1,6,1034
48451001800,2564,621,1490,365,10,18,1,10,1943
48451980000,9,0,3,0,0,0,0,0,9
48453000101,4469,3643,430,44,6,154,1,30,826
48453000102,2597,2216,159,11,2,104,0,1,381
48453000203,2537,1579,379,159,2,333,0,13,958
48453000204,3167,2353,398,30,3,205,3,22,814
48453000205,4186,2831,728,130,8,248,3,19,1355
48453000206,3201,2392,412,88,4,135,0,13,809
48453000302,5245,3680,721,90,14,474,1,25,1565
48453000304,3068,2047,620,75,3,167,3,9,1021
48453000305,3773,2687,586,82,10,203,3,20,1086
48453000307,1841,1301,320,79,0,51,3,4,540
48453000308,2698,1514,591,125,2,312,3,8,1184
48453000309,5602,3187,999,395,14,644,4,33,2415
48453000401,4477,2882,731,151,9,457,2,17,1595
48453000402,3625,2031,750,452,16,175,9,22,1594
48453000500,4490,3093,640,62,0,442,0,24,1397
48453000601,8580,2924,2147,611,41,2786,10,4,5656
48453000605,4645,2553,906,189,6,786,11,19,2092
48453000606,5012,2665,837,162,5,1178,0,7,2347
48453000607,4268,2081,779,169,3,1038,0,38,2187
48453000608,5286,2717,769,162,4,1355,0,39,2569
48453000700,1411,811,256,33,0,244,1,6,600
48453000801,1730,666,828,139,3,30,0,8,1064
48453000802,3330,1133,1236,778,2,61,9,7,2197
48453000803,3158,1874,645,274,8,154,1,25,1284
48453000804,2419,1001,715,535,3,45,5,11,1418
48453000901,2719,1217,780,461,1,129,0,10,1502
48453000902,7803,3743,2872,467,24,352,3,46,4060
48453001000,3445,1643,1394,158,8,109,6,20,1802
48453001101,2258,1211,419,449,10,92,3,28,1047
48453001102,4013,3077,396,98,3,246,0,18,936
48453001103,3339,2342,445,155,9,242,0,22,997
48453001200,6173,4585,664,115,21,461,4,33,1588
48453001304,4087,3051,552,81,9,158,4,18,1036
48453001307,3743,2155,1180,147,10,110,0,21,1588
48453001308,2927,1871,778,50,7,111,0,6,1056
48453001309,2707,2120,304,26,4,133,3,7,587
48453001310,3489,2519,504,81,15,191,8,15,970
48453001311,1656,1217,225,35,1,102,0,11,439
48453001312,4575,2708,1213,278,12,112,4,19,1867
48453001401,2876,2227,382,54,5,91,1,9,649
48453001402,2552,1926,380,40,3,73,1,14,626
48453001403,1391,866,362,26,2,50,3,5,525
48453001501,5457,4270,670,65,15,192,4,37,1187
48453001503,4802,2858,1081,199,13,313,5,56,1944
48453001504,6374,4286,1031,145,7,488,3,50,2088
48453001505,4843,3505,814,84,4,198,2,13,1338
48453001602,3084,1975,327,48,0,584,2,30,1109
48453001603,4789,4172,330,21,3,96,0,7,617
48453001604,4147,3539,324,13,2,83,1,15,608
48453001605,3889,3108,412,25,7,165,0,13,781
48453001606,228,167,36,21,0,0,1,2,61
48453001910,4914,3615,574,53,14,399,0,20,1299
48453001911,2948,1932,455,46,2,329,1,14,1016
48453001912,4385,3258,385,63,3,414,1,21,1127
48453001913,5009,3872,414,23,5,457,0,19,1137
48453001914,6805,5292,814,103,8,260,0,36,1513
48453001915,3404,2001,663,130,9,439,0,16,1403
48453001916,3366,2528,289,27,1,359,2,6,838
48453001917,5005,3703,410,18,4,614,0,12,1302
48453001918,2609,2129,221,2,0,140,0,14,480
48453001919,3767,3028,343,20,5,194,0,7,739
48453001920,6872,3276,2536,203,16,581,4,25,3596
48453001921,3696,3013,338,34,7,143,0,11,683
48453001922,2324,1657,368,53,3,90,0,12,667
48453001923,3274,2454,479,37,8,73,5,24,820
48453002002,2975,1873,828,50,14,60,1,15,1102
48453002003,4005,1834,1760,160,13,89,5,16,2171
48453002004,3041,1871,660,121,11,181,1,15,1170
48453002006,2890,1271,1280,80,11,108,0,17,1619
48453002007,2271,1584,403,35,1,133,1,20,687
48453002104,2707,1632,774,116,4,57,0,20,1075
48453002105,4614,1360,2373,567,8,123,6,26,3254
48453002106,2952,1453,994,307,1,56,0,21,1499
48453002107,3681,1406,1213,777,7,93,2,22,2275
48453002108,3836,919,1127,1516,6,77,0,50,2917
48453002109,3834,1421,1007,1147,4,122,0,15,2413
48453002110,4278,1183,1785,1049,3,79,1,16,3095
48453002111,4987,1428,2466,824,8,90,0,23,3559
48453002112,5236,1758,2466,674,11,143,0,34,3478
48453002113,3484,1605,1057,621,5,60,3,7,1879
48453002201,2114,318,1025,663,1,64,1,8,1796
48453002211,3592,714,2062,595,8,130,2,15,2878
48453002213,5253,876,3850,360,5,49,1,9,4377
48453002214,3624,668,2114,790,2,17,0,10,2956
48453002215,4182,495,2993,554,8,53,4,10,3687
48453002216,10133,2030,5626,1893,21,197,1,39,8103
48453002217,5967,1318,3171,1137,19,123,6,32,4649
48453002218,5160,931,3103,911,12,53,4,26,4229
48453002219,6614,1690,4055,571,16,100,2,25,4924
48453002220,3795,260,2406,1046,5,14,1,18,3535
48453002221,2709,132,2086,441,4,9,0,13,2577
48453002222,4214,253,2847,1014,10,32,0,18,3961
48453002304,4166,2606,883,139,1,297,0,22,1560
48453002307,5325,2342,2200,376,12,191,0,17,2983
48453002310,3090,299,2572,156,5,4,0,8,2791
48453002313,4192,1537,1881,464,19,112,7,34,2655
48453002314,5999,2254,2343,842,13,289,9,43,3745
48453002315,3027,903,1449,244,25,254,3,26,2124
48453002316,4737,1292,2518,381,14,335,1,34,3445
48453002319,2330,796,820,705,0,4,0,1,1534
48453002320,3940,797,2536,335,8,158,0,26,3143
48453002321,4725,701,3541,272,11,80,2,44,4024
48453002322,2011,757,1031,94,12,35,6,9,1254
48453002323,4470,2079,1407,282,30,474,3,16,2391
48453002324,1671,445,534,493,12,122,0,4,1226
48453002325,4352,747,2960,448,3,96,1,28,3605
48453002326,1307,399,499,186,5,134,4,2,908
48453002327,4321,1363,1595,835,52,235,1,39,2958
48453002403,2706,1218,1186,126,6,66,2,16,1488
48453002407,9856,4630,3753,694,15,308,7,51,5226
48453002409,3327,1571,1416,129,9,66,2,19,1756
48453002410,3542,1263,1902,147,10,55,0,32,2279
48453002411,5730,617,4486,503,14,38,5,19,5113
48453002412,5109,547,4234,190,8,34,5,16,4562
48453002413,4193,361,3299,418,4,19,2,27,3832
48453002419,4839,862,3247,489,19,88,3,27,3977
48453002422,6118,2426,2740,495,17,170,1,33,3692
48453002423,6457,2991,2745,270,15,193,3,34,3466
48453002424,3500,1655,1434,149,33,78,0,22,1845
48453002430,2267,359,1756,61,4,28,0,16,1908
48453002432,4097,1443,2222,131,9,132,3,23,2654
48453002434,2110,512,1504,48,0,6,1,5,1598
48453002436,3054,387,2579,50,4,3,0,10,2667
48453002437,4432,1784,1755,325,10,360,2,26,2648
48453002438,7319,3155,2817,487,23,467,0,24,4164
48453002439,3265,592,2242,269,11,55,0,3,2673
48453002440,6905,1761,4232,474,19,173,7,36,5144
48453002441,5407,689,4188,310,18,98,1,10,4718
48453002442,3426,483,2615,210,9,37,8,8,2943
48453002443,4088,1741,1662,294,7,211,2,15,2347
48453002444,4226,1790,1988,177,6,110,0,21,2436
48453002445,8161,2630,4279,605,20,302,5,40,5531
48453002446,1453,1019,328,16,6,33,0,1,434
48453002447,3393,645,2423,188,12,42,1,23,2748
48453002448,7222,1976,4158,497,4,283,0,48,5246
48453002449,6501,677,4981,532,20,173,0,16,5824
48453002450,3538,436,2868,56,5,98,0,2,3102
48453002451,7587,2854,3410,627,29,341,7,43,4733
48453002452,2180,311,1664,150,3,13,6,5,1869
48453002453,6085,1081,4213,498,25,87,6,20,5004
48453002500,5540,3540,1025,240,8,456,0,33,2000
48453030000,4933,3914,472,54,3,195,2,26,1019
48453030100,3607,2573,559,70,7,202,0,17,1034
48453030200,4754,3365,762,130,8,239,0,24,1389
48453030300,4238,2588,1226,183,17,56,6,20,1650
48453030400,4560,2812,1263,120,5,111,2,21,1748
48453030500,6521,4433,949,169,15,601,7,37,2088
48453030600,5879,4059,768,103,7,688,3,15,1820
48453030700,3979,3092,391,33,4,284,0,12,887
48453030800,3893,2245,739,179,14,525,9,17,1648
48453030900,7195,4171,2198,293,11,182,8,31,3024
48453031000,4981,2665,1598,171,10,261,7,25,2316
48453031100,4241,2937,679,58,6,331,3,35,1304
48453031200,6661,4734,1137,109,15,297,2,32,1927
48453031300,4527,2790,990,104,17,358,1,20,1737
48453031400,4783,3273,944,91,24,227,3,15,1510
48453031500,7498,4678,2065,85,30,245,6,45,2820
48453031600,2365,1580,441,89,5,143,0,7,785
48453031700,4509,2561,1383,202,6,149,7,18,1948
48453031800,5255,2687,1914,261,14,131,3,47,2568
48453031900,6160,3486,1890,207,15,259,5,26,2674
48453032000,6301,3120,1344,277,2,1257,7,41,3181
48453032100,5434,2919,1598,196,16,455,1,28,2515
48453032200,2251,1869,211,15,0,66,0,4,382
48453032300,3908,1707,888,166,3,938,3,19,2201
48453032400,1558,749,327,65,1,326,0,8,809
48453032500,4759,3081,908,252,3,266,3,22,1678
48453032600,5829,3096,436,48,9,1999,1,32,2733
48453032700,4159,2665,584,130,12,509,2,31,1494
48453032800,2206,1603,251,24,0,218,3,8,603
48453032900,7748,5491,884,144,10,797,3,40,2257
48453033000,7074,4774,1292,149,17,404,2,51,2300
48453033100,4710,3960,421,29,19,98,0,15,750
48453033200,5068,2304,2094,167,7,251,7,34,2764
48453033300,9564,5894,1780,167,17,1257,4,48,3670
48453033400,2720,1672,731,123,3,45,0,20,1048
48453033500,5460,3246,1449,203,11,262,1,38,2214
48453033600,4819,3837,512,71,17,151,7,35,982
48453033700,2495,1676,272,28,3,399,6,13,819
48453033800,5004,2483,386,68,5,1804,0,32,2521
48453033900,5638,4212,725,24,8,354,0,22,1426
48453034000,7381,4491,788,137,9,1528,2,66,2890
48453034100,5615,2256,1089,457,10,1483,3,34,3359
48453034200,6365,2086,719,247,26,3056,3,51,4279
48453034300,4893,2725,380,51,5,1487,2,23,2168
48453034400,3378,1734,828,306,5,308,0,26,1644
48453034500,2346,947,211,31,0,1021,0,9,1399
48453034600,4889,2381,1289,544,14,411,6,33,2508
48453034700,5683,3900,891,140,6,416,1,33,1783
48453034800,5129,3256,883,104,8,620,6,19,1873
48453034900,7596,5241,972,97,27,824,5,42,2355
48453035000,7266,4556,1007,282,11,981,2,50,2710
48453035100,4242,2871,402,57,6,634,0,9,1371
48453035200,3999,3347,394,20,23,56,1,16,652
48453035300,2022,1659,199,14,12,21,0,23,363
48453035400,5518,4272,610,69,9,254,3,17,1246
48453035500,4437,3142,540,79,5,459,0,18,1295
48453035600,2033,1538,263,19,0,85,2,5,495
48453035700,4785,3360,554,87,7,507,0,13,1425
48453035800,4420,2683,783,267,6,416,1,34,1737
48453035900,3176,2037,887,34,21,38,1,9,1139
48453036000,1994,1507,224,51,3,89,3,8,487
48453036100,4899,2919,720,201,6,771,3,32,1980
48453036200,2683,1198,344,135,10,855,3,20,1485
48453036300,1613,1046,438,16,5,16,1,10,567
48453036400,2299,1797,307,37,12,20,7,7,502
48453036500,7797,4999,911,134,8,1315,5,27,2798
48453036600,8848,6706,1185,135,21,338,0,42,2142
48453036700,7934,5176,1125,82,10,1097,0,38,2758
48453036800,4462,3146,594,56,4,424,3,15,1316
48453036900,4442,3698,307,52,19,141,0,14,744
48453037000,6281,4171,822,165,10,776,4,40,2110
48453037100,2629,1719,561,69,0,142,0,4,910
48453037200,6211,3216,2018,264,19,377,1,30,2995
48453037300,3234,2248,677,48,12,35,5,13,986
48453037400,4591,3726,551,39,9,34,0,19,865
48453037500,1602,1284,192,12,1,22,0,10,318
48453037600,3535,2734,475,36,10,87,4,14,801
48453040000,6361,1766,3294,627,16,405,2,34,4595
48453040100,4302,942,2738,398,8,88,2,15,3360
48453040200,3013,605,1755,480,13,56,1,15,2408
48453040300,7645,970,5681,607,3,255,0,15,6675
48453040400,3962,2593,821,173,8,167,0,22,1369
48453040500,5312,2165,2621,258,7,103,2,37,3147
48453040600,3929,719,2715,185,15,203,1,8,3210
48453040700,7248,1382,4765,697,15,136,0,48,5866
48453040800,5056,1584,2808,301,10,191,2,24,3472
48453040900,6562,1145,4660,363,24,197,6,46,5417
48453041000,7089,718,5024,655,6,489,3,20,6371
48453041100,1762,960,404,106,8,174,4,8,802
48453041200,2811,1165,743,424,8,343,0,9,1646
48453041300,4285,2834,721,183,5,274,0,18,1451
48453041400,2538,1518,559,148,5,180,2,7,1020
48453041500,2659,1140,972,380,1,47,0,6,1519
48453041600,7549,1699,4650,782,6,189,2,11,5850
48453041700,2158,1047,698,110,7,167,2,9,1111
48453041800,3675,1498,1341,419,7,232,5,33,2177
48453041900,3237,1743,949,166,11,207,3,15,1494
48453042000,2436,1698,386,50,7,160,0,10,738
48453042100,5088,1978,1654,468,3,744,1,23,3110
48453042200,4008,1505,1335,456,9,523,2,21,2503
48453042300,3364,1909,859,255,3,176,0,16,1455
48453042400,11722,3514,4035,2124,19,1502,3,84,8208
48453042500,7341,2800,2196,1102,19,790,11,69,4541
48453042600,4134,1232,2000,610,10,96,10,23,2902
48453042700,4347,1589,1567,706,10,261,4,23,2758
48453042800,6343,2558,1732,1071,15,627,12,38,3785
48453042900,3218,935,1149,731,11,264,7,14,2283
48453043000,3774,1440,1051,813,4,267,5,14,2334
48453043100,3005,479,2253,173,0,17,4,30,2526
48453043200,2923,526,1909,378,17,20,1,17,2397
48453043300,3708,543,2525,444,4,111,1,13,3165
48453043400,3657,770,2379,282,17,128,3,0,2887
48453043500,7281,2273,2048,1138,19,1464,11,35,5008
48453043600,3854,1286,1522,668,6,205,1,20,2568
48453043700,2332,527,1150,333,0,246,0,17,1805
48453043800,3272,987,1697,337,3,149,0,18,2285
48453043900,8592,2111,2601,1829,7,1740,4,26,6481
48453044000,3167,935,1213,462,2,441,0,11,2232
48453044100,3933,1188,1545,642,9,358,0,30,2745
48453044200,5344,1558,1728,969,9,880,3,30,3786
48453044300,7018,1079,4110,855,28,733,3,19,5939
48453044400,6540,1988,2788,669,22,735,17,61,4552
48453044500,3172,1518,810,420,10,239,0,25,1654
48453044600,5112,1251,1707,852,14,1044,5,35,3861
48453044700,2026,530,1331,75,3,32,0,20,1496
48453044800,4788,1377,2821,349,11,91,1,22,3411
48453044900,8901,1410,4959,1188,4,1169,4,34,7491
48453045000,2554,725,865,408,3,436,0,7,1829
48453045100,2812,1066,711,511,2,373,4,16,1746
48453045200,4226,1914,1096,307,12,684,5,24,2312
48453045300,4120,1826,1109,291,11,671,4,22,2294
48453045400,6785,3564,1341,389,21,1063,6,42,3221
48453045500,2967,1180,828,546,9,242,0,14,1787
48453045600,5619,2179,1352,680,9,1087,4,26,3440
48453045700,3687,1225,1317,636,12,332,3,28,2462
48453045800,2708,839,1425,329,4,37,0,10,1869
48453045900,11718,2253,5921,2669,27,417,8,58,9465
48453046000,4899,1532,1759,1089,9,270,19,34,3367
48453046100,6972,2838,2013,1137,16,604,15,32,4134
48453046200,7446,2813,2131,1233,15,792,15,69,4633
48453046300,2175,1345,499,190,4,48,5,8,830
48453046400,3537,1379,1122,436,9,432,0,17,2158
48453046500,3407,1154,1149,668,7,271,4,16,2253
48453046600,5415,2414,1587,733,16,330,1,40,3001
48453046700,3750,2219,810,273,0,182,11,28,1531
48453046800,11615,5349,2486,1555,19,1497,13,56,6266
48453046900,9175,4201,2229,1164,18,1030,5,50,4974
48453047000,1571,766,381,179,5,154,0,11,805
48453980000,3,0,2,0,1,0,0,0,3
48455950100,2422,2048,145,128,4,0,2,2,374
48455950200,3627,3033,216,193,7,3,2,0,594
48455950300,1695,1363,133,131,2,14,0,2,332
48455950400,3935,3188,435,85,13,8,0,23,747
48455950500,1923,901,385,549,3,5,0,6,1022
48457950100,2709,2381,145,50,22,1,0,9,328
48457950201,3260,1524,656,1001,0,15,0,3,1736
48457950202,3757,3022,290,234,18,18,0,12,735
48457950300,2329,1434,161,601,14,31,2,6,895
48457950400,4672,4176,188,96,37,17,1,7,496
48457950500,3071,2765,80,58,20,15,0,10,306
48459950101,4219,3151,545,213,42,20,0,7,1068
48459950102,4643,3549,381,367,34,23,0,43,1094
48459950200,3750,2780,409,339,22,20,0,9,970
48459950301,4620,3549,531,276,30,7,0,13,1071
48459950302,4310,3560,363,122,21,8,0,11,750
48459950400,4382,2959,454,655,14,44,4,6,1423
48459950501,3006,2509,197,105,22,6,4,15,497
48459950502,2613,2091,164,197,10,7,0,4,522
48459950600,4151,3067,308,461,23,32,1,3,1084
48459950700,5198,4072,634,173,43,10,0,39,1126
48461950100,1089,630,381,11,7,2,0,1,459
48461950200,2219,688,1416,48,4,2,0,2,1531
48463950100,2614,1311,1248,4,2,2,1,5,1303
48463950201,2440,1215,1129,14,6,10,0,4,1225
48463950202,4679,1330,3175,51,4,43,5,25,3349
48463950300,6283,1128,5054,9,4,31,0,10,5155
48463950400,3351,1033,2180,16,4,67,0,8,2318
48463950500,5197,596,4531,13,5,5,0,14,4601
48465950202,4713,840,3625,88,3,59,12,10,3873
48465950203,4839,1359,3143,99,16,74,10,11,3480
48465950301,4623,354,4136,54,8,31,1,11,4269
48465950302,3718,173,3503,18,1,9,0,0,3545
48465950400,3351,255,2969,37,3,57,0,4,3096
48465950501,2392,1257,881,112,2,65,5,7,1135
48465950502,5050,1065,3888,50,3,19,2,11,3985
48465950601,3648,63,3563,11,0,0,0,4,3585
48465950602,3596,81,3495,12,0,1,1,1,3515
48465950701,2512,433,2013,10,4,9,1,9,2079
48465950702,3624,270,3305,21,2,3,0,7,3354
48465950801,3587,708,2824,12,5,6,0,6,2879
48465950802,1933,978,862,14,10,18,3,4,955
48465980000,0,0,0,0,0,0,0,0,0
48467950100,5193,4382,520,39,31,20,3,11,811
48467950200,3444,2513,768,15,11,7,0,5,931
48467950300,5112,4247,450,148,34,27,3,10,865
48467950400,5980,4717,857,104,39,20,7,17,1263
48467950500,4945,3486,742,471,22,12,3,11,1459
48467950601,4245,3547,460,26,25,25,6,5,698
48467950602,4376,3755,385,31,33,26,2,15,621
48467950700,4749,3810,445,256,26,48,4,5,939
48467950801,4639,3703,638,62,17,32,0,16,936
48467950802,1536,1256,167,33,4,1,0,0,280
48467950901,5065,4166,576,80,40,3,2,0,899
48467950902,3144,2349,423,203,3,16,0,7,795
48467951001,2602,2205,242,18,9,18,0,4,397
48467951002,4511,3850,398,31,34,17,0,27,661
48469000100,1767,524,1079,118,17,2,1,3,1243
48469000201,2992,418,2236,259,7,19,0,2,2574
48469000202,5797,882,4091,676,11,70,1,11,4915
48469000301,1865,230,1431,163,0,4,4,12,1635
48469000302,2196,229,1659,293,1,1,0,4,1967
48469000400,1662,800,758,43,7,12,1,0,862
48469000501,4006,1242,2316,265,14,54,0,6,2764
48469000502,3587,976,2252,247,3,31,7,11,2611
48469000601,2656,565,1840,180,6,16,0,6,2091
48469000602,3975,1017,2422,403,21,52,0,6,2958
48469000700,3449,1418,1777,157,3,13,0,17,2031
48469000800,2154,1289,741,35,10,3,0,5,865
48469001300,2289,1431,697,40,17,9,0,7,858
48469001401,4229,2240,1738,126,9,8,1,9,1989
48469001402,4377,3299,874,48,9,4,1,8,1078
48469001501,3634,2502,940,72,0,8,0,5,1132
48469001503,2401,1492,590,101,5,127,3,18,909
48469001504,8664,5515,2440,206,22,242,2,36,3149
48469001601,6410,2676,2939,527,12,65,0,20,3734
48469001604,6496,2431,3233,424,13,249,3,3,4065
48469001605,3387,1344,1606,290,2,49,3,4,2043
48469001607,4193,2702,1098,151,4,140,1,17,1491
48469001608,5237,2871,1710,274,16,208,2,15,2366
48469001700,3896,1237,2464,132,5,5,5,7,2659
48469980000,0,0,0,0,0,0,0,0,0
48471790101,7170,2952,2031,2070,16,23,1,12,4218
48471790102,4039,2588,768,467,25,27,4,12,1451
48471790103,5642,3553,1039,792,20,22,0,33,2089
48471790200,7162,4386,1484,1054,21,33,0,12,2776
48471790301,3661,2428,358,679,9,26,1,16,1233
48471790302,7092,5794,511,345,24,135,12,26,1298
48471790401,7277,3802,1663,1550,28,103,0,20,3475
48471790402,4918,2143,1401,1294,16,11,0,4,2775
48471790500,7609,3745,1538,1886,26,204,1,31,3864
48471790600,5209,1292,2144,1653,5,42,2,27,3917
48471790700,8658,3718,2205,2133,32,155,6,55,4940
48471790800,7963,3422,1436,2459,29,345,12,70,4541
48473680100,9840,5790,2348,710,33,527,1,43,4050
48473680201,5454,1918,3011,398,8,27,0,16,3536
48473680202,5690,1069,3044,1378,27,29,1,11,4621
48473680301,3596,1102,1219,1121,23,18,0,34,2494
48473680302,2911,1606,973,204,14,36,0,12,1305
48473680303,4632,1832,1610,1036,13,21,1,17,2800
48473680501,4879,1460,1876,1376,15,34,3,22,3419
48473680502,4337,2201,1529,441,16,20,2,8,2136
48473680601,2639,1899,575,38,15,14,1,9,740
48473680602,6975,4593,1907,129,31,54,0,31,2382
48473980000,5841,24,394,5273,15,5,1,111,5817
48475950100,4201,1846,2140,77,11,15,0,4,2355
48475950200,4233,1788,2072,215,19,38,1,13,2445
48475950300,3210,872,2113,123,11,16,1,5,2338
48477170100,3573,1421,998,1009,5,21,0,11,2152
48477170201,3612,1676,812,849,15,141,2,10,1936
48477170202,3053,2427,409,73,4,36,0,20,626
48477170300,6428,4103,1004,932,6,171,4,34,2325
48477170400,6990,3832,1508,1284,17,115,8,13,3158
48477170501,3290,2551,361,234,8,11,0,20,739
48477170502,3666,2746,510,245,9,22,0,17,920
48477170601,3175,2119,572,380,4,21,0,7,1056
48477170602,2018,1148,251,549,7,9,0,8,870
48479000101,4072,68,3983,9,0,5,0,2,4004
48479000105,2339,16,2314,1,2,0,0,2,2323
48479000106,3471,58,3388,4,6,2,0,2,3413
48479000107,2758,37,2720,0,0,0,0,0,2721
48479000108,3499,71,3423,0,0,1,1,1,3428
48479000109,2215,42,2163,7,0,0,0,0,2173
48479000200,3810,72,3723,1,6,3,0,0,3738
48479000300,1927,54,1863,1,1,0,0,5,1873
48479000601,2528,51,2465,0,0,2,0,8,2477
48479000602,2135,30,2095,0,0,0,0,2,2105
48479000700,2517,52,2458,0,0,6,0,1,2465
48479000800,2394,32,2355,0,3,1,0,2,2362
48479000901,4468,130,4288,14,6,8,0,4,4338
48479000903,2124,23,2077,2,1,2,1,8,2101
48479000904,3074,68,2986,1,4,0,0,9,3006
48479001001,4300,176,4086,8,2,7,1,14,4124
48479001003,2931,74,2794,18,0,24,0,6,2857
48479001004,1818,28,1783,3,1,0,0,0,1790
48479001101,3584,121,3350,4,1,96,0,2,3463
48479001103,1549,27,1514,1,2,0,1,2,1522
48479001104,3052,115,2911,8,2,14,0,1,2937
48479001105,2507,82,2402,6,0,7,0,9,2425
48479001201,2504,61,2434,2,2,0,0,2,2443
48479001202,2614,45,2563,3,0,0,0,1,2569
48479001300,3290,57,3231,0,1,0,0,0,3233
48479001401,3309,60,3219,0,3,5,0,13,3249
48479001402,3004,32,2962,0,0,0,0,5,2972
48479001501,2644,62,2567,1,0,2,0,4,2582
48479001502,4391,118,4242,3,0,11,0,8,4273
48479001601,4102,292,3761,7,4,28,0,4,3810
48479001602,7810,355,7171,64,2,160,9,19,7455
48479001706,4851,119,4696,8,1,8,0,13,4732
48479001709,6227,419,5669,13,3,90,0,9,5808
48479001710,1258,81,1168,0,5,0,0,0,1177
48479001711,8052,438,7536,17,18,11,1,15,7614
48479001714,5148,268,4585,175,2,80,0,22,4880
48479001715,8028,229,7696,32,0,37,2,17,7799
48479001716,5128,166,4925,5,3,16,0,7,4962
48479001717,2915,74,2812,4,1,12,0,6,2841
48479001718,2313,91,2195,2,1,19,0,3,2222
48479001719,3369,143,3188,12,2,15,0,4,3226
48479001720,5640,274,5240,32,0,59,0,20,5366
48479001721,2022,123,1869,0,4,13,0,5,1899
48479001722,8276,523,7539,24,1,142,1,18,7753
48479001723,4034,186,3757,34,2,45,0,5,3848
48479001724,3122,123,2947,7,2,28,0,5,2999
48479001725,5877,328,5414,32,2,64,0,22,5549
48479001726,4990,248,4603,21,1,83,0,22,4742
48479001727,7699,382,7181,43,0,60,4,11,7317
48479001806,8527,206,8265,12,3,8,2,10,8321
48479001809,10372,242,10076,9,1,6,0,25,10130
48479001810,6731,176,6507,3,5,26,1,4,6555
48479001811,4160,111,4024,9,0,4,0,5,4049
48479001813,780,16,758,1,0,3,0,0,764
48479001815,1211,48,1155,3,0,0,0,0,1163
48479001816,4396,110,4247,0,1,26,0,11,4286
48479001818,2578,59,2509,4,0,0,0,3,2519
48479001819,5263,115,5102,3,4,16,0,11,5148
48479001820,4772,638,4100,16,5,6,0,0,4134
48479001821,3412,42,3360,2,0,0,0,7,3370
48479001822,3136,37,3073,0,1,2,0,4,3099
48479001823,4692,107,4565,4,0,2,0,6,4585
48479001824,4669,108,4507,8,5,21,1,10,4561
48479001825,4354,145,4179,6,0,1,0,6,4209
48479001826,3962,124,3818,2,4,8,0,1,3838
48479001827,656,219,401,34,0,0,0,1,437
48479001828,4500,78,4409,6,0,2,0,0,4422
48479001900,3242,190,2983,37,8,3,0,14,3052
48479980000,12,0,5,0,1,0,0,0,12
48481740100,5678,3404,1297,858,11,14,0,8,2274
48481740200,1550,470,696,340,3,2,0,0,1080
48481740300,1315,248,408,631,1,4,0,0,1067
48481740400,5932,2540,2197,1017,5,24,0,27,3392
48481740500,3457,1052,1371,920,5,27,0,6,2405
48481740600,3767,1750,1682,230,11,17,0,13,2017
48481740700,1824,431,1204,148,0,7,0,3,1393
48481740800,3861,983,2542,256,5,20,0,10,2878
48481740901,3254,1979,1141,78,0,7,0,10,1275
48481740902,4315,2490,1440,274,23,18,0,3,1825
48481741000,4308,1353,2265,630,1,17,0,12,2955
48481741100,2309,1430,724,87,4,7,0,12,879
48483950100,2709,1838,797,9,11,1,0,1,871
48483950300,2281,1631,430,72,22,23,2,11,650
48485010100,1573,653,449,386,12,7,0,7,920
48485010200,1067,509,374,111,11,23,0,0,558
48485010400,2164,256,466,1333,15,3,0,5,1908
48485010600,2302,1257,816,97,10,16,1,8,1045
48485010700,2493,1081,1040,256,19,20,1,7,1412
48485010800,2378,891,1170,151,24,16,0,11,1487
48485010900,1622,981,390,113,16,9,0,3,641
48485011000,2306,1069,805,255,31,31,2,11,1237
48485011100,1419,301,965,49,6,40,0,10,1118
48485011200,2145,1236,399,362,21,22,1,3,909
48485011300,1205,414,192,517,12,7,0,3,791
48485011400,2321,784,1162,220,19,17,0,9,1537
48485011500,2380,1359,515,324,23,19,1,9,1021
48485011600,4148,2104,1268,507,27,37,4,4,2044
48485011700,2447,1849,347,74,22,25,6,4,598
48485011800,1990,1514,247,58,16,32,1,20,476
48485011901,2457,1584,328,284,9,84,4,14,873
48485011902,1428,1031,218,65,6,45,0,6,397
48485012001,3073,2219,350,279,13,68,1,14,854
48485012002,3305,1902,535,607,17,59,5,81,1403
48485012100,3139,1909,760,208,18,77,0,3,1230
48485012201,2639,1498,360,457,18,101,5,26,1141
48485012202,4458,3086,801,176,21,137,4,15,1372
48485012301,5763,3748,994,411,22,281,16,18,2015
48485012302,2457,1678,284,142,19,178,0,9,779
48485012401,2696,1888,417,173,19,71,3,15,808
48485012402,5019,3496,720,282,25,245,5,17,1523
48485012600,3987,2765,689,204,34,123,2,9,1222
48485012700,2347,1408,696,97,16,8,2,3,939
48485012800,4493,3109,802,153,47,177,3,6,1384
48485012900,2511,1949,360,52,27,25,4,8,562
48485013000,2240,1133,583,339,38,22,0,13,1107
48485013100,8129,3539,2149,1991,56,123,5,12,4590
48485013201,3230,1474,538,898,34,48,1,8,1756
48485013202,2982,1782,446,420,23,125,13,15,1200
48485013300,1278,803,146,168,5,22,12,5,475
48485013401,5071,3113,833,642,20,157,28,14,1958
48485013502,5262,4135,548,124,48,54,1,13,1127
48485013503,2867,2257,325,118,23,14,1,6,610
48485013504,2393,1875,293,67,21,14,3,2,518
48485013600,5906,4997,441,42,78,37,2,15,909
48485013700,2301,1727,310,114,12,11,0,5,574
48485013800,3959,3331,272,53,39,17,3,10,628
48485980000,0,0,0,0,0,0,0,0,0
48487950300,2122,1488,352,182,4,28,0,5,634
48487950500,2522,1135,665,420,20,207,0,1,1387
48487950600,5875,3406,1616,253,40,303,0,19,2469
48487950700,2368,983,1101,158,32,28,0,7,1385
48489950300,4787,266,4461,30,10,3,0,4,4521
48489950400,7526,774,6158,391,14,153,0,22,6752
48489950500,3089,201,2851,22,4,4,0,3,2888
48489950600,2363,175,2156,1,17,0,2,2,2188
48489950700,2399,389,1985,1,2,0,0,3,2010
48489990000,0,0,0,0,0,0,0,0,0
48491020106,3924,3117,481,76,13,93,5,19,807
48491020108,3908,3139,457,87,14,67,2,36,769
48491020109,4835,3856,589,101,13,80,2,20,979
48491020111,3179,2461,513,42,5,34,1,7,718
48491020113,2679,1534,807,171,5,21,1,9,1145
48491020114,5422,3087,1640,342,21,49,3,23,2335
48491020115,5577,4336,727,141,11,104,3,6,1241
48491020116,3637,3424,92,21,6,26,0,9,213
48491020117,2213,2020,113,19,4,9,0,3,193
48491020118,4383,3985,190,37,13,34,0,7,398
48491020119,2499,2190,178,29,5,47,0,5,309
48491020120,4994,3363,915,249,17,171,10,32,1631
48491020121,2706,2078,325,81,7,117,0,7,628
48491020122,2556,2090,288,27,9,35,2,13,466
48491020123,3051,2289,454,96,15,73,3,8,762
48491020124,5929,4373,818,151,13,245,5,31,1556
48491020201,1849,1163,550,6,8,16,2,3,686
48491020203,3404,3112,150,23,3,33,0,13,292
48491020205,4535,3581,636,52,16,41,0,24,954
48491020206,2530,1458,910,37,15,10,2,5,1072
48491020207,5608,4187,933,80,28,76,3,12,1421
48491020208,3058,2221,595,39,3,33,3,26,837
48491020310,5351,3018,674,91,14,1271,0,38,2333
48491020311,10330,4507,1852,571,26,2866,5,46,5823
48491020319,7209,4341,1557,326,34,542,5,54,2868
48491020321,2610,1496,793,126,0,53,7,9,1114
48491020323,2714,1444,772,209,5,125,2,26,1270
48491020325,2359,970,1056,125,1,54,9,11,1389
48491020326,6699,4617,985,156,13,559,2,25,2082
48491020327,3957,2168,1044,270,12,233,0,23,1789
48491020329,8540,5375,1953,391,28,247,6,42,3165
48491020330,5187,3954,814,65,34,59,2,12,1233
48491020331,6358,3504,1791,424,23,216,17,27,2854
48491020332,4181,2167,1519,153,16,128,2,23,2014
48491020333,4908,3324,860,139,16,295,2,19,1584
48491020334,6344,3570,1394,365,6,627,13,48,2774
48491020335,3901,2664,650,132,8,218,3,20,1237
48491020336,4905,3029,1123,199,13,261,0,19,1876
48491020337,4924,3298,910,140,25,221,2,27,1626
48491020338,5147,2919,1258,281,12,378,7,36,2228
48491020339,2950,1686,489,129,17,510,3,14,1264
48491020340,3106,1965,750,90,8,118,9,16,1141
48491020341,2936,1949,585,115,16,104,4,22,987
48491020342,2953,1781,651,217,2,121,0,18,1172
48491020343,2140,1283,581,79,19,76,0,17,857
48491020344,4426,2615,1081,260,13,216,2,19,1811
48491020345,9433,3625,994,267,19,4108,6,31,5808
48491020346,1360,626,204,108,7,349,2,6,734
48491020347,3522,1567,814,297,10,699,0,16,1955
48491020348,3309,1760,657,202,5,510,7,12,1549
48491020349,3357,1898,1022,109,6,129,10,27,1459
48491020350,6664,4120,979,203,14,972,4,44,2544
48491020351,5370,3528,1145,206,18,146,3,26,1842
48491020352,2363,1510,502,110,12,90,4,13,853
48491020353,3201,2122,709,127,11,85,0,5,1079
48491020354,3987,2586,756,248,13,148,4,33,1401
48491020355,3570,1976,558,162,12,690,0,26,1594
48491020356,3446,2127,673,191,17,246,8,24,1319
48491020403,2555,1554,527,129,7,241,1,11,1001
48491020404,3437,2219,676,90,13,220,2,11,1218
48491020405,6681,3118,1552,414,13,1241,2,23,3563
48491020406,7012,3538,1760,634,15,626,1,42,3474
48491020408,5460,3023,1091,532,17,460,5,39,2437
48491020409,6859,3634,1330,533,18,954,6,45,3225
48491020410,5849,3353,1143,365,12,651,0,38,2496
48491020411,6115,3567,1107,361,13,710,0,39,2548
48491020503,6258,3929,928,112,11,978,1,61,2329
48491020505,2632,1869,344,64,1,202,0,14,763
48491020507,3703,1884,628,287,6,652,0,27,1819
48491020508,5655,2344,1020,418,14,1525,4,47,3311
48491020509,7017,3540,921,164,8,1950,0,19,3477
48491020511,3255,1120,1598,331,4,56,8,16,2135
48491020512,3907,1343,1548,475,13,323,0,20,2564
48491020513,2928,967,872,658,4,283,0,14,1961
48491020514,4522,2830,674,180,8,574,9,14,1692
48491020515,4639,2391,922,300,10,716,1,27,2248
48491020516,6548,1745,547,111,19,3841,0,31,4803
48491020517,5943,3413,884,271,21,1037,7,25,2530
48491020602,5115,2666,1736,296,4,201,1,23,2449
48491020604,9645,5273,1618,351,21,1903,3,53,4372
48491020606,4284,2249,537,152,19,1136,2,10,2035
48491020607,6395,3601,605,193,13,1693,0,42,2794
48491020608,6947,4244,1275,312,15,681,5,40,2703
48491020609,2297,1395,340,96,8,322,0,13,902
48491020701,2788,1065,1266,299,13,47,10,12,1723
48491020704,5698,2040,2725,546,18,119,12,17,3658
48491020706,4636,2590,918,254,3,584,4,26,2046
48491020707,6229,2703,1909,709,14,574,11,36,3526
48491020709,4306,1713,1582,512,11,311,10,14,2593
48491020710,3400,1157,953,606,17,464,8,20,2243
48491020711,5172,2709,1081,427,4,648,0,33,2463
48491020712,5038,1989,1395,668,15,680,10,37,3049
48491020713,3501,1416,1157,532,11,162,2,33,2085
48491020808,1747,1001,532,148,1,0,1,6,746
48491020810,6538,2760,2455,799,6,139,3,43,3778
48491020811,4279,1793,1580,523,9,89,9,28,2486
48491020812,5470,2285,2108,575,8,202,30,25,3185
48491020813,6343,3259,2074,570,19,102,4,24,3084
48491020814,5506,3191,894,382,12,698,12,25,2315
48491020815,1926,1396,300,72,8,81,0,2,530
48491020816,6634,3350,1657,977,28,267,9,39,3284
48491020817,5942,2570,1856,912,12,263,11,26,3372
48491020818,7925,3709,1850,872,15,1003,10,48,4216
48491020819,1169,782,232,31,0,35,3,21,387
48491020820,6511,2972,2257,799,19,111,4,25,3539
48491020821,2820,1316,1188,89,10,108,5,8,1504
48491020822,4458,2675,1290,182,21,30,6,30,1783
48491020900,5573,3928,1266,122,13,31,2,21,1645
48491021000,3003,572,1851,466,3,40,4,10,2431
48491021100,2636,990,1356,166,18,23,0,6,1646
48491021201,2971,1679,972,158,5,14,2,7,1292
48491021202,4177,2281,1359,312,23,30,1,10,1896
48491021203,2699,1318,1037,253,12,9,0,10,1381
48491021300,3794,2173,1294,195,2,3,3,19,1621
48491021402,3991,1982,1475,355,7,46,3,14,2009
48491021404,5611,3222,1768,258,11,90,5,21,2389
48491021405,6049,3218,2175,278,21,148,12,18,2831
48491021406,4362,2435,981,282,6,414,2,16,1927
48491021407,4498,1837,1823,328,12,249,6,29,2661
48491021502,4901,1414,2766,462,12,59,8,13,3487
48491021503,4206,1787,1688,415,17,108,1,56,2419
48491021506,3383,1619,1078,304,11,184,16,14,1764
48491021509,5834,2736,1155,500,9,1096,0,29,3098
48491021510,5761,2876,1182,691,10,643,12,51,2885
48491021511,2341,1229,583,254,10,107,2,28,1112
48491021512,4750,2357,1265,556,5,283,4,30,2393
48491021513,3026,1278,842,643,18,96,5,16,1748
48491021514,4256,1740,1261,593,15,364,18,33,2516
48491021515,4553,2046,1435,501,22,273,12,27,2507
48491021516,2663,1283,725,333,7,173,5,14,1380
48491021517,3783,1367,1682,425,16,134,14,23,2416
48491021518,3916,1520,1475,478,0,223,10,36,2396
48491021601,9951,4802,3875,640,27,129,14,43,5149
48491021602,4118,1953,1962,40,8,24,2,14,2165
48491021603,2324,1365,799,46,9,12,0,2,959
48493000102,4441,2761,1374,93,7,20,3,27,1680
48493000103,3463,2579,714,28,20,16,1,12,884
48493000104,4956,3377,1314,44,13,16,0,16,1579
48493000201,2442,968,1369,27,1,6,2,10,1474
48493000202,2157,1238,840,20,8,12,5,5,919
48493000300,5744,1863,3623,83,12,27,0,22,3881
48493000402,2803,1338,1345,34,2,26,1,0,1465
48493000404,7686,4427,2748,146,30,50,7,35,3259
48493000405,2582,1758,646,56,11,8,1,10,824
48493000406,5470,2724,2366,126,22,32,4,19,2746
48493000500,4235,2661,1400,22,19,7,0,14,1574
48493000600,3774,2183,1493,14,3,9,0,17,1591
48495950200,2378,777,1512,58,13,3,0,6,1601
48495950300,3905,1077,2626,58,23,63,0,0,2828
48495950400,1508,848,594,23,2,11,0,3,660
48497150101,4348,3494,578,19,29,18,0,7,854
48497150103,5462,3998,1118,35,36,27,6,25,1464
48497150104,3431,2850,408,22,19,14,0,1,581
48497150201,2691,1767,746,28,12,34,0,11,924
48497150202,3761,2290,1243,34,12,47,0,3,1471
48497150300,3194,2718,303,18,27,13,0,0,476
48497150402,6317,5161,816,22,35,31,2,13,1156
48497150403,4519,3709,528,19,32,5,3,21,810
48497150404,2732,2174,424,19,23,6,0,7,558
48497150405,3863,2813,786,136,24,7,0,6,1050
48497150500,6025,2965,2729,40,28,46,0,2,3060
48497150603,4990,3382,1157,103,55,50,0,19,1608
48497150604,4590,3817,479,16,28,13,1,15,773
48497150605,4901,3879,660,21,48,10,0,17,1022
48497150606,3283,2311,664,91,20,23,0,5,972
48497150607,4525,3167,1055,34,46,28,0,20,1358
48499950100,5109,4256,525,28,29,48,0,30,853
48499950200,3670,2708,543,258,20,24,0,12,962
48499950301,3726,3102,355,65,14,18,0,8,624
48499950303,3451,2905,324,72,8,6,0,7,546
48499950304,2544,2180,247,19,10,5,0,10,364
48499950401,2000,1707,174,8,11,3,1,10,293
48499950402,2757,2382,200,12,22,9,0,1,375
48499950500,2415,1904,251,107,10,17,0,8,511
48499950601,4087,3068,189,534,23,19,0,24,1019
48499950602,4344,3898,204,32,15,13,0,9,446
48499950700,5616,4473,756,63,47,31,0,16,1143
48499950800,5124,3323,1126,460,18,37,0,3,1801
48501950100,1877,789,1049,1,7,0,0,0,1088
48501950200,5817,1699,3919,54,15,46,0,15,4118
48503950200,4175,3046,844,89,13,28,0,10,1129
48503950401,2318,1855,355,15,11,14,0,3,463
48503950402,3277,2847,265,15,15,8,0,8,430
48503950500,2514,1633,755,20,15,8,0,4,881
48503950600,5583,4028,1289,35,25,28,0,13,1555
48505950303,1301,37,1250,2,0,2,0,0,1264
48505950304,3029,73,2947,2,2,3,0,0,2956
48505950305,2344,346,1970,2,0,3,0,10,1998
48505950306,2163,54,2097,1,1,2,0,1,2109
48505950401,2485,174,2293,0,4,3,0,5,2311
48505950402,2567,112,2442,2,0,3,0,0,2455
48507950100,855,113,731,0,0,4,0,0,742
48507950200,1483,177,1288,10,2,2,0,0,1306
48507950301,1744,124,1581,13,10,7,0,0,1620
48507950302,5588,158,5344,44,9,6,1,3,5430
49001100100,4426,3641,580,23,51,25,8,8,785
49001100200,2646,2076,486,0,19,7,13,0,570
49003960100,3498,3213,191,7,11,9,0,13,285
49003960200,8037,7132,567,24,34,52,9,17,905
49003960301,4500,3887,426,3,20,33,3,5,613
49003960302,5746,4466,916,21,39,105,20,11,1280
49003960400,5350,4772,370,13,31,55,7,15,578
49003960500,5311,4419,624,27,57,31,10,10,892
49003960601,3695,3109,397,14,29,19,10,3,586
49003960602,2620,2307,168,6,14,28,7,1,313
49003960701,5379,4221,850,14,71,19,8,9,1158
49003960702,2893,2256,380,11,53,18,11,4,637
49003960801,5166,4616,330,12,22,29,10,13,550
49003960802,5471,4963,318,9,2,40,3,1,508
49005000101,5201,4721,360,8,16,7,12,9,480
49005000102,1682,1480,147,2,6,2,0,7,202
49005000201,4273,3570,497,18,15,24,13,23,703
49005000202,10042,8736,817,36,22,102,14,32,1306
49005000301,2312,2096,163,14,1,0,0,5,216
49005000302,5869,4080,1398,100,32,77,21,18,1789
49005000401,4947,3797,693,37,41,160,37,18,1150
49005000402,4567,4150,182,19,6,80,9,7,417
49005000403,6530,5594,589,25,10,114,8,15,936
49005000501,5247,3578,1139,160,58,132,41,13,1669
49005000502,6714,4553,1294,172,104,190,95,28,2161
49005000601,4277,3669,266,45,20,130,6,11,608
49005000602,4107,3300,441,42,23,98,55,5,807
49005000701,4947,4452,158,16,10,132,11,21,495
49005000702,3480,2936,201,30,21,171,6,6,544
49005000800,4737,3900,464,35,28,120,14,20,837
49005000900,3206,2573,414,13,27,43,43,14,633
49005001001,2882,1675,914,78,18,83,29,8,1207
49005001002,4626,3087,1006,90,44,142,95,20,1539
49005001101,5816,5035,462,12,6,103,23,40,781
49005001102,5246,4514,317,16,10,167,13,13,732
49005001201,6226,5693,278,6,12,45,21,26,533
49005001202,7230,5911,1008,12,16,67,14,10,1319
49005001300,7159,6606,257,34,33,27,8,27,553
49005001401,5392,4302,823,10,16,48,27,13,1090
49005001402,4149,3223,720,14,23,26,38,8,926
49005001500,2175,2053,61,1,2,6,7,5,122
49005980100,115,92,7,0,0,7,0,0,23
49007000100,3236,2757,330,10,26,15,0,3,479
49007000200,4211,3428,542,11,54,20,0,11,783
49007000300,4202,3217,724,21,81,11,15,4,985
49007000500,4010,3362,437,4,16,8,13,21,648
49007000600,4753,3881,644,4,22,9,1,19,872
49009960100,935,881,29,1,0,1,2,2,54
49011125102,4290,3813,221,27,3,83,15,15,477
49011125103,7390,5855,891,77,23,154,31,32,1535
49011125104,6064,5256,399,75,15,90,10,14,808
49011125201,3548,2296,612,184,8,60,36,8,1252
49011125301,5386,3934,1013,56,29,86,39,26,1452
49011125304,5606,4301,858,43,18,106,35,13,1305
49011125305,6449,4939,918,57,40,151,59,17,1510
49011125306,4335,3375,546,57,25,93,32,11,960
49011125307,8734,7094,926,75,21,167,25,34,1640
49011125407,8219,7036,578,47,20,148,39,24,1183
49011125408,6670,5597,570,62,13,118,39,13,1073
49011125409,5271,4419,463,54,2,111,32,11,852
49011125410,4223,3545,370,22,12,95,1,24,678
49011125411,6523,5354,636,90,27,96,43,27,1169
49011125412,2918,2222,415,38,10,78,27,12,696
49011125413,6232,5354,380,48,7,146,13,32,878
49011125414,5271,3981,728,88,8,131,51,24,1290
49011125415,5093,3856,703,119,39,107,27,26,1237
49011125501,6741,5047,1013,104,41,166,83,11,1694
49011125502,5555,3764,1241,58,22,126,66,22,1791
49011125503,5657,4553,581,88,27,128,40,27,1104
49011125600,239,161,58,4,2,2,0,1,78
49011125701,4972,3290,1001,156,51,126,65,21,1682
49011125702,3943,2850,694,51,28,62,47,26,1093
49011125801,7086,4513,1789,131,93,158,49,36,2573
49011125804,6480,5256,600,69,11,188,39,36,1224
49011125805,6377,4398,1138,136,34,240,92,43,1979
49011125807,3675,2270,967,65,19,123,30,12,1405
49011125809,4513,3038,875,117,46,149,45,8,1475
49011125810,2875,1900,431,128,37,140,57,17,975
49011125905,6701,5321,825,77,46,86,31,26,1380
49011125906,7987,6547,797,96,54,118,48,29,1440
49011125907,2596,2107,286,40,7,36,18,2,489
49011125908,5201,4285,464,77,29,66,23,25,916
49011126001,5835,3921,1379,91,28,95,56,23,1914
49011126002,7994,6931,561,36,26,129,15,19,1063
49011126101,6670,5719,547,47,16,54,38,13,951
49011126105,6436,5799,360,14,3,55,18,19,637
49011126106,4590,4257,164,20,3,24,3,0,333
49011126107,3889,3558,169,20,9,44,6,1,331
49011126108,6625,6041,259,48,8,87,9,27,584
49011126203,4517,4055,164,29,9,70,12,5,462
49011126204,5304,4715,293,32,13,51,20,13,589
49011126205,6615,5786,355,49,20,105,19,14,829
49011126206,7040,6275,428,51,12,112,4,14,765
49011126303,4723,4226,241,9,8,70,27,5,497
49011126304,6955,6136,397,47,12,112,51,27,819
49011126305,2556,2362,103,6,3,15,1,3,194
49011126306,7585,6324,658,61,23,126,84,32,1261
49011126402,3606,3196,181,8,0,94,9,2,410
49011126404,8413,6770,732,67,29,275,161,27,1643
49011126405,3779,3291,213,20,3,98,22,11,488
49011126406,4770,3762,487,64,32,107,113,14,1008
49011126500,6551,5861,318,35,18,75,49,15,690
49011126600,5502,4421,593,38,20,113,47,25,1081
49011126700,4218,3256,534,72,15,59,98,30,962
49011126801,3534,3177,178,16,5,37,17,17,357
49011126802,5052,4398,232,31,7,85,67,30,654
49011126901,6123,4787,623,60,53,112,190,22,1336
49011126902,7142,5720,744,69,45,79,166,29,1422
49011127002,8272,4909,2296,119,60,227,293,27,3363
49011127003,8446,6812,714,82,38,250,139,32,1634
49011127005,3899,3154,412,22,11,69,76,14,745
49011127006,4130,3391,398,26,24,48,60,5,739
49011127100,8538,7594,487,41,41,73,43,23,944
49011980000,550,327,88,62,3,23,4,1,223
49013940300,3994,3663,188,5,34,6,10,12,331
49013940501,2888,2011,412,2,271,33,22,6,877
49013940502,5619,4841,344,8,250,9,4,21,778
49013940600,7095,6221,341,6,320,12,3,8,874
49015976200,3844,3492,236,2,13,17,6,5,352
49015976300,2903,2701,113,0,16,11,1,8,202
49015976500,3078,2618,356,0,26,8,0,3,460
49017000300,2342,2115,113,4,31,11,3,0,227
49017000400,2741,2331,271,1,59,19,4,3,410
49019000200,4676,3337,805,31,211,34,0,37,1339
49019000301,2470,2094,182,5,64,11,1,12,376
49019000302,2523,2050,239,29,55,35,10,13,473
49021110100,4434,4004,283,1,21,20,4,6,430
49021110201,4488,3842,394,9,58,7,4,20,646
49021110202,5294,4647,331,8,74,16,7,18,647
49021110300,4527,3762,528,6,56,35,6,13,765
49021110400,5031,4037,425,102,74,133,71,6,994
49021110501,7022,5492,894,37,221,89,47,18,1530
49021110502,4602,3327,842,32,163,47,14,11,1275
49021110601,1980,1632,175,26,20,40,5,10,348
49021110602,4751,3878,453,40,97,67,30,16,873
49021110702,6609,5733,504,12,70,48,23,19,876
49021110703,4645,4081,268,32,34,65,9,10,564
49021110704,3906,3185,385,70,60,54,17,7,721
49023010100,6653,6044,375,8,33,25,22,3,609
49023010200,5133,4737,199,3,56,7,19,7,396
49025130100,2392,2160,81,9,64,12,1,3,232
49025130200,5275,4764,241,18,55,47,0,15,511
49027974100,5040,4109,772,5,17,27,4,9,931
49027974200,2918,2496,336,2,9,7,0,4,422
49027974300,5017,4031,666,8,74,107,9,14,986
49029970101,6568,6128,210,10,22,35,0,1,440
49029970102,4058,3837,86,2,4,20,0,7,221
49029970200,1669,1597,42,0,5,2,0,1,72
49031960100,1438,1276,124,0,4,0,0,1,162
49033950100,2510,2329,97,11,1,2,4,1,181
49035100100,2987,1801,627,129,9,176,51,19,1186
49035100200,1333,1128,77,6,2,60,0,7,205
49035100306,6043,1937,2738,359,34,397,333,19,4106
49035100307,4968,1115,2691,213,57,384,330,27,3853
49035100308,4025,961,2209,249,57,178,249,18,3064
49035100500,5893,2827,2173,257,85,138,148,39,3066
49035100600,6699,2944,2783,238,104,137,216,25,3755
49035100700,2683,1958,372,73,25,78,18,23,725
49035100800,2562,1897,272,60,11,149,25,15,665
49035101000,3127,2599,220,19,9,106,6,12,528
49035101101,1973,1547,198,42,10,66,10,17,426
49035101102,3431,2654,332,56,12,176,41,32,777
49035101200,3972,3188,299,47,12,148,17,18,784
49035101401,2171,1211,131,40,17,619,15,15,960
49035101402,4339,2579,601,221,6,684,34,70,1760
49035101500,3288,2502,255,45,22,275,10,14,786
49035101600,3742,2829,348,85,25,246,7,17,913
49035101700,3582,2523,357,65,35,383,22,24,1059
49035101800,3347,2433,367,45,26,261,32,32,914
49035101900,3103,2075,385,91,28,362,17,20,1028
49035102000,2837,1935,429,67,26,178,35,11,902
49035102100,2378,1472,464,165,24,118,15,12,906
49035102300,3153,1788,654,186,70,273,29,28,1365
49035102501,3134,1657,738,176,57,253,21,43,1477
49035102502,2062,1383,248,86,38,190,15,17,679
49035102600,4391,1713,1954,125,53,164,240,28,2678
49035102701,4752,1576,2285,106,58,207,323,25,3176
49035102702,3704,842,2239,120,21,196,192,15,2862
49035102801,5919,1767,3213,102,49,359,258,11,4152
49035102802,4888,1420,1677,463,80,306,737,26,3468
49035102900,5768,2928,1584,467,110,240,98,46,2840
49035103000,2756,1883,528,43,20,91,46,12,873
49035103100,4144,2834,704,143,42,130,35,39,1310
49035103200,4433,3326,586,77,26,152,33,18,1107
49035103300,4256,3376,391,47,21,180,34,23,880
49035103400,4167,3351,385,60,17,119,19,18,816
49035103500,4031,3406,252,35,14,106,13,26,625
49035103600,2671,2293,129,14,6,79,10,15,378
49035103700,2631,2318,110,15,0,69,0,9,313
49035103800,2325,1970,153,14,2,74,4,0,355
49035103900,3605,2965,279,17,26,140,14,19,640
49035104000,3302,2818,160,29,0,142,2,18,484
49035104100,2941,2499,150,13,5,140,6,15,442
49035104200,6895,5736,272,38,15,496,16,30,1159
49035104300,2901,2285,213,40,27,196,8,10,616
49035104400,2067,1893,63,10,1,38,5,1,174
49035104700,4818,4031,330,45,5,118,22,24,787
49035104800,5263,4409,379,53,34,137,32,14,854
49035104900,3135,2222,551,61,26,106,12,12,913
49035110103,3562,3110,167,6,2,132,4,18,452
49035110104,5557,4680,251,17,4,328,2,10,877
49035110105,2011,1740,113,4,2,56,2,24,271
49035110106,2519,2200,105,19,7,77,5,2,319
49035110200,5070,4403,279,33,19,102,18,31,667
49035110300,5802,4819,443,51,29,136,51,27,983
49035110401,3401,2673,362,80,14,112,9,11,728
49035110402,3873,3291,259,46,19,116,23,10,582
49035110500,6425,5611,280,44,10,245,18,17,814
49035110600,5825,5119,249,31,12,187,18,32,706
49035110701,3798,2866,401,64,24,189,39,17,932
49035110702,5199,4434,312,54,14,161,14,17,765
49035110800,5813,4868,397,77,18,169,44,26,945
49035110900,4923,4301,229,23,10,106,17,32,622
49035111001,4594,4119,212,14,4,107,4,15,475
49035111002,5627,4556,426,48,22,268,7,21,1071
49035111104,2982,2417,301,22,18,80,18,30,565
49035111105,3847,2823,635,34,13,151,11,33,1024
49035111106,3118,2514,295,65,17,74,12,16,604
49035111107,3090,2394,337,50,8,134,17,13,696
49035111108,3332,2847,178,24,4,89,19,3,485
49035111109,3233,2724,201,22,10,125,15,5,509
49035111201,2632,2093,290,17,10,77,8,14,539
49035111202,4664,3644,478,31,41,163,23,25,1020
49035111302,5878,5120,268,37,12,130,15,27,758
49035111304,3692,3170,196,34,6,121,7,14,522
49035111305,3872,3276,225,22,16,112,6,16,596
49035111306,2454,2021,187,12,0,120,8,8,433
49035111400,6976,4114,1403,287,83,618,71,30,2862
49035111500,2529,1187,868,147,39,133,47,18,1342
49035111601,4449,2020,955,583,54,366,71,55,2429
49035111602,6762,3254,1857,643,165,394,191,25,3508
49035111701,5452,2471,1421,472,89,638,50,53,2981
49035111702,4407,2551,1062,144,37,358,54,21,1856
49035111801,5762,3951,893,190,49,275,60,44,1811
49035111802,2777,2058,347,45,12,131,37,20,719
49035111903,4113,2878,560,95,48,277,27,23,1235
49035111904,3624,2705,399,95,9,156,53,33,919
49035111905,3806,2665,563,87,52,157,53,30,1141
49035111906,4524,2621,831,298,69,372,40,26,1903
49035112001,3362,2436,502,97,61,86,20,21,926
49035112002,4871,3760,614,79,29,154,21,15,1111
49035112101,5058,2274,1469,498,55,357,96,30,2784
49035112102,5041,3844,659,78,35,113,58,18,1197
49035112201,5018,4142,505,47,13,129,17,10,876
49035112202,4005,3143,533,22,14,91,15,14,862
49035112301,3815,2884,553,41,27,116,20,26,931
49035112302,3623,2990,350,33,12,53,10,24,633
49035112402,7498,3841,2790,153,69,151,134,50,3657
49035112404,4578,2701,1230,151,44,136,94,24,1877
49035112405,6241,3515,1410,295,47,487,113,64,2726
49035112406,3394,1376,1643,74,37,65,74,23,2018
49035112501,4027,2896,582,101,22,178,44,16,1131
49035112503,4832,3324,936,63,30,193,23,35,1508
49035112504,2995,2187,391,61,24,108,50,19,808
49035112505,3972,2819,567,93,41,172,43,29,1153
49035112604,4767,3792,526,26,15,111,33,21,975
49035112608,5165,4362,361,28,13,156,59,18,803
49035112609,5402,4614,293,40,7,229,7,20,788
49035112610,6292,4283,1110,125,26,334,57,30,2009
49035112611,6681,5315,665,40,37,282,54,16,1366
49035112612,5440,4008,631,50,22,284,86,48,1432
49035112613,5264,4287,441,40,17,212,23,10,977
49035112614,3575,3110,174,8,7,132,1,15,465
49035112615,2340,2042,123,13,10,67,4,7,298
49035112616,4239,3605,250,43,6,167,1,4,634
49035112617,3354,2926,180,23,4,90,9,20,428
49035112618,3911,3200,279,35,13,179,22,14,711
49035112619,3111,2619,194,34,0,104,20,6,492
49035112620,3206,2592,336,22,21,84,27,12,614
49035112621,5540,3627,1095,104,44,334,58,53,1913
49035112700,5671,4194,842,50,44,238,61,20,1477
49035112804,5429,4486,467,40,31,126,20,27,943
49035112805,5319,4256,466,32,20,265,28,35,1063
49035112812,5774,4553,612,40,24,156,65,29,1221
49035112813,5410,4706,278,30,11,137,39,29,704
49035112814,4960,4349,206,30,7,158,4,34,611
49035112815,5126,4369,294,31,14,175,15,12,757
49035112816,5906,5232,333,39,6,115,23,20,674
49035112818,3159,2010,619,241,163,1,1,5,1149
49035112821,7038,5898,470,38,2,262,7,40,1140
49035112822,5269,3690,872,32,24,427,33,19,1579
49035112823,6165,4717,690,65,27,384,31,26,1448
49035112824,5722,4005,527,78,38,790,51,29,1717
49035112825,4874,3387,634,74,15,423,77,15,1487
49035112826,5253,4766,293,12,14,20,5,17,487
49035112827,10862,8569,1086,93,52,377,87,70,2293
49035112828,5063,4387,194,13,4,227,10,18,676
49035112829,3181,2306,478,37,3,180,30,18,875
49035112830,5027,3990,443,51,23,265,15,14,1037
49035112831,3398,2564,392,69,9,178,8,21,834
49035112904,6352,3683,1794,85,37,293,233,17,2669
49035112905,5295,3959,675,26,29,336,61,32,1336
49035112907,4705,3141,1156,47,54,62,76,6,1564
49035112912,2648,1901,465,31,18,64,73,17,747
49035112913,5158,3928,813,23,26,99,69,6,1230
49035112914,6548,4538,1217,82,37,226,132,55,2010
49035112916,4736,2731,1418,67,28,86,153,18,2005
49035112917,4168,2809,868,45,9,174,85,26,1359
49035112918,5362,3290,1468,67,31,193,80,19,2072
49035112920,5155,3660,863,44,4,196,120,40,1495
49035112921,4280,3065,806,36,15,142,38,12,1215
49035113007,4947,4077,433,40,10,109,90,3,870
49035113008,6285,5280,520,27,10,164,94,18,1005
49035113010,7371,6374,374,43,7,314,29,22,997
49035113011,6567,5409,488,21,11,321,75,45,1158
49035113012,5837,4873,365,46,11,230,74,37,964
49035113013,6130,5262,422,30,7,148,79,7,868
49035113014,5273,4465,354,31,26,182,56,24,808
49035113016,7420,6358,500,39,10,195,48,39,1062
49035113017,7279,6283,605,27,19,77,43,9,996
49035113021,5887,4077,696,94,9,601,140,22,1810
49035113022,7589,6037,754,74,20,243,46,39,1552
49035113023,6756,5210,826,72,11,224,69,39,1546
49035113024,5388,4460,382,30,6,292,34,16,928
49035113025,5320,3896,603,64,30,411,65,42,1424
49035113101,7013,4686,1729,67,29,156,92,18,2327
49035113102,3766,2987,459,15,10,103,70,11,779
49035113105,7886,6736,625,36,23,81,41,27,1150
49035113108,4035,2976,645,20,18,119,95,11,1059
49035113109,4823,4013,462,33,8,106,27,9,810
49035113110,4399,3745,365,27,10,53,45,7,654
49035113111,5210,4303,501,64,20,97,35,34,907
49035113112,3726,3166,313,4,17,59,20,8,560
49035113113,11122,7928,1812,149,47,454,182,41,3194
49035113114,9861,7071,1779,77,46,271,132,55,2790
49035113307,7413,2002,4222,164,43,365,411,40,5411
49035113308,5196,1749,2465,172,68,257,340,18,3447
49035113309,5111,2297,2021,116,45,221,283,11,2814
49035113310,3143,1573,1055,76,36,127,145,10,1570
49035113311,4900,1937,2112,215,56,275,144,30,2963
49035113312,3859,1166,1852,140,98,142,324,3,2693
49035113313,3993,1670,1366,178,72,284,244,10,2323
49035113314,2821,939,1276,146,38,189,141,10,1882
49035113406,6787,2139,3671,146,60,209,398,18,4648
49035113408,7119,3733,2606,91,69,151,211,24,3386
49035113409,5049,2775,1667,70,30,105,219,14,2274
49035113410,6805,3335,2246,240,55,340,367,15,3470
49035113411,2808,1350,804,61,7,301,174,3,1458
49035113412,3018,1226,1029,65,17,422,134,9,1792
49035113413,5980,3546,1638,138,34,196,242,10,2434
49035113414,6530,3309,2338,80,38,378,187,18,3221
49035113415,5951,2510,2635,88,52,267,182,9,3441
49035113505,6558,3486,2084,156,58,166,356,25,3072
49035113509,7826,2274,3706,427,78,836,230,16,5552
49035113510,3357,1973,861,91,33,156,125,13,1384
49035113511,3900,2344,805,170,27,220,150,21,1556
49035113512,3417,1978,772,152,48,182,103,29,1439
49035113513,6186,3536,1505,158,77,497,159,47,2650
49035113514,6757,2943,2838,272,73,185,132,26,3814
49035113515,6168,4422,899,152,37,238,146,40,1746
49035113520,4101,2266,1182,126,41,161,142,20,1835
49035113521,6493,3763,1898,97,49,178,222,26,2730
49035113522,3281,2268,566,44,26,198,59,14,1013
49035113523,6102,3537,1944,71,58,148,122,23,2565
49035113526,5793,3035,2145,61,58,137,162,23,2758
49035113527,4241,2408,1379,45,38,61,122,22,1833
49035113528,4976,3048,1451,78,22,127,92,18,1928
49035113532,3259,2342,550,55,7,90,97,4,917
49035113533,4918,3755,624,54,10,187,71,23,1163
49035113536,4201,1593,1920,88,40,149,284,23,2608
49035113537,3699,2081,1126,42,12,177,162,5,1618
49035113538,3105,1438,1265,76,25,119,104,8,1667
49035113539,4883,2212,1992,127,25,149,196,30,2671
49035113540,5367,3244,1475,100,27,178,138,18,2123
49035113541,2545,1442,795,29,6,86,92,3,1103
49035113542,4018,2436,993,96,17,215,76,20,1582
49035113543,4478,3446,691,30,19,100,38,11,1032
49035113544,4050,1864,1657,111,38,153,121,14,2186
49035113545,3791,1314,1311,114,15,757,125,10,2477
49035113600,5498,2557,2321,48,43,100,190,34,2941
49035113701,4160,2183,1608,33,32,74,109,14,1977
49035113702,2619,1405,1042,8,21,14,46,10,1214
49035113801,5939,2670,2647,118,33,85,192,38,3269
49035113802,4371,1729,2274,61,20,52,96,16,2642
49035113804,4809,2166,1929,87,34,234,154,20,2643
49035113805,4178,2005,1728,62,28,85,148,17,2173
49035113903,5403,3061,1815,76,29,94,147,40,2342
49035113904,6039,3449,1988,90,32,43,207,6,2590
49035113905,7667,3967,3013,81,53,116,189,23,3700
49035113906,4888,3074,1286,69,36,34,144,18,1814
49035113908,5272,2890,1962,87,23,47,93,26,2382
49035113909,4119,2888,784,75,9,97,91,31,1231
49035114000,4344,2951,633,150,47,265,57,55,1393
49035114100,3582,2949,294,27,14,144,10,6,633
49035114200,5161,3719,740,40,27,353,51,28,1442
49035114301,5511,2803,1859,99,58,240,157,32,2708
49035114302,2833,1982,539,37,9,103,35,26,851
49035114303,10724,7330,2082,125,58,439,215,38,3394
49035114304,5801,3836,1271,84,24,210,100,28,1965
49035114500,7487,2846,2809,230,76,883,364,26,4641
49035114601,5315,4549,353,40,15,116,34,28,766
49035114602,2083,1883,110,11,3,12,8,6,200
49035114700,4620,2161,1819,99,28,186,137,17,2459
49035114800,3654,3088,128,18,4,199,8,33,566
49035115107,6431,5532,464,21,12,96,68,32,899
49035115108,8083,6419,912,80,10,233,54,42,1664
49035115109,7272,5127,1281,129,41,181,155,28,2145
49035115210,8274,6593,779,66,19,289,50,38,1681
49035115211,7033,4943,1243,98,19,237,165,36,2090
49035980000,16,11,3,0,0,0,0,0,5
49035980100,10,7,2,0,0,0,1,0,3
49037942000,3595,34,57,6,3440,0,1,0,3561
49037942100,2482,112,19,5,2307,2,5,5,2370
49037978100,3562,2913,376,3,131,11,3,12,649
49037978200,4879,2979,295,18,1308,21,42,9,1900
49039972101,4575,3894,339,33,20,98,21,20,681
49039972102,3579,3322,123,10,9,3,10,10,257
49039972200,4138,3197,778,0,16,5,46,9,941
49039972300,5580,4435,761,123,111,9,4,0,1145
49039972401,1767,1303,347,2,16,6,47,6,464
49039972402,4174,3389,453,38,23,45,92,15,785
49039972500,4624,4148,242,18,45,5,27,21,476
49041975100,4603,4190,284,4,8,4,10,0,413
49041975200,2624,2470,76,0,8,0,4,1,154
49041975300,5054,4479,200,23,171,16,17,23,575
49041975400,4099,3636,228,27,76,11,10,3,463
49041975500,5142,4621,265,11,50,9,8,22,521
49043964101,2269,1931,268,0,5,10,4,0,338
49043964103,1308,1152,62,3,1,23,6,19,156
49043964104,2222,1864,294,5,0,9,2,0,358
49043964201,4438,3828,483,7,6,12,1,3,610
49043964202,3216,2832,274,1,10,13,7,2,384
49043964203,192,169,15,0,1,0,0,3,23
49043964303,3276,2907,137,11,4,71,7,9,369
49043964304,5531,4569,558,20,7,125,1,26,962
49043964305,2285,1692,392,30,2,85,3,15,593
49043964306,3397,2894,260,16,10,60,1,15,503
49043964307,5382,4693,359,15,9,75,3,20,689
49043964308,3238,2761,258,13,1,66,0,18,477
49043964401,1473,1278,79,12,3,46,1,7,195
49043964402,4130,2538,1298,30,8,128,6,18,1592
49045130600,1717,661,856,25,76,25,7,9,1056
49045130701,5109,4211,528,44,26,28,66,20,898
49045130704,6070,5029,588,38,15,47,85,28,1041
49045130705,5812,4879,589,34,11,44,53,16,933
49045130706,6774,5401,874,58,22,58,90,18,1373
49045130707,3909,3371,314,12,7,13,6,21,538
49045130708,7224,6030,779,31,32,29,62,24,1194
49045130800,6988,6236,456,19,41,20,14,14,752
49045130900,5579,4038,1091,36,62,59,67,22,1541
49045131001,2898,2253,404,27,12,42,28,13,645
49045131003,3800,2889,606,21,39,15,47,16,911
49045131004,2465,1852,405,19,2,27,29,18,613
49045131005,2198,1655,360,16,15,16,25,4,543
49045131101,4606,3626,648,28,43,42,30,17,980
49045131102,3986,3209,536,14,22,24,16,28,777
49045131200,3563,2859,488,14,20,22,12,14,704
49045980000,0,0,0,0,0,0,0,0,0
49047940201,5552,3199,327,10,1743,19,5,20,2353
49047968201,4912,4470,235,4,32,7,1,12,442
49047968202,3586,3115,254,8,46,15,1,2,471
49047968301,5921,4884,552,21,143,36,30,23,1037
49047968302,4752,4239,282,5,33,12,8,10,513
49047968401,3589,2808,469,13,103,32,27,13,781
49047968403,3707,3150,325,9,63,5,6,28,557
49047968404,3601,2861,390,20,114,31,19,8,740
49049000102,4785,4032,551,20,15,12,19,5,753
49049000103,4323,3598,422,15,14,51,17,15,725
49049000104,3200,2830,192,12,8,13,12,6,370
49049000105,4073,3566,260,27,8,50,43,17,507
49049000203,4751,3838,517,45,29,56,43,13,913
49049000205,3875,3411,197,2,22,39,23,21,464
49049000206,3747,3304,209,19,6,50,20,12,443
49049000207,2551,2058,254,10,8,72,24,16,493
49049000208,4088,3448,382,25,25,26,30,29,640
49049000400,5843,4390,924,29,22,146,87,18,1453
49049000504,4373,3722,389,42,6,28,26,22,651
49049000505,3288,2860,210,12,10,19,12,30,428
49049000506,4316,3502,522,21,8,66,51,7,814
49049000507,2203,1910,197,12,8,9,3,2,293
49049000508,5309,4113,841,29,27,35,41,21,1196
49049000510,3748,2830,529,12,12,126,28,14,918
49049000511,5103,3321,1231,61,15,96,66,48,1782
49049000601,4075,3305,468,3,15,70,63,9,770
49049000603,4279,3734,301,31,7,39,10,5,545
49049000604,3162,2655,281,10,0,51,20,9,507
49049000703,6141,3857,1646,60,40,122,75,44,2284
49049000706,6370,4496,1240,37,36,129,129,26,1874
49049000707,3948,2981,623,15,13,92,53,19,967
49049000708,2951,2491,291,16,11,56,7,3,460
49049000709,3127,2358,478,23,15,66,7,32,769
49049000710,2821,2387,192,7,6,75,24,10,434
49049000711,2325,1996,149,8,9,35,19,11,329
49049000801,5624,3094,2002,33,45,77,96,30,2530
49049000803,2694,1387,1050,24,24,61,35,9,1307
49049000804,3150,2009,832,20,18,58,65,24,1141
49049000901,5559,3307,1745,43,32,106,87,22,2252
49049000903,3547,2951,355,10,16,29,41,14,596
49049000904,3183,2625,319,7,1,35,46,1,558
49049001001,3914,2918,640,34,9,55,67,12,996
49049001002,2776,2251,338,20,0,47,23,3,525
49049001103,2731,2083,443,31,13,43,21,3,648
49049001105,3755,2741,610,68,14,83,52,7,1014
49049001106,2967,2105,617,16,7,46,24,19,862
49049001107,3961,2964,620,25,12,102,55,10,997
49049001108,3574,1914,1201,65,26,94,85,29,1660
49049001201,5803,4344,832,74,27,162,81,53,1459
49049001202,5201,3304,1377,45,23,97,113,16,1897
49049001300,3677,2636,683,45,21,75,51,28,1041
49049001401,3710,3170,236,32,11,76,14,10,540
49049001403,2321,1667,455,23,4,59,17,12,654
49049001404,4011,2623,797,69,41,148,84,24,1388
49049001501,4191,3530,329,21,7,86,45,10,661
49049001503,3919,3357,238,10,15,74,31,13,562
49049001504,4632,3707,419,30,7,125,60,12,925
49049001601,4385,3421,391,47,31,232,29,7,964
49049001602,5380,4375,433,38,8,153,67,4,1005
49049001701,3697,3049,221,14,16,102,41,28,648
49049001702,4282,3305,514,25,12,136,31,11,977
49049001801,6062,4858,614,32,14,225,27,19,1204
49049001802,7141,5687,769,93,24,152,58,23,1454
49049001803,1945,1442,346,9,2,46,6,7,503
49049001900,4063,3053,586,50,11,124,38,1,1010
49049002001,3357,2195,801,30,15,59,46,11,1162
49049002002,3223,1519,1364,32,29,25,74,20,1704
49049002101,4206,3349,480,31,6,54,70,3,857
49049002102,3098,2116,679,21,20,67,38,12,982
49049002204,4520,2856,1176,17,12,125,101,3,1664
49049002205,4427,2672,1380,25,31,47,76,3,1755
49049002206,3314,2044,995,32,17,25,60,14,1270
49049002208,6588,4930,872,45,23,211,111,10,1658
49049002209,3869,2432,907,43,50,50,129,45,1437
49049002210,2728,1784,574,86,11,96,37,10,944
49049002211,2117,1454,410,36,25,41,28,12,663
49049002212,5502,4187,731,34,39,119,101,30,1315
49049002213,3935,2270,1247,41,13,77,105,7,1665
49049002300,3683,2111,1107,64,47,46,111,26,1572
49049002400,2149,1509,385,22,16,59,28,9,640
49049002500,4218,2635,1200,39,55,56,42,5,1583
49049002702,4975,3288,915,39,40,152,184,43,1687
49049002703,2794,1933,609,11,18,32,38,2,861
49049002901,8681,6270,1785,64,39,88,100,25,2411
49049002902,3579,2249,1084,10,32,22,35,12,1330
49049003001,4473,3535,652,15,21,42,55,22,938
49049003002,2227,1812,267,14,26,15,12,6,415
49049003103,2814,2418,231,11,11,13,4,12,396
49049003104,4257,3902,173,14,14,36,9,1,355
49049003105,3838,3095,494,25,16,21,40,16,743
49049003106,2856,2055,597,21,17,12,34,11,801
49049003201,2664,1918,589,11,12,10,18,5,746
49049003203,4014,3501,321,36,10,15,23,30,513
49049003204,2725,2172,382,12,1,9,28,17,553
49049003205,3993,3206,552,17,18,10,56,0,787
49049003301,4205,3064,899,23,19,17,20,28,1141
49049003302,3034,2384,468,4,17,20,48,18,650
49049003401,3896,3026,682,8,14,22,6,12,870
49049003403,5315,3962,1140,17,16,21,28,12,1353
49049003404,2361,2008,238,12,21,5,14,8,353
49049003405,3935,3290,477,17,18,18,19,0,645
49049010107,5765,5111,391,16,11,20,18,14,654
49049010110,5326,4670,352,7,12,74,10,10,656
49049010114,7244,5820,874,61,29,39,71,30,1424
49049010115,3604,2934,451,12,13,23,7,7,670
49049010116,7299,6057,633,55,6,90,89,19,1242
49049010117,3801,3300,221,16,4,31,36,10,501
49049010118,5723,4756,497,32,24,69,39,28,967
49049010119,2622,2073,342,15,5,13,15,3,549
49049010120,11715,9266,1389,97,33,136,149,70,2449
49049010121,9403,7673,1036,66,24,108,59,37,1730
49049010122,7132,5689,856,42,8,41,115,45,1443
49049010123,7623,6215,734,48,29,95,95,46,1408
49049010124,5299,3988,660,45,16,209,49,28,1311
49049010125,3542,2809,494,33,16,24,16,24,733
49049010126,3115,2565,302,29,15,65,32,2,550
49049010127,6391,5275,639,37,20,60,50,17,1116
49049010128,4394,3242,634,24,27,98,91,35,1152
49049010129,5147,4178,526,19,5,138,34,2,969
49049010130,4250,3659,301,19,10,39,26,12,591
49049010131,5060,4305,464,21,12,55,48,9,755
49049010132,4378,3515,498,52,11,52,72,12,863
49049010208,4107,3699,175,18,5,31,5,16,408
49049010209,5649,5105,227,18,0,47,11,18,544
49049010210,5868,5065,374,15,16,93,48,13,803
49049010211,3898,3548,129,17,11,56,9,9,350
49049010212,9953,7524,817,90,38,764,151,80,2429
49049010213,3240,2923,129,19,5,49,4,7,317
49049010216,3544,3165,159,10,6,42,14,5,379
49049010217,7135,6163,377,20,22,142,43,21,972
49049010219,5704,5082,290,19,5,63,43,2,622
49049010220,6336,5549,402,13,20,55,43,21,787
49049010221,2032,1543,244,18,17,80,46,9,489
49049010222,7105,6084,474,37,13,152,30,7,1021
49049010223,2489,2271,101,14,0,18,13,11,218
49049010224,3619,3259,164,20,8,48,23,7,360
49049010225,4188,3702,267,18,0,39,37,0,486
49049010226,3751,3252,282,6,6,27,21,14,499
49049010303,5205,4751,231,14,10,23,13,16,454
49049010305,3974,3642,161,9,4,12,6,21,332
49049010306,2282,1552,597,6,12,17,14,6,730
49049010307,6502,5418,673,23,15,56,49,20,1084
49049010308,4919,4117,459,16,24,28,55,8,802
49049010404,5188,4267,556,31,30,28,44,35,921
49049010405,3893,3221,485,10,8,26,12,8,672
49049010406,3555,3124,245,28,10,32,1,10,431
49049010407,2652,2358,185,17,8,10,2,8,294
49049010408,4745,4379,211,22,11,12,6,3,366
49049010409,3721,3281,345,6,15,7,4,6,440
49049010410,4410,3600,645,7,8,13,12,6,810
49049010411,7911,7213,337,30,12,44,30,17,698
49049010503,3687,3030,441,24,40,18,23,9,657
49049010504,3942,3262,514,16,8,24,14,15,680
49049010505,5087,4083,816,13,26,3,18,10,1004
49049010506,2109,1487,509,3,9,2,4,5,622
49049010600,5884,4949,706,5,15,11,25,9,935
49049010700,5310,4633,370,22,14,66,39,17,677
49049010900,1094,996,47,1,9,5,3,0,98
49049980100,0,0,0,0,0,0,0,0,0
49049980200,2035,1529,211,10,1,135,17,10,506
49049980300,3707,1458,1865,37,42,36,85,45,2249
49049980400,320,214,63,16,9,6,7,1,106
49049980500,1616,841,583,11,16,38,26,11,775
49049980600,0,0,0,0,0,0,0,0,0
49051940501,4026,3121,699,34,3,50,3,12,905
49051960100,5016,3449,1281,30,10,75,2,1,1567
49051960201,4252,3376,637,8,20,72,15,4,876
49051960202,5236,4223,756,17,20,50,9,5,1013
49051960203,4017,3560,298,15,1,19,0,12,457
49051960204,3976,2862,968,11,0,40,7,4,1114
49051960401,3066,2777,140,11,13,14,3,18,289
49051960402,4121,3762,246,10,0,23,2,8,359
49051960500,1058,1025,19,2,0,4,0,1,33
49051980100,20,13,2,3,0,0,0,0,7
49053270101,4693,4273,233,7,30,34,0,27,420
49053270102,3483,3156,196,13,26,15,7,18,327
49053270200,3549,3272,177,9,16,9,2,13,277
49053270301,6557,5093,952,74,79,67,68,17,1464
49053270302,3231,2904,129,4,74,21,0,9,327
49053270401,7008,5958,641,20,40,44,65,29,1050
49053270402,2725,2428,162,9,12,50,0,12,297
49053270501,2694,2403,148,2,1,28,8,2,291
49053270502,5149,4507,370,10,19,41,40,8,642
49053270601,7255,5666,1033,56,112,64,60,22,1589
49053270602,1671,1453,110,11,5,23,29,2,218
49053270701,5764,3277,1968,46,116,36,75,13,2487
49053270702,5422,4034,1018,31,54,52,29,38,1388
49053270802,7387,5876,973,30,62,106,68,22,1511
49053270803,5594,5000,310,17,10,51,17,22,594
49053270804,5760,5006,356,36,20,41,93,9,754
49053270805,6380,4977,900,26,92,48,51,30,1403
49053270806,1983,1764,102,8,7,32,17,2,219
49053270901,4085,3577,282,10,24,14,19,18,508
49053270903,3976,3295,387,6,54,32,34,17,681
49053270904,5581,4461,810,23,40,37,35,22,1120
49053270905,6501,5446,618,33,35,61,29,24,1055
49053271000,4593,3852,501,7,39,20,27,16,741
49053271101,6034,4022,1413,28,98,116,115,8,2012
49053271102,5901,4426,987,31,65,70,72,26,1475
49053271200,3845,2832,620,47,46,81,64,19,1013
49053271300,4380,3066,813,85,79,55,115,14,1314
49053271400,3847,2837,734,29,46,27,42,12,1010
49053271501,4751,3639,742,31,60,34,44,12,1112
49053271502,2927,2514,224,15,27,24,25,13,413
49053271600,7244,6485,403,22,17,69,21,10,759
49053271702,15965,13615,1163,71,58,227,173,70,2350
49053271703,7249,6511,349,30,23,76,40,30,738
49053271704,3405,2960,210,15,10,51,33,11,445
49053271800,3690,2877,448,21,70,46,90,14,813
49055979100,2486,2267,96,1,19,16,3,5,219
49057200100,4586,3189,1054,58,38,52,7,15,1397
49057200202,3978,2209,1349,91,45,70,21,13,1769
49057200203,5420,2862,2108,108,26,54,19,33,2558
49057200204,5209,2981,1879,61,28,39,34,10,2228
49057200301,4805,2358,2082,69,37,64,20,9,2447
49057200302,3519,1653,1590,41,18,46,35,16,1866
49057200400,1829,814,859,57,25,7,4,11,1015
49057200500,6255,4114,1645,102,38,57,22,17,2141
49057200600,4488,3280,829,88,21,45,12,15,1208
49057200700,3270,2493,548,37,26,35,7,14,777
49057200800,4531,2532,1653,65,30,41,5,27,1999
49057200900,4200,2349,1385,160,49,41,9,28,1851
49057201100,2525,1753,422,72,43,122,8,20,772
49057201200,2378,796,1232,127,61,28,31,8,1582
49057201301,2744,1387,1118,52,28,33,3,10,1357
49057201302,3468,1524,1596,118,27,32,10,25,1944
49057201400,3213,2634,363,19,13,33,10,5,579
49057201500,4261,3472,404,71,9,86,15,42,789
49057201600,4156,2911,912,67,23,52,29,9,1245
49057201700,3460,1697,1544,40,23,20,11,21,1763
49057201800,2421,948,1237,78,41,28,9,9,1473
49057201900,1284,577,591,36,17,10,2,6,707
49057202000,5560,4408,580,87,31,206,9,40,1152
49057210101,3965,3603,187,8,9,24,15,20,362
49057210102,4301,3947,172,19,9,28,2,12,354
49057210201,4532,3969,320,24,13,40,12,46,563
49057210203,3235,2760,301,12,2,37,7,13,475
49057210204,4994,4180,581,19,18,44,8,21,814
49057210303,8164,7206,546,25,24,85,14,21,958
49057210304,5762,4653,664,38,26,155,16,31,1109
49057210305,5785,4465,924,46,18,80,14,17,1320
49057210306,4824,3876,625,31,11,67,18,10,948
49057210404,2363,2155,126,2,16,4,11,6,208
49057210405,3290,2752,314,77,18,34,6,5,538
49057210406,5349,4640,458,21,19,27,3,13,709
49057210407,6511,5823,396,22,19,36,4,30,688
49057210408,3571,3269,184,11,1,13,6,18,302
49057210508,2411,1740,461,18,6,61,20,6,671
49057210509,4575,3494,736,43,16,87,10,13,1081
49057210510,3626,2831,477,32,6,71,16,23,795
49057210511,4202,3176,744,34,15,76,4,6,1026
49057210512,5165,3749,1018,45,17,72,63,9,1416
49057210513,6533,4563,1362,61,42,162,40,25,1970
49057210514,6022,4608,897,54,32,141,22,20,1414
49057210515,4964,4222,436,39,14,63,9,14,742
49057210516,6014,5395,391,23,22,22,3,20,619
49057210517,4639,3992,391,19,17,44,5,13,647
49057210518,7352,6006,863,90,29,71,16,26,1346
49057210600,6958,5232,1084,81,56,126,31,16,1726
49057210701,6063,4427,1049,80,35,144,35,27,1636
49057210703,2606,1908,466,34,16,36,13,10,698
49057210704,6142,4571,1096,55,50,85,35,15,1571
49057210800,3168,2054,884,47,17,27,2,12,1114
49057210900,6776,5321,865,103,26,118,29,30,1455
49057211000,3314,2468,597,39,22,19,9,6,846
49057211100,5713,4185,1058,114,19,99,45,11,1528
49057211201,4922,3984,484,63,22,77,19,34,938
49057211202,6852,5724,605,76,15,127,54,12,1128
50001960100,3835,3524,83,12,5,16,0,10,311
50001960200,2646,2450,79,8,7,12,0,7,196
50001960300,2553,2336,54,30,10,15,1,7,217
50001960400,4954,4563,150,17,8,25,0,10,391
50001960500,3782,3476,78,13,2,27,0,12,306
50001960600,2894,2612,64,17,8,27,0,16,282
50001960700,4004,3598,98,38,9,45,1,12,406
50001960800,5148,3930,370,171,12,389,4,9,1218
50001960900,5336,4882,151,34,13,30,0,21,454
50001961000,2211,2069,26,2,6,8,4,6,142
50003970401,2803,2500,110,28,6,56,0,14,303
50003970402,1681,1488,62,45,1,21,1,7,193
50003970500,1890,1757,49,4,3,24,0,1,133
50003970601,2053,1952,16,11,1,8,0,1,101
50003970800,3598,3330,76,19,6,22,0,5,268
50003970900,2239,1993,57,38,7,2,0,0,246
50003971000,3540,3026,132,66,5,120,0,16,514
50003971100,4596,4173,114,51,7,44,0,19,423
50003971200,4958,4424,131,93,10,32,4,19,534
50003971300,3258,3043,55,23,15,11,0,2,215
50003971400,2831,2626,61,10,0,26,0,16,205
50003971600,3900,3585,76,17,2,31,0,19,315
50005957000,4102,3797,37,14,13,6,0,29,305
50005957100,2226,2060,39,3,4,14,0,10,166
50005957200,2558,2383,23,4,9,12,3,7,175
50005957300,2933,2622,67,45,14,47,4,18,311
50005957400,3709,3155,118,53,14,183,3,15,554
50005957500,3655,3226,151,38,13,48,0,16,429
50005957600,2335,2164,29,9,8,13,2,8,171
50005957700,2920,2657,58,19,5,23,2,11,263
50005957800,2864,2660,28,12,8,7,0,4,204
50005957900,2931,2741,55,17,6,10,3,1,190
50007000100,4573,3575,118,252,9,367,1,14,998
50007000200,6101,5089,165,306,12,216,1,38,1012
50007000300,5259,3750,186,418,14,551,0,22,1509
50007000600,4306,3413,157,238,5,253,0,14,893
50007000800,2595,2264,82,53,1,47,0,13,331
50007000900,2742,2347,116,67,12,78,0,8,395
50007001000,2906,2241,143,172,6,171,0,21,665
50007001100,2486,1961,85,209,0,106,0,9,525
50007002101,2789,2567,50,14,6,16,3,5,222
50007002103,4156,3818,59,41,6,22,1,9,338
50007002104,3778,3374,70,57,24,57,0,23,404
50007002201,3062,2440,145,209,11,128,3,14,622
50007002202,4967,4367,87,57,12,204,3,13,600
50007002301,1369,1226,22,19,0,21,1,5,143
50007002303,5215,4688,125,71,3,113,4,4,527
50007002304,2895,2493,65,64,0,107,1,10,402
50007002400,3441,2261,101,341,19,501,0,12,1180
50007002501,2252,1685,52,156,11,225,3,11,567
50007002502,2320,1700,96,210,6,172,0,12,620
50007002601,6049,5007,157,128,8,457,2,24,1042
50007002602,4563,3772,122,122,0,321,1,8,791
50007002701,6231,5305,195,148,11,284,4,27,926
50007002702,5251,4655,103,64,19,129,0,16,596
50007002800,5104,4623,119,45,6,35,0,25,481
50007002900,6492,5977,105,24,7,44,1,20,515
50007003000,4167,3833,83,19,0,22,0,21,334
50007003101,8002,7044,191,130,8,307,2,39,958
50007003102,2101,1897,32,13,4,47,1,8,204
50007003301,4851,4005,136,63,3,420,0,34,846
50007003304,5983,4944,182,216,6,354,3,28,1039
50007003401,5343,4779,127,49,8,108,3,26,564
50007003402,2374,2167,46,10,1,41,3,10,207
50007003501,3912,3541,94,25,4,26,0,36,371
50007003502,5492,4969,121,23,14,40,4,50,523
50007003503,1963,1800,38,8,5,10,0,20,163
50007003600,4703,3767,204,170,1,334,0,26,936
50007003900,7343,6363,281,127,9,321,0,25,980
50007004002,4755,3941,165,164,7,252,4,17,814
50007004100,2231,1896,94,80,3,73,0,19,335
50007004200,4201,3336,232,175,10,223,0,26,865
50007980000,0,0,0,0,0,0,0,0,0
50009950100,1693,1589,14,4,0,5,1,0,104
50009950200,1157,1091,22,0,1,1,2,4,66
50009950500,3070,2864,31,11,13,10,2,1,206
50011010101,3472,3118,53,10,86,8,0,5,354
50011010102,3499,3225,63,12,27,6,1,12,274
50011010200,4357,3993,98,15,39,26,3,12,364
50011010300,3530,3267,56,16,47,10,1,4,263
50011010400,3317,3082,68,4,16,4,1,3,235
50011010500,6701,5960,69,31,133,15,0,12,741
50011010600,6988,6359,129,70,41,56,3,10,629
50011010700,3523,3032,96,64,41,59,0,10,491
50011010800,3354,2930,84,51,23,44,1,17,424
50011010900,4845,4457,74,17,13,32,5,6,388
50011011000,6360,5816,125,31,17,52,1,29,544
50013020100,3533,3222,61,24,34,14,0,6,311
50013020200,3760,3475,66,25,5,16,0,10,285
50015953000,2382,2214,19,2,17,7,0,14,168
50015953100,3839,3537,92,20,9,7,0,18,302
50015953200,3491,3124,75,50,22,17,0,14,367
50015953300,3020,2795,57,6,11,11,0,14,225
50015953400,2556,2393,30,15,2,14,1,10,163
50015953500,5434,4828,201,57,18,43,0,24,606
50015953600,5223,4694,177,67,9,42,0,27,529
50017959000,2293,2109,29,6,18,33,0,9,184
50017959101,2080,1904,45,8,7,8,0,11,176
50017959102,2654,2423,33,18,9,7,0,4,231
50017959200,3515,3268,62,13,9,11,0,10,247
50017959300,2451,2267,36,14,13,7,1,8,184
50017959400,4774,4350,99,43,18,38,1,13,424
50017959500,4336,3979,51,12,19,11,1,24,357
50017959600,2775,2540,44,15,8,26,0,17,235
50017959700,1609,1477,33,7,4,2,1,3,132
50017959800,2790,2535,45,15,8,17,1,20,255
50019951100,2291,2147,34,8,19,3,0,3,144
50019951200,2753,2561,54,9,12,1,0,4,192
50019951300,1826,1719,20,5,5,6,0,0,107
50019951400,2017,1824,40,23,24,17,0,7,193
50019951500,2438,2188,36,20,23,21,0,6,250
50019951600,4333,3982,63,16,44,20,0,12,351
50019951700,4439,4079,111,23,16,33,0,14,360
50019951800,2872,2616,35,12,35,9,0,3,256
50019951900,2499,2332,46,1,17,4,0,3,167
50019952000,1925,1811,23,10,2,5,1,7,114
50021962100,1741,1606,38,12,1,17,1,5,135
50021962200,4129,3801,55,19,12,24,0,15,328
50021962300,2493,2313,44,8,0,4,0,11,180
50021962400,2862,2540,52,10,11,12,0,7,322
50021962500,1763,1574,19,8,0,1,6,7,189
50021962600,2214,2044,26,22,1,11,0,3,170
50021962700,3924,3637,68,22,24,43,0,4,287
50021962800,3652,3381,74,19,2,42,0,10,271
50021963000,4273,3838,110,55,6,62,3,15,435
50021963100,3195,2825,85,53,15,31,1,9,370
50021963200,2910,2575,81,30,14,19,1,3,335
50021963300,5429,4679,237,70,23,54,2,18,750
50021963400,2412,2245,17,9,0,27,0,5,167
50021963500,1715,1579,25,6,3,8,0,10,136
50021963600,4458,4109,76,83,7,47,0,12,349
50021963700,2736,2509,35,15,9,9,0,8,227
50021963800,4234,3905,73,17,10,20,0,19,329
50021964000,3514,3248,48,17,8,14,0,8,266
50021964200,1494,1378,29,5,0,9,0,1,116
50021964300,1424,1306,33,13,0,4,0,1,118
50023954000,4262,3815,98,35,12,27,1,23,447
50023954100,2589,2387,52,12,4,13,0,6,202
50023954200,2743,2499,49,17,1,14,0,27,244
50023954300,5331,4839,105,41,20,66,7,34,492
50023954400,3166,2896,52,13,7,37,3,18,270
50023954500,2849,2578,70,33,3,27,0,10,271
50023954600,2318,2012,79,24,7,62,0,9,306
50023954700,1640,1453,48,19,0,30,2,9,187
50023954800,2193,1890,72,26,3,79,1,24,303
50023954900,1923,1683,54,18,2,40,3,26,240
50023955000,2598,2381,53,16,1,19,0,7,217
50023955100,4251,3717,156,65,27,27,0,23,534
50023955200,4240,3698,144,70,13,49,1,38,542
50023955300,4100,3778,120,16,8,25,0,16,322
50023955400,3823,3497,97,19,5,27,1,14,326
50023955501,2043,1832,51,7,6,27,0,2,211
50023955502,4553,3918,166,158,10,33,3,14,635
50023955600,1977,1834,46,6,4,7,0,12,143
50023955700,1844,1723,34,7,2,17,1,0,121
50023955800,1364,1274,23,10,0,6,0,7,90
50025967000,2924,2566,82,43,6,27,0,9,358
50025967100,1908,1756,59,9,0,9,1,4,152
50025967200,3305,3062,63,12,8,11,0,28,243
50025967300,1919,1785,38,10,7,11,0,10,134
50025967400,1005,900,23,7,2,4,0,2,105
50025967500,1315,1211,22,11,1,6,1,7,104
50025967600,3016,2701,88,17,12,15,0,27,315
50025967700,2617,2297,87,36,6,37,1,21,320
50025967800,1645,1488,48,8,3,6,0,17,157
50025967900,1798,1659,61,9,2,22,1,6,139
50025968000,2255,2060,76,8,4,15,1,4,195
50025968100,1344,1249,23,3,0,2,0,0,95
50025968200,2493,2183,79,59,5,39,1,24,310
50025968300,1865,1717,41,11,0,9,0,10,148
50025968400,4123,3598,109,62,15,57,0,20,525
50025968500,5601,4697,263,123,16,130,0,35,904
50025968600,2460,2141,61,48,2,69,1,5,319
50025968700,4312,3940,110,19,10,24,1,14,372
50027965000,3612,3192,109,25,7,78,0,29,420
50027965100,2750,2486,40,27,8,31,2,9,264
50027965400,4186,3815,102,18,6,28,0,19,371
50027965501,3677,3349,84,54,8,25,0,16,328
50027965502,2724,2377,68,35,15,66,0,3,347
50027965600,4285,3787,108,48,4,94,1,11,498
50027965700,3446,3172,69,15,15,23,4,12,274
50027965800,3005,2795,81,17,5,15,0,11,210
50027965901,1544,1440,17,5,5,5,0,10,104
50027965902,2031,1890,36,1,5,7,0,23,141
50027966000,3559,3239,60,33,3,15,0,19,320
50027966100,2842,2628,41,10,3,9,0,8,214
50027966200,1621,1479,34,10,6,7,0,8,142
50027966300,2172,1985,44,12,4,19,4,14,187
50027966501,3005,2763,69,4,13,16,0,19,242
50027966502,1191,1120,22,12,0,5,1,4,71
50027966600,5002,4532,91,46,25,61,0,22,470
50027966700,4060,3693,91,62,10,21,3,16,367
50027966800,3041,2795,64,17,2,14,1,25,246
51001090101,1799,1640,46,17,3,12,0,4,159
51001090102,1545,1395,50,11,5,7,0,3,150
51001090201,3990,2921,137,740,13,28,0,14,1069
51001090202,3046,1634,160,1100,11,35,0,11,1412
51001090300,2093,1362,259,343,4,9,0,4,731
51001090401,2455,971,601,814,0,14,0,0,1484
51001090402,3281,1179,809,1190,7,14,0,0,2102
51001090500,2721,1356,472,754,1,31,0,14,1365
51001090600,3900,2810,189,716,10,20,1,6,1090
51001090700,5220,2923,361,1674,10,74,0,30,2297
51001090800,3362,1634,346,1280,1,5,0,13,1728
51001980100,1,0,0,0,0,0,0,0,1
51001980200,0,0,0,0,0,0,0,0,0
51001990100,0,0,0,0,0,0,0,0,0
51001990200,0,0,0,0,0,0,0,0,0
51003010100,5147,4638,148,98,7,55,1,18,509
51003010201,5550,4202,315,485,10,222,3,23,1348
51003010202,3238,2850,138,38,5,50,2,29,388
51003010301,1939,1179,265,184,0,204,0,9,760
51003010302,1450,1119,75,22,0,162,0,10,331
51003010303,5685,4109,414,310,5,514,0,37,1576
51003010401,4201,3392,170,350,6,61,2,33,809
51003010402,3605,3063,132,156,5,85,2,27,542
51003010501,3004,2464,71,121,0,179,1,19,540
51003010502,3371,2328,262,441,0,193,6,24,1043
51003010602,4409,3224,231,451,2,239,1,19,1185
51003010603,2391,1449,304,334,2,140,0,14,942
51003010604,4029,2651,268,591,3,305,3,32,1378
51003010701,2862,1226,436,798,2,256,0,14,1636
51003010702,3763,1887,666,739,6,252,0,25,1876
51003010801,3598,2118,448,586,3,244,1,19,1480
51003010802,2404,1333,430,394,3,101,4,22,1071
51003010901,1746,955,114,115,0,491,0,6,791
51003010904,6163,2055,462,790,2,2698,0,5,4108
51003011000,6612,5758,199,136,5,219,0,34,854
51003011101,2884,2426,111,120,0,95,5,18,458
51003011102,3286,2655,206,68,3,179,1,14,631
51003011103,4608,3996,142,102,1,159,0,19,612
51003011201,4208,3578,190,167,1,41,1,24,630
51003011202,4043,3189,214,225,4,212,0,46,854
51003011301,5127,4314,260,264,4,61,3,12,813
51003011302,5151,2258,1371,712,11,563,5,25,2893
51003011303,3791,2785,213,416,1,182,3,14,1006
51003011400,4130,3134,198,580,5,24,0,13,996
51005070100,3662,3064,62,355,6,9,2,7,598
51005080100,3198,2931,30,134,12,9,4,5,267
51005080201,2790,2502,44,102,0,27,0,3,288
51005080202,2381,2238,21,45,1,6,0,5,143
51005080301,1854,1733,17,38,3,4,1,3,121
51005080302,1338,1286,4,2,0,4,0,1,52
51007930101,2634,1912,109,480,0,6,0,10,722
51007930102,4475,3349,100,822,8,23,0,22,1126
51007930200,6156,4426,216,1244,10,34,0,18,1730
51009010100,5103,4140,130,576,23,17,1,29,963
51009010201,4398,3207,153,750,25,44,1,36,1191
51009010202,2223,1696,67,315,21,2,2,3,527
51009010300,3638,3055,57,276,44,20,2,22,583
51009010401,3356,2392,113,572,32,14,5,12,964
51009010402,3089,2316,36,541,17,32,2,9,773
51009010504,4183,2790,87,947,44,32,3,21,1393
51009010505,1045,690,33,231,4,3,4,1,355
51009010506,1585,1037,83,339,9,11,2,1,548
51009010600,2687,1644,79,799,24,7,3,11,1043
51011040101,3683,2999,81,421,16,6,0,24,684
51011040102,3524,2460,119,760,11,29,0,20,1064
51011040200,4535,3396,76,838,14,3,3,18,1139
51011040300,4377,3300,68,858,9,4,0,22,1077
51013100100,5125,3959,385,63,3,355,0,27,1166
51013100200,6660,5248,493,92,5,366,1,48,1412
51013100300,6199,4973,463,153,1,295,2,39,1226
51013100400,3780,3028,271,33,3,220,0,47,752
51013100500,5029,3864,364,113,6,322,2,24,1165
51013100600,3285,2363,325,155,2,237,3,27,922
51013100700,5827,3905,724,288,7,519,2,28,1922
51013100800,1596,663,325,352,0,155,0,8,933
51013100900,4406,3087,480,214,5,341,0,10,1319
51013101000,3319,2455,344,118,0,203,3,13,864
51013101100,5948,4413,410,145,5,579,0,35,1535
51013101200,3897,2459,723,105,9,322,0,27,1438
51013101300,6940,5012,754,140,2,576,0,32,1928
51013101401,1938,1155,189,161,11,299,2,12,783
51013101402,2878,2082,226,84,7,302,0,9,796
51013101405,2176,1471,133,72,0,390,0,12,705
51013101406,3641,2526,266,122,1,507,4,31,1115
51013101407,3812,2511,272,151,4,637,4,19,1301
51013101408,788,542,72,28,0,84,1,8,246
51013101409,2120,1519,122,49,0,320,1,11,601
51013101501,3136,1964,454,221,4,354,0,12,1172
51013101502,3284,2338,293,80,1,356,1,23,946
51013101503,1793,1394,110,39,2,130,1,10,399
51013101601,1362,913,130,53,0,180,0,10,449
51013101602,1654,913,214,236,1,214,0,6,741
51013101603,4482,2945,376,180,2,747,3,28,1537
51013101701,5507,3311,694,469,8,740,6,28,2196
51013101703,2352,1439,403,126,2,266,1,5,913
51013101704,1990,933,190,144,3,613,2,15,1057
51013101705,4175,2390,497,284,3,760,0,37,1785
51013101801,3399,2485,227,75,2,430,0,15,914
51013101803,4722,3046,625,267,1,533,2,18,1676
51013101804,2215,1052,569,219,3,286,0,13,1163
51013101805,3760,2747,271,98,3,435,0,26,1013
51013101900,3183,2455,173,97,4,223,2,14,728
51013102001,2802,1221,834,234,1,365,1,18,1581
51013102002,1243,724,199,124,3,141,0,3,519
51013102003,4820,1784,1809,630,4,437,0,24,3036
51013102100,2325,1350,314,107,2,423,1,12,975
51013102200,7880,1201,4051,1365,13,941,2,86,6679
51013102301,1734,1036,257,183,3,126,4,25,698
51013102302,4668,2064,1420,552,9,347,0,41,2604
51013102400,3617,2106,654,314,4,328,6,32,1511
51013102500,5291,2513,1179,695,12,620,3,24,2778
51013102600,3688,1469,1117,441,6,483,2,18,2219
51013102701,3579,590,1332,1000,6,520,0,29,2989
51013102702,1912,795,573,223,3,217,0,11,1117
51013102802,1317,913,200,57,0,65,1,2,404
51013102803,2748,962,800,441,6,395,5,15,1786
51013102804,5339,1481,1733,979,5,842,4,29,3858
51013102901,2904,2166,288,157,0,128,0,17,738
51013102903,1625,1227,160,74,0,63,0,11,398
51013102904,3125,1437,730,528,3,230,1,14,1688
51013103000,3390,2697,318,86,0,88,4,22,693
51013103100,6207,1847,1618,1893,11,533,5,36,4360
51013103200,5520,2710,1093,585,11,849,9,37,2810
51013103300,2492,867,357,607,1,522,0,15,1625
51013103401,923,661,75,125,0,7,1,3,262
51013103403,1328,690,184,234,6,134,0,5,638
51013103404,1438,916,131,139,4,169,3,2,522
51013103405,3874,2059,349,470,8,723,9,43,1815
51013103501,3535,1844,430,264,6,806,1,22,1691
51013103503,5102,2613,514,507,7,1134,1,27,2489
51013103504,2571,1364,271,291,1,487,3,7,1207
51013103505,3813,1909,402,619,2,632,1,24,1904
51013103601,2612,1862,285,55,7,215,4,30,750
51013103602,1241,610,135,87,0,336,1,9,631
51013103700,2626,2008,237,76,0,141,1,32,618
51013103800,4964,2394,742,958,4,492,2,39,2570
51013980100,12,3,4,4,0,0,0,0,9
51013980200,0,0,0,0,0,0,0,0,0
51015070100,3973,3014,138,681,8,3,0,2,959
51015070200,3788,3462,193,32,3,8,0,20,326
51015070300,6450,5643,453,90,8,30,1,17,807
51015070400,5436,4851,204,121,11,10,4,18,585
51015070500,5189,4772,89,155,8,15,0,6,417
51015070601,2724,2467,89,73,0,21,0,2,257
51015070602,3646,2767,304,322,9,43,7,13,879
51015070603,4328,3670,120,304,13,64,3,22,658
51015070701,4800,4144,204,245,12,24,0,14,656
51015070702,2250,2012,102,55,4,5,1,8,238
51015070801,2293,2183,27,13,5,11,1,3,110
51015070802,4036,3749,55,93,4,8,0,6,287
51015070900,5176,4672,105,146,5,73,0,13,504
51015071000,5968,5540,83,137,8,11,0,5,428
51015071101,4817,4075,237,252,18,27,0,12,742
51015071102,6333,5775,136,128,1,52,9,12,558
51015071201,2110,1945,47,38,8,16,1,8,165
51015071202,4170,3634,142,187,5,40,0,17,536
51017920101,2112,1987,20,35,0,2,0,2,125
51017920102,2097,1854,53,79,3,15,1,2,243
51019030101,7719,6719,175,398,20,94,3,52,1000
51019030103,7788,6314,347,453,8,355,3,21,1474
51019030104,4450,3691,146,356,1,57,0,14,759
51019030202,6024,5162,99,415,16,85,1,21,862
51019030203,4724,4010,142,230,5,118,2,12,714
51019030204,4365,3774,149,185,10,75,3,14,591
51019030300,3620,3135,60,292,11,7,0,11,485
51019030401,2925,2633,47,132,3,10,1,13,292
51019030403,3347,2936,63,179,12,13,0,19,411
51019030404,3480,2709,60,501,7,13,0,31,771
51019030501,4190,3651,121,256,15,5,1,21,539
51019030503,2439,2265,48,35,3,14,2,9,174
51019030504,2858,2518,72,127,4,20,3,8,340
51019030601,3336,2983,84,113,11,8,4,14,353
51019030602,3610,3278,154,39,9,14,3,11,332
51019030603,2690,2499,58,34,1,7,1,2,191
51019030604,2595,2430,13,31,6,17,0,13,165
51019030605,3161,2908,34,64,13,15,3,9,253
51019050101,2932,1947,76,673,7,13,3,22,985
51019050102,3209,2566,107,351,5,27,0,12,643
51021040100,3646,3363,37,155,0,4,0,1,283
51021040200,2624,2494,23,12,0,0,0,4,130
51023040100,3343,3118,20,87,8,0,0,4,225
51023040200,4219,3938,51,79,4,12,0,20,281
51023040301,3002,2638,59,166,6,28,0,21,364
51023040303,4193,3843,91,97,2,35,0,9,350
51023040304,3908,3655,63,43,5,42,0,4,253
51023040401,2236,2058,37,37,4,4,0,7,178
51023040402,5030,4238,311,195,8,68,3,25,792
51023040501,6360,5830,109,162,4,45,0,12,530
51023040502,1305,1188,35,39,2,0,0,0,117
51025930100,3382,1670,51,1562,15,10,0,5,1712
51025930201,2101,688,70,1297,0,3,0,2,1413
51025930202,1595,322,61,1201,0,3,0,0,1273
51025930203,3848,1056,88,2572,2,12,5,19,2792
51025930301,1604,868,19,686,0,2,0,2,736
51025930302,3319,1853,98,1255,6,12,0,1,1466
51027010100,4401,4152,9,155,0,13,1,0,249
51027010200,2558,2530,15,0,0,0,0,0,28
51027010300,2852,2798,20,1,0,8,0,2,54
51027010400,2032,1938,30,8,2,7,0,2,94
51027010500,1184,1131,10,0,5,0,0,0,53
51027010600,3951,3359,69,446,2,20,0,5,592
51027010700,3377,3302,24,3,6,1,0,1,75
51029930101,3791,2470,75,1020,8,20,0,15,1321
51029930102,2927,1617,45,1127,11,4,0,5,1310
51029930201,5526,3015,163,2213,16,14,0,11,2511
51029930202,4580,3212,130,1030,9,21,0,21,1368
51031020101,5718,4484,128,804,29,26,0,21,1234
51031020102,4635,3758,89,553,13,15,0,17,877
51031020200,5655,4447,257,582,22,80,0,35,1208
51031020300,3938,3250,128,320,3,74,0,30,688
51031020401,5253,3751,439,674,13,120,2,20,1502
51031020402,3422,2722,117,305,9,88,3,5,700
51031020403,6119,4848,242,632,16,105,0,35,1271
51031020500,7065,5628,185,826,31,56,2,21,1437
51031020600,3604,2897,49,519,5,11,1,6,707
51031020700,3378,2130,83,980,3,23,0,13,1248
51031020800,3321,2415,46,718,9,1,0,14,906
51031020900,3588,2554,52,848,16,2,0,24,1034
51033030100,4130,2641,521,697,12,34,4,27,1489
51033030201,2870,1490,156,992,7,47,0,31,1380
51033030202,1812,1215,52,404,41,3,0,5,597
51033030300,3383,2125,185,762,24,57,3,9,1258
51033030400,1854,1201,121,387,9,14,0,13,653
51033030501,4648,2879,292,1008,13,49,1,30,1769
51033030502,6450,4242,425,1259,21,64,7,32,2208
51033030503,2346,1197,96,927,8,11,0,5,1149
51033030600,3394,1851,120,1191,25,17,0,11,1543
51035080100,3656,3425,81,13,4,17,0,2,231
51035080200,4724,4384,173,28,2,18,0,11,340
51035080300,4689,4376,150,20,4,17,0,2,313
51035080401,2797,2478,158,54,2,8,0,11,319
51035080402,2568,2286,189,11,4,3,2,2,282
51035080501,2493,2377,53,6,3,8,0,0,116
51035080502,2180,2086,31,6,0,4,1,3,94
51035080601,1846,1720,51,8,8,2,0,2,126
51035080603,2511,2346,93,3,6,2,0,7,165
51035080604,1691,1562,63,14,2,1,0,2,129
51036600100,2583,1344,30,938,112,19,3,16,1239
51036600200,2180,719,43,991,314,3,1,24,1461
51036600300,2010,934,28,907,15,12,2,10,1076
51037930101,3003,1951,124,766,3,9,2,12,1052
51037930102,2732,1858,37,733,6,2,0,8,874
51037930200,2663,1897,32,637,4,9,0,12,766
51037930300,3131,1971,60,1004,5,3,4,3,1160
51041100106,3138,2505,140,268,3,85,2,9,633
51041100107,2423,681,820,685,1,79,0,28,1742
51041100206,6726,2699,1061,2478,23,103,5,63,4027
51041100208,2616,1723,188,434,4,142,5,19,893
51041100209,6716,3265,984,1855,15,183,2,54,3451
51041100210,2243,653,594,764,3,94,1,7,1590
51041100211,3419,478,863,1851,6,62,3,19,2941
51041100212,4585,647,1505,2153,3,72,2,48,3938
51041100300,2848,811,1175,716,20,41,1,15,2037
51041100403,7006,3547,923,1508,13,662,2,38,3459
51041100404,2532,635,1276,411,17,96,1,12,1897
51041100405,2257,653,1012,503,3,23,0,14,1604
51041100406,1451,277,368,755,0,12,0,11,1174
51041100407,4100,1800,936,1061,18,100,1,16,2300
51041100409,7250,4814,584,1331,20,132,14,37,2436
51041100410,2352,1223,138,833,12,40,2,9,1129
51041100505,5780,3550,411,1385,8,116,1,59,2230
51041100506,6951,2586,1861,1945,19,189,3,60,4365
51041100507,6822,3352,601,2236,19,214,12,31,3470
51041100508,5083,2323,460,1891,28,58,16,33,2760
51041100509,7164,3826,484,2092,8,344,2,35,3338
51041100510,3871,2342,294,911,7,114,0,13,1529
51041100600,4377,704,162,3275,6,83,1,9,3673
51041100701,6209,2370,293,3160,34,34,3,35,3839
51041100702,2118,1026,108,856,5,9,3,20,1092
51041100704,5116,3705,159,921,18,35,0,35,1411
51041100705,2948,2177,113,461,6,30,4,10,771
51041100804,5085,1346,1107,2021,14,411,0,43,3739
51041100805,5369,1361,1409,2250,7,108,1,41,4008
51041100806,4199,506,1966,1487,6,98,0,35,3693
51041100807,2334,707,540,885,7,55,0,30,1627
51041100812,5908,3646,481,1286,10,220,0,35,2262
51041100814,3935,1447,828,1364,15,60,8,33,2488
51041100815,4688,2180,722,1402,22,129,7,34,2508
51041100816,4583,2589,748,922,11,72,4,15,1994
51041100817,3440,1730,438,1014,26,50,2,13,1710
51041100818,4127,1630,422,1703,18,128,0,18,2497
51041100819,7197,1552,1076,4069,17,218,0,46,5645
51041100820,3709,833,749,1770,12,181,6,23,2876
51041100821,4721,3783,193,509,8,71,0,21,938
51041100822,6011,4016,283,1315,16,128,12,23,1995
51041100823,6508,3606,400,2040,11,168,6,40,2902
51041100902,3978,3475,109,142,12,45,0,15,503
51041100907,3145,1800,668,470,0,87,0,8,1345
51041100910,5705,3184,758,1262,14,229,0,46,2521
51041100912,6247,4886,277,520,27,215,1,21,1361
51041100915,4171,2818,342,567,8,209,3,29,1353
51041100919,6942,4204,566,1407,36,319,1,47,2738
51041100920,1766,890,151,511,2,117,0,23,876
51041100921,6425,4324,547,820,3,357,3,46,2101
51041100922,5308,2743,690,1289,18,230,4,55,2565
51041100923,2786,1413,399,707,9,127,0,10,1373
51041100924,5379,4301,178,324,18,310,0,23,1078
51041100926,6819,5612,214,295,1,419,0,20,1207
51041100928,7858,5424,391,904,6,770,6,41,2434
51041100929,6532,5036,267,527,12,380,0,31,1496
51041100930,3412,2923,134,136,6,65,1,9,489
51041100931,5845,4875,209,331,3,178,0,33,970
51041100932,3521,2620,179,358,6,197,0,9,901
51041100933,2473,1362,291,596,10,60,2,6,1111
51041100934,6995,3975,862,1546,22,200,6,36,3020
51041100935,4025,3548,100,67,7,166,0,13,477
51041100936,4038,3542,135,129,4,96,3,35,496
51041100937,4252,3275,243,432,0,80,0,17,977
51041100938,7835,5829,356,515,4,694,2,38,2006
51041101003,11552,8761,574,951,12,635,5,62,2791
51041101004,5020,4162,198,371,19,60,0,7,858
51041101007,6395,5142,286,430,12,196,0,50,1253
51041101008,5749,4475,211,568,4,249,2,43,1274
51041101009,8778,5991,601,1162,7,504,1,45,2787
51041101011,3170,2201,227,478,3,66,1,10,969
51041101012,5575,3546,452,1036,16,184,0,34,2029
51041101013,3754,2799,213,487,9,62,4,10,955
51041101014,2703,1968,146,388,8,69,0,2,735
51041101015,6480,4473,387,990,11,272,0,35,2007
51043010101,4595,3615,308,301,8,101,3,28,980
51043010102,4170,3597,212,70,14,42,4,23,573
51043010200,3118,2547,234,169,8,26,2,10,571
51043010300,2900,2550,133,24,3,41,6,28,350
51045050100,4892,4631,53,11,5,11,3,12,261
51047930101,4385,3250,484,354,3,49,5,29,1135
51047930103,5342,4658,267,130,5,31,3,34,684
51047930104,3207,2415,337,297,5,20,0,3,792
51047930202,6283,4960,380,528,17,50,0,22,1323
51047930203,6844,3868,1285,1076,21,145,6,27,2976
51047930204,1520,1167,113,160,3,25,0,3,353
51047930300,7819,3388,2198,1485,20,192,0,45,4431
51047930400,5143,3754,539,499,15,50,0,16,1389
51047930501,5742,4001,544,879,8,52,6,27,1741
51047930502,6267,3379,1362,1045,13,153,0,27,2888
51049930101,3283,2243,57,775,15,12,2,7,1040
51049930102,2929,1763,107,917,18,11,1,13,1166
51049930200,3463,2098,77,1125,6,13,5,20,1365
51051040100,3910,3780,38,23,3,2,1,0,130
51051040200,2633,2559,9,1,7,1,1,8,74
51051040300,4851,4694,24,20,7,7,0,4,157
51051040400,2730,2658,12,4,5,2,0,0,72
51053840101,2481,1923,63,394,9,0,0,4,558
51053840102,3084,1927,74,917,6,8,0,14,1157
51053840200,4449,3567,121,592,4,22,1,18,882
51053840300,6482,2972,325,2817,18,33,0,36,3510
51053840400,798,436,21,288,4,3,1,2,362
51053840500,3949,1974,399,1377,20,25,1,10,1975
51053840601,3662,2617,76,813,15,10,0,14,1045
51053840602,3042,1930,49,917,15,18,0,4,1112
51053980100,0,0,0,0,0,0,0,0,0
51057950600,3527,1859,106,1378,31,9,0,21,1668
51057950700,3912,1857,131,1648,8,51,1,13,2055
51057950800,3160,2155,132,717,22,2,2,6,1005
51059415100,3633,2214,826,284,7,164,0,16,1419
51059415200,3218,2467,296,168,3,113,3,18,751
51059415300,3908,2088,958,404,4,269,2,13,1820
51059415401,5352,1248,1741,1620,6,447,12,38,4104
51059415402,2801,1743,328,327,2,244,1,13,1058
51059415500,6306,3804,612,1171,14,438,0,29,2502
51059415600,2754,2353,161,24,4,83,4,22,401
51059415700,4187,3524,258,33,0,102,7,20,663
51059415800,5047,4143,339,105,6,137,3,31,904
51059415900,3216,2342,376,134,0,168,6,20,874
51059416000,5569,2223,1368,1243,8,464,3,46,3346
51059416100,4129,3040,345,280,14,239,4,21,1089
51059416200,5201,2927,833,802,9,169,34,30,2274
51059416300,2025,1525,165,86,5,99,1,16,500
51059420100,4106,1084,1187,434,6,1222,0,21,3022
51059420201,3732,1567,527,776,13,642,0,13,2165
51059420202,1943,823,205,591,5,203,1,6,1120
51059420203,2718,1488,308,400,3,309,5,16,1230
51059420300,6184,3366,1283,506,12,629,2,45,2818
51059420400,3835,1819,609,723,6,470,5,20,2016
51059420501,980,630,89,106,2,107,0,3,350
51059420502,2516,1435,434,337,5,142,3,21,1081
51059420503,3505,1153,915,676,2,535,2,28,2352
51059420600,4911,1998,1543,785,7,342,4,40,2913
51059420700,4241,2272,847,375,3,469,0,29,1969
51059420800,3640,1773,1059,288,5,324,0,33,1867
51059421001,2855,1051,520,509,7,568,9,17,1804
51059421002,5348,1763,1143,1026,3,1124,2,48,3585
51059421101,5912,2636,782,1146,17,911,21,31,3276
51059421102,3514,1648,418,727,0,459,2,26,1866
51059421103,5913,3023,652,1008,10,808,3,31,2890
51059421200,2024,1491,177,134,4,101,0,2,533
51059421300,3658,2006,555,512,6,324,4,37,1652
51059421400,8188,1447,3780,1952,7,713,10,46,6741
51059421500,7103,795,3840,1675,10,585,0,21,6308
51059421600,6409,493,2992,2318,8,444,0,18,5916
51059421701,4517,452,2348,1137,3,406,0,29,4065
51059421702,4000,1079,1394,913,5,418,8,19,2921
51059421800,5933,1187,1757,1970,16,722,14,42,4746
51059421900,2916,1434,517,516,10,124,39,10,1482
51059422000,3979,1649,636,916,12,543,2,33,2330
51059422101,6872,1663,1475,2186,7,1165,9,29,5209
51059422102,6677,1331,1313,2457,10,1225,4,51,5346
51059422201,4071,1488,331,635,4,1247,11,17,2583
51059422202,6444,1466,747,2075,0,1675,27,49,4978
51059422301,3133,1464,462,542,0,459,7,15,1669
51059422302,5788,2720,696,999,8,960,7,43,3068
51059422401,2447,1139,315,569,4,246,4,21,1308
51059422402,5236,2395,713,1176,9,534,13,37,2841
51059422403,3024,1766,364,353,8,325,4,25,1258
51059430101,4718,3164,461,155,7,622,6,30,1554
51059430102,3117,1466,405,271,2,769,1,21,1651
51059430201,4379,2515,544,243,3,835,4,25,1864
51059430202,4949,2801,604,252,6,984,3,36,2148
51059430203,2679,1630,256,122,6,494,1,22,1049
51059430400,7217,3676,1285,291,17,1489,12,49,3541
51059430500,1716,795,307,91,0,413,0,20,921
51059430600,7152,1120,3590,358,7,1891,1,32,6032
51059430700,2923,1082,843,120,2,766,0,16,1841
51059430801,4629,2502,747,299,11,735,2,41,2127
51059430802,4276,2205,798,372,8,647,4,39,2071
51059430901,4326,1534,806,615,18,1048,4,32,2792
51059430902,3415,1488,730,220,1,843,1,3,1927
51059431001,4948,2081,980,390,4,1167,6,35,2867
51059431002,2368,763,447,449,1,569,0,20,1605
51059431300,4419,2712,452,261,7,642,0,34,1707
51059431400,4405,2223,616,415,0,822,3,28,2182
51059431500,5733,3400,668,517,9,750,4,28,2333
51059431601,1908,1574,222,14,4,76,0,2,334
51059431602,6485,1776,1304,784,6,2265,4,35,4709
51059431801,4263,1868,949,304,9,850,1,39,2395
51059431802,3259,1638,597,167,3,681,2,26,1621
51059431900,3173,1990,394,119,4,491,1,4,1183
51059432000,3393,1768,474,250,9,613,3,20,1625
51059432100,3573,2204,500,197,6,422,2,37,1369
51059432201,2393,1064,515,213,2,466,0,1,1329
51059432202,4741,2809,648,233,0,769,5,26,1932
51059432300,5127,2999,600,269,1,924,6,28,2128
51059432401,3615,2411,270,128,3,560,1,16,1204
51059432402,5100,3142,514,349,4,753,3,35,1958
51059432500,5758,3719,476,459,15,688,7,21,2039
51059432600,4967,2671,477,551,7,878,5,28,2296
51059432701,3132,1678,411,337,0,481,3,25,1454
51059432702,4502,1590,1022,767,11,849,3,36,2912
51059432800,2225,828,356,465,4,414,3,4,1397
51059440100,7503,4436,708,279,14,1579,1,39,3067
51059440201,4133,1804,743,334,11,956,4,28,2329
51059440202,6032,2322,1370,476,7,1477,4,52,3710
51059440300,2765,1842,189,64,6,429,0,19,923
51059440501,5006,2911,483,163,2,1177,3,27,2095
51059440503,6817,2402,1124,1984,58,948,0,9,4415
51059440504,643,227,109,267,1,27,0,1,416
51059440505,1346,784,84,63,1,324,0,9,562
51059440600,3002,1351,650,139,25,640,0,28,1651
51059440701,2895,1869,158,72,1,573,2,25,1026
51059440702,5397,3394,444,217,6,1028,1,38,2003
51059440800,6397,3827,629,166,3,1445,0,31,2570
51059450100,5524,2101,1603,212,11,1334,1,56,3423
51059450200,4330,1328,2082,251,0,524,1,20,3002
51059450300,5620,2545,1670,369,6,738,3,46,3075
51059450400,2726,1496,509,132,4,410,0,23,1230
51059450500,3065,908,1298,48,2,713,2,17,2157
51059450601,4192,2074,783,83,12,1013,0,16,2118
51059450602,4814,1359,2224,179,13,887,4,37,3455
51059450701,3055,1311,489,160,0,941,1,18,1744
51059450702,4568,766,2477,483,5,680,0,25,3802
51059450800,3483,1308,791,148,4,1052,5,21,2175
51059450900,1704,1003,311,42,3,251,1,10,701
51059451000,2707,1486,517,136,3,455,0,7,1221
51059451100,2314,1403,508,89,1,195,1,8,911
51059451200,1721,1289,187,19,8,124,0,6,432
51059451300,2491,1556,366,110,2,323,3,21,935
51059451400,3263,474,1837,156,0,707,2,15,2789
51059451501,5868,1555,2370,588,6,1089,3,44,4313
51059451502,4924,1720,1662,658,8,682,2,37,3204
51059451601,6129,385,5111,130,5,387,0,55,5744
51059451602,2885,1136,639,451,9,499,1,15,1749
51059451800,3485,1340,1065,240,6,688,4,23,2145
51059451900,6015,2233,1288,1063,4,1079,1,38,3782
51059452000,3061,1181,512,329,4,909,0,12,1880
51059452101,5091,1838,1076,669,7,1212,1,30,3253
51059452102,3354,1165,842,274,4,902,0,11,2189
51059452200,6982,1318,2410,1031,8,1949,4,21,5664
51059452301,3568,631,1131,357,5,1325,3,9,2937
51059452302,5762,629,3885,264,2,833,0,34,5133
51059452400,7283,2373,2243,461,2,1880,2,57,4910
51059452501,3912,1556,832,306,9,992,4,34,2356
51059452502,5011,762,1654,1556,0,842,2,37,4249
51059452600,6347,1909,1370,1702,8,1010,8,40,4438
51059452700,5398,1386,1687,1359,14,734,0,17,4012
51059452801,5627,2141,921,1131,13,1057,0,47,3486
51059452802,3030,1473,229,743,2,349,2,36,1557
51059460100,4544,2600,215,84,0,1339,3,32,1944
51059460200,3970,2940,225,58,1,466,0,25,1030
51059460300,2896,2104,154,23,0,433,0,24,792
51059460400,5134,2860,348,178,4,1438,0,45,2274
51059460501,2691,1500,186,76,0,757,1,23,1191
51059460503,3778,1866,296,225,1,1149,2,27,1912
51059460504,3979,2066,230,265,2,1148,1,34,1913
51059460600,4173,2687,353,108,8,745,0,13,1486
51059460701,3501,1769,852,81,6,584,4,29,1732
51059460702,4649,3061,375,117,3,795,6,27,1588
51059460800,3162,2146,258,44,5,494,1,20,1016
51059460900,2631,1802,216,36,2,434,0,9,829
51059461000,2530,1673,195,123,2,365,2,23,857
51059461100,7442,4613,885,190,1,1243,0,59,2829
51059461201,4633,3279,254,90,2,692,0,26,1354
51059461202,6502,2496,473,651,1,2497,3,29,4006
51059461500,6940,3716,545,302,3,1891,10,45,3224
51059461603,5056,2214,459,332,3,1755,3,31,2842
51059461604,2520,1229,236,115,5,777,1,8,1291
51059461605,3829,1950,325,272,8,1014,1,19,1879
51059461606,3069,968,590,148,2,1216,0,21,2101
51059461700,6937,2398,1199,465,11,2423,6,20,4539
51059461801,1385,632,230,113,0,317,0,7,753
51059461802,5448,2612,637,386,7,1447,5,38,2836
51059461901,3756,1282,640,417,3,1222,2,10,2474
51059461902,1839,331,850,219,1,375,1,16,1508
51059470100,2769,1865,176,27,1,519,0,5,904
51059470300,3418,2558,265,62,3,321,0,26,860
51059470400,4994,3543,337,100,2,700,0,47,1451
51059470500,5717,3644,337,114,3,1283,0,37,2073
51059470600,2849,1802,181,53,0,660,0,12,1047
51059470700,5753,3481,361,130,5,1359,7,42,2272
51059470800,3255,1886,221,65,8,852,4,23,1369
51059470900,7993,5430,443,92,3,1534,1,52,2563
51059471000,2247,1327,167,59,3,525,0,14,920
51059471100,7030,3476,1219,223,10,1660,1,58,3554
51059471201,3050,1224,325,163,1,1203,0,14,1826
51059471203,2420,1150,263,200,0,678,0,21,1270
51059471204,2692,1093,370,233,0,857,1,15,1599
51059471301,3973,1228,968,251,6,1348,1,24,2745
51059471303,4153,1974,624,175,3,1126,0,30,2179
51059471304,2073,1390,181,75,0,222,7,6,683
51059471401,3759,1786,856,145,9,724,1,44,1973
51059471402,3550,1328,995,295,4,782,3,17,2222
51059480100,4399,3295,206,70,9,514,2,28,1104
51059480201,4646,2908,209,81,2,1158,2,37,1738
51059480203,2828,1557,201,140,4,761,1,20,1271
51059480204,3823,1761,298,230,0,1329,1,22,2062
51059480205,3268,1559,222,243,1,1062,3,29,1709
51059480301,3145,1896,147,65,2,822,2,32,1249
51059480302,4621,2788,225,167,0,1171,1,28,1833
51059480401,4717,2993,239,89,2,1095,0,17,1724
51059480402,6028,3841,350,141,8,1357,1,39,2187
51059480501,3537,2234,298,139,0,693,0,29,1303
51059480502,5763,3805,549,265,5,756,8,41,1958
51059480503,3259,2127,314,142,0,434,2,20,1132
51059480504,2017,1499,135,114,4,147,0,12,518
51059480505,3263,2227,294,141,1,390,1,17,1036
51059480801,5388,2049,2027,438,15,626,0,29,3339
51059480802,3910,1721,690,271,6,1039,0,30,2189
51059480901,6969,1882,3251,481,9,1089,3,44,5087
51059480902,4211,1475,1491,495,4,553,0,26,2736
51059480903,4177,898,1788,334,9,1013,2,29,3279
51059481000,6231,1106,2696,767,8,1432,1,33,5125
51059481101,2376,699,190,222,1,1174,2,10,1677
51059481102,3656,946,292,286,8,1955,0,39,2710
51059481103,3664,506,521,752,7,1760,0,14,3158
51059481104,2948,618,193,373,7,1651,0,17,2330
51059481105,5332,2519,305,211,5,1993,3,36,2813
51059481106,5362,3393,345,180,3,1054,0,32,1969
51059481201,1156,666,83,105,4,226,1,1,490
51059481202,6301,1920,2040,1132,9,899,0,45,4381
51059481400,6647,4427,588,401,8,737,2,66,2220
51059481500,2289,1738,142,74,1,193,0,18,551
51059481600,3480,2592,241,40,0,399,3,23,888
51059481701,6196,4395,305,101,2,1035,0,38,1801
51059481702,4787,2251,517,287,6,1434,1,16,2536
51059481900,5821,3455,500,671,1,840,8,37,2366
51059482001,4874,3373,326,197,3,624,3,43,1501
51059482002,3545,2629,229,189,3,285,0,14,916
51059482100,3258,1861,542,355,5,269,3,24,1397
51059482201,2481,1043,682,337,4,274,2,16,1438
51059482203,4695,3299,346,294,7,509,0,30,1396
51059482204,1975,1361,133,120,2,258,4,7,614
51059482205,2622,1413,324,277,2,444,1,28,1209
51059482206,1154,663,97,85,3,231,0,3,491
51059482301,5387,3643,513,325,3,519,2,49,1744
51059482302,4625,1385,1524,887,4,519,2,21,3240
51059482303,3617,2651,283,138,1,268,0,28,966
51059482400,2344,1714,159,42,0,313,0,2,630
51059482502,3090,1803,245,97,0,783,2,4,1287
51059482503,4832,2464,256,157,1,1734,2,25,2368
51059482504,5277,3142,309,116,2,1499,2,18,2135
51059482505,3528,1120,122,248,8,1874,0,16,2408
51059482506,5298,1601,624,1409,7,1396,2,23,3697
51059482507,3656,913,435,576,13,1566,2,7,2743
51059482601,7321,3375,637,308,8,2589,0,53,3946
51059482603,3501,1664,251,189,1,1194,0,22,1837
51059482604,4210,1526,160,223,2,2120,0,17,2684
51059490101,5064,2760,458,406,19,1109,0,32,2304
51059490104,3504,1355,1557,121,8,316,2,22,2149
51059490105,2761,1532,420,137,5,512,1,8,1229
51059490501,3326,1316,552,234,2,1055,9,23,2010
51059490502,6585,3627,422,225,4,1875,1,44,2958
51059491000,2206,1405,125,108,3,459,0,18,801
51059491101,3765,2481,243,134,0,657,0,32,1284
51059491102,3422,2136,438,127,4,535,0,15,1286
51059491103,6548,2267,1807,608,18,1469,7,42,4281
51059491201,6558,2358,1357,685,14,1759,16,43,4200
51059491202,2102,804,543,221,3,436,0,12,1298
51059491301,6797,2476,1181,718,6,1989,6,36,4321
51059491302,3405,1458,441,282,9,1007,2,20,1947
51059491303,4269,963,1431,444,12,1203,2,26,3306
51059491401,4934,1809,844,312,6,1654,4,31,3125
51059491402,4323,1512,749,304,4,1508,1,17,2811
51059491403,3711,2510,282,107,5,583,4,21,1201
51059491404,4006,1684,590,347,4,1188,2,6,2322
51059491405,2761,1816,178,86,0,464,6,9,945
51059491501,7696,1757,494,476,7,4607,6,45,5939
51059491502,7014,3417,367,247,10,2645,3,51,3597
51059491601,5421,1393,1338,536,8,1914,2,32,4028
51059491602,5310,1840,1268,272,4,1693,1,39,3470
51059491701,4127,1921,389,370,0,1142,7,18,2206
51059491703,5035,2429,636,691,10,964,7,33,2606
51059491704,5062,1960,521,585,4,1656,7,20,3102
51059491705,3341,990,193,196,0,1773,0,28,2351
51059491706,2899,1314,403,411,4,569,2,13,1585
51059491707,4568,1923,558,609,4,1198,1,23,2645
51059491801,2324,993,243,245,0,698,1,23,1331
51059491802,2915,1500,289,224,7,696,0,23,1415
51059491803,7003,3492,806,389,3,1932,4,45,3511
51059492000,6550,4653,407,219,5,820,4,43,1897
51059492100,6592,4966,307,177,5,744,1,29,1626
51059492201,3097,2034,229,190,3,479,0,13,1063
51059492202,6831,4421,455,500,6,992,3,19,2410
51059492203,4014,2597,290,265,2,554,0,19,1417
51059492300,3402,1690,606,281,3,558,12,29,1712
51059492400,4873,2058,908,667,3,910,7,27,2815
51059492500,4139,3188,226,57,10,453,7,18,951
51059980100,9,0,2,0,0,5,0,0,9
51059980200,0,0,0,0,0,0,0,0,0
51059980300,0,0,0,0,0,0,0,0,0
51061930101,3182,2088,647,263,1,21,0,8,1094
51061930102,2744,2170,362,83,4,32,0,18,574
51061930203,2703,2170,213,185,13,25,0,11,533
51061930204,3468,2963,151,149,8,37,7,14,505
51061930205,1847,1544,80,134,0,10,0,12,303
51061930206,2220,1837,124,93,4,32,0,8,383
51061930207,1734,1334,146,121,3,24,1,7,400
51061930303,3797,3014,277,244,9,67,2,19,783
51061930304,2564,2220,128,51,2,39,3,3,344
51061930305,4677,3420,402,514,7,104,2,20,1257
51061930306,2900,2201,277,162,2,108,0,11,699
51061930401,7315,5797,591,348,8,183,7,32,1518
51061930402,6027,4955,369,244,13,98,9,46,1072
51061930404,2758,2093,295,154,6,49,2,21,665
51061930405,4932,3497,452,507,8,154,7,38,1435
51061930703,2541,2130,149,99,5,5,0,6,411
51061930704,3920,3071,353,251,12,52,5,19,849
51061930705,3988,2655,556,448,7,80,0,7,1333
51061930706,6071,3466,1600,596,10,42,1,16,2605
51061930707,3584,2344,621,353,6,42,3,23,1240
51063920102,3739,3404,117,101,2,3,0,7,335
51063920103,3687,3387,73,30,3,12,0,21,300
51063920104,2753,2399,147,80,1,15,0,21,354
51063920201,3222,3015,70,12,11,8,0,18,207
51063920202,2075,1909,80,11,1,8,0,5,166
51065020101,6345,4558,347,1079,23,67,0,29,1787
51065020103,3260,2768,129,165,2,31,0,18,492
51065020104,6276,5076,288,464,12,53,0,35,1200
51065020200,5580,3694,185,1318,19,32,7,32,1886
51065020300,5788,4664,158,643,12,29,0,41,1124
51067020102,2721,2411,78,114,7,11,0,7,310
51067020103,2323,2130,41,38,3,4,0,9,193
51067020104,3092,2932,42,17,7,17,0,3,160
51067020200,5173,4398,220,347,10,12,0,2,775
51067020301,2798,2528,60,68,0,11,0,17,270
51067020302,3559,3213,82,109,6,26,0,11,346
51067020400,5271,4620,212,187,4,25,1,16,651
51067020501,3892,3412,130,187,9,17,0,8,480
51067020502,4245,3850,147,72,0,13,0,12,395
51067020600,3295,2879,152,120,9,40,12,8,416
51067020701,2975,2586,98,138,7,11,3,5,389
51067020702,2368,2043,55,185,3,8,0,3,325
51067020801,3168,2168,113,681,3,35,2,14,1000
51067020802,3400,2283,228,692,6,59,2,11,1117
51067020901,3226,2303,236,546,1,8,0,12,923
51067020902,2971,2462,61,347,0,6,0,15,509
51069050100,6758,5524,506,241,9,167,3,11,1234
51069050200,4044,3710,96,65,0,18,0,17,334
51069050300,6345,5804,196,82,11,32,3,20,541
51069050401,4490,3949,225,49,7,43,0,21,541
51069050402,2826,2577,90,20,3,12,3,32,249
51069050500,5328,4763,286,63,3,41,0,20,565
51069050600,4699,3947,288,143,5,68,9,16,752
51069050700,2974,2527,199,90,3,11,0,21,447
51069050801,6689,4867,1117,255,15,125,0,22,1822
51069050804,5133,3957,533,278,5,83,7,20,1176
51069050805,3051,2379,226,137,8,110,1,17,672
51069050806,3812,3089,302,158,6,89,3,9,723
51069050807,3885,2992,367,197,5,74,0,38,893
51069050900,5000,3596,771,286,10,96,1,27,1404
51069051001,4203,3211,456,185,8,148,0,24,992
51069051002,5821,3799,1137,437,9,127,2,18,2022
51069051102,7547,4384,2263,485,6,112,1,25,3163
51069051103,4889,3648,598,262,4,131,5,27,1241
51069051104,3925,3016,334,172,3,174,1,17,909
51071930100,2057,1935,29,11,2,4,0,2,122
51071930200,3718,3425,59,96,8,5,0,6,293
51071930300,5503,5134,73,55,10,47,0,9,369
51071930400,5509,5179,83,76,8,13,0,2,330
51073100101,2987,2476,94,218,20,16,3,4,511
51073100102,4655,3719,171,366,26,30,0,33,936
51073100201,6078,4876,225,556,21,49,4,11,1202
51073100202,3735,3033,124,287,16,29,5,29,702
51073100203,4239,3581,134,313,14,22,1,9,658
51073100301,5756,4821,224,372,12,73,3,3,935
51073100302,5728,4648,258,421,10,42,3,29,1080
51073100400,1469,1239,52,75,3,11,2,16,230
51073100500,4064,3581,128,98,7,33,0,9,483
51075400101,4468,3714,144,200,6,233,0,15,754
51075400102,4072,3333,142,301,11,144,0,22,739
51075400200,4682,3660,254,576,10,30,0,42,1022
51075400300,886,653,28,195,0,2,0,2,233
51075400400,6141,4469,174,1143,22,58,3,39,1672
51075400500,4478,3252,120,837,9,26,0,26,1226
51077060101,2796,2544,87,62,0,9,0,13,252
51077060102,3904,3551,151,87,2,5,0,4,353
51077060201,3862,2972,169,624,11,4,0,4,890
51077060202,2975,2603,155,110,9,4,2,9,372
51077060300,1796,1726,34,4,4,2,0,0,70
51079030101,4070,3333,185,331,2,28,0,16,737
51079030102,5437,4794,173,210,2,23,0,14,643
51079030201,7563,5265,792,651,12,363,4,53,2298
51079030202,3482,2822,180,250,10,42,0,9,660
51081880101,4117,1669,74,2198,15,32,0,5,2448
51081880102,3099,1031,138,1911,0,0,0,0,2068
51081880200,4175,1517,64,2507,4,0,0,8,2658
51083930100,2701,1628,41,947,6,4,0,16,1073
51083930202,2370,1091,44,1158,2,10,0,4,1279
51083930203,2643,1705,17,840,4,1,0,2,938
51083930204,2076,1363,21,615,9,1,0,6,713
51083930301,2416,1553,45,731,6,5,1,0,863
51083930302,4380,3010,116,1122,13,11,1,0,1370
51083930400,3511,2787,80,505,15,14,0,13,724
51083930500,3921,2668,121,934,8,43,0,28,1253
51083930601,2628,1152,43,1317,3,30,1,6,1476
51083930602,3033,1403,57,1491,4,17,0,18,1630
51083930800,4343,1890,175,2078,7,82,0,19,2453
51085320100,6343,5350,145,516,14,26,0,44,993
51085320200,5870,4818,131,635,20,28,0,30,1052
51085320300,4216,3583,91,307,6,74,0,14,633
51085320400,5120,3939,426,402,15,123,0,17,1181
51085320500,3198,2856,40,149,7,35,0,10,342
51085320601,4617,3022,222,1067,15,83,3,18,1595
51085320602,3256,1949,591,467,8,35,0,27,1307
51085320701,4639,3819,111,419,8,83,0,13,820
51085320702,3237,2615,65,376,5,25,3,12,622
51085320801,2618,2115,60,306,2,33,0,27,503
51085320803,7091,5795,177,459,5,271,0,30,1296
51085320804,5623,4625,146,357,8,170,0,15,998
51085320805,3421,2833,88,230,8,96,0,11,588
51085320901,6244,5001,213,406,13,257,5,89,1243
51085320902,2921,2457,83,226,10,43,0,5,464
51085321001,3651,3082,133,256,4,42,0,15,569
51085321003,2615,1995,111,321,5,50,0,16,620
51085321004,5117,4238,179,316,11,107,2,39,879
51085321100,5938,5010,181,359,29,108,0,15,928
51085321201,4505,3666,184,304,22,75,6,12,839
51085321202,4114,2801,218,797,18,43,7,11,1313
51085321300,6881,5500,182,646,36,156,3,21,1381
51085321401,2337,2077,43,109,4,17,2,0,260
51085321402,3407,3063,50,117,17,27,1,13,344
51085321403,3000,2660,68,131,21,14,0,6,340
51087200106,4780,2824,775,583,0,336,0,41,1956
51087200108,2960,2638,79,20,1,119,0,7,322
51087200109,4007,3729,58,43,7,72,0,12,278
51087200122,4879,3597,255,232,7,526,1,21,1282
51087200123,2982,1646,277,718,2,126,0,26,1336
51087200124,4359,3483,196,304,2,177,0,18,876
51087200125,4139,1215,262,1184,11,1273,1,37,2924
51087200126,3961,1331,380,863,7,1180,3,24,2630
51087200127,5988,4767,240,306,13,410,0,21,1221
51087200131,1978,1278,176,199,5,203,1,35,700
51087200132,3436,2367,338,343,5,185,0,33,1069
51087200133,3182,1941,198,634,1,224,0,40,1241
51087200134,5093,4003,295,397,7,172,0,32,1090
51087200135,2316,1807,82,192,2,102,0,9,509
51087200136,3099,2311,260,282,1,126,0,9,788
51087200137,2107,1540,96,280,2,74,0,11,567
51087200138,3710,3011,181,260,4,109,0,20,699
51087200139,4399,3419,173,344,6,240,0,21,980
51087200140,5023,3189,218,380,8,991,3,31,1834
51087200141,2779,1671,127,144,6,756,1,5,1108
51087200142,4462,3148,180,189,7,764,0,18,1314
51087200143,2692,2014,98,105,2,329,1,17,678
51087200144,3257,1394,153,336,8,1195,0,30,1863
51087200145,4333,3104,164,110,6,769,0,30,1229
51087200146,3036,2093,76,206,2,547,0,20,943
51087200147,6631,3187,287,406,15,2409,0,43,3444
51087200148,5313,1936,183,378,14,2566,3,24,3377
51087200149,5606,2586,193,395,15,2227,4,25,3020
51087200150,4815,2151,154,341,8,1942,5,15,2664
51087200151,5631,3135,397,838,13,946,0,31,2496
51087200152,2721,1948,186,269,12,179,2,13,773
51087200153,4458,1835,868,869,3,593,5,24,2623
51087200201,2737,2312,123,97,0,72,0,18,425
51087200202,4162,3874,102,12,1,37,0,23,288
51087200301,1526,1312,43,92,1,29,0,6,214
51087200302,3190,2427,297,126,6,150,1,34,763
51087200303,3487,2297,411,336,9,256,2,14,1190
51087200305,4316,2207,657,462,28,673,0,33,2109
51087200404,2991,1367,493,727,12,239,4,29,1624
51087200407,4738,2474,480,786,20,659,1,46,2264
51087200409,2576,944,410,838,0,254,10,15,1632
51087200411,5634,2138,716,1707,16,649,8,79,3496
51087200412,2086,635,527,664,6,160,0,10,1451
51087200413,4864,3353,218,464,1,590,0,15,1511
51087200414,6170,3571,439,723,8,1086,5,43,2599
51087200415,4257,2434,151,773,13,684,0,26,1823
51087200416,6399,4426,246,1032,12,400,0,23,1973
51087200417,2211,827,420,748,3,114,0,7,1384
51087200418,3113,762,869,985,7,336,0,27,2351
51087200501,2518,1276,462,328,5,313,4,18,1242
51087200502,2098,1484,241,177,15,86,0,8,614
51087200503,4073,2528,424,701,21,208,0,26,1545
51087200600,5056,3353,613,651,25,152,3,16,1703
51087200700,3685,2395,177,898,9,57,0,9,1290
51087200801,3364,1720,243,1072,13,143,3,14,1644
51087200802,2192,1094,183,698,12,115,0,8,1098
51087200805,3533,195,94,3091,9,18,0,28,3338
51087200806,1513,192,81,1134,3,25,1,0,1321
51087200807,4440,556,299,3255,8,67,2,28,3884
51087200904,6185,2222,262,3179,20,209,2,23,3963
51087200905,5877,1990,394,2437,14,680,0,37,3887
51087200906,4888,2894,347,930,16,430,0,34,1994
51087200907,4619,2162,246,1421,8,486,4,18,2457
51087200908,2975,1381,261,987,12,168,16,15,1594
51087201001,6162,681,191,4941,19,80,2,40,5481
51087201002,2961,394,93,2304,9,25,1,11,2567
51087201003,6008,251,166,5334,19,38,0,21,5757
51087201102,4231,986,170,2847,17,31,2,35,3245
51087201103,3580,190,272,2947,12,22,0,11,3390
51087201104,3561,571,126,2677,11,33,0,24,2990
51087201203,3090,633,111,2207,7,10,6,13,2457
51087201204,3926,1636,157,1915,14,23,0,22,2290
51087201205,3608,847,157,2418,19,25,0,17,2761
51087201206,2892,155,81,2555,11,5,0,19,2737
51087201403,5932,1974,564,3071,25,47,6,33,3958
51087201404,4320,3037,123,898,25,38,0,19,1283
51087201405,1481,65,33,1320,4,17,0,2,1416
51087201406,3906,948,399,2292,19,85,0,19,2958
51087201502,5537,2235,153,2774,41,48,2,55,3302
51087201503,6334,854,175,5020,17,38,0,42,5480
51087201504,4489,808,181,3257,12,37,8,30,3681
51087201601,3364,2196,70,878,26,22,0,31,1168
51087201602,5565,2992,180,2006,27,91,3,20,2573
51087201701,3837,2477,149,990,19,48,1,18,1360
51087980100,0,0,0,0,0,0,0,0,0
51089010100,3855,2428,583,654,2,28,1,10,1427
51089010200,5114,3259,380,1170,5,55,0,34,1855
51089010300,5223,2974,208,1816,10,41,1,11,2249
51089010400,3618,1942,383,1156,3,29,0,12,1676
51089010500,3853,2567,287,828,18,10,0,8,1286
51089010601,2713,1769,185,617,0,22,0,9,944
51089010602,3891,2747,240,718,4,23,0,4,1144
51089010700,3345,2298,96,810,8,8,0,16,1047
51089010800,2384,1135,100,1046,5,8,0,5,1249
51089010900,2515,1919,72,447,3,8,2,5,596
51089011000,4656,3555,190,759,1,12,0,15,1101
51089011100,2613,2078,173,225,4,15,2,0,535
51089011200,3293,2664,254,208,2,9,0,18,629
51089011300,3875,2972,150,608,3,16,0,6,903
51091970100,2232,2132,35,2,1,6,1,8,100
51093280101,3771,2468,45,1054,31,21,2,11,1303
51093280104,4439,3604,130,484,9,30,8,17,835
51093280105,4925,2553,175,1882,10,52,9,17,2372
51093280106,3049,1956,133,718,15,59,0,21,1093
51093280107,4571,3364,190,716,14,51,0,26,1207
51093280108,4678,2857,249,1131,16,105,7,24,1821
51093280200,3780,2657,48,878,10,15,5,22,1123
51093280300,5481,4055,157,928,30,39,0,46,1426
51093280400,3912,2896,72,788,4,19,0,18,1016
51095080102,4163,1483,867,1524,16,33,1,30,2680
51095080103,3229,2199,358,430,5,85,3,13,1030
51095080104,2449,2204,68,50,2,68,0,4,245
51095080202,5907,4487,402,546,10,154,0,27,1420
51095080203,3750,2985,146,274,7,143,3,27,765
51095080205,4436,2707,359,930,10,186,7,23,1729
51095080207,4067,3192,141,484,2,67,4,22,875
51095080208,3467,2922,147,146,5,72,0,11,545
51095080209,3434,2619,187,263,7,193,1,23,815
51095080304,6323,5306,361,192,6,194,0,7,1017
51095080305,5418,3128,429,1201,9,291,6,39,2290
51095080306,4073,2745,217,776,20,101,0,10,1328
51095080307,4624,3713,245,244,4,207,3,20,911
51095080308,4675,3612,271,373,11,124,7,24,1063
51095080402,10117,7149,604,1556,15,214,7,50,2968
51095080403,3792,2741,229,457,24,55,3,11,1051
51095080404,4330,3455,168,386,12,67,3,20,875
51097950400,3710,2356,78,1043,65,10,2,11,1354
51097950500,2898,2104,104,518,17,13,1,8,794
51099040100,5692,3619,430,1039,31,149,2,40,2073
51099040200,4377,3249,228,548,24,54,2,19,1128
51099040301,4933,3541,317,646,20,57,5,16,1392
51099040302,3077,2234,180,311,32,35,2,25,843
51099040400,5459,3650,288,985,16,85,2,36,1809
51099040500,3185,2416,139,390,30,21,0,11,769
51101950101,5043,3817,153,761,57,23,6,23,1226
51101950102,6702,5293,157,844,63,33,2,31,1409
51101950200,2556,1743,56,523,132,3,0,10,813
51101950300,3509,2646,110,457,25,70,1,12,863
51103030100,3264,2052,36,1057,3,11,0,10,1212
51103030200,3901,2413,42,1301,3,38,1,16,1488
51103030301,1997,1523,27,348,4,17,0,10,474
51103030302,1757,1453,20,240,4,11,0,3,304
51103990100,0,0,0,0,0,0,0,0,0
51105950100,2679,2577,9,6,4,8,0,0,102
51105950200,3655,3488,22,6,9,6,0,6,167
51105950301,1615,1550,8,13,2,8,0,2,65
51105950302,3266,2037,337,821,34,11,0,2,1229
51105950400,2910,2780,23,8,2,6,0,11,130
51105950500,4381,4217,42,8,6,0,0,3,164
51105950600,3667,3544,35,6,12,0,0,9,123
51107610101,5055,4074,387,155,12,121,1,19,981
51107610102,3866,3181,197,117,9,95,5,25,685
51107610201,6225,5017,463,179,5,203,0,30,1208
51107610202,5624,4482,488,174,2,152,0,16,1142
51107610300,8911,6570,900,414,12,466,0,58,2341
51107610400,4695,3714,431,178,3,130,4,26,981
51107610503,8097,4683,891,683,6,1238,2,59,3414
51107610504,7094,4181,1465,603,0,465,2,37,2913
51107610505,6702,1322,4034,669,6,459,3,35,5380
51107610506,5646,2298,1256,685,4,1110,0,21,3348
51107610507,6297,4328,441,446,1,716,2,36,1969
51107610601,7193,5221,964,389,6,220,5,31,1972
51107610602,2807,1884,262,127,7,381,0,7,923
51107610603,3587,1834,898,380,10,244,3,13,1753
51107610604,6964,4578,791,494,20,615,4,26,2386
51107610701,5640,4498,417,121,6,222,6,38,1142
51107610702,6207,4735,655,257,8,198,3,25,1472
51107610703,5364,4158,377,155,5,314,3,45,1206
51107610800,6657,5569,454,209,6,112,3,22,1088
51107610900,2404,1791,229,202,4,46,1,16,613
51107611002,4736,2118,878,596,9,837,3,47,2618
51107611004,8935,5279,929,653,24,1481,6,73,3656
51107611005,5573,3385,661,368,1,787,8,24,2188
51107611006,5950,3001,746,429,9,1419,4,34,2949
51107611009,5542,3352,366,370,2,1062,0,40,2190
51107611010,1951,1608,75,83,3,130,0,10,343
51107611011,3833,2027,404,421,8,730,5,13,1806
51107611012,4509,2433,314,255,7,1253,3,8,2076
51107611013,4370,2303,340,253,3,1162,3,39,2067
51107611014,4472,2638,661,288,4,576,2,29,1834
51107611015,3771,1866,362,287,5,1008,0,31,1905
51107611016,4140,2733,326,274,5,605,5,23,1407
51107611017,3397,1977,316,272,3,664,1,16,1420
51107611018,4004,2225,463,527,6,613,4,9,1779
51107611019,6045,3709,510,296,6,1199,0,22,2336
51107611020,6892,2911,967,772,7,1783,2,55,3981
51107611022,7320,3554,611,444,8,2287,9,40,3766
51107611023,5954,3890,421,293,0,1011,5,38,2064
51107611026,14425,5224,1194,1174,21,5935,11,64,9201
51107611027,2163,1039,236,209,3,547,0,15,1124
51107611028,6439,2917,421,361,8,2341,2,27,3522
51107611029,7139,4593,530,283,5,1280,3,30,2546
51107611030,6176,2145,346,510,11,2837,4,23,4031
51107611031,2141,901,199,301,3,569,2,8,1240
51107611032,2991,897,378,457,3,1067,2,24,2094
51107611101,4716,2370,1080,481,0,525,2,21,2346
51107611102,6225,3886,1058,305,1,585,0,48,2339
51107611202,4735,3123,524,289,2,563,3,18,1612
51107611204,5768,2215,2310,357,8,597,6,36,3553
51107611205,6018,2005,1990,486,2,1212,2,61,4013
51107611206,4311,2473,659,273,7,598,7,19,1838
51107611207,4325,2374,476,312,2,846,5,33,1951
51107611208,4384,2772,302,169,3,818,1,28,1612
51107611209,6639,4261,600,312,5,1004,3,38,2378
51107611300,6349,1883,2273,552,6,1297,0,55,4466
51107611400,5767,1563,2848,313,4,824,1,42,4204
51107611501,4242,1349,1306,585,1,729,6,50,2893
51107611502,6550,2107,2474,476,8,1166,4,40,4443
51107611601,4317,1613,1269,474,5,730,2,29,2704
51107611602,4316,850,2718,248,5,350,0,38,3466
51107611701,4797,1697,2170,218,5,547,1,38,3100
51107611702,2461,579,497,290,4,952,0,29,1882
51107611803,6838,2755,603,452,12,2626,6,33,4083
51107611804,8852,3229,723,641,11,3676,4,39,5623
51107611805,5069,3013,386,271,5,1089,3,17,2056
51107611807,7561,2478,515,644,13,3474,10,40,5083
51107611808,5569,2089,437,401,6,2296,4,20,3480
51107611809,6941,2345,572,719,19,2820,0,37,4596
51107611810,8135,3805,480,423,14,2798,7,38,4330
51107611811,8098,3332,782,880,17,2522,4,55,4766
51107611812,3241,919,289,423,14,1413,0,20,2322
51107611813,13108,5046,1014,1151,37,4994,11,79,8062
51107611901,7388,1728,360,452,17,4479,0,65,5660
51107611902,6290,2145,370,315,7,3141,1,32,4145
51107980100,46,18,5,0,0,11,3,0,28
51109950101,2706,2346,70,128,13,13,2,5,360
51109950102,4985,3750,198,699,21,26,0,21,1235
51109950201,5553,3745,279,1138,5,36,0,25,1808
51109950202,4164,3237,163,494,15,34,5,22,927
51109950301,4203,3176,198,550,2,75,3,18,1027
51109950302,3010,2253,164,418,3,10,0,20,757
51109950303,2946,2365,93,324,4,9,1,5,581
51109950400,3460,2172,72,985,11,19,2,16,1288
51109950500,6569,5491,128,629,19,29,5,23,1078
51111930100,5432,3025,353,1820,9,7,4,16,2407
51111930200,4208,2606,109,1250,10,12,0,14,1602
51111930300,2296,1385,127,703,13,6,1,1,911
51113930101,3611,3031,139,188,3,47,0,27,580
51113930102,4309,3508,125,456,4,15,0,9,801
51113930201,2972,2441,92,283,1,4,0,5,531
51113930202,2945,2583,85,129,6,20,1,12,362
51115951301,2613,2189,61,220,0,21,4,7,424
51115951302,1679,1520,35,58,1,12,3,1,159
51115951401,2762,2290,62,288,6,8,1,10,472
51115951402,1479,1251,39,92,0,8,7,7,228
51115990100,0,0,0,0,0,0,0,0,0
51117930101,2997,1526,239,1144,3,8,0,16,1471
51117930103,859,732,24,44,9,0,0,13,127
51117930104,1877,1509,19,270,8,10,0,6,368
51117930201,3699,2119,79,1238,7,108,0,12,1580
51117930202,2213,636,58,1418,6,5,0,13,1577
51117930300,3113,1790,100,1137,8,6,0,3,1323
51117930401,2349,1276,33,942,7,4,0,11,1073
51117930402,2522,1149,39,1236,7,1,0,8,1373
51117930500,1842,1333,51,400,1,3,0,3,509
51117930600,2610,1621,48,855,2,6,0,4,989
51117930700,2638,1612,40,878,3,13,0,11,1026
51117930800,3600,2561,91,802,12,41,0,10,1039
51119950900,1537,993,37,424,5,3,0,0,544
51119951000,3849,2911,96,672,11,6,0,9,938
51119951100,2655,2122,54,343,0,9,3,20,533
51119951200,2584,2313,72,80,8,8,0,11,271
51119990100,0,0,0,0,0,0,0,0,0
51121020100,9927,6691,663,489,2,1719,1,6,3236
51121020201,5611,3674,347,179,1,1122,6,40,1937
51121020202,2912,2205,224,164,6,197,1,11,707
51121020301,4190,2545,275,143,1,1022,10,11,1645
51121020302,3446,2720,136,71,3,351,0,10,726
51121020401,2516,1534,174,139,0,520,1,10,982
51121020402,4281,2771,217,307,0,750,0,13,1510
51121020500,6478,4846,271,178,7,858,3,22,1632
51121020600,5507,4349,271,166,2,472,3,28,1158
51121020701,2563,2038,131,67,0,192,2,13,525
51121020702,3315,2229,197,232,8,437,0,16,1086
51121020801,4097,3421,157,222,7,44,4,13,676
51121020802,2864,2264,118,276,2,31,0,3,600
51121020900,5156,4465,149,241,9,63,2,8,691
51121021000,5138,4524,126,203,9,60,3,21,614
51121021101,3827,3239,113,179,7,86,0,4,588
51121021102,4720,3607,356,319,6,197,0,12,1113
51121021201,3516,3174,75,93,11,46,2,10,342
51121021202,3122,2568,153,167,5,71,5,11,554
51121021300,3645,3370,78,33,5,34,0,15,275
51121021400,4711,4073,260,107,17,15,2,10,638
51121021501,4403,4055,94,65,11,12,0,5,348
51121021502,3776,3556,66,14,7,11,0,15,220
51125950101,3240,2585,75,429,11,3,0,9,655
51125950102,2240,1707,99,311,7,17,2,16,533
51125950201,2831,2316,152,208,4,12,0,24,515
51125950202,2268,2033,57,68,5,17,0,12,235
51125950300,4196,3238,280,510,20,18,0,7,958
51127700100,7035,5684,189,656,73,63,0,24,1351
51127700200,5638,4354,186,709,43,39,5,41,1284
51127700301,5813,4572,170,554,84,71,2,25,1241
51127700302,4459,3208,186,795,25,50,1,12,1251
51131930100,4407,2331,384,1488,27,26,3,9,2076
51131930200,3511,1850,455,1077,18,23,2,17,1661
51131930301,2528,1712,128,576,4,26,2,4,816
51131930302,1836,1039,101,615,9,5,1,0,797
51131990100,0,0,0,0,0,0,0,0,0
51133020100,3409,2365,151,738,5,19,0,32,1044
51133020200,3078,1891,64,980,1,17,0,12,1187
51133020301,2344,1821,64,348,3,14,0,10,523
51133020302,3008,2233,72,607,5,17,0,5,775
51133990100,0,0,0,0,0,0,0,0,0
51135000101,2201,1271,122,683,9,28,0,7,930
51135000102,3578,1668,183,1557,12,11,0,39,1910
51135000200,2527,1752,52,628,19,5,1,4,775
51135000300,7328,3756,415,2905,10,20,1,22,3572
51135980100,8,5,1,0,0,0,1,0,3
51137110104,3432,2836,199,190,18,16,5,13,596
51137110105,4815,3761,226,614,8,21,0,14,1054
51137110106,4181,3426,178,350,5,22,3,13,755
51137110107,4863,3948,269,269,9,76,2,33,915
51137110108,6881,4780,574,949,27,100,2,29,2101
51137110200,5422,3700,331,994,13,39,3,30,1722
51137110301,3400,2311,211,667,2,14,3,19,1089
51137110302,3260,2627,183,271,10,23,0,5,633
51139030100,2560,2361,56,26,6,6,5,2,199
51139030200,4141,3633,76,216,8,35,1,14,508
51139030300,4963,4507,99,102,9,29,1,10,456
51139030401,2166,2061,25,17,6,11,1,1,105
51139030402,3993,3767,110,23,5,7,0,3,226
51139030500,5886,5541,131,52,15,27,0,10,345
51141030101,2459,2238,93,24,2,9,0,20,221
51141030102,2288,1983,85,129,3,7,2,15,305
51141030201,2881,2576,124,111,0,9,0,7,305
51141030202,3047,2803,57,80,3,3,1,9,244
51141030301,3048,2630,85,228,6,5,0,16,418
51141030302,3885,3347,123,259,10,10,0,5,538
51143010100,3911,2914,54,831,5,1,1,12,997
51143010200,4117,3084,72,805,12,20,0,9,1033
51143010301,1225,933,30,230,0,6,0,0,292
51143010302,2658,2075,38,429,0,2,0,3,583
51143010400,3784,2791,104,777,7,8,0,2,993
51143010500,5238,3312,151,1637,2,8,3,19,1926
51143010600,2908,1975,36,788,9,16,1,4,933
51143010700,1647,891,71,628,5,5,0,5,756
51143010801,2396,1335,76,881,3,10,0,8,1061
51143010803,2920,2334,75,393,4,8,1,9,586
51143010804,3008,2376,41,496,8,4,0,7,632
51143010900,2686,2259,73,258,2,6,0,10,427
51143011001,4360,3421,257,566,6,14,0,1,939
51143011002,4504,3585,137,573,8,55,3,7,919
51143011100,2818,1845,152,711,5,27,0,7,973
51143011200,2329,1967,49,252,0,3,1,6,362
51143011301,3858,2776,150,762,5,58,4,6,1082
51143011302,2541,2105,68,267,5,14,2,5,436
51143011400,3593,2299,78,1070,7,24,1,8,1294
51145500101,6783,6011,151,239,19,46,11,22,772
51145500102,5856,5167,157,233,11,31,4,11,689
51145500201,6114,5216,161,403,13,47,2,18,898
51145500202,4242,3762,138,142,4,25,0,22,480
51145500300,1469,677,55,717,2,2,0,0,792
51145500400,5869,4664,130,743,10,16,1,26,1205
51147930101,3231,1319,102,1600,10,67,0,8,1912
51147930102,3391,1983,99,1155,8,23,0,18,1408
51147930202,3275,1778,62,1280,2,12,0,1,1497
51147930204,5264,2052,683,2267,4,79,0,9,3212
51147930301,3187,1636,78,1328,8,9,0,14,1551
51147930302,3501,1745,64,1564,1,6,0,11,1756
51149850100,4842,1875,366,2429,72,43,0,3,2967
51149850200,9994,3938,2355,2708,32,375,96,64,6056
51149850301,7052,2884,604,2873,33,157,21,33,4168
51149850302,4571,2835,243,1116,19,95,10,14,1736
51149850400,5305,3741,233,1001,26,37,0,22,1564
51149850501,6086,4366,235,1071,25,47,2,46,1720
51149850502,5160,3023,308,1496,14,68,12,9,2137
51153900100,3271,1651,528,539,3,331,2,25,1620
51153900201,2710,703,1014,610,4,250,4,12,2007
51153900202,4127,835,2442,365,6,315,5,10,3292
51153900203,5392,564,2604,1530,1,396,6,32,4828
51153900301,3301,1510,664,568,14,328,11,17,1791
51153900302,6165,1528,1670,1797,11,780,3,37,4637
51153900403,5550,1171,2117,1292,15,622,0,49,4379
51153900404,5996,1185,3146,910,13,414,6,104,4811
51153900407,6849,1129,2392,2260,12,730,4,62,5720
51153900408,4700,1152,1221,1423,4,582,7,50,3548
51153900409,5517,1033,2522,1214,1,486,8,76,4484
51153900410,5663,752,1185,2775,1,627,10,34,4911
51153900502,4323,1155,597,1789,6,397,5,46,3168
51153900503,3368,635,1531,801,5,282,0,26,2733
51153900504,5065,728,3011,815,9,351,5,17,4337
51153900601,3950,727,2258,463,0,384,3,27,3223
51153900602,4332,500,2376,1052,4,215,9,36,3832
51153900701,7608,1320,1587,3373,14,804,3,59,6288
51153900702,8133,1843,3389,1673,19,761,9,63,6290
51153900801,7324,2129,1109,2411,4,1127,8,55,5195
51153900803,6016,797,1483,2866,9,460,7,52,5219
51153900804,5423,1347,675,2606,14,437,7,30,4076
51153900901,6221,903,2573,2103,13,296,15,58,5318
51153900904,6853,1505,1112,2904,12,867,13,53,5348
51153900905,5628,1460,1066,2219,10,452,22,65,4168
51153901005,6501,3182,939,1408,2,484,5,34,3319
51153901009,7488,4106,950,1353,23,502,9,37,3382
51153901010,4416,2380,561,822,14,302,8,30,2036
51153901011,6654,2521,1159,1658,18,795,17,27,4133
51153901012,3721,2018,404,854,10,228,1,18,1703
51153901013,3494,660,997,1358,4,285,2,13,2834
51153901014,3977,1465,738,1213,12,297,8,41,2512
51153901015,3726,443,717,2014,4,359,3,26,3283
51153901016,5440,812,1224,2147,2,910,13,39,4628
51153901101,2191,1213,416,267,2,115,13,34,978
51153901102,3607,2142,713,326,18,81,28,38,1465
51153901203,4013,973,1728,690,6,391,6,46,3040
51153901208,3116,1590,673,451,1,246,6,23,1526
51153901209,6645,2313,1943,1078,11,881,9,59,4332
51153901211,4659,1001,2399,615,7,421,0,25,3658
51153901212,7978,1720,2332,2319,16,1044,3,81,6258
51153901219,5662,3883,539,513,13,375,2,33,1779
51153901221,5646,2455,972,1327,12,443,7,36,3191
51153901222,2654,1417,431,428,5,176,2,19,1237
51153901223,6777,2923,1596,1219,5,584,9,58,3854
51153901224,4459,2200,1129,517,5,368,0,38,2259
51153901225,4875,1641,1174,1129,15,568,0,27,3234
51153901226,6345,1624,1592,1607,23,1054,8,31,4721
51153901227,5282,1245,2202,1060,7,467,6,41,4037
51153901228,6336,1961,2047,1285,7,665,2,43,4375
51153901229,3983,1125,1125,925,7,559,7,22,2858
51153901230,4419,1341,1131,1076,7,518,7,50,3078
51153901231,7144,4035,1123,691,14,853,2,46,3109
51153901232,5839,2997,789,973,4,623,14,25,2842
51153901233,7347,4567,1268,656,11,367,4,37,2780
51153901234,3385,1997,541,411,5,175,8,24,1388
51153901235,3262,1636,385,628,5,343,0,36,1626
51153901236,6506,2717,779,1688,16,790,5,48,3789
51153901237,3468,1326,646,850,3,329,17,27,2142
51153901303,5107,2718,933,599,5,525,2,31,2389
51153901304,2789,1955,467,71,10,101,0,16,834
51153901305,3642,2783,389,94,2,112,0,26,859
51153901306,5777,4226,673,306,3,200,0,40,1551
51153901403,6754,2030,2399,1091,4,846,5,43,4724
51153901407,4247,964,1859,667,8,523,0,25,3283
51153901409,8502,3932,1500,1428,10,1009,10,51,4570
51153901411,6810,3920,686,620,8,1200,2,41,2890
51153901412,8112,4212,1020,869,7,1433,7,34,3900
51153901413,4504,2580,627,404,4,510,0,35,1924
51153901414,4936,2897,665,507,5,554,7,15,2039
51153901415,4224,2512,596,394,3,450,13,22,1712
51153901416,4984,2770,659,627,20,567,8,29,2214
51153901417,3427,2363,397,225,5,226,0,3,1064
51153901418,4138,1137,1412,926,9,372,4,40,3001
51153901419,4270,695,1981,879,3,470,6,31,3575
51153901420,4546,2337,704,607,10,613,0,25,2209
51153901421,4884,2369,569,652,6,877,1,25,2515
51153901503,6044,4570,570,188,12,341,5,29,1474
51153901504,4713,3687,203,251,7,419,0,18,1026
51153901505,7669,4575,674,805,4,1096,0,35,3094
51153901506,5536,2531,763,695,2,1116,5,39,3005
51153901507,2958,1645,450,296,2,383,2,23,1313
51153901508,6034,2632,804,941,10,1220,4,40,3402
51153901509,7056,5003,587,458,4,480,1,53,2053
51153901510,6546,3902,578,571,6,960,7,38,2644
51153901511,4691,3426,294,377,5,363,3,17,1265
51153901601,4130,1182,2250,294,13,276,0,16,2948
51153901602,8294,2426,3511,1080,11,831,1,47,5868
51153901702,4047,954,2661,155,0,172,0,16,3093
51153901703,2762,876,1339,212,4,230,4,23,1886
51153901704,6821,1198,3877,779,13,667,4,43,5623
51153901900,8748,2149,3792,957,12,1402,3,108,6599
51153980100,2,1,1,0,0,0,0,0,1
51155210101,4008,3387,135,242,3,44,0,19,621
51155210102,2831,2589,50,58,2,22,0,9,242
51155210201,4155,3489,135,244,13,35,0,21,666
51155210202,3729,3477,51,74,6,9,0,5,252
51155210300,4097,3504,88,273,5,11,2,1,593
51155210401,2963,2500,55,224,4,17,0,14,463
51155210402,1856,1745,33,16,1,0,0,3,111
51155210500,2405,2241,21,39,0,9,0,4,164
51155210600,4276,3721,77,303,6,18,0,15,555
51155210700,3476,3062,57,160,9,12,1,9,414
51155980100,0,0,0,0,0,0,0,0,0
51155980200,4,1,2,0,0,0,0,0,3
51157950100,2729,2392,106,69,2,11,0,20,337
51157950200,4619,4052,183,129,15,52,0,10,567
51159040100,5417,3448,347,1403,10,25,0,3,1969
51159040200,3506,2116,250,1016,6,17,0,2,1390
51161030100,3557,3283,54,30,7,16,3,12,274
51161030201,4856,3549,209,661,14,181,0,29,1307
51161030203,3987,3144,125,333,4,194,0,20,843
51161030205,4253,3191,263,411,1,222,6,8,1062
51161030206,4437,3405,260,409,3,161,0,18,1032
51161030207,2772,1723,242,520,13,111,0,5,1049
51161030300,7288,6537,171,217,6,105,0,36,751
51161030501,1892,1658,33,159,3,1,0,4,234
51161030502,2937,2540,48,61,3,165,0,13,397
51161030601,5474,4723,123,84,6,305,0,31,751
51161030602,2443,2021,71,55,6,184,0,24,422
51161030701,6936,5846,246,169,5,402,6,13,1090
51161030702,5835,4528,347,441,9,204,0,25,1307
51161030802,5124,4349,199,216,11,147,1,23,775
51161030803,3669,2562,184,351,4,354,0,33,1107
51161030804,1876,1563,87,76,2,77,0,13,313
51161030900,6162,5180,161,279,15,235,5,38,982
51161031000,3856,3400,112,144,21,23,0,17,456
51161031101,4557,3705,140,363,7,72,0,17,852
51161031102,3485,2936,148,203,2,19,0,8,549
51161031201,5358,4746,101,199,3,107,2,19,612
51161031202,6175,5339,183,269,10,140,1,29,836
51163930101,3151,2664,83,160,9,75,2,8,487
51163930102,4414,4004,133,67,29,9,2,17,410
51163930200,4875,4518,88,80,7,42,1,11,357
51163930301,2753,2523,41,46,7,8,0,20,230
51163930302,3762,3447,73,33,10,37,1,12,315
51163930400,3695,3201,95,179,23,10,0,14,494
51165010100,3250,3019,109,23,1,11,0,8,231
51165010200,3611,3232,149,108,6,11,0,14,379
51165010301,1908,1632,149,45,1,25,0,4,276
51165010302,2900,2489,121,133,7,20,0,24,411
51165010400,2464,2233,159,15,4,1,0,1,231
51165010500,3060,1968,934,53,3,30,0,3,1092
51165010600,3862,3453,270,46,3,11,1,6,409
51165010700,3682,3427,130,12,2,11,0,19,255
51165010801,3663,3048,396,41,6,31,2,9,615
51165010802,3238,2745,334,33,3,16,0,12,493
51165010900,2584,2331,148,27,5,11,0,4,253
51165011000,2948,2791,43,12,6,9,0,5,157
51165011100,3180,2944,118,25,0,9,0,0,236
51165011200,4772,4456,160,28,0,4,0,24,316
51165011400,6094,4598,1089,138,3,91,0,15,1496
51165011500,6856,5660,463,413,8,62,4,24,1196
51165011600,2137,1962,111,10,1,14,0,7,175
51165011700,5337,3770,1053,213,2,153,0,14,1567
51165011801,3261,2875,261,17,4,23,0,8,386
51165011802,6384,5337,341,141,7,330,2,12,1047
51165011900,3291,2775,257,85,0,31,0,8,516
51165012000,5275,4622,298,150,8,16,0,22,653
51167030100,4119,4017,17,6,6,2,0,4,102
51167030201,2091,2033,9,17,0,0,0,2,58
51167030202,2722,2578,22,54,0,2,0,3,144
51167030300,3518,3360,20,20,1,6,0,3,158
51167030402,2904,2809,8,20,0,5,0,0,95
51167030403,3111,2897,49,49,4,21,0,5,214
51167030404,2213,2147,11,12,1,4,0,0,66
51167030500,1858,1811,10,9,3,0,1,2,47
51167030600,3245,3102,22,35,2,2,0,6,143
51169030100,3327,3114,45,66,8,1,0,6,213
51169030200,3933,3731,59,26,5,0,0,1,202
51169030300,3336,3165,50,11,2,6,2,5,171
51169030400,3564,3401,40,7,5,0,0,7,163
51169030500,3649,3529,23,9,0,2,0,6,120
51169030600,3767,3588,38,15,6,11,0,3,179
51171040101,3365,2838,204,126,3,23,2,20,527
51171040102,6395,5383,382,241,21,65,2,22,1012
51171040201,2701,2485,101,24,0,10,0,1,216
51171040202,3303,3062,88,26,6,14,0,20,241
51171040300,3958,3574,186,46,8,18,0,17,384
51171040400,2571,2342,67,8,12,24,0,6,229
51171040501,6952,5135,1088,335,12,101,0,28,1817
51171040502,2159,1893,162,14,0,15,1,0,266
51171040600,3762,3238,294,50,5,8,3,22,524
51171040700,4204,3429,558,74,12,22,0,2,775
51171040800,4816,3925,596,87,5,44,0,11,891
51173030100,3060,2883,60,15,3,4,0,6,177
51173030200,4136,3979,35,11,0,14,0,4,157
51173030301,3082,2891,44,39,5,21,0,7,191
51173030302,3770,3421,120,69,4,41,1,7,349
51173030400,1871,1800,19,0,6,0,0,1,71
51173030500,2423,2178,25,126,5,13,0,8,245
51173030600,2895,2619,75,74,3,0,0,3,276
51173030701,4527,4185,134,49,7,4,0,7,342
51173030702,4036,3806,46,25,3,7,0,6,230
51175200100,4162,3121,71,767,13,17,5,9,1041
51175200200,2737,1539,74,1022,14,3,0,2,1198
51175200300,1319,530,28,749,0,1,1,0,789
51175200401,3599,2204,46,1177,10,22,0,17,1395
51175200402,2815,1771,41,887,4,18,7,8,1044
51175200500,3364,1794,72,1306,15,6,7,14,1570
51177020104,4945,3487,422,540,8,161,5,34,1458
51177020105,2434,1968,164,79,2,47,0,28,466
51177020106,8064,5635,892,726,14,323,7,66,2429
51177020107,2340,1424,239,418,3,76,0,16,916
51177020108,4225,2148,757,897,1,157,4,24,2077
51177020109,3656,2224,638,476,16,96,0,22,1432
51177020110,3881,2049,936,557,2,95,8,20,1832
51177020111,2454,1357,369,488,10,49,3,13,1097
51177020112,2749,1636,367,462,6,55,2,17,1113
51177020113,4512,2962,457,715,6,61,2,36,1550
51177020114,5913,3028,892,1297,18,264,7,29,2885
51177020201,7310,3927,1187,1497,10,160,9,43,3383
51177020202,5418,3025,834,1037,14,129,13,28,2393
51177020203,5067,2570,708,1287,8,196,0,16,2497
51177020204,4572,2754,619,731,31,169,0,20,1818
51177020206,4570,2839,415,838,16,129,0,28,1731
51177020207,1575,892,201,332,2,39,4,14,683
51177020304,4351,2752,599,564,14,127,4,28,1599
51177020305,3858,2005,533,834,10,187,6,25,1853
51177020307,3791,1857,822,693,11,121,1,29,1934
51177020308,4032,2469,559,612,13,87,7,31,1563
51177020309,5749,3565,646,1028,21,146,4,35,2184
51177020311,5571,3872,443,767,21,77,14,43,1699
51177020312,6724,3166,822,1837,24,481,1,42,3558
51177020313,695,221,75,344,0,9,2,2,474
51177020314,1850,866,216,534,0,106,1,12,984
51177020315,593,400,82,64,3,7,2,5,193
51177020316,5003,3188,476,861,10,103,0,21,1815
51177020403,4091,3196,216,292,14,65,3,24,895
51177020404,3677,2979,145,274,11,24,0,20,698
51177020405,3677,3104,79,283,12,23,3,11,573
51177020406,3817,3063,213,246,16,32,1,10,754
51177020407,5768,4444,321,537,11,95,4,37,1324
51177020408,3100,2206,310,289,17,37,5,16,894
51179010103,5044,2419,794,1173,15,174,10,75,2625
51179010105,8089,3782,1206,2118,21,394,9,70,4307
51179010106,3865,2497,462,505,5,121,1,29,1368
51179010107,3661,2319,580,405,13,80,10,21,1342
51179010108,6426,2870,1243,1457,20,317,6,73,3556
51179010201,1633,973,347,116,11,71,9,3,660
51179010202,6860,4925,881,357,26,145,17,33,1935
51179010205,6821,3763,1232,982,19,275,17,48,3058
51179010206,5495,2361,1353,1147,13,260,12,46,3134
51179010210,11687,4752,1823,3485,30,690,16,72,6935
51179010211,4242,1844,859,1056,0,176,2,23,2398
51179010212,4675,2138,936,1052,11,165,12,33,2537
51179010213,2629,1422,356,532,4,126,2,19,1207
51179010214,3873,1750,740,936,2,183,5,21,2123
51179010215,2114,615,385,733,6,137,9,30,1499
51179010216,7379,2012,2757,1829,12,302,8,71,5367
51179010217,5305,3543,558,648,11,206,6,30,1762
51179010218,4638,2319,655,1262,18,117,5,29,2319
51179010219,1462,743,180,332,13,97,1,1,719
51179010301,4690,3489,395,381,9,102,0,43,1201
51179010304,6868,3548,845,1664,20,279,18,55,3320
51179010305,6752,3526,798,1448,23,471,19,32,3226
51179010306,2773,999,526,888,6,170,11,9,1774
51179010307,8635,5064,895,1741,21,300,9,62,3571
51179010308,2618,1966,238,152,12,65,4,5,652
51179010403,3815,2458,467,438,32,104,0,10,1357
51179010404,6642,4128,675,1064,39,213,5,46,2514
51179010405,6241,4458,525,649,39,184,14,35,1783
51179010406,3216,2019,361,502,14,97,0,19,1197
51179010502,4226,3325,292,250,31,69,4,24,901
51179010503,2618,2116,163,72,43,38,0,17,502
51179010504,1935,1444,119,118,62,9,0,21,491
51181860100,3059,1601,80,1260,5,8,6,5,1458
51181860200,3502,1858,69,1427,12,6,4,10,1644
51183870100,2652,1103,59,1373,5,3,0,4,1549
51183870201,3262,1446,128,1608,3,3,2,4,1816
51183870202,700,225,27,443,1,0,0,0,475
51183870300,2633,878,72,1589,5,2,5,6,1755
51183870400,1582,729,20,753,0,3,0,11,853
51185020100,3219,2840,54,229,2,1,0,3,379
51185020200,5043,4334,84,339,7,36,6,29,709
51185020301,2450,2288,13,59,0,2,0,3,162
51185020302,3225,3088,31,13,7,9,2,0,137
51185020400,3982,3804,28,24,9,20,4,8,178
51185020500,2897,2732,13,10,3,19,0,13,165
51185020600,3806,3653,36,17,5,2,0,4,153
51185020700,2994,2730,39,85,4,14,0,8,264
51185020800,1805,1688,21,25,0,1,3,5,117
51185020900,1807,1719,20,12,7,0,0,0,88
51185021000,3739,3547,40,15,5,18,0,5,192
51185021101,2773,2504,39,96,3,22,0,5,269
51185021102,2689,2409,89,37,4,69,0,6,280
51187020101,4716,3941,359,83,14,85,6,30,775
51187020102,4010,3442,258,77,11,31,0,24,568
51187020200,3865,3256,191,165,16,43,0,37,609
51187020300,6829,6057,246,137,23,43,0,46,772
51187020400,4834,3683,326,415,13,61,1,21,1151
51187020500,4178,3044,331,490,24,40,0,25,1134
51187020601,6094,5031,438,209,18,116,3,21,1063
51187020602,2665,2216,153,96,7,22,0,29,449
51187020700,3536,3161,111,50,4,21,3,22,375
51191010101,3492,3256,84,16,8,19,0,0,236
51191010102,3384,3188,76,19,4,17,0,4,196
51191010200,5051,4737,69,50,13,9,0,5,314
51191010301,3149,3014,40,10,1,4,0,16,135
51191010302,3231,3090,36,7,8,4,0,20,141
51191010401,2546,2391,38,7,1,34,0,6,155
51191010402,3294,3034,68,35,9,24,0,7,260
51191010501,4012,3669,62,86,6,33,0,9,343
51191010502,4346,3817,94,189,3,107,0,12,529
51191010601,4087,3781,88,51,10,45,0,10,306
51191010602,2620,2390,56,90,4,11,0,20,230
51191010700,4252,3979,50,68,4,10,0,7,273
51191010800,2933,2826,29,1,5,5,0,4,107
51191010900,4148,3907,64,15,7,7,0,9,241
51191011000,3390,3259,37,7,8,5,0,5,131
51193010101,2073,1323,72,574,8,11,0,0,750
51193010102,2963,1197,215,1428,7,5,0,17,1766
51193010200,3642,2244,202,996,4,23,0,12,1398
51193010300,3472,2280,362,585,14,21,0,8,1192
51193010401,2551,1937,86,350,15,22,2,15,614
51193010402,3776,2777,112,537,19,64,9,16,999
51195930700,3081,2428,53,538,2,2,0,3,653
51195930800,1815,1753,12,3,1,5,0,0,62
51195930900,4013,3762,51,38,4,23,1,7,251
51195931000,2075,1986,19,13,4,4,0,10,89
51195931100,2428,2258,19,59,3,7,0,1,170
51195931200,6152,4868,101,897,6,22,2,14,1284
51195931300,3584,3395,36,22,5,9,0,3,189
51195931400,4541,4184,80,53,3,66,5,35,357
51195931500,4283,3987,55,116,6,8,0,8,296
51195931600,2390,2282,12,23,5,3,2,0,108
51195931700,1768,1683,14,9,9,1,1,5,85
51197050101,2790,2309,77,238,6,28,0,9,481
51197050102,2570,2447,7,22,6,6,0,6,123
51197050201,3172,2789,54,167,13,42,0,16,383
51197050202,3654,3372,49,83,9,17,1,1,282
51197050301,4411,4069,60,91,10,10,1,17,342
51197050302,3090,2949,21,25,3,3,0,2,141
51197050401,3649,3441,46,48,0,0,0,10,208
51197050402,4954,4706,41,25,7,12,0,5,248
51199050203,6656,3885,471,769,16,1013,10,52,2771
51199050205,4645,3490,258,297,12,319,7,31,1155
51199050206,6702,4457,411,779,18,521,11,39,2245
51199050207,4540,2449,718,725,10,159,30,35,2091
51199050208,2026,1052,178,369,5,257,12,13,974
51199050303,5773,4121,460,467,11,259,7,26,1652
51199050304,5496,4583,227,154,4,225,0,23,913
51199050305,3457,2058,227,451,15,473,5,30,1399
51199050306,5287,3706,381,556,14,265,7,37,1581
51199050401,3652,2975,138,209,7,123,2,21,677
51199050402,3677,3211,130,86,7,52,5,13,466
51199050500,3724,1623,427,1261,7,98,9,16,2101
51199050900,2370,1269,288,572,13,80,8,9,1101
51199051000,4690,3540,265,480,15,151,3,10,1150
51199051100,7350,4513,557,1458,14,256,11,61,2837
51199990100,0,0,0,0,0,0,0,0,0
51510200102,5043,1179,2184,821,5,628,1,43,3864
51510200104,4095,831,1717,983,13,344,0,23,3264
51510200105,4065,925,301,2195,3,432,0,14,3140
51510200106,3392,1549,774,657,5,260,0,19,1843
51510200108,1667,448,257,680,0,195,0,7,1219
51510200109,5794,1169,1959,1877,9,537,1,41,4625
51510200110,2614,1260,330,628,5,236,5,11,1354
51510200111,3909,1576,616,1073,9,357,1,20,2333
51510200201,3505,2000,453,624,12,220,5,12,1505
51510200202,1698,1358,111,100,0,64,0,2,340
51510200301,3333,1176,600,968,4,362,2,32,2157
51510200302,4452,1722,1268,1000,1,243,0,25,2730
51510200304,2825,880,395,1037,9,316,3,28,1945
51510200305,2426,765,384,908,3,198,4,30,1661
51510200403,1410,630,147,329,0,194,2,20,780
51510200404,3694,2473,280,316,3,327,1,43,1221
51510200406,4949,1096,1105,1952,5,521,0,36,3853
51510200407,3921,1644,595,932,6,479,0,34,2277
51510200408,2713,569,587,982,7,404,0,12,2144
51510200409,6318,1844,1066,2125,10,797,5,53,4474
51510200500,4650,1534,848,1745,5,266,7,20,3116
51510200600,4731,1819,1027,1106,7,512,1,30,2912
51510200701,951,581,110,120,0,78,0,2,370
51510200703,3494,2207,222,795,2,112,0,14,1287
51510200704,2906,1711,295,484,5,246,0,16,1195
51510200705,2597,1903,171,140,0,245,2,20,694
51510200801,2701,1955,359,135,4,77,0,6,746
51510200802,2991,1546,558,569,3,170,3,21,1445
51510200900,5078,4136,301,225,8,145,3,27,942
51510201000,2831,2156,218,167,5,108,2,21,675
51510201100,3388,2313,733,75,1,103,4,32,1075
51510201202,3429,2279,484,309,2,143,5,21,1150
51510201204,2878,1506,595,459,4,128,0,15,1372
51510201205,2568,656,1274,418,5,110,6,17,1912
51510201206,5710,796,3952,648,8,146,0,42,4914
51510201300,4004,3057,269,289,6,124,4,21,947
51510201400,4158,3073,536,223,6,107,0,15,1085
51510201500,3835,3023,442,59,7,89,1,19,812
51510201601,3347,2226,186,530,5,161,0,22,1121
51510201602,3220,1788,280,851,2,151,0,17,1432
51510201802,2084,1439,158,356,4,55,2,18,645
51510201803,2393,1771,214,171,0,95,5,15,622
51510201804,3710,2140,407,564,7,342,2,22,1570
51510201805,3383,2422,215,408,4,156,0,23,961
51510201900,1798,1410,119,90,3,71,0,14,388
51510202001,2379,2103,97,56,1,48,0,15,276
51510202002,2430,1875,173,135,4,103,0,16,555
51510980000,0,0,0,0,0,0,0,0,0
51520020100,3709,3124,186,165,19,18,0,3,585
51520020201,2346,1786,69,306,13,2,1,5,560
51520020202,2479,2210,54,85,2,38,0,18,269
51520020300,2972,2417,60,295,2,3,0,4,555
51520020400,5713,5115,86,157,19,98,3,6,598
51530930601,3357,2953,94,96,29,12,0,7,404
51530930602,3284,2707,135,193,10,12,24,11,577
51540000201,2697,1580,189,559,1,218,1,23,1117
51540000202,5949,3644,368,1035,5,582,2,18,2305
51540000302,2877,2119,187,327,10,105,0,15,758
51540000401,3553,1642,276,1194,2,236,0,25,1911
51540000402,4485,3001,419,621,3,164,0,21,1484
51540000501,3274,1419,267,1252,6,181,3,8,1855
51540000502,5751,3926,355,721,10,362,1,30,1825
51540000600,4183,2154,299,288,16,1164,9,17,2029
51540000700,4610,3565,226,201,2,429,2,19,1045
51540000800,3912,2474,327,433,5,440,0,11,1438
51540000900,2444,1832,154,225,0,95,0,14,612
51540001000,2818,2253,140,174,6,88,0,17,565
51550020001,1642,1196,92,170,2,48,2,9,446
51550020002,4322,1996,352,1598,14,76,0,20,2326
51550020003,5667,3299,432,1343,22,166,4,33,2368
51550020100,4911,531,278,3877,19,37,3,16,4380
51550020200,4289,363,205,3486,9,41,2,20,3926
51550020300,1681,471,108,961,2,22,0,21,1210
51550020400,2870,1391,239,960,9,40,4,21,1479
51550020500,2016,531,408,900,13,44,4,11,1485
51550020600,4255,2687,296,892,18,79,5,21,1568
51550020700,6114,1257,1350,3111,12,66,5,15,4857
51550020804,10716,5831,650,2351,22,1215,18,79,4885
51550020805,6033,2639,529,1928,22,531,9,43,3394
51550020808,3400,438,166,2619,8,48,2,17,2962
51550020809,4900,2177,382,1810,37,174,6,35,2723
51550020810,2253,1360,180,414,8,150,0,17,893
51550020811,5356,3149,360,1169,9,273,10,21,2207
51550020812,2213,1155,183,608,6,114,4,10,1058
51550020813,2526,1065,229,971,17,77,0,15,1461
51550020814,4463,2341,274,1133,15,391,10,27,2122
51550020903,2555,476,216,1658,5,71,0,17,2079
51550020905,2718,1535,377,501,24,117,0,12,1183
51550020907,2324,1398,140,566,5,68,3,23,926
51550020908,2441,1463,139,573,3,115,4,22,978
51550020909,2904,1323,211,1028,11,112,7,18,1581
51550020910,1548,220,78,1107,5,55,1,0,1328
51550020911,3101,1409,240,1073,11,135,8,23,1692
51550020912,5020,2203,386,1829,9,253,4,15,2817
51550021004,8823,6305,603,832,16,434,14,26,2518
51550021005,5600,3613,375,1133,12,150,7,20,1987
51550021009,4316,3555,227,185,17,129,0,21,761
51550021010,6129,4806,327,512,14,154,7,24,1323
51550021011,3728,2940,179,284,6,98,0,12,788
51550021012,6115,5024,291,274,13,115,7,16,1091
51550021013,4479,3515,200,358,3,168,0,30,964
51550021014,2851,2052,177,316,10,114,3,6,799
51550021015,2151,1768,97,109,5,38,2,6,383
51550021016,4625,3299,262,516,16,268,8,25,1326
51550021101,5468,4529,270,224,14,142,3,17,939
51550021103,3575,2805,195,235,10,117,0,14,770
51550021104,5385,3337,156,1660,3,28,2,7,2048
51550021200,6705,5218,436,452,9,101,12,42,1487
51550021301,8568,4511,659,2465,34,224,19,38,4057
51550021303,2432,1384,149,578,16,62,2,26,1048
51550021304,3367,1828,271,935,8,90,12,10,1539
51550021305,3692,2050,269,919,3,149,3,31,1642
51550021306,2373,1208,194,671,4,107,3,23,1165
51550021401,2087,1259,159,488,8,52,0,22,828
51550021402,6607,4121,837,1130,30,90,16,11,2486
51550021403,4769,2539,489,1380,10,60,2,35,2230
51550021405,2168,772,315,919,12,36,2,21,1396
51550021406,2563,265,116,1971,2,65,7,17,2298
51550021407,2950,502,175,2090,6,51,6,11,2448
51550021503,3248,2064,151,680,1,136,8,8,1184
51550021504,3082,2443,106,273,15,67,1,11,639
51550021505,6094,3034,451,1993,31,236,9,32,3060
51550021506,2651,337,140,1980,12,42,4,13,2314
51550021507,5263,2629,323,1876,14,111,2,20,2634
51550021602,6665,2365,349,3252,27,251,18,39,4300
51550021603,1831,1248,59,306,5,126,2,3,583
51550021604,2025,1509,89,213,5,71,2,3,516
51550021605,4799,2941,228,1040,3,268,14,2,1858
51570830100,4840,3916,198,319,4,186,3,16,924
51570830200,3646,2035,339,878,4,180,7,12,1611
51570830300,2836,1853,184,535,13,95,3,24,983
51570830400,2693,1669,224,607,0,51,0,11,1024
51570830500,4155,2936,331,509,11,57,0,22,1219
51580060100,2962,2133,104,546,5,18,4,9,829
51580060200,2775,2408,75,170,7,14,1,2,367
51590000100,5856,2035,172,3384,9,85,0,21,3821
51590000200,4140,1537,216,2175,15,87,0,8,2603
51590000300,3264,733,86,2313,6,4,0,7,2531
51590000400,3708,879,99,2600,3,1,0,9,2829
51590000500,1809,635,47,1040,6,19,0,3,1174
51590000600,2159,458,50,1556,6,13,0,10,1701
51590000700,3336,2267,164,708,11,71,1,8,1069
51590000800,2712,1268,178,1110,7,69,0,18,1444
51590000900,3579,1769,213,1435,6,35,0,4,1810
51590001000,3541,839,231,2327,6,17,0,22,2702
51590001100,1244,273,41,886,3,7,0,4,971
51590001200,1831,917,155,708,0,20,0,3,914
51590001301,1526,591,132,738,5,20,0,12,935
51590001302,841,317,103,383,5,5,0,1,524
51590001400,3039,2364,186,370,0,50,0,13,675
51590980100,5,2,1,0,0,0,0,0,3
51595890100,2862,353,211,2198,3,9,1,19,2509
51595890200,2904,1176,134,1433,4,41,3,18,1728
51600300100,5368,2632,1106,347,20,956,7,58,2736
51600300200,5200,3018,941,138,4,774,0,51,2182
51600300300,5889,3021,907,278,17,1337,0,46,2868
51600300400,4129,2010,876,199,1,851,2,31,2119
51600300500,3560,2230,448,90,2,601,0,18,1330
51610500100,3529,2652,239,66,3,309,0,26,877
51610500200,6692,4336,914,302,5,622,10,50,2356
51610500300,4437,2967,376,186,4,563,0,41,1470
51620090100,4695,2736,144,1556,11,72,2,11,1959
51620090200,3485,230,74,3054,14,9,0,5,3255
51630000100,3175,2675,125,192,4,37,0,14,500
51630000201,4690,2437,612,1006,12,278,10,57,2253
51630000202,1521,1106,105,161,10,30,0,10,415
51630000301,1725,1300,144,127,1,55,0,80,425
51630000302,4471,2598,678,776,24,116,6,35,1873
51630000400,3528,1598,328,1098,12,229,1,22,1930
51630000500,8872,3487,1480,2596,23,580,7,62,5385
51640070101,4231,3126,612,275,9,39,0,7,1105
51640070102,2489,1849,449,79,4,13,0,8,640
51650010103,7065,4250,379,1725,22,197,8,31,2815
51650010104,6175,1845,403,3261,16,173,13,32,4330
51650010200,1395,850,194,149,4,75,9,10,545
51650010304,8137,2612,642,4004,15,270,23,83,5525
51650010306,6865,2382,443,3205,36,281,4,74,4483
51650010307,5554,1658,283,2908,24,327,1,32,3896
51650010309,4316,1603,350,1983,19,76,4,21,2713
51650010310,4264,1834,223,1839,10,165,2,34,2430
51650010311,4315,1389,281,2210,29,133,5,28,2926
51650010312,3265,1975,192,785,9,86,1,2,1290
51650010314,1838,624,161,841,8,71,5,12,1214
51650010315,3945,1015,380,2129,8,154,6,37,2930
51650010316,4220,1089,311,2413,12,129,9,43,3131
51650010400,6172,996,302,4506,19,67,19,24,5176
51650010502,2916,501,218,1936,15,80,17,16,2415
51650010503,2598,364,113,1952,14,32,1,15,2234
51650010504,3730,569,195,2592,14,147,6,42,3161
51650010601,1949,479,113,1228,4,16,2,7,1470
51650010602,3115,416,218,2289,15,16,3,10,2699
51650010701,3456,1059,232,1852,9,74,4,23,2397
51650010702,3996,2017,247,1306,22,66,7,23,1979
51650010703,3134,1804,175,811,3,71,0,18,1330
51650010800,5253,2683,309,1744,11,194,8,31,2570
51650010900,2384,370,129,1709,13,16,0,14,2014
51650011001,2312,1389,127,608,15,17,1,19,923
51650011002,3076,1284,196,1288,3,78,13,16,1792
51650011100,494,404,22,45,0,3,2,4,90
51650011200,2803,1444,185,926,5,44,5,15,1359
51650011300,1940,644,114,1010,11,26,3,15,1296
51650011400,2614,129,56,2394,5,5,0,0,2485
51650011500,4056,2799,221,681,15,91,8,31,1257
51650011600,3056,574,148,2067,22,73,4,21,2482
51650011800,4730,1258,300,2831,23,46,10,37,3472
51650011900,2976,271,102,2396,9,32,4,12,2705
51650012000,3089,569,133,2158,14,25,2,24,2520
51650012100,5945,4240,314,851,12,137,0,39,1705
51650990100,0,0,0,0,0,0,0,0,0
51660000101,4821,1937,1890,584,7,121,1,20,2884
51660000102,5344,2696,1700,456,14,214,1,33,2648
51660000203,1806,1316,279,71,5,55,0,5,490
51660000204,3640,2035,1100,296,3,107,0,14,1605
51660000205,6558,4451,1020,376,9,406,1,27,2107
51660000206,4507,3496,270,293,4,248,2,8,1011
51660000207,6088,4104,789,498,5,401,2,15,1984
51660000301,3402,2522,492,109,4,145,1,14,880
51660000302,6359,3497,1819,584,11,201,4,17,2862
51660000401,3118,1987,793,187,3,52,8,11,1131
51660000402,6171,3413,1893,452,6,139,0,32,2758
51670820100,1556,697,74,676,10,7,0,14,859
51670820300,2635,1068,222,1155,11,20,2,11,1567
51670820400,6155,3136,511,2034,19,108,1,31,3019
51670820500,4858,2864,412,1215,17,55,3,29,1994
51670820600,5399,1792,490,2746,18,51,9,27,3607
51670820700,2430,262,180,1863,11,10,0,17,2168
51670980100,0,0,0,0,0,0,0,0,0
51678930501,4610,3710,233,386,8,92,0,18,900
51678980000,2710,2305,102,68,0,189,0,5,405
51680000100,4509,3706,140,379,12,45,0,47,803
51680000201,6588,5515,207,394,11,165,2,27,1073
51680000203,1519,1118,83,225,8,31,0,2,401
51680000204,3533,1695,214,1342,11,73,1,15,1838
51680000205,3372,1838,159,1102,7,47,0,16,1534
51680000300,3965,2409,131,1151,6,28,0,45,1556
51680000400,3012,1102,105,1587,19,12,1,16,1910
51680000500,829,611,40,120,0,20,0,6,218
51680000600,2758,630,104,1831,0,17,4,10,2128
51680000700,3770,1259,178,2037,15,30,3,27,2511
51680000801,2061,1256,119,505,6,24,1,16,805
51680000802,3002,1981,125,636,3,89,1,10,1021
51680000901,3493,2217,216,794,11,56,0,12,1276
51680000902,2823,1480,215,860,5,78,3,20,1343
51680001000,3045,1967,147,686,8,31,2,18,1078
51680001100,1901,475,67,1240,0,7,0,10,1426
51680001400,7403,5956,521,416,18,222,10,228,1447
51680001601,2875,1617,212,798,0,90,1,22,1258
51680001602,3340,2096,238,604,7,211,0,33,1244
51680001603,2518,1548,135,477,10,182,3,27,970
51680001700,5533,3958,278,801,17,224,2,23,1575
51680001800,2260,1719,119,315,4,49,0,1,541
51680001900,4900,1501,127,2928,22,21,0,38,3399
51683910100,4656,1980,1808,393,2,246,9,21,2676
51683910201,5239,2337,2099,370,9,219,0,35,2902
51683910202,8207,1999,4408,887,10,583,2,57,6208
51683910301,4579,1617,1794,531,11,410,4,45,2962
51683910302,6436,2336,2396,925,13,440,3,52,4100
51683910401,7543,1423,4483,981,12,367,1,48,6120
51683910402,6112,3124,1357,827,8,438,0,59,2988
51685920100,7137,1524,4754,346,17,278,0,50,5613
51685920201,2872,683,1397,403,1,250,3,26,2189
51685920202,7210,2499,1648,1327,9,1299,10,57,4711
51690000100,3340,1236,257,1713,9,6,0,13,2104
51690000200,1983,174,84,1620,0,0,0,7,1809
51690000300,2506,1203,135,1003,3,36,3,5,1303
51690000400,2593,891,417,1180,9,12,1,10,1702
51690000500,3063,2228,132,527,2,62,0,11,835
51700030100,3770,631,295,2620,22,66,0,12,3139
51700030300,5874,357,198,4961,18,16,5,39,5517
51700030400,3453,108,92,3056,15,2,6,9,3345
51700030500,1931,86,83,1653,6,5,2,13,1845
51700030600,2335,74,90,2060,11,4,5,7,2261
51700030800,2023,85,59,1773,12,6,2,5,1938
51700030900,2616,483,209,1721,5,27,3,17,2133
51700031100,3783,1629,352,1455,20,91,6,25,2154
51700031200,2287,701,543,894,9,16,6,15,1586
51700031300,4311,1286,167,2611,22,34,6,22,3025
51700031400,5925,2485,374,2491,33,105,9,27,3440
51700031500,5984,3940,431,1129,25,80,4,41,2044
51700031602,4362,2756,289,905,22,90,17,18,1606
51700031603,4099,1767,293,1589,5,159,2,45,2332
51700031604,3055,1020,298,1388,9,141,6,34,2035
51700031701,4131,1435,280,2197,4,71,3,23,2696
51700031702,5361,2399,405,2255,1,82,1,10,2962
51700031800,3902,3290,160,183,4,71,5,19,612
51700031901,3793,2792,213,478,5,87,6,17,1001
51700031902,4270,2388,287,1240,10,89,9,9,1882
51700032001,3054,2164,159,408,10,124,0,15,890
51700032002,5960,3500,435,1243,14,338,14,36,2460
51700032005,2635,1724,192,379,4,139,6,11,911
51700032006,4226,856,396,2506,13,154,5,25,3370
51700032007,3419,1587,352,1067,6,143,1,21,1832
51700032113,3221,1284,542,1056,16,148,5,21,1937
51700032114,1668,844,164,415,3,118,1,9,824
51700032117,4325,2405,321,1189,18,141,9,27,1920
51700032123,5477,1498,639,2548,12,300,14,47,3979
51700032124,3684,904,406,1826,14,238,24,21,2780
51700032126,4095,1125,1651,964,4,78,2,57,2970
51700032128,4814,1497,911,2005,6,160,5,17,3317
51700032129,3337,1124,321,1484,6,106,4,38,2213
51700032130,5499,2817,439,1378,4,470,22,36,2682
51700032131,4667,1792,424,1841,12,240,1,22,2875
51700032132,5492,2267,621,1858,19,255,46,56,3225
51700032133,1927,777,182,730,2,103,2,6,1150
51700032134,2638,1076,216,979,8,180,1,14,1562
51700032211,6041,3194,515,1522,20,347,16,36,2847
51700032212,4223,515,918,2354,21,153,2,20,3708
51700032223,3896,733,430,2263,8,162,11,8,3163
51700032225,4376,783,683,2475,13,144,8,36,3593
51700032226,4461,955,1083,2008,9,112,20,37,3506
51700032227,4584,1456,522,2048,24,183,19,30,3128
51700032228,2808,764,242,1470,8,143,5,12,2044
51700032300,5160,2529,994,1000,28,227,55,33,2631
51700032400,3295,1368,412,1195,11,82,3,26,1927
51710000100,2357,1357,245,524,10,51,4,15,1000
51710000201,2824,1446,390,681,12,69,5,17,1378
51710000202,3807,2189,424,787,21,95,5,28,1618
51710000300,3112,1804,323,688,7,66,6,15,1308
51710000400,3333,1970,398,628,16,67,8,4,1363
51710000500,3190,1787,320,706,9,126,19,27,1403
51710000600,4506,1680,852,1532,10,117,22,21,2826
51710000700,2940,1801,282,524,7,108,0,15,1139
51710000800,2146,1055,350,470,9,87,1,14,1091
51710000901,6124,2799,1196,1458,42,175,25,17,3325
51710000902,14006,6171,3090,2977,77,741,107,125,7835
51710001100,2356,747,290,847,5,320,3,9,1609
51710001200,3772,2314,324,757,13,152,4,16,1458
51710001300,2337,756,226,1187,6,57,4,14,1581
51710001400,2546,1293,166,809,8,98,0,14,1253
51710001500,2039,1206,198,416,9,71,0,11,833
51710001600,1746,244,146,1194,11,56,3,8,1502
51710001700,2283,1261,195,625,5,57,2,25,1022
51710002000,1588,1024,120,284,5,39,0,7,564
51710002100,1495,1044,98,196,0,96,1,8,451
51710002200,1906,1468,111,166,6,41,4,8,438
51710002300,2249,1705,125,75,0,195,1,11,544
51710002400,3515,3032,142,73,5,92,0,11,483
51710002500,4561,1603,281,2280,9,159,5,24,2958
51710002600,4241,1331,218,2089,9,314,11,36,2910
51710002700,2744,568,167,1776,7,49,0,16,2176
51710002800,4359,2771,265,922,16,95,2,25,1588
51710002900,3581,619,161,2531,8,67,7,19,2962
51710003000,1880,1073,147,471,6,40,0,16,807
51710003100,2923,821,217,1655,4,49,3,4,2102
51710003200,2632,589,238,1611,7,52,7,8,2043
51710003300,2593,430,158,1855,2,26,1,15,2163
51710003400,2101,186,103,1687,0,17,2,6,1915
51710003501,3256,165,172,2748,11,21,0,12,3091
51710003600,2172,1386,166,357,5,127,6,3,786
51710003700,2148,1600,143,159,4,81,2,21,548
51710003800,2766,2209,129,175,0,83,5,26,557
51710004001,1223,919,58,55,0,87,1,27,304
51710004002,3294,2508,171,201,0,192,4,19,786
51710004100,1848,58,62,1661,4,3,2,5,1790
51710004200,1171,57,23,1044,6,2,3,7,1114
51710004300,3074,131,113,2718,11,10,0,5,2943
51710004400,1542,77,53,1328,5,14,0,9,1465
51710004500,1377,60,26,1181,5,38,0,4,1317
51710004600,1991,137,86,1685,8,10,0,1,1854
51710004700,2984,36,107,2770,46,12,0,2,2948
51710004800,1430,22,33,1292,9,5,0,15,1408
51710004900,5469,3293,406,1118,4,348,6,23,2176
51710005000,3164,111,116,2809,8,9,0,6,3053
51710005100,3897,207,155,3358,17,32,1,21,3690
51710005500,2854,1231,321,898,6,160,1,28,1623
51710005601,3904,2727,314,485,21,96,9,20,1177
51710005602,3358,1776,459,776,23,99,5,16,1582
51710005701,4212,812,572,2460,15,110,11,33,3400
51710005702,2624,527,213,1635,7,68,2,21,2097
51710005800,4296,477,475,3056,7,92,10,27,3819
51710005901,4963,708,589,3224,7,159,3,36,4255
51710005902,4068,1392,423,1613,19,380,10,24,2676
51710005903,1590,519,140,698,5,139,0,8,1071
51710006000,3485,1693,293,1055,3,161,22,14,1792
51710006100,7386,2270,664,3587,38,342,18,49,5116
51710006200,3241,1330,312,1210,21,153,6,14,1911
51710006400,3192,698,212,2039,1,46,6,24,2494
51710006501,2930,1456,379,789,12,73,1,28,1474
51710006502,3458,2368,245,549,14,91,9,32,1090
51710006601,1513,876,179,249,7,49,25,5,637
51710006602,2428,1654,281,206,13,81,3,10,774
51710006603,2356,1513,279,250,6,161,2,13,843
51710006604,2474,1157,504,545,9,93,0,14,1317
51710006605,2649,1466,273,530,23,175,6,18,1183
51710006606,4195,1776,580,1295,12,260,9,23,2419
51710006607,2865,1219,332,778,7,330,5,10,1646
51710006800,1682,909,140,437,6,95,0,6,773
51710006901,3571,912,393,1808,13,306,0,10,2659
51710006902,2398,1367,180,576,11,103,7,12,1031
51710007001,2265,315,176,1632,9,18,6,6,1950
51710007002,3443,936,217,2033,13,70,7,15,2507
51710980100,0,0,0,0,0,0,0,0,0
51710980200,7,1,0,0,0,0,0,0,6
51710980300,0,0,0,0,0,0,0,0,0
51710990000,0,0,0,0,0,0,0,0,0
51720960100,3687,3223,81,179,4,27,0,14,464
51730810100,2501,219,104,2058,4,10,2,5,2282
51730810300,2712,518,273,1778,24,6,2,18,2194
51730810400,1688,199,48,1336,0,23,0,6,1489
51730810500,4019,212,154,3498,4,14,1,23,3807
51730810600,1739,45,43,1573,7,21,1,2,1694
51730810700,1961,135,56,1685,14,5,0,0,1826
51730810900,3342,563,125,2508,12,35,2,23,2779
51730811000,4447,1060,212,2916,14,43,3,28,3387
51730811100,3274,527,161,2345,4,92,1,30,2747
51730811200,4749,953,651,2847,16,66,18,43,3796
51730811300,3026,747,143,1986,6,15,0,12,2279
51735340100,3876,3383,135,25,11,119,0,17,493
51735340200,5299,4639,197,57,10,88,2,34,660
51735340300,3285,2915,131,25,12,46,0,16,370
51735990100,0,0,0,0,0,0,0,0,0
51740210200,2119,1217,138,584,21,16,0,21,902
51740210300,2308,1174,118,836,16,19,4,14,1134
51740210400,1432,899,51,388,0,24,2,5,533
51740210500,1717,101,31,1513,4,7,3,8,1616
51740210600,1555,978,53,403,6,12,4,3,577
51740210900,4073,2016,264,1478,11,99,4,17,2057
51740211100,1933,99,42,1702,5,10,0,2,1834
51740211400,1860,61,32,1534,6,4,1,11,1799
51740211500,1953,662,85,1023,14,16,3,13,1291
51740211600,4015,2641,230,769,30,73,0,23,1374
51740211700,3109,298,113,2550,17,22,2,7,2811
51740211800,3483,188,127,3014,23,10,0,14,3295
51740211900,1632,106,60,1380,2,0,2,23,1526
51740212000,2146,76,103,1884,1,7,2,11,2070
51740212100,1285,57,28,1122,16,8,3,5,1228
51740212300,4895,1652,288,2510,11,76,8,38,3243
51740212400,3925,1167,220,2248,14,33,20,22,2758
51740212500,2150,961,187,802,19,50,0,22,1189
51740212600,1747,563,120,937,2,29,3,9,1184
51740212701,5258,395,111,4607,13,16,1,20,4863
51740212702,3238,168,54,2915,0,16,0,8,3070
51740212801,4709,1796,174,2446,15,36,4,14,2913
51740212802,2815,1890,117,595,11,31,6,18,925
51740212900,5246,4048,184,571,22,52,4,26,1198
51740213001,6440,3529,308,2054,21,157,8,29,2911
51740213002,4303,2967,177,830,10,66,11,19,1336
51740213101,5044,928,290,3442,19,54,11,17,4116
51740213103,6719,2496,298,3398,15,103,7,43,4223
51740213104,3976,675,150,2838,4,76,10,23,3301
51740213200,2206,772,160,1071,7,85,11,5,1434
51740980100,624,332,100,142,0,37,0,0,292
51750010101,3762,2857,212,358,3,59,0,42,905
51750010102,5376,3517,300,1139,15,100,0,204,1859
51750010201,4028,3090,143,518,10,35,0,16,938
51750010202,2904,2542,110,110,2,16,0,7,362
51760010201,1754,1296,54,290,3,28,2,15,458
51760010202,1963,1508,45,305,9,24,0,8,455
51760010300,1445,109,44,1215,5,10,1,4,1336
51760010401,2889,1852,78,802,5,37,1,26,1037
51760010402,3513,1920,61,1337,5,50,0,14,1593
51760010500,1465,410,35,946,3,9,0,14,1055
51760010600,1978,726,73,1043,4,30,0,18,1252
51760010700,2454,611,98,1606,8,25,0,7,1843
51760010800,3409,490,95,2644,9,21,0,28,2919
51760010900,2739,416,129,2043,13,19,0,25,2323
51760011000,2169,452,52,1516,17,18,0,18,1717
51760011100,3550,769,199,2300,3,90,3,22,2781
51760020100,1663,48,38,1528,1,5,1,0,1615
51760020200,3497,69,73,3248,0,1,0,11,3428
51760020300,1783,360,80,1205,6,27,0,10,1423
51760020400,4449,252,98,3940,13,9,0,39,4197
51760020501,3131,1780,182,861,11,146,4,16,1351
51760020502,3317,1921,236,725,4,230,7,17,1396
51760020600,1814,1261,87,319,3,46,0,19,553
51760020700,1614,538,76,889,11,26,0,5,1076
51760020800,1717,1203,85,260,2,48,0,23,514
51760020900,3090,834,104,1927,12,41,0,17,2256
51760021000,1623,347,76,1116,0,11,2,16,1276
51760021100,1738,390,108,1115,11,26,1,17,1348
51760021200,1420,301,58,969,7,6,0,11,1119
51760030100,2500,48,79,2244,10,0,0,4,2452
51760030200,2460,1211,195,761,3,112,1,28,1249
51760030501,3808,1963,330,610,3,635,1,24,1845
51760030502,2541,1497,157,360,3,365,2,23,1044
51760040201,3093,1167,326,1157,0,207,0,17,1926
51760040202,3356,2354,200,447,0,156,0,14,1002
51760040300,5560,2474,507,1251,7,950,0,37,3086
51760040400,4350,2934,286,605,5,249,1,22,1416
51760040500,3298,2696,171,195,0,75,0,17,602
51760040600,1863,1530,118,75,0,40,0,13,333
51760040700,2657,2177,153,133,0,71,0,2,480
51760040800,1440,1187,91,44,3,34,0,9,253
51760040900,2609,2166,139,110,3,47,4,10,443
51760041000,2715,2422,90,50,3,62,4,5,293
51760041100,4303,3243,266,413,6,184,0,15,1060
51760041200,1276,1015,78,58,0,66,0,1,261
51760041300,3042,1065,129,1571,1,107,3,11,1977
51760041400,2195,1200,84,779,4,34,1,8,995
51760041600,1421,882,54,402,2,15,0,2,539
51760050100,3118,2540,149,227,0,69,0,7,578
51760050200,3380,2964,160,58,0,63,0,11,416
51760050300,1427,1263,55,25,4,22,0,14,164
51760050400,3084,2725,64,173,2,21,1,16,359
51760050500,5045,4010,268,232,0,298,2,27,1035
51760050600,2637,2483,39,33,2,31,0,7,154
51760060200,2237,320,103,1709,5,11,0,9,1917
51760060400,5106,1001,264,3509,22,27,3,50,4105
51760060501,2116,1438,81,443,1,36,2,9,678
51760060502,3796,1732,225,1553,13,49,3,29,2064
51760060600,2497,2045,108,196,0,36,1,8,452
51760060700,5187,353,399,4225,7,7,1,15,4834
51760060800,3572,217,1434,1793,11,25,0,12,3355
51760060900,1613,206,922,402,2,16,0,13,1407
51760061001,2813,771,140,1702,4,45,0,27,2042
51760061002,4063,1831,294,1419,13,198,0,19,2232
51760070100,5711,4284,203,849,6,135,3,40,1427
51760070300,3441,1696,376,1183,2,60,4,17,1745
51760070400,3888,3004,130,529,7,83,0,7,884
51760070601,6806,406,4085,2029,15,80,3,76,6400
51760070602,2371,173,706,1406,6,7,0,13,2198
51760070700,5276,475,1820,2748,11,41,2,61,4801
51760070802,2890,436,888,1395,14,30,0,35,2454
51760070803,4699,403,1495,2618,7,14,4,64,4296
51760070804,3324,489,687,1967,2,57,0,23,2835
51760070901,4583,414,1061,2903,6,26,0,33,4169
51760070902,2466,346,356,1640,10,18,0,11,2120
51760071002,3414,729,476,1973,11,81,0,8,2685
51760071003,2998,560,350,1891,14,47,1,16,2438
51760071004,2594,475,297,1691,8,26,0,4,2119
51760071100,5787,2337,395,2555,17,148,0,35,3450
51770000100,3796,803,243,2503,11,34,0,17,2993
51770000300,4913,2182,1330,1028,12,142,6,29,2731
51770000400,5350,2890,990,674,5,500,14,37,2460
51770000500,4775,2491,812,1058,13,111,4,38,2284
51770000601,5098,3336,525,787,11,92,0,21,1762
51770000602,3656,2492,405,414,11,107,1,24,1164
51770000900,5759,1171,321,3689,13,205,1,26,4588
51770001000,2074,740,133,930,6,109,0,14,1334
51770001100,2067,1448,105,319,2,118,0,8,619
51770001200,3556,2572,169,464,6,122,2,26,984
51770001800,3929,3103,153,380,14,44,0,30,826
51770001900,5049,3814,324,493,4,167,1,24,1235
51770002100,3864,3270,162,216,5,50,0,9,594
51770002200,2834,1509,185,940,2,36,1,12,1325
51770002301,3253,845,334,1721,13,134,1,14,2408
51770002302,3803,1374,324,1784,3,60,4,21,2429
51770002400,3792,317,311,2922,10,22,1,31,3475
51770002501,2632,327,226,1877,11,22,0,14,2305
51770002502,2879,598,200,1903,7,13,0,16,2281
51770002600,2623,1541,266,576,2,28,0,13,1082
51770002700,5191,3661,346,728,17,36,4,18,1530
51770002800,5559,4315,221,564,11,69,0,21,1244
51770002900,5511,4834,122,248,5,93,0,25,677
51770003000,4095,3019,166,570,15,81,0,21,1076
51770003100,3953,3299,111,289,2,67,2,14,654
51775010100,5928,4499,273,761,7,80,1,17,1429
51775010200,6937,6079,193,253,10,138,3,6,858
51775010300,4378,3153,406,553,17,100,0,12,1225
51775010501,3357,2807,87,196,0,132,1,9,550
51775010502,4746,4135,129,150,8,84,0,22,611
51790000100,1145,899,53,112,3,12,0,6,246
51790000200,4096,2843,203,779,9,20,1,21,1253
51790000300,5340,4202,205,500,10,88,3,24,1138
51790000401,3964,3359,144,260,5,15,3,6,605
51790000402,3642,2975,101,298,11,12,1,37,667
51790000500,3239,2527,178,352,19,39,0,43,712
51790000600,4324,3154,204,581,8,134,3,18,1170
51800065100,2124,204,55,1752,7,2,0,3,1920
51800065200,2265,1336,62,763,4,9,0,12,929
51800065301,1458,704,30,638,4,0,3,7,754
51800065302,1713,407,53,1156,6,7,4,6,1306
51800065401,2387,283,76,1931,4,13,0,8,2104
51800065402,1149,43,29,1028,5,0,0,3,1106
51800065500,2830,119,49,2577,2,1,1,7,2711
51800075103,4005,929,269,2421,18,98,9,25,3076
51800075104,3213,1783,130,988,7,122,4,32,1430
51800075105,2730,1678,100,608,0,173,0,25,1052
51800075106,4866,1951,357,2032,22,144,1,37,2915
51800075202,1562,771,71,570,0,46,0,29,791
51800075203,4283,2151,274,1379,9,144,11,29,2132
51800075205,3267,1065,153,1769,10,111,3,17,2202
51800075206,2635,799,308,1286,4,44,4,28,1836
51800075207,1902,1281,85,400,0,37,0,4,621
51800075208,2815,2169,104,276,4,89,0,14,646
51800075301,2253,1818,71,220,18,42,0,8,435
51800075302,2455,1616,93,606,1,18,0,12,839
51800075401,3182,1465,144,1419,8,27,3,14,1717
51800075402,4572,1840,295,1962,21,156,10,45,2732
51800075404,1160,863,50,175,0,8,0,1,297
51800075405,2273,1982,48,175,7,11,0,0,291
51800075406,3605,1149,191,1961,8,82,3,31,2456
51800075407,1510,940,57,402,2,35,1,8,570
51800075502,4162,1854,223,1733,13,74,2,34,2308
51800075503,3135,1499,137,1237,13,60,0,16,1636
51800075504,3158,842,235,1861,12,19,0,35,2316
51800075601,3128,338,55,2621,3,18,0,1,2790
51800075602,1476,1197,26,155,5,10,4,0,279
51800075701,1667,878,64,643,6,10,3,9,789
51800075702,3408,2139,131,935,9,33,0,18,1269
51800075703,1521,1020,68,346,0,7,2,11,501
51800075801,3128,2447,85,397,17,6,0,7,681
51800075802,1825,1141,38,546,4,4,0,2,684
51800075803,1502,1136,36,226,2,12,0,5,366
51810040000,2548,1213,536,479,4,118,9,20,1335
51810040200,5391,1495,938,2397,33,195,9,45,3896
51810040403,4170,2226,381,976,3,277,5,32,1944
51810040404,8290,4672,627,1531,10,990,5,53,3618
51810040405,3003,832,399,1412,8,201,6,15,2171
51810040406,4910,903,516,2959,8,215,3,29,4007
51810040600,7591,2222,831,3449,19,548,19,51,5369
51810040801,4068,2319,427,802,18,216,15,17,1749
51810040802,4966,2253,464,1413,10,400,4,39,2713
51810041002,2356,1127,552,348,3,136,0,17,1229
51810041003,3534,2196,273,586,17,172,0,22,1338
51810041004,3964,2187,431,673,10,309,7,5,1777
51810041200,6428,4942,386,380,16,326,7,58,1486
51810041400,5386,3896,361,329,17,463,4,32,1490
51810041600,3485,2609,213,221,9,231,4,30,876
51810041801,5184,3531,545,571,11,111,11,10,1653
51810041803,2951,2530,162,35,2,74,3,10,421
51810041804,3124,2617,132,127,2,54,3,19,507
51810042000,3626,3062,135,72,6,158,2,25,564
51810042201,3745,2947,221,175,6,220,4,13,798
51810042202,4418,3580,232,210,16,152,4,13,838
51810042400,4902,3491,401,543,3,185,7,20,1411
51810042600,2468,1541,206,433,6,79,0,21,927
51810042801,5552,3383,559,893,24,213,3,23,2169
51810042802,4413,2107,527,1163,37,215,9,35,2306
51810043002,4439,3759,176,43,2,272,5,17,680
51810043004,4007,3457,193,60,10,91,0,13,550
51810043005,2167,1976,46,45,1,52,0,5,191
51810043006,2654,2312,134,32,1,58,3,11,342
51810043200,1187,640,210,161,12,43,5,4,547
51810043400,2128,1986,49,5,7,13,0,6,142
51810043600,1798,1664,47,4,2,22,1,3,134
51810043800,4104,3722,113,63,10,69,0,21,382
51810044004,2440,1842,166,182,18,61,10,14,598
51810044005,2251,1454,275,282,3,88,5,0,797
51810044006,3391,2339,309,411,15,120,2,18,1052
51810044007,3754,3160,169,137,13,59,1,24,594
51810044008,1835,1548,79,56,1,54,2,13,287
51810044201,2983,2108,189,402,11,78,9,14,875
51810044202,4041,1433,1095,1204,14,65,2,33,2608
51810044401,3752,3241,166,51,6,89,0,23,511
51810044402,5956,4559,375,494,15,194,5,23,1397
51810044600,5918,5190,186,171,13,107,4,29,728
51810044805,3252,1685,406,763,13,112,15,20,1567
51810044806,3313,1585,298,1018,11,127,10,22,1728
51810044807,5609,3175,523,1280,20,183,2,23,2434
51810044808,4106,2556,299,811,1,113,3,31,1550
51810045000,1362,625,300,258,7,78,6,12,737
51810045200,3299,1860,514,519,11,109,22,25,1439
51810045405,4579,1793,481,1405,8,503,17,35,2786
51810045407,4456,2502,464,643,15,462,4,30,1954
51810045408,6311,3813,763,898,21,285,8,34,2498
51810045412,1542,1392,38,9,2,32,0,6,150
51810045414,6068,2452,742,1801,9,476,5,31,3616
51810045415,1893,1095,206,300,4,131,14,11,798
51810045420,5520,4337,379,203,17,230,12,25,1183
51810045421,3599,2351,262,375,9,293,0,12,1248
51810045422,4859,3029,432,597,9,429,7,18,1830
51810045424,6960,5284,453,362,1,396,6,30,1676
51810045425,2846,2167,206,134,9,137,4,5,679
51810045426,6452,4584,547,522,12,322,7,39,1868
51810045427,6203,4278,510,747,21,178,14,46,1925
51810045428,1518,1267,84,70,2,37,3,4,251
51810045429,5202,1692,531,1419,17,1162,17,43,3510
51810045430,4079,1486,567,1219,20,459,2,29,2593
51810045431,4208,2982,304,324,6,241,11,15,1226
51810045432,4848,3656,344,348,9,157,4,25,1192
51810045433,4542,2810,285,994,6,232,9,21,1732
51810045434,5444,4024,308,393,6,406,10,26,1420
51810045601,2870,2113,174,257,6,126,3,25,757
51810045603,2192,1197,220,420,1,199,0,12,995
51810045605,2761,1472,268,616,17,172,3,16,1289
51810045606,3848,1413,486,1425,24,172,1,32,2435
51810045801,4672,2798,511,722,18,282,15,18,1874
51810045803,3206,1908,205,694,8,166,8,13,1298
51810045805,1293,798,101,208,0,86,0,6,495
51810045806,3906,1899,409,970,5,277,8,22,2007
51810045807,1552,755,162,429,5,109,7,6,797
51810045808,3231,1302,396,1018,12,277,7,20,1929
51810045809,6212,2438,738,1827,12,742,10,30,3774
51810045810,2082,437,162,1094,8,214,0,10,1645
51810046002,5483,3668,339,701,13,357,1,30,1815
51810046006,4379,3112,302,387,8,283,31,15,1267
51810046009,5352,3483,457,752,22,233,6,32,1869
51810046010,3017,1778,229,644,14,100,2,31,1239
51810046011,1521,969,96,252,6,95,2,19,552
51810046013,4460,1801,455,1314,17,535,5,18,2659
51810046014,6301,2526,657,1231,15,1406,16,35,3775
51810046015,5584,2713,567,1120,4,744,4,31,2871
51810046016,3888,2042,305,636,2,606,9,24,1846
51810046017,3423,1589,352,887,12,304,1,21,1834
51810046018,4389,1837,519,1063,15,586,3,22,2552
51810046019,3589,2018,289,834,4,178,2,30,1571
51810046020,5738,2384,787,1694,15,402,8,29,3354
51810046204,5308,3562,282,787,12,314,5,25,1746
51810046206,5313,2896,342,856,17,817,7,28,2417
51810046207,6204,2903,648,1532,25,669,12,33,3301
51810046211,3014,2053,226,310,9,178,6,19,961
51810046212,3950,2599,206,511,10,369,15,11,1351
51810046213,6052,2547,637,1641,16,748,4,47,3505
51810046214,5136,2627,492,984,6,630,5,17,2509
51810046216,6385,3114,571,1164,5,1000,10,48,3271
51810046217,5668,2241,447,1181,13,1366,6,50,3427
51810046219,4157,1581,371,952,19,903,2,17,2576
51810046220,5671,1910,395,2572,14,430,16,38,3761
51810046221,3817,960,369,1904,10,308,6,32,2857
51810046222,5087,3037,310,771,11,547,2,41,2050
51810046223,2685,1644,165,359,8,307,3,6,1041
51810046224,4614,1745,471,1343,7,671,3,43,2869
51810046225,4864,2362,420,938,15,729,5,20,2502
51810046400,5248,4584,188,191,6,36,3,34,664
51810990100,0,0,0,0,0,0,0,0,0
51820003100,1116,753,182,133,0,4,2,0,363
51820003200,5093,3207,663,831,11,21,2,16,1886
51820003300,4993,3271,474,892,3,48,5,31,1722
51820003400,5583,4344,372,434,10,125,1,41,1239
51820003500,5411,4499,254,320,9,60,10,16,912
51830370100,5119,3106,311,1357,9,126,4,20,2013
51830370200,2928,1443,393,818,4,74,17,17,1485
51830370300,7378,2821,511,3473,7,297,4,16,4557
51840000101,3267,1518,1148,380,5,45,3,16,1749
51840000102,3812,1557,1204,765,8,43,0,17,2255
51840000201,3679,2814,378,239,7,54,0,20,865
51840000202,5987,4830,350,268,4,279,5,28,1157
51840000301,5261,3278,951,649,25,63,3,28,1983
51840000302,6114,3626,1463,499,17,216,3,26,2488
53001950100,2579,2242,146,7,21,13,0,22,337
53001950200,1804,1483,212,2,9,11,0,20,321
53001950301,1759,661,1045,1,3,8,2,4,1098
53001950302,2599,268,2313,0,1,3,0,6,2331
53001950303,3067,641,2361,1,18,2,0,6,2426
53001950400,2859,687,2094,2,2,33,0,8,2172
53001950500,5946,847,4949,11,9,59,1,21,5099
53003960100,4392,3939,111,2,41,36,12,21,453
53003960200,4781,4266,150,25,30,58,4,12,515
53003960300,3614,3062,209,33,61,37,3,8,552
53003960400,2272,1924,135,15,27,15,7,19,348
53003960500,3476,2966,148,28,62,40,5,4,510
53003960600,3750,3316,162,10,41,20,3,24,434
53005010100,4684,3715,377,42,9,289,7,35,969
53005010201,6203,4714,619,106,18,356,27,27,1489
53005010203,3975,2632,725,57,18,288,0,26,1343
53005010204,3236,2036,703,98,16,151,6,27,1200
53005010300,5643,4283,796,82,31,111,12,44,1360
53005010400,3731,2677,630,33,29,69,16,37,1054
53005010500,3154,2292,483,51,27,56,13,20,862
53005010600,4551,3083,878,69,42,106,8,17,1468
53005010701,2184,1708,279,8,23,33,1,12,476
53005010703,3697,2553,834,23,28,30,5,19,1144
53005010705,5535,4523,516,38,23,109,4,47,1012
53005010707,3687,2977,345,25,27,91,3,14,710
53005010708,4532,3450,588,47,25,111,6,22,1082
53005010807,1558,1194,232,7,6,34,4,12,364
53005010809,6792,4395,1595,114,40,256,16,47,2397
53005010810,5430,4298,520,45,7,241,14,31,1132
53005010811,5530,4401,476,40,24,293,12,29,1129
53005010814,5129,4286,406,41,15,104,1,33,843
53005010815,9675,7088,1435,112,48,415,14,66,2587
53005010816,5525,4221,643,62,42,168,7,15,1304
53005010817,6613,4882,661,88,21,546,7,36,1731
53005010818,3358,2369,502,31,23,220,3,12,989
53005010819,3431,2687,260,56,6,211,9,24,744
53005010820,3916,2755,621,58,20,214,13,9,1161
53005010901,6025,3326,1984,179,56,104,14,29,2699
53005010902,5620,2898,2152,83,28,129,12,35,2722
53005011001,5482,2972,1948,157,27,104,13,13,2510
53005011002,5038,2560,1984,73,29,104,43,22,2478
53005011100,7838,4631,2530,113,56,103,39,32,3207
53005011201,4564,1551,2417,99,21,192,70,24,3013
53005011202,3168,976,1660,173,18,192,48,10,2192
53005011300,4925,2021,2511,71,29,99,13,10,2904
53005011401,4317,2055,1905,52,33,65,26,22,2262
53005011402,5492,3886,1098,44,34,70,12,24,1606
53005011501,6971,4384,2127,17,85,31,3,25,2587
53005011504,3367,2156,979,27,10,30,3,13,1211
53005011505,4534,3063,1055,60,25,138,4,16,1471
53005011506,6575,4930,985,57,32,197,6,28,1645
53005011600,835,442,366,2,4,4,1,0,393
53005011701,2591,1194,1259,7,7,17,0,15,1397
53005011702,4837,2413,2086,26,22,122,11,17,2424
53005011801,3366,1740,1451,16,32,8,0,17,1626
53005011802,3183,1410,1642,15,24,4,0,5,1773
53005011900,6355,3890,2064,17,51,29,10,31,2465
53005012000,21,1,12,0,0,0,0,0,20
53007960100,2661,1903,569,2,24,20,9,1,758
53007960201,4148,3494,378,18,18,27,0,19,654
53007960202,1825,1651,92,2,6,3,1,11,174
53007960203,957,853,21,4,12,2,0,18,104
53007960301,2687,1738,823,5,12,21,5,12,949
53007960302,2586,1485,1007,4,3,23,3,2,1101
53007960303,1811,1409,304,3,0,14,0,17,402
53007960400,4034,2489,1395,6,19,12,0,18,1545
53007960501,2938,1974,828,4,6,24,1,14,964
53007960502,4289,2915,1134,13,21,26,10,16,1374
53007960600,4235,2698,1251,6,15,40,7,39,1537
53007960700,4296,3512,459,6,19,79,13,13,784
53007960801,2948,2464,328,7,3,48,1,3,484
53007960803,3681,2348,1043,27,22,86,5,22,1333
53007960804,4567,2851,1365,13,34,63,8,19,1716
53007961001,2802,1781,832,10,16,22,1,22,1021
53007961002,3778,1797,1688,35,44,30,10,15,1981
53007961101,4554,1507,2852,9,26,16,5,12,3047
53007961102,5881,2793,2766,20,22,82,8,33,3088
53007961200,4531,3053,1153,19,31,35,3,35,1478
53007961301,1395,1158,140,8,3,7,7,12,237
53007961303,4063,2798,1030,21,30,36,4,9,1265
53007961304,4407,3422,646,11,22,71,8,19,985
53009000300,4593,3036,943,26,248,49,8,17,1557
53009000600,3451,2821,120,4,212,21,3,38,630
53009000700,4001,3214,211,47,141,62,4,20,787
53009000800,4186,3297,241,25,151,59,13,26,889
53009000900,2895,2373,145,21,76,52,2,17,522
53009001000,2388,1954,124,23,64,50,3,12,434
53009001100,3158,2554,179,27,97,67,9,9,604
53009001200,4039,3295,242,20,87,128,9,13,744
53009001300,3209,2705,162,24,60,22,6,30,504
53009001400,5009,4312,186,15,75,57,5,30,697
53009001500,2218,1524,79,9,388,31,0,17,694
53009001600,3490,3051,143,4,36,32,6,34,439
53009001701,2113,1758,107,12,21,48,0,14,355
53009001702,2913,2478,146,17,43,52,0,12,435
53009001800,3304,2864,139,4,36,41,0,10,440
53009001901,3188,2721,169,17,44,60,4,10,467
53009001902,3172,2705,170,15,50,54,6,15,467
53009002001,3003,2587,117,5,48,62,3,12,416
53009002002,3410,2886,162,14,41,89,1,19,524
53009002100,3774,2965,308,29,119,107,12,24,809
53009002301,1974,1684,70,8,53,29,3,3,290
53009002302,2496,2104,102,11,33,36,6,20,392
53009002400,3463,2145,318,190,502,19,7,30,1318
53009940000,1708,131,149,4,1306,7,3,0,1577
53009990100,0,0,0,0,0,0,0,0,0
53011040101,5606,5009,224,9,30,37,12,48,597
53011040102,3903,3498,155,5,13,20,1,28,405
53011040201,6560,5594,435,17,38,95,16,24,966
53011040202,4345,3842,182,6,28,40,18,24,503
53011040203,5642,4936,220,26,37,45,9,56,706
53011040301,2025,1664,146,12,10,62,7,10,361
53011040303,5527,4294,457,70,28,210,20,54,1233
53011040304,3054,2498,196,21,13,101,2,21,556
53011040305,3063,2565,202,15,26,55,13,8,498
53011040403,4209,3591,261,6,37,67,5,21,618
53011040407,5930,4767,621,50,23,83,21,34,1163
53011040408,3915,3329,202,20,21,95,10,30,586
53011040409,2180,1844,100,13,5,63,8,7,336
53011040411,2238,1755,137,51,8,142,13,12,483
53011040412,5915,4498,481,114,40,316,36,39,1417
53011040413,3272,2686,247,15,18,71,8,21,586
53011040414,6705,5379,607,79,20,148,28,20,1326
53011040415,4649,3873,349,23,33,71,12,12,776
53011040416,3592,3082,209,28,15,36,6,18,510
53011040504,5438,4664,223,102,62,56,2,30,774
53011040505,6207,5394,288,24,24,105,17,28,813
53011040507,2443,1807,373,26,16,25,11,21,636
53011040509,3218,2615,281,23,33,28,13,27,603
53011040510,6265,5251,287,45,24,159,12,22,1014
53011040511,2574,2202,139,4,14,40,3,6,372
53011040512,2458,2055,178,23,9,29,6,7,403
53011040513,4735,3975,316,48,31,78,9,8,760
53011040603,5009,4301,222,16,24,106,22,29,708
53011040604,7057,4982,801,161,29,499,110,41,2075
53011040605,7107,5381,604,55,31,433,15,29,1726
53011040608,5029,3553,355,63,19,658,12,18,1476
53011040609,5208,3596,322,47,9,826,6,21,1612
53011040610,4065,3033,306,45,9,378,6,13,1032
53011040703,6800,4769,1027,111,52,282,55,31,2031
53011040706,4057,2540,832,98,37,181,82,19,1517
53011040707,3318,2365,499,69,23,133,22,21,953
53011040709,5825,4315,561,116,34,406,27,27,1510
53011040711,3161,2072,503,82,23,174,38,13,1089
53011040712,6792,4895,697,138,50,429,45,25,1897
53011040713,4549,3444,305,90,23,379,24,25,1105
53011040714,4652,3064,699,169,32,353,49,16,1588
53011040715,2780,2353,204,7,17,26,11,14,427
53011040803,5540,4069,678,82,49,232,35,25,1471
53011040806,5143,3774,471,130,20,339,47,16,1369
53011040808,1755,1202,292,15,7,69,29,7,553
53011040809,6938,4377,1155,310,35,443,102,17,2561
53011040810,3856,2479,589,149,16,206,104,14,1377
53011040811,3593,2905,208,60,14,192,1,6,688
53011040812,5036,3899,433,88,30,276,16,16,1137
53011040904,6364,4598,843,167,56,190,46,31,1766
53011040905,3446,2849,261,25,16,101,8,19,597
53011040907,6597,5380,354,54,31,298,10,35,1217
53011040908,6931,5476,503,98,42,296,24,47,1455
53011040909,5293,4201,388,79,15,226,7,36,1092
53011040910,4421,3357,388,96,14,239,9,18,1064
53011041003,4266,3306,367,95,33,121,9,17,960
53011041005,2732,1503,875,79,15,17,55,18,1229
53011041007,3580,2499,572,61,43,95,14,46,1081
53011041008,3942,3222,291,32,23,113,23,13,720
53011041009,4047,3028,439,100,37,108,38,21,1019
53011041010,4725,3215,684,203,33,209,33,26,1510
53011041011,3663,2722,419,76,39,89,39,34,941
53011041104,4101,2775,567,130,18,162,139,16,1326
53011041105,6463,4685,729,193,27,329,52,29,1778
53011041107,3046,2180,334,84,19,202,39,5,866
53011041110,6905,4714,973,238,57,309,75,41,2191
53011041111,4068,1831,1248,293,54,167,134,22,2237
53011041112,6911,4332,1291,329,30,283,143,38,2579
53011041113,2322,1633,320,122,13,62,43,10,689
53011041114,4614,3292,556,129,17,193,94,29,1322
53011041203,5513,3596,1013,207,39,258,80,19,1917
53011041205,5386,3284,1121,152,39,273,169,25,2102
53011041206,6258,4326,934,161,39,283,92,26,1932
53011041207,2222,1322,537,52,16,56,43,21,900
53011041208,4652,3243,566,133,32,275,44,20,1409
53011041309,4905,3433,587,137,30,299,64,17,1472
53011041310,5013,3812,492,95,14,318,30,18,1201
53011041312,5506,3275,1143,197,31,310,171,11,2231
53011041313,3038,1778,660,136,21,148,73,27,1260
53011041317,6662,4293,1127,299,43,289,146,42,2369
53011041319,6590,4478,840,148,36,499,140,27,2112
53011041320,6580,4153,1098,200,38,451,127,42,2427
53011041321,2801,1873,343,54,10,282,25,11,928
53011041322,4919,2923,1091,190,42,190,107,34,1996
53011041323,5732,3554,1109,166,44,352,101,15,2178
53011041325,5579,3604,350,98,12,1086,25,9,1975
53011041326,2577,1744,344,53,12,202,38,15,833
53011041328,6058,4028,536,178,28,786,35,29,2030
53011041329,5397,3598,507,144,30,719,28,38,1799
53011041330,4887,3531,654,87,34,224,65,26,1356
53011041331,2934,1833,466,91,25,164,90,21,1101
53011041332,3599,2650,340,83,23,190,56,13,949
53011041333,3333,2438,379,80,21,135,35,4,895
53011041334,2958,1962,272,108,10,349,45,11,996
53011041335,6275,4297,652,192,43,576,88,43,1978
53011041336,3461,2058,763,118,16,174,113,19,1403
53011041337,3157,2261,337,72,32,166,57,18,896
53011041400,6176,4817,448,54,40,355,24,34,1359
53011041500,2781,2323,179,22,16,38,7,13,458
53011041600,3711,1913,1029,157,29,138,197,22,1798
53011041700,4145,2229,1157,183,29,107,158,32,1916
53011041800,4221,2577,1066,125,39,73,37,29,1644
53011041900,2098,1640,205,31,13,41,20,12,458
53011042000,1612,1315,118,39,12,28,5,5,297
53011042100,3187,2304,386,109,26,79,19,12,883
53011042300,3303,2465,316,95,36,99,21,32,838
53011042400,1924,1400,174,100,31,80,20,12,524
53011042500,1535,1180,137,23,5,43,2,22,355
53011042601,1966,1568,150,43,9,65,8,4,398
53011042602,3573,2449,538,156,36,77,36,24,1124
53011042700,4910,2648,1475,180,31,115,123,25,2262
53011042800,2932,2237,289,69,27,92,19,13,695
53011042900,1646,1135,221,41,7,54,74,7,511
53011043000,1885,1257,404,29,10,51,13,3,628
53011043100,4339,3090,556,104,24,215,47,4,1249
53013960200,3952,3347,304,6,41,21,0,18,605
53015000400,3996,3246,295,43,48,83,7,30,750
53015000501,2902,2225,335,38,37,41,16,2,677
53015000502,4912,3061,1046,103,80,71,115,25,1851
53015000601,3871,2800,551,42,52,108,29,12,1071
53015000602,3144,2545,237,21,42,108,10,9,599
53015000702,3160,2505,268,27,40,94,1,11,655
53015000703,1697,1385,152,6,19,54,4,2,312
53015000705,4039,3093,446,31,78,112,29,7,946
53015000706,3305,2600,316,32,44,85,4,16,705
53015000801,3536,2930,238,12,38,95,5,20,606
53015000802,3608,3032,213,19,64,66,6,8,576
53015000901,3834,3018,403,11,39,92,15,16,816
53015000902,3848,3058,393,38,35,73,18,21,790
53015001000,1336,959,197,10,32,9,19,11,377
53015001100,6254,4375,1004,51,105,63,184,27,1879
53015001200,4571,3799,304,20,61,86,23,20,772
53015001300,3856,2913,477,31,68,28,51,17,943
53015001501,3541,3084,175,3,30,40,4,30,457
53015001503,6105,4935,653,23,27,84,16,37,1170
53015001504,3492,2352,859,25,11,36,2,14,1140
53015001601,4387,3742,286,24,37,46,11,15,645
53015001602,2884,2482,137,6,21,29,5,16,402
53015001700,5857,5026,285,11,111,47,5,14,831
53015001800,2144,1828,113,3,31,14,5,15,316
53015001900,5278,4542,213,9,61,29,6,27,736
53015002001,3738,3274,122,7,49,23,12,16,464
53015002003,4871,4213,250,16,70,31,12,17,658
53015002004,2094,1834,77,1,27,11,6,15,260
53015002100,3899,2884,587,74,50,52,23,9,1015
53015980000,571,327,170,9,2,11,0,6,244
53017950101,3579,1492,1912,6,15,10,0,26,2087
53017950102,3059,1012,1869,12,83,1,0,8,2047
53017950200,2452,2023,275,1,24,12,0,27,429
53017950300,7295,3987,2906,17,31,52,18,28,3308
53017950400,7786,5426,1785,17,45,91,8,34,2360
53017950500,3596,2089,1245,18,30,49,0,12,1507
53017950600,4708,3452,872,24,27,84,9,14,1256
53017950700,4609,2519,1722,15,49,38,16,33,2090
53017950800,5854,3445,2051,7,34,69,4,21,2409
53019940000,1713,383,36,3,1205,11,0,3,1330
53019970100,2529,2182,74,17,44,11,7,13,347
53019970200,2936,2491,100,1,44,21,4,20,445
53021020101,2532,154,2296,6,33,16,2,6,2378
53021020102,5279,311,4717,44,6,126,4,12,4968
53021020103,3546,201,3167,68,2,74,0,7,3345
53021020201,1998,173,1752,13,19,5,2,0,1825
53021020202,3786,569,3017,59,35,20,26,6,3217
53021020300,5475,950,4257,94,17,59,12,17,4525
53021020401,1687,230,1430,10,5,1,2,6,1457
53021020402,1922,307,1551,16,0,12,23,0,1615
53021020403,3212,413,2690,52,2,26,5,4,2799
53021020404,2615,372,2119,45,2,30,4,2,2243
53021020501,5540,3930,1182,59,20,72,14,40,1610
53021020503,3351,2101,986,43,18,42,4,20,1250
53021020504,7046,2893,3516,136,29,149,8,45,4153
53021020603,5151,2364,2257,91,23,164,23,22,2787
53021020605,10570,5449,4152,156,33,333,25,43,5121
53021020606,8686,4536,3340,144,34,261,24,37,4150
53021020607,6332,3355,2389,94,16,189,8,36,2977
53021020608,6843,4173,2270,35,19,73,6,27,2670
53021020700,1499,827,596,4,12,2,0,6,672
53021020801,3525,1202,2240,0,1,20,1,2,2323
53021020802,6154,2715,2521,434,111,122,2,0,3439
53021980100,0,0,0,0,0,0,0,0,0
53023970300,2286,2055,110,3,18,9,0,5,231
53025010100,3633,2848,189,30,295,25,4,14,785
53025010200,3314,2592,508,18,20,39,4,16,722
53025010300,4642,3410,899,15,43,44,4,15,1232
53025010401,3241,2279,681,32,23,25,0,17,962
53025010402,5630,3675,1581,28,45,50,0,23,1955
53025010500,3341,1576,1611,4,9,19,0,21,1765
53025010600,7601,1523,5888,11,7,68,3,23,6078
53025010700,3327,1704,1508,4,12,16,2,6,1623
53025010800,4607,2238,1893,76,71,22,10,35,2369
53025010901,1590,943,544,3,10,19,7,16,647
53025010903,5527,2108,2982,71,32,150,14,15,3419
53025010904,6282,3861,1935,61,38,106,5,28,2421
53025011001,6660,4625,1468,56,41,128,10,36,2035
53025011002,6849,3909,2340,57,23,167,16,33,2940
53025011101,4188,2561,1250,39,17,116,0,20,1627
53025011102,3814,2042,1351,83,33,62,9,22,1772
53025011200,6132,4182,1618,22,38,48,0,16,1950
53025011300,3687,1191,2349,18,15,25,1,6,2496
53025011401,2581,957,1566,0,13,2,3,11,1624
53025011403,4708,244,4398,6,18,6,3,8,4464
53025011404,1411,253,1143,3,0,0,0,4,1158
53025011405,3042,570,2446,6,4,2,1,5,2472
53025011406,3316,959,2253,8,23,14,0,7,2357
53027000201,6728,5723,278,66,141,127,9,45,1005
53027000202,2018,1625,94,13,124,18,4,21,393
53027000300,3308,2631,278,17,123,25,8,27,677
53027000401,2927,2525,121,14,43,32,4,19,402
53027000402,3978,3348,215,23,59,68,4,24,630
53027000501,2994,2414,343,13,31,29,4,18,580
53027000502,4192,3186,530,37,109,59,6,26,1006
53027000600,4110,3475,219,11,48,43,12,18,635
53027000700,4740,3447,280,27,585,43,8,30,1293
53027000800,4238,3468,309,11,53,89,15,22,770
53027000900,6114,4341,1072,54,172,116,11,15,1773
53027001000,3796,2306,934,62,137,50,10,21,1490
53027001100,4330,3299,463,43,123,101,8,19,1031
53027001200,4477,3002,859,47,154,76,8,39,1475
53027001300,3535,2509,550,20,140,43,10,25,1026
53027001400,2144,1643,228,23,86,26,0,8,501
53027001500,3937,2996,382,38,166,35,5,15,941
53027001601,2995,2381,275,13,56,20,1,12,614
53027001602,3706,2614,282,430,92,20,0,7,1092
53027940000,1369,135,122,10,1053,4,0,0,1234
53027990000,0,0,0,0,0,0,0,0,0
53029970100,2830,2188,185,48,17,119,8,28,642
53029970200,1788,896,391,255,10,118,13,11,892
53029970300,5475,4246,500,92,43,155,25,20,1229
53029970401,3468,2253,332,137,15,345,44,33,1215
53029970402,3302,1783,565,154,31,458,31,23,1519
53029970500,6853,4949,592,195,39,470,30,38,1904
53029970601,3561,2096,458,202,35,395,19,10,1465
53029970602,3541,2351,391,147,25,312,5,14,1190
53029970700,2163,1335,269,150,21,144,27,22,828
53029970800,2767,1803,334,125,19,212,27,12,964
53029970900,5066,2623,1021,459,30,362,60,51,2443
53029971000,5158,4117,308,73,25,127,24,53,1041
53029971100,3610,2918,282,28,16,60,20,26,692
53029971301,2423,2079,106,11,12,46,4,17,344
53029971302,2414,2119,75,17,3,43,3,18,295
53029971400,4713,4140,162,27,27,104,11,18,573
53029971500,3848,3432,141,9,20,70,8,10,416
53029971600,4365,3677,221,33,37,75,10,26,688
53029971700,4430,3801,194,32,35,66,11,11,629
53029971800,2851,2485,108,13,20,41,9,10,366
53029971900,4067,3536,166,20,20,64,15,40,531
53029972000,4275,3676,163,17,25,74,4,40,599
53029972100,3889,3353,154,21,18,56,6,31,536
53029992201,0,0,0,0,0,0,0,0,0
53031950202,1936,1699,44,6,23,27,0,31,237
53031950301,3764,3277,139,19,31,62,4,25,487
53031950302,3071,2697,119,10,14,47,7,23,374
53031950400,4332,3708,190,13,66,51,12,14,624
53031950501,4724,4086,186,26,51,56,4,29,638
53031950502,2653,2285,101,11,30,39,8,27,368
53031950602,3591,3013,168,19,34,61,11,30,578
53031950603,3306,2828,163,26,18,48,2,18,478
53031950604,3483,3068,98,16,22,80,0,27,415
53031950702,2117,1555,97,61,233,16,1,5,562
53031990000,0,0,0,0,0,0,0,0,0
53033000101,3759,1452,644,789,26,554,15,26,2307
53033000102,4321,2466,354,436,18,696,12,31,1855
53033000201,4416,2393,496,401,16,764,14,25,2023
53033000202,4099,2405,393,232,21,630,9,25,1694
53033000300,2820,1690,256,169,10,453,0,19,1130
53033000402,5174,3491,428,295,32,519,12,34,1683
53033000403,3074,1937,244,274,9,369,11,22,1137
53033000404,4067,1666,532,881,35,621,16,25,2401
53033000500,3400,2703,135,36,4,251,3,25,697
53033000601,4074,2175,312,387,19,841,14,12,1899
53033000602,4006,2086,560,350,35,599,7,38,1920
53033000700,5204,2721,595,501,35,894,4,42,2483
53033000800,2693,1879,199,52,13,311,5,25,814
53033000900,2076,1452,99,27,7,297,3,15,624
53033001000,2012,1229,135,209,10,275,0,11,783
53033001100,2711,1745,217,126,5,360,9,31,966
53033001201,3781,1849,545,443,33,630,21,20,1932
53033001202,3880,1988,385,244,15,887,5,31,1892
53033001300,5085,2610,727,430,67,803,26,16,2475
53033001400,5298,3734,392,189,21,457,15,74,1564
53033001500,2679,2183,133,14,9,126,3,22,496
53033001600,4504,3426,207,92,8,380,13,24,1078
53033001701,4252,2752,390,187,31,477,19,41,1500
53033001702,5327,3551,411,197,41,674,5,38,1776
53033001800,5109,3059,536,218,19,794,6,42,2050
53033001900,4959,3247,286,181,11,809,20,26,1712
53033002000,3723,2613,264,78,8,422,8,32,1110
53033002100,4423,2905,280,120,20,742,5,11,1518
53033002200,5948,4319,262,52,22,823,5,24,1629
53033002400,3217,2276,155,47,5,425,8,11,941
53033002500,3155,2277,162,60,0,370,4,27,878
53033002600,5355,3820,313,101,22,592,3,53,1535
53033002700,5876,4352,343,72,12,558,2,29,1524
53033002800,4956,3757,339,42,8,398,2,44,1199
53033002900,4690,3771,280,38,17,227,1,18,919
53033003000,6493,4981,366,53,11,518,5,36,1512
53033003100,6545,5295,363,37,27,321,4,33,1250
53033003201,4724,3729,255,60,8,348,5,22,995
53033003202,4781,3633,261,75,17,404,4,21,1148
53033003301,4351,3068,270,81,13,593,3,29,1283
53033003302,3466,2540,256,37,19,328,4,17,926
53033003400,3560,2808,208,46,9,211,4,15,752
53033003500,4210,3383,216,40,20,231,3,25,827
53033003601,3838,2750,252,70,10,415,5,22,1088
53033003602,4574,2827,393,146,14,774,7,30,1747
53033003800,2469,1598,142,46,7,405,0,24,871
53033003900,3041,2128,140,31,9,409,1,13,913
53033004000,3308,1985,288,276,17,412,29,31,1323
53033004101,3914,3121,123,44,5,352,2,13,793
53033004102,4198,2920,190,52,14,703,6,31,1278
53033004201,3959,2722,224,165,12,465,8,33,1237
53033004202,4441,3261,276,48,13,441,8,51,1180
53033004301,3943,2584,244,66,12,707,4,30,1359
53033004302,3920,2263,351,114,11,853,3,17,1657
53033004401,3810,2625,336,87,8,485,1,7,1185
53033004402,3564,1758,357,98,15,1071,7,24,1806
53033004500,2972,2085,201,53,5,321,2,25,887
53033004600,3563,2748,215,36,7,243,1,13,815
53033004701,3639,2600,277,75,32,368,14,21,1039
53033004702,3917,2613,293,83,11,611,6,36,1304
53033004703,3635,2477,283,128,20,372,10,19,1158
53033004800,5113,3869,292,70,17,421,9,24,1244
53033004901,3846,2853,227,78,12,383,1,17,993
53033004902,3143,2218,204,78,10,386,0,26,925
53033005000,4523,3211,305,143,17,513,4,20,1312
53033005100,4012,3002,235,56,9,314,7,24,1010
53033005201,3898,2299,324,97,18,788,4,22,1599
53033005202,3595,1141,240,120,17,1818,8,18,2454
53033005303,5310,2345,590,152,24,1743,25,20,2965
53033005304,3506,1401,331,111,18,1357,29,15,2105
53033005305,2885,969,228,83,13,1400,11,11,1916
53033005306,3134,905,201,192,13,1593,6,14,2229
53033005307,2921,1876,250,78,10,500,3,16,1045
53033005401,3853,2745,258,93,15,468,7,33,1108
53033005402,3262,2340,176,43,7,407,3,15,922
53033005600,7130,5708,339,47,11,480,9,30,1422
53033005700,6586,4993,349,68,13,613,16,34,1593
53033005801,6116,4100,567,179,30,707,24,51,2016
53033005803,3347,2288,288,58,10,382,7,17,1059
53033005804,2993,1797,428,130,24,376,15,19,1196
53033005901,3570,2312,319,140,13,444,17,22,1258
53033005902,4127,3075,239,50,15,384,2,19,1052
53033006000,6061,4223,387,112,36,789,17,32,1838
53033006100,5667,4158,340,87,20,617,5,49,1509
53033006200,4075,3118,192,98,6,307,4,29,957
53033006300,5530,4567,259,60,7,300,0,19,963
53033006400,3420,2610,175,79,8,249,4,27,810
53033006500,4672,3524,308,69,1,396,8,29,1148
53033006600,4061,2777,293,90,11,608,10,19,1284
53033006701,4060,1598,288,129,8,1821,3,22,2462
53033006702,3256,1766,261,99,15,903,7,10,1490
53033006703,3259,2290,209,88,0,431,1,19,969
53033006800,3341,2534,220,27,10,322,0,10,807
53033006900,4698,3610,286,53,7,396,6,24,1088
53033007001,3757,2747,275,112,12,388,12,24,1010
53033007002,3981,2733,302,173,23,462,4,27,1248
53033007101,3221,1783,298,201,26,683,3,21,1438
53033007102,2661,1525,250,111,6,605,3,18,1136
53033007201,4646,2022,306,176,16,1882,6,20,2624
53033007202,4148,1871,316,272,12,1424,22,23,2277
53033007203,3421,1235,259,226,10,1449,9,24,2186
53033007301,3736,1520,288,212,20,1464,3,27,2216
53033007302,5290,2436,452,327,24,1680,10,72,2854
53033007303,3880,1805,250,160,4,1479,5,12,2075
53033007403,2545,1662,254,87,8,341,3,19,883
53033007404,2799,1944,253,60,7,306,4,28,855
53033007405,2801,1589,296,237,13,408,7,30,1212
53033007406,2589,1586,252,169,15,359,8,12,1003
53033007501,3915,2650,331,166,14,432,6,13,1265
53033007502,3474,2137,310,181,12,533,17,30,1337
53033007503,2460,1416,226,126,8,495,1,9,1044
53033007600,4344,2935,296,297,18,426,2,27,1409
53033007700,5390,3232,409,582,16,592,13,30,2158
53033007800,5285,3924,207,363,8,333,2,47,1361
53033007901,2807,1842,239,196,10,333,6,15,965
53033007902,3682,2097,344,407,16,504,9,12,1585
53033008002,4419,2526,358,353,54,860,11,39,1893
53033008003,4119,2133,280,268,30,1141,8,27,1986
53033008004,3410,1799,230,108,9,1072,2,21,1611
53033008101,2808,1639,220,128,29,595,7,20,1169
53033008102,3005,1746,218,356,51,440,2,20,1259
53033008200,4802,2648,391,269,17,1160,16,22,2154
53033008300,3417,1909,301,179,34,764,14,15,1508
53033008401,3469,1943,359,211,8,673,7,27,1526
53033008402,3012,1734,264,109,13,627,10,25,1278
53033008500,4464,2052,384,985,53,741,11,31,2412
53033008600,7639,3595,848,673,42,1773,55,30,4044
53033008700,4244,2258,472,585,17,515,14,34,1986
53033008800,3822,2223,312,685,12,250,10,22,1599
53033008900,5625,2906,456,1063,18,674,11,16,2719
53033009000,4284,1578,412,802,49,1025,16,28,2706
53033009100,2935,649,195,311,8,1603,6,19,2286
53033009200,3374,1321,357,428,77,913,22,20,2053
53033009300,3611,1798,459,294,55,670,23,18,1813
53033009400,6566,2581,888,467,37,2048,27,35,3985
53033009500,6747,3698,470,854,34,1064,6,42,3049
53033009600,5847,4638,330,97,30,367,1,35,1209
53033009701,5955,4635,369,134,36,335,5,21,1320
53033009702,5911,4650,372,69,20,265,11,35,1261
53033009801,3846,2962,241,86,9,200,10,13,884
53033009802,3523,2677,213,55,16,250,5,16,846
53033009900,6257,3942,614,357,27,691,29,36,2315
53033010001,4526,1502,468,1006,25,1178,5,16,3024
53033010002,4861,1884,845,300,23,1349,16,23,2977
53033010101,4328,1166,412,1406,30,979,31,22,3162
53033010102,4382,2162,375,847,13,616,4,18,2220
53033010200,5035,2970,333,530,12,705,19,49,2065
53033010301,3850,1449,298,862,15,893,18,29,2401
53033010302,3767,1963,340,533,22,542,9,29,1804
53033010401,4514,1048,351,426,13,2379,10,27,3466
53033010402,5097,1377,539,338,18,2412,19,21,3720
53033010501,4778,3161,446,218,12,538,6,35,1617
53033010502,5294,3929,403,122,19,404,11,15,1365
53033010601,4074,2954,291,137,29,268,12,43,1120
53033010602,3991,3150,259,72,19,186,13,12,841
53033010701,4121,1815,481,813,36,574,18,25,2306
53033010702,4536,1525,360,1693,25,601,34,22,3011
53033010800,5063,2538,489,424,43,1082,41,22,2525
53033010900,1457,922,142,90,9,162,2,11,535
53033011001,4790,706,249,1548,16,2047,8,30,4084
53033011002,4590,492,252,1168,14,2456,21,10,4098
53033011101,5747,1250,483,1364,12,2262,41,14,4497
53033011102,4652,1876,550,822,9,972,18,76,2776
53033011200,3736,1262,1176,361,48,581,39,23,2474
53033011300,6600,3347,981,576,70,1009,62,28,3253
53033011401,4226,2119,648,472,19,587,25,34,2107
53033011402,4199,1743,969,502,36,581,30,25,2456
53033011500,4452,3176,398,120,18,291,25,25,1276
53033011601,3555,2662,263,53,11,237,7,24,893
53033011602,3321,2655,234,49,6,149,9,28,666
53033011700,5657,900,462,1150,7,2714,53,20,4757
53033011801,3794,819,542,1048,17,1113,18,18,2975
53033011802,4223,1004,583,1601,13,711,40,16,3219
53033011901,3718,768,308,910,19,1446,32,14,2950
53033011902,3869,1422,303,718,21,1030,13,19,2447
53033012000,3560,2641,266,108,20,207,9,30,919
53033012100,2793,2173,236,19,9,146,4,29,620
53033020100,3335,2602,148,33,17,297,5,15,733
53033020200,5887,4033,425,206,32,755,11,45,1854
53033020301,3754,1917,451,295,31,788,38,9,1837
53033020302,3718,2094,365,253,20,731,11,12,1624
53033020401,3917,2315,498,200,27,538,15,35,1602
53033020402,5682,3636,421,329,28,759,6,46,2046
53033020500,7451,4349,675,588,39,1225,23,30,3102
53033020600,3842,2168,348,209,19,768,22,32,1674
53033020700,4170,2210,442,423,32,717,9,12,1960
53033020800,4599,3384,253,77,14,492,3,19,1215
53033020900,3700,2267,286,206,10,658,7,14,1433
53033021000,5966,3297,619,367,33,1088,66,28,2669
53033021100,4543,2611,410,487,25,664,10,18,1932
53033021300,4030,2535,335,185,17,675,6,17,1495
53033021400,3907,2954,187,53,9,323,9,36,953
53033021500,4622,3467,214,66,16,434,6,25,1155
53033021600,5458,3733,428,124,11,691,15,32,1725
53033021701,4604,2617,452,133,12,1026,12,26,1987
53033021702,4656,2771,721,120,27,619,26,40,1885
53033021802,6090,3525,672,105,17,1249,0,52,2565
53033021803,6097,4135,507,198,20,754,18,42,1962
53033021804,5632,3617,584,138,27,704,21,46,2015
53033021903,6187,3951,625,181,28,825,12,76,2236
53033021904,5762,2850,600,157,14,1655,12,75,2912
53033021905,5540,3243,721,80,40,1015,10,39,2297
53033021906,4673,2682,415,69,16,1078,4,63,1991
53033022001,5570,3725,545,59,16,853,11,36,1845
53033022003,5109,3246,529,114,27,733,7,62,1863
53033022005,5132,2959,548,172,20,962,7,45,2173
53033022006,3935,2580,268,60,7,750,2,19,1355
53033022101,5257,3727,305,79,12,653,6,47,1530
53033022102,6921,4477,525,109,16,1258,16,47,2444
53033022201,4583,3241,355,71,15,460,6,56,1342
53033022203,5419,3631,319,79,3,952,22,52,1788
53033022204,3815,2563,316,110,3,525,1,47,1252
53033022205,4071,2682,320,122,8,604,7,36,1389
53033022300,2878,2180,141,39,5,292,0,32,698
53033022401,4045,2781,306,64,5,530,10,26,1264
53033022402,5544,4029,288,86,6,737,0,30,1515
53033022501,4390,2844,274,41,6,883,1,35,1546
53033022502,4725,3273,307,72,8,789,3,31,1452
53033022603,6488,3552,512,100,21,1756,6,120,2936
53033022604,5238,3011,329,94,17,1351,21,48,2227
53033022605,6300,2849,771,152,17,2048,13,87,3451
53033022606,6060,3230,343,84,7,1960,6,41,2830
53033022701,3284,2276,159,60,6,562,4,12,1008
53033022702,4185,2851,261,58,21,694,29,17,1334
53033022703,2655,1646,191,25,1,603,2,12,1009
53033022802,5515,2693,283,78,20,2101,6,51,2822
53033022803,7566,2250,437,233,10,4276,5,34,5316
53033022804,4936,1265,688,202,12,2561,16,11,3671
53033022805,4181,1584,191,59,1,2119,8,35,2597
53033022901,3000,1582,198,39,1,973,6,8,1418
53033022902,6821,3809,318,89,13,2207,0,43,3012
53033023000,7193,3645,493,173,19,2405,5,71,3548
53033023100,4158,2110,363,64,6,1328,16,25,2048
53033023201,6652,1915,588,178,7,3741,2,25,4737
53033023202,5017,1656,971,307,12,1840,3,19,3361
53033023300,6895,3647,655,197,13,1871,19,27,3248
53033023401,4206,1781,427,209,12,1491,11,20,2425
53033023403,4371,2460,174,89,20,1326,9,17,1911
53033023404,3442,2466,140,30,3,588,5,14,976
53033023500,4063,2078,237,80,4,1372,5,33,1985
53033023601,4412,2068,253,106,4,1713,11,25,2344
53033023603,6705,1938,766,289,14,3410,4,43,4767
53033023604,6581,2588,962,270,21,2343,29,32,3993
53033023701,4254,2405,216,75,4,1247,5,17,1849
53033023702,1165,378,68,48,0,606,2,5,787
53033023801,3536,1622,274,79,9,1268,11,22,1914
53033023805,3076,1364,186,40,6,1337,0,18,1712
53033023806,3115,1268,180,54,0,1455,7,16,1847
53033023807,5750,2845,305,116,3,2180,10,39,2905
53033023808,2869,1030,188,115,4,1390,2,12,1839
53033023901,4551,2666,305,109,5,1142,18,17,1885
53033023902,3040,1782,126,44,1,864,0,24,1258
53033024001,4791,2074,213,109,16,2069,5,19,2717
53033024002,4230,1999,164,60,8,1807,7,17,2231
53033024100,4717,2920,149,4,2,1376,0,24,1797
53033024200,2898,1814,93,11,4,836,0,11,1084
53033024301,5153,2976,254,93,5,1461,3,28,2177
53033024302,3954,2552,184,36,6,824,13,37,1402
53033024400,3053,1849,199,49,5,711,2,16,1204
53033024500,5192,3317,203,44,4,1226,6,29,1875
53033024601,4665,3205,190,25,10,927,2,26,1460
53033024602,3731,2484,145,28,0,759,3,41,1247
53033024701,4053,1692,220,112,8,1774,12,30,2361
53033024703,3984,2183,180,103,8,1199,3,30,1801
53033024704,3799,1987,167,113,6,1273,9,15,1812
53033024800,6299,2333,471,204,7,2910,11,28,3966
53033024901,5344,1835,157,52,6,3022,4,25,3509
53033024902,4176,1817,221,76,9,1778,0,23,2359
53033024904,2908,1047,87,12,7,1617,0,14,1861
53033024905,4115,1713,129,56,2,1989,0,22,2402
53033025001,5638,2746,328,176,7,1978,6,32,2892
53033025005,6163,2708,369,219,5,2394,7,28,3455
53033025006,6613,3642,373,118,11,1948,15,36,2971
53033025007,4868,2327,289,181,13,1734,12,19,2541
53033025008,2499,1336,131,23,1,829,0,32,1163
53033025101,6028,2660,1236,318,20,1274,49,26,3368
53033025103,5073,1786,592,330,14,1992,24,37,3287
53033025104,4354,1952,444,103,26,1513,5,12,2402
53033025201,3965,1882,468,277,5,996,16,34,2083
53033025202,4674,2068,933,214,13,1063,32,26,2606
53033025302,5292,2233,776,809,54,939,57,35,3059
53033025303,2986,1291,556,340,21,461,18,35,1695
53033025304,3733,2125,394,187,10,722,12,28,1608
53033025401,3997,1354,1382,382,18,584,30,19,2643
53033025402,3785,1375,1061,407,34,586,27,27,2410
53033025500,5314,2036,1300,424,20,1203,35,33,3278
53033025601,5366,1909,846,384,6,1838,31,23,3457
53033025602,7173,3510,459,273,32,2291,16,31,3663
53033025702,3606,1854,360,285,7,777,35,18,1752
53033025703,3428,1465,620,497,12,462,29,14,1963
53033025704,2986,1664,264,318,11,468,12,17,1322
53033025803,5261,2015,1147,779,26,788,77,43,3246
53033025804,3757,1778,707,249,20,633,21,18,1979
53033025805,5606,2137,822,794,31,1306,65,15,3469
53033025806,5303,1620,474,686,18,2024,79,49,3683
53033026001,5551,1910,496,1071,27,1501,51,32,3641
53033026003,4599,814,575,2025,47,660,85,31,3785
53033026004,3927,1221,441,605,20,1322,25,34,2706
53033026101,4052,980,461,943,31,1359,24,25,3072
53033026102,3646,627,437,1135,34,1095,21,20,3019
53033026200,6469,2074,1269,1039,32,1451,156,42,4395
53033026300,1743,505,206,236,12,664,22,2,1238
53033026400,5982,2179,1676,831,57,725,130,25,3803
53033026500,4384,1331,868,821,44,972,65,32,3053
53033026600,2484,1089,455,143,13,590,16,15,1395
53033026700,5856,3231,1160,255,57,722,58,33,2625
53033026801,6594,1774,1899,1057,53,1297,97,28,4820
53033026802,6238,1703,1722,692,44,1636,101,21,4535
53033027000,3453,1336,854,195,34,673,89,27,2117
53033027100,3773,1270,1114,469,29,600,57,22,2503
53033027200,2931,876,638,446,18,773,51,9,2055
53033027300,6670,1640,1448,989,35,2097,98,21,5030
53033027400,5781,2136,1430,282,45,1336,147,35,3645
53033027500,4977,2230,1227,265,47,803,45,18,2747
53033027600,4324,2068,1266,320,19,325,72,11,2256
53033027701,5884,4889,333,40,14,144,6,53,995
53033027702,5171,4407,298,33,13,82,5,75,764
53033027800,3316,2698,163,44,17,166,15,23,618
53033027901,3757,2515,518,95,22,267,33,25,1242
53033027902,3885,1983,973,259,28,275,48,34,1902
53033028000,3797,1145,1300,523,28,467,114,20,2652
53033028100,2934,469,591,1046,8,606,106,0,2465
53033028200,5128,1343,984,1261,33,1021,204,22,3785
53033028300,6194,2177,842,812,26,1716,169,48,4017
53033028402,5921,1397,869,2011,19,1197,121,30,4524
53033028403,5787,1821,993,1679,32,806,175,19,3966
53033028500,4680,2016,1036,478,34,624,123,16,2664
53033028600,6662,4989,572,130,26,425,26,32,1673
53033028700,5418,3407,676,246,31,527,82,12,2011
53033028801,3732,1803,763,527,103,319,16,21,1929
53033028802,6976,1843,1602,1700,42,1071,341,32,5133
53033028901,3653,2196,463,245,18,332,112,16,1457
53033028902,7177,1799,1835,1756,49,848,360,33,5378
53033029001,4485,2753,529,218,48,572,40,12,1732
53033029003,6266,2175,1458,903,31,1076,207,44,4091
53033029004,4016,844,1746,416,31,640,47,30,3172
53033029101,4231,1112,484,1046,20,1143,145,17,3119
53033029102,4675,1776,918,676,37,753,155,33,2899
53033029203,4405,1774,844,682,28,575,192,30,2631
53033029205,5119,1812,1177,814,23,772,165,24,3307
53033029206,4582,1310,1426,714,45,404,349,12,3272
53033029207,2917,1109,275,223,12,996,67,19,1808
53033029208,4520,1303,893,827,40,876,173,32,3217
53033029304,5750,2604,573,443,27,1552,34,55,3146
53033029305,4667,1691,507,426,24,1643,81,16,2976
53033029306,4361,1647,309,454,14,1609,48,32,2714
53033029307,3903,2193,364,185,35,759,23,21,1710
53033029308,3534,1117,254,448,12,1427,25,13,2417
53033029309,5047,1901,463,685,21,1553,54,22,3146
53033029403,6306,2133,775,729,19,2126,146,20,4173
53033029405,6269,2555,600,590,13,1900,145,41,3714
53033029406,5346,2170,452,509,21,1771,81,19,3176
53033029407,5112,1649,919,815,36,1195,144,43,3463
53033029408,4626,1365,986,668,21,1154,112,24,3261
53033029504,6469,2187,910,1203,32,1480,168,50,4282
53033029505,3963,1204,571,481,18,1266,129,31,2759
53033029506,4844,1305,1207,758,15,933,247,49,3539
53033029507,3674,1679,347,308,8,1060,49,17,1995
53033029508,4165,1640,490,252,16,1457,54,16,2525
53033029602,7288,3714,600,428,19,2005,52,25,3574
53033029603,3925,1182,459,486,11,1382,77,40,2743
53033029604,3888,1687,613,506,22,653,99,35,2201
53033029701,5089,2405,1279,487,36,436,86,27,2684
53033029702,3226,1438,481,316,3,714,77,11,1788
53033029803,4347,1683,983,681,24,482,146,42,2664
53033029804,4468,2020,603,490,34,879,140,22,2448
53033029805,5153,2548,895,389,19,785,129,43,2605
53033029806,4548,2090,517,369,24,1109,93,28,2458
53033029901,4834,2714,725,352,13,568,118,27,2120
53033029902,5744,3057,535,300,28,1395,69,19,2687
53033030003,6592,2884,1255,901,30,946,104,47,3708
53033030005,6117,1751,2476,597,23,757,159,16,4366
53033030006,4318,1262,1314,717,31,639,186,7,3056
53033030007,4554,758,966,1472,22,761,260,25,3796
53033030008,4745,1317,1102,823,25,898,222,23,3428
53033030101,3772,2074,621,279,29,351,142,17,1698
53033030102,3694,2355,252,144,7,618,64,20,1339
53033030201,5662,2259,1337,638,26,730,197,34,3403
53033030203,4167,1187,854,978,19,543,243,26,2980
53033030204,3803,1666,724,486,22,578,78,21,2137
53033030304,4537,1976,557,621,18,694,232,35,2561
53033030305,5425,2917,683,490,27,624,204,31,2508
53033030306,5864,2988,958,542,31,694,185,41,2876
53033030308,6883,2269,1362,1117,31,1138,426,47,4614
53033030309,5906,2084,1091,902,35,921,352,48,3822
53033030310,6466,2447,875,632,21,1798,217,33,4019
53033030311,5093,2098,1470,496,33,547,109,20,2995
53033030312,5538,2159,1092,804,54,599,284,41,3379
53033030313,4835,1591,1000,1099,40,516,265,34,3244
53033030314,4655,1912,873,676,42,766,72,25,2743
53033030403,4638,2863,440,245,26,666,64,23,1775
53033030404,5264,3239,600,191,21,767,74,41,2025
53033030405,3559,2255,400,121,17,465,34,30,1304
53033030406,3145,1658,433,289,30,374,117,21,1487
53033030407,3151,1048,368,427,30,952,95,9,2103
53033030501,2985,1671,472,306,29,209,78,26,1314
53033030503,6406,2813,915,637,61,1225,265,32,3593
53033030504,5137,2645,1043,453,48,361,218,24,2492
53033030600,5776,3274,963,347,55,337,297,39,2502
53033030700,4317,2010,940,435,70,302,183,41,2307
53033030801,7411,2050,3934,481,84,210,290,46,5361
53033030802,4460,1902,1160,289,55,373,341,19,2558
53033030901,3916,2053,745,197,47,514,64,16,1863
53033030902,6262,2999,1327,349,75,701,291,40,3263
53033031000,4948,2869,489,278,27,718,117,38,2079
53033031101,3726,1619,732,280,424,222,193,10,2107
53033031102,3718,1661,822,209,282,281,135,23,2057
53033031202,6718,4211,625,72,1141,152,36,46,2507
53033031204,6258,4828,577,63,74,272,13,27,1430
53033031206,5213,2617,1303,258,38,609,94,14,2596
53033031207,5265,2156,621,896,40,897,163,25,3109
53033031208,4282,2277,618,308,22,688,65,19,2005
53033031301,2518,1959,354,7,26,33,5,16,559
53033031302,4856,3798,570,41,47,57,15,21,1058
53033031400,5811,4833,454,39,53,34,8,25,978
53033031501,4094,3402,339,12,26,60,3,26,692
53033031502,5000,4159,317,31,58,57,25,22,841
53033031601,5285,3961,511,85,26,288,18,29,1324
53033031603,6801,5009,655,100,41,467,19,50,1792
53033031604,6017,4094,527,175,34,610,18,20,1923
53033031605,3686,3027,290,31,24,74,10,10,659
53033031704,6201,2995,817,587,34,1216,87,31,3206
53033031705,4147,2598,363,233,16,526,61,42,1549
53033031707,3739,2132,360,208,16,711,34,19,1607
53033031708,3973,2405,681,166,16,436,35,7,1568
53033031709,3810,2141,333,219,5,741,19,19,1669
53033031710,3934,2426,414,303,25,383,29,18,1508
53033031800,4944,3165,314,177,17,892,41,18,1779
53033031904,3496,2672,251,70,12,170,6,22,824
53033031906,3975,2470,303,121,10,733,2,30,1505
53033031908,4470,2295,546,515,15,598,51,37,2175
53033031909,3052,1669,239,237,16,611,21,19,1383
53033031910,3840,2068,399,258,7,749,22,22,1772
53033031911,4165,2079,275,238,19,1192,37,38,2086
53033031912,3946,2584,507,48,25,433,25,23,1362
53033031913,3708,2149,284,96,21,831,4,16,1559
53033032002,3070,2524,162,24,11,110,11,10,546
53033032003,5135,4162,295,58,25,151,2,28,973
53033032005,6956,4386,1113,260,44,493,36,43,2570
53033032006,5339,3934,458,148,31,258,34,43,1405
53033032007,4172,3092,368,83,9,262,18,21,1080
53033032008,4488,3375,336,100,16,174,19,17,1113
53033032010,6720,4673,540,182,27,692,23,35,2047
53033032011,5247,3745,399,138,24,480,5,16,1502
53033032102,4883,3996,253,28,19,215,0,31,887
53033032103,6347,4245,626,100,16,962,13,47,2102
53033032104,6294,4568,571,70,14,585,9,39,1726
53033032207,3809,2382,179,25,5,955,0,6,1427
53033032211,5359,2593,386,57,11,2001,8,26,2766
53033032213,4415,2800,215,26,6,1084,0,18,1615
53033032215,5813,2688,301,44,2,2418,0,26,3125
53033032216,4825,2122,240,63,7,2167,8,14,2703
53033032217,4340,2647,208,51,10,1186,3,32,1693
53033032218,5442,3337,258,52,6,1507,4,22,2105
53033032219,4529,2397,301,76,11,1450,2,27,2132
53033032220,8837,4163,688,288,26,3017,17,37,4674
53033032221,6818,3729,283,97,10,2220,4,35,3089
53033032222,3881,1917,270,94,9,1330,4,10,1964
53033032223,4727,2359,348,56,6,1642,10,20,2368
53033032224,3456,1154,118,86,5,1862,1,7,2302
53033032225,4313,1854,209,52,8,1906,1,35,2459
53033032307,6401,5026,381,45,14,375,7,35,1375
53033032311,5925,4734,285,51,7,346,4,54,1191
53033032313,7670,2262,489,125,13,4497,8,32,5408
53033032315,5586,4265,309,27,10,538,9,39,1321
53033032316,5892,3433,270,54,18,1818,0,27,2459
53033032317,6617,4037,369,101,10,1668,14,16,2580
53033032318,6903,3077,326,62,2,2991,7,31,3826
53033032319,6068,4177,638,136,21,629,11,25,1891
53033032320,4529,3575,203,27,13,341,8,27,954
53033032321,7837,3530,349,77,12,3407,4,58,4307
53033032322,3299,2300,136,27,6,600,3,15,999
53033032323,6630,3576,356,104,16,2170,17,22,3054
53033032324,5866,3083,519,97,21,1667,4,36,2783
53033032325,7196,3057,811,325,23,2493,19,56,4139
53033032326,3723,2451,449,30,0,552,3,13,1272
53033032327,4127,3423,149,21,4,366,0,15,704
53033032328,3309,2319,218,23,2,512,4,8,990
53033032330,5224,2234,356,145,17,2110,9,83,2990
53033032331,5509,2578,437,157,23,1993,6,55,2931
53033032332,5543,2368,272,99,15,2483,4,19,3175
53033032333,4360,1498,356,165,3,2109,2,22,2862
53033032401,6677,5303,528,36,24,311,0,53,1374
53033032402,6828,5275,741,46,31,267,3,23,1553
53033032500,5835,4638,431,47,30,255,9,57,1197
53033032601,2866,2334,230,8,27,52,5,16,532
53033032603,4681,3613,197,31,19,438,7,10,1068
53033032604,5941,3817,429,125,35,1101,7,25,2124
53033032605,4126,3075,249,26,20,408,4,13,1051
53033032703,1941,1543,178,24,33,22,0,9,398
53033032704,7644,6136,599,44,67,263,14,28,1508
53033032705,3727,3054,241,24,14,104,5,8,673
53033032706,3112,2620,164,19,28,55,10,22,492
53033032800,2898,2491,98,11,36,48,4,7,407
53033990100,0,0,0,0,0,0,0,0,0
53035080101,3210,2056,305,125,17,312,98,13,1154
53035080102,5229,2941,746,301,55,583,75,38,2288
53035080200,3872,2498,384,180,46,302,104,30,1374
53035080300,3948,2429,552,257,46,267,68,23,1519
53035080400,3657,2781,298,97,15,137,16,18,876
53035080500,3168,2060,372,238,31,162,45,16,1108
53035080600,5268,3428,606,218,54,302,37,61,1840
53035080700,3579,2774,279,66,32,115,24,20,805
53035080800,2384,1242,485,256,20,86,56,13,1142
53035080900,4465,3144,496,104,57,170,50,26,1321
53035081000,4674,2881,553,348,54,263,53,22,1793
53035081100,3093,2124,339,102,24,150,29,21,969
53035081200,3035,1960,382,180,15,121,57,17,1075
53035081400,3737,1729,862,669,38,167,26,15,2008
53035090101,6058,4408,461,28,701,94,5,25,1650
53035090102,6506,5224,384,44,85,157,18,43,1282
53035090201,5072,4070,305,67,36,211,14,35,1002
53035090202,5621,4431,423,45,58,225,18,30,1190
53035090300,5482,3265,1002,494,34,208,32,29,2217
53035090400,4833,3756,402,45,30,206,26,54,1077
53035090501,4404,3451,350,53,49,178,21,17,953
53035090502,5527,4051,676,61,42,267,17,8,1476
53035090700,5211,4410,232,24,3,175,0,27,801
53035090800,4380,3654,212,19,20,127,16,31,726
53035090901,3997,3284,219,28,16,166,4,33,713
53035090902,3970,3350,164,15,13,159,6,41,620
53035091001,3568,2993,160,13,22,125,6,17,575
53035091002,3699,3208,153,23,6,72,1,3,491
53035091100,5162,4105,393,53,46,163,32,43,1057
53035091201,4268,2708,454,142,37,426,33,15,1560
53035091204,3213,2186,275,115,18,323,35,13,1027
53035091205,3870,2231,329,94,28,692,49,16,1639
53035091206,4175,2318,640,238,25,415,86,34,1857
53035091301,4494,3631,252,39,46,95,21,48,863
53035091302,5905,4606,304,64,26,350,26,29,1299
53035091400,3478,2537,265,92,22,220,35,22,941
53035091500,4346,2818,352,97,29,392,127,32,1528
53035091600,7326,4326,872,272,65,797,175,31,3000
53035091701,4145,2763,294,114,19,409,65,36,1382
53035091702,4186,2570,420,190,43,368,111,19,1616
53035091800,2997,2184,309,53,23,155,10,24,813
53035091900,4669,2832,532,166,21,562,87,26,1837
53035092000,5927,4958,300,46,39,96,23,43,969
53035092101,5067,3880,368,98,46,248,35,34,1187
53035092102,5079,3324,599,146,30,404,54,50,1755
53035092200,7250,4855,707,238,82,414,158,46,2395
53035092300,6642,4555,619,187,84,370,144,47,2087
53035092400,6517,4645,669,187,53,218,112,38,1872
53035092500,6269,4832,439,136,61,216,39,37,1437
53035092600,6381,5040,417,95,42,196,72,33,1341
53035092701,4798,3905,231,46,30,116,43,37,893
53035092704,3433,2785,186,25,27,64,20,31,648
53035092801,4698,3510,374,65,42,180,56,44,1188
53035092802,4443,3557,229,52,37,103,44,59,886
53035092803,3054,2515,184,12,41,44,23,23,539
53035092901,5874,4729,309,58,47,110,75,43,1145
53035092902,5826,4627,362,59,57,110,75,51,1199
53035940000,3664,2951,208,22,134,68,9,27,713
53035940100,6808,4935,490,37,572,184,18,25,1873
53035990100,0,0,0,0,0,0,0,0,0
53037975101,2894,2624,75,0,17,27,8,23,270
53037975102,1170,1000,50,0,32,0,0,6,170
53037975103,1374,1190,78,2,8,22,0,2,184
53037975104,2027,1758,124,8,7,27,0,15,269
53037975201,2842,2475,147,4,16,22,4,15,367
53037975202,1528,1326,80,10,10,7,6,3,202
53037975203,1305,1119,89,4,5,8,4,8,186
53037975300,5246,4478,370,17,24,41,4,39,768
53037975402,5644,4478,702,31,44,69,12,26,1166
53037975403,1751,1338,195,18,26,57,0,9,413
53037975404,4744,3135,660,145,113,299,27,19,1609
53037975500,6667,4855,1003,80,42,216,17,46,1812
53037975600,2418,1738,361,51,41,84,5,15,680
53037975700,4727,3809,660,10,22,28,0,20,918
53039950101,1407,1007,299,7,42,3,0,1,400
53039950102,3116,2715,162,5,53,18,11,10,401
53039950103,4409,3568,330,17,173,28,6,28,841
53039950200,4524,3725,311,7,118,24,7,37,799
53039950301,3402,2715,446,2,16,26,4,15,687
53039950302,5877,4001,1365,26,101,36,7,22,1876
53041970100,3670,3174,158,10,45,35,6,15,496
53041970200,4033,3148,559,17,26,39,10,15,885
53041970300,5577,4065,986,71,67,79,20,12,1512
53041970400,6266,4284,1369,54,54,81,8,29,1982
53041970500,2304,1795,236,20,30,16,14,7,509
53041970600,2220,1559,402,13,25,42,6,16,661
53041970700,4284,2862,910,52,56,38,0,19,1422
53041970800,4306,3407,474,34,39,58,13,21,899
53041970900,2008,1417,335,59,26,20,4,14,591
53041971000,3208,2498,401,40,25,47,7,11,710
53041971100,4398,3713,299,16,32,35,7,47,685
53041971200,3828,3284,205,6,81,21,9,20,544
53041971300,5983,4942,538,19,46,48,12,21,1041
53041971400,2923,2456,183,28,33,59,4,14,467
53041971501,2802,2192,313,17,34,11,9,15,610
53041971502,4860,4190,243,10,70,35,9,18,670
53041971600,4046,3345,259,22,84,34,11,11,701
53041971700,5079,4136,525,11,63,37,6,22,943
53041971800,4612,3986,195,8,65,31,1,51,626
53041971900,2865,2500,141,14,38,13,1,16,365
53041972000,2877,2543,99,9,39,17,0,9,334
53043960100,1718,1445,101,2,51,14,6,6,273
53043960200,3319,2966,99,1,53,17,0,11,353
53043960300,2852,2519,75,1,77,21,7,16,333
53043960400,2987,2646,110,11,23,15,1,24,341
53045940000,723,155,32,2,460,4,5,3,568
53045960100,797,677,29,3,18,16,2,1,120
53045960201,2537,2113,122,10,53,42,5,23,424
53045960202,3421,2800,220,16,91,30,4,26,621
53045960301,2302,1917,100,1,28,32,22,21,385
53045960302,4439,3299,582,54,39,42,24,27,1140
53045960401,4932,3917,471,39,62,85,17,20,1015
53045960402,2022,1615,185,7,17,24,7,24,407
53045960403,2683,2245,187,13,31,26,3,24,438
53045960500,5635,4748,333,30,100,75,13,29,887
53045960600,5811,3778,1051,306,161,47,27,21,2033
53045960700,1775,992,609,6,31,15,7,15,783
53045960800,4049,2747,876,33,109,41,4,12,1302
53045960900,5208,3289,1301,37,108,63,22,20,1919
53045961000,5115,4043,460,15,134,74,22,48,1072
53045961101,2314,1987,94,7,26,26,2,33,327
53045961102,4234,3331,371,50,68,29,14,24,903
53045961200,4049,3395,248,47,46,41,7,39,654
53045961300,3680,2543,324,12,377,46,9,12,1137
53047940100,2777,594,97,5,1894,12,4,12,2183
53047940200,3314,774,716,4,1608,6,3,24,2540
53047970301,3161,2154,740,17,74,27,0,21,1007
53047970302,1911,1331,415,8,37,16,6,14,580
53047970303,2234,1961,70,7,35,7,0,19,273
53047970400,3883,2719,845,10,54,18,4,38,1164
53047970500,2511,1992,253,19,79,19,0,8,519
53047970601,3184,2109,551,22,245,36,1,17,1075
53047970602,3531,2412,540,31,300,41,3,5,1119
53047970700,4036,2765,779,9,171,20,6,41,1271
53047970800,4680,1668,2818,12,43,22,4,15,3012
53047970900,2768,2531,79,3,8,22,6,15,237
53047971000,4114,3512,294,12,40,22,3,42,602
53049950200,4639,3368,612,14,122,197,6,30,1271
53049950301,2294,1626,298,8,147,41,1,28,668
53049950302,1452,938,304,10,46,86,5,0,514
53049950400,4025,3425,253,30,58,46,8,15,600
53049950501,1876,1551,136,10,19,19,5,0,325
53049950502,1020,822,82,5,17,6,3,6,198
53049950600,1474,1184,145,11,19,15,3,5,290
53049950701,1325,1121,88,2,20,7,0,7,204
53049950702,2215,1905,136,2,22,18,5,9,310
53049950801,1822,1602,85,4,20,19,0,4,220
53049950802,1223,1067,57,4,11,7,3,15,156
53049990100,0,0,0,0,0,0,0,0,0
53051970100,2079,1847,84,7,41,3,0,6,232
53051970200,2719,2201,89,7,248,4,3,14,518
53051970300,3219,2852,126,13,30,31,0,16,367
53051970400,2872,2538,102,18,26,10,6,21,334
53051970500,2512,2246,47,9,28,21,0,8,266
53053060200,2247,1063,686,125,24,200,25,5,1184
53053060300,5424,4251,309,141,39,260,12,27,1173
53053060400,4243,3442,274,47,14,99,10,11,801
53053060500,4120,3356,199,47,20,140,6,20,764
53053060600,5617,4273,419,185,29,207,15,34,1344
53053060700,7330,5479,533,236,58,395,49,39,1851
53053060800,5597,4437,352,89,34,167,17,40,1160
53053060903,3272,2501,155,204,22,180,17,7,771
53053060904,4968,3464,441,221,42,210,38,36,1504
53053060906,2153,1615,112,121,19,107,4,25,538
53053060907,3717,2525,303,370,26,166,17,27,1192
53053060908,2807,1992,188,170,23,220,6,7,815
53053061001,4026,2894,284,177,32,328,27,13,1132
53053061002,4733,2845,443,488,41,363,92,32,1888
53053061100,6745,4470,562,483,52,458,32,52,2275
53053061200,5184,3404,559,413,56,164,32,41,1780
53053061300,5049,2646,549,867,63,218,105,48,2403
53053061400,4730,2194,659,924,121,251,124,28,2536
53053061501,2671,1741,272,239,42,127,15,24,930
53053061502,2946,2051,311,163,14,133,12,11,895
53053061601,1909,1108,166,189,23,256,11,19,801
53053061602,1655,894,195,204,45,114,23,10,761
53053061700,5292,2271,726,1085,61,418,92,52,3021
53053061800,2898,1411,532,339,38,175,82,18,1487
53053061900,2007,1089,256,171,27,181,39,18,918
53053062000,4374,2113,829,400,100,379,109,37,2261
53053062300,5977,2069,1455,573,126,1085,177,38,3908
53053062400,5796,3413,705,459,71,398,113,28,2383
53053062501,4313,2260,613,381,51,412,86,26,2053
53053062502,3215,1666,490,329,42,240,54,13,1549
53053062600,4365,1985,655,726,66,352,98,37,2380
53053062801,7347,3233,1151,1396,65,447,206,49,4114
53053062802,4589,2249,603,603,61,472,140,23,2340
53053062901,4666,1825,817,841,32,450,154,23,2841
53053062902,4016,2200,548,317,46,396,84,29,1816
53053063000,3268,1510,602,381,66,220,123,22,1758
53053063100,4663,2443,565,437,66,528,102,56,2220
53053063200,5181,2779,686,441,86,545,91,36,2402
53053063301,4167,1247,1097,600,56,695,104,29,2920
53053063302,4261,1276,1059,468,79,858,180,13,2985
53053063401,4425,1989,765,494,58,534,149,25,2436
53053063402,4109,1828,675,429,90,524,152,39,2281
53053063501,4520,1628,796,679,45,668,133,35,2892
53053063502,5352,1603,803,747,53,1367,250,34,3749
53053070100,3900,3272,260,18,32,36,4,6,628
53053070204,3734,2916,372,38,42,61,14,30,818
53053070205,3523,2865,299,13,26,26,3,35,658
53053070206,4722,4083,198,13,47,32,0,39,639
53053070207,5769,4872,316,39,75,64,18,28,897
53053070208,7162,5340,569,147,22,336,39,44,1822
53053070209,4085,3124,352,61,34,84,19,38,961
53053070307,5712,4839,288,30,41,139,23,12,873
53053070308,5179,3763,432,151,94,121,57,22,1416
53053070309,6640,5163,545,71,68,170,45,25,1477
53053070310,5408,4075,535,78,52,152,35,50,1333
53053070311,5066,3906,548,61,43,75,13,41,1160
53053070312,6784,5049,547,190,57,300,29,50,1735
53053070313,6441,5159,444,61,45,119,15,28,1282
53053070314,3432,2635,201,43,28,218,22,20,797
53053070315,7040,4500,592,278,47,996,51,36,2540
53053070316,5468,2967,581,410,51,894,71,15,2501
53053070401,2233,1673,265,21,18,70,10,4,560
53053070403,4524,3538,381,84,39,102,29,42,986
53053070404,6045,4579,514,136,53,158,69,16,1466
53053070703,6594,4496,751,237,65,373,113,29,2098
53053071100,2551,1814,307,56,54,114,7,4,737
53053071205,4953,3729,368,140,69,227,37,10,1224
53053071206,7118,4786,769,309,69,407,79,31,2332
53053071207,7619,4862,1021,398,60,455,146,41,2757
53053071209,4086,3064,355,107,35,148,8,12,1022
53053071210,5698,4139,539,109,33,392,46,40,1559
53053071211,4993,3372,588,243,64,198,133,13,1621
53053071212,3986,2393,495,229,35,335,80,31,1593
53053071304,7273,4475,887,474,66,483,162,54,2798
53053071305,4281,2626,721,201,44,254,70,20,1655
53053071306,6558,4242,687,419,103,371,116,48,2316
53053071307,5335,3619,556,232,50,262,103,24,1716
53053071309,4545,2748,586,271,45,326,93,36,1797
53053071310,7363,4321,690,586,65,753,149,56,3042
53053071403,4193,2599,473,312,57,197,118,49,1594
53053071408,4296,2084,845,381,44,243,228,6,2212
53053071409,4755,2544,690,459,73,246,204,15,2211
53053071411,7481,3168,1475,873,56,595,465,33,4313
53053071412,7734,3871,994,899,48,596,425,66,3863
53053071413,2650,1467,334,215,8,183,109,36,1183
53053071414,4408,2577,560,343,34,250,115,21,1831
53053071415,2787,1876,322,130,35,85,46,9,911
53053071416,3329,1614,627,303,38,201,181,20,1715
53053071417,6112,2751,810,825,46,663,324,29,3361
53053071503,5671,2942,876,510,61,507,226,13,2729
53053071504,5791,3065,863,505,58,361,260,36,2726
53053071505,5560,3200,578,447,67,435,204,40,2360
53053071506,5556,3172,557,493,80,426,214,47,2384
53053071601,5340,2032,1565,488,71,643,114,39,3308
53053071603,3702,1761,734,327,65,352,148,8,1941
53053071604,4750,1726,791,910,44,451,274,37,3024
53053071703,4319,1244,1305,940,16,364,177,31,3075
53053071704,4686,1262,1444,885,32,202,417,35,3424
53053071705,4024,1821,853,412,62,336,161,22,2203
53053071706,1943,818,335,285,34,106,97,14,1125
53053071707,2899,1420,488,271,31,200,92,61,1479
53053071803,6098,2190,1025,1207,46,761,263,37,3908
53053071805,3716,989,1061,521,28,573,173,40,2727
53053071806,4665,1235,1470,846,50,193,396,46,3430
53053071807,4270,1410,1073,718,33,364,247,37,2860
53053071808,4459,1355,1560,454,36,467,194,26,3104
53053071901,5139,2584,660,599,57,538,150,31,2555
53053071902,5723,3890,475,312,59,378,123,37,1833
53053072000,5060,2317,1158,599,50,231,164,38,2743
53053072105,5505,3200,410,604,36,620,88,27,2305
53053072106,6507,3098,1024,886,56,584,195,39,3409
53053072107,4550,2747,482,375,17,370,81,30,1803
53053072108,5588,2895,796,576,66,382,200,59,2693
53053072109,3871,2616,353,186,24,255,20,23,1255
53053072111,2784,1747,263,149,21,214,40,12,1037
53053072112,5059,2480,661,557,38,514,194,31,2579
53053072305,6449,4487,485,446,37,282,22,32,1962
53053072307,4773,2829,449,445,31,437,67,23,1944
53053072309,6248,4155,572,440,44,433,46,20,2093
53053072310,4111,2670,417,277,29,255,46,16,1441
53053072311,5116,2971,493,660,23,376,92,27,2145
53053072312,5930,2744,690,816,28,908,120,30,3186
53053072313,4446,2579,324,318,12,757,32,23,1867
53053072314,4750,2655,508,451,24,607,43,26,2095
53053072315,3056,2028,266,141,21,274,24,10,1028
53053072405,4381,3661,253,33,15,103,4,35,720
53053072406,6895,5481,556,47,20,242,16,59,1414
53053072407,5049,3916,376,82,37,210,37,31,1133
53053072408,6377,5236,373,72,30,222,34,18,1141
53053072409,2520,2131,139,11,12,55,4,14,389
53053072410,3921,3336,209,21,23,75,7,27,585
53053072503,4421,3595,249,23,33,103,12,32,826
53053072504,5048,4069,373,122,87,101,6,19,979
53053072506,3676,3097,140,28,18,102,13,36,579
53053072507,3197,2757,137,21,5,75,4,13,440
53053072508,4430,3585,270,53,45,138,21,28,845
53053072509,6438,4965,427,77,15,453,17,34,1473
53053072601,5481,4373,395,56,51,84,28,23,1108
53053072602,4086,3417,193,17,25,47,20,44,669
53053072603,5981,4768,383,90,106,99,19,49,1213
53053072801,5284,2707,759,458,32,718,54,31,2577
53053072802,4938,2777,592,357,35,613,63,48,2161
53053072901,3195,1778,589,312,28,105,71,16,1417
53053072903,6762,3099,1577,1059,58,296,161,45,3663
53053072907,4393,1909,1139,500,56,170,176,29,2484
53053072908,7871,3925,1816,957,72,395,193,25,3946
53053072909,1805,923,417,242,21,109,21,0,882
53053073001,6546,5162,515,89,84,104,61,23,1384
53053073005,5668,4599,325,52,76,87,40,34,1069
53053073006,4271,3439,279,26,48,73,15,44,832
53053073110,3820,2917,294,102,44,130,28,11,903
53053073111,4448,3057,566,153,61,153,51,43,1391
53053073114,5486,3858,533,219,64,155,110,38,1628
53053073115,4506,3356,504,89,47,103,67,19,1150
53053073116,4966,3704,458,122,63,109,58,25,1262
53053073117,3971,3279,223,34,44,57,6,21,692
53053073118,4802,3862,364,38,57,106,17,17,940
53053073119,3446,2864,205,24,26,36,8,19,582
53053073120,5152,2941,677,303,47,446,144,34,2211
53053073121,5246,3265,619,259,39,379,134,27,1981
53053073122,5718,3475,806,350,30,392,86,21,2243
53053073123,5891,3987,490,279,34,489,82,51,1904
53053073124,3940,2595,430,208,34,216,58,18,1345
53053073126,3984,1889,515,460,22,500,161,25,2095
53053073127,4190,1907,1107,298,44,323,120,20,2283
53053073128,6739,3659,1009,605,73,395,246,45,3080
53053073129,5700,2982,775,477,50,529,194,47,2718
53053073130,3618,2765,343,100,23,56,17,28,853
53053073131,3346,2112,418,204,30,188,58,18,1234
53053073132,4449,2668,563,268,26,261,114,33,1781
53053073133,3856,2313,530,260,58,161,141,12,1543
53053073200,6418,5383,347,48,73,63,22,27,1035
53053073301,5994,4116,1001,91,48,202,55,31,1878
53053073302,4616,3463,470,77,36,118,59,29,1153
53053073404,6452,4941,554,108,59,242,62,40,1511
53053073405,3632,2417,373,177,46,241,65,25,1215
53053073406,5942,4155,584,235,48,314,98,32,1787
53053073407,3602,2595,379,85,116,96,33,30,1007
53053073408,4422,3251,575,99,54,114,37,14,1171
53053073501,4394,3225,323,107,22,308,44,16,1169
53053073502,4489,3589,292,87,28,137,21,15,900
53053940001,2838,2078,158,89,33,250,11,16,760
53053940002,4327,2179,669,310,105,481,160,21,2148
53053940004,6867,5060,614,133,214,279,47,29,1807
53053940005,6571,3235,995,529,160,842,172,26,3336
53053940006,3651,852,469,774,54,845,163,38,2799
53053940007,3485,1161,760,348,361,355,139,27,2324
53053940008,6158,3509,647,466,51,840,132,31,2649
53053940009,4020,2581,410,170,37,377,97,14,1439
53053940010,5083,3205,605,290,72,320,133,59,1878
53053940011,4308,2871,302,156,16,558,17,19,1437
53053940012,4418,1708,802,431,86,446,535,27,2710
53053940013,3912,1460,420,443,54,962,149,12,2452
53055960101,2736,2322,204,15,1,39,4,22,414
53055960102,1468,1279,40,0,12,20,2,26,189
53055960103,1796,1558,112,6,8,14,1,9,238
53055960301,2722,2427,123,2,6,39,0,14,295
53055960302,2492,2165,125,5,12,23,1,18,327
53055960400,3418,2566,479,17,25,55,9,21,852
53055960501,1792,1542,113,2,14,21,3,12,250
53055960502,1364,1165,102,1,14,13,3,0,199
53055990100,0,0,0,0,0,0,0,0,0
53057940201,2488,2126,119,13,10,64,0,18,362
53057940301,2579,2200,115,15,23,55,1,14,379
53057940302,2975,2604,105,19,21,39,1,24,371
53057940401,3182,2670,164,20,19,90,5,11,512
53057940402,1645,1378,107,14,12,40,1,11,267
53057940403,3011,2533,160,17,24,72,14,9,478
53057940500,2633,2032,287,13,24,68,11,20,601
53057940600,1681,1409,99,4,21,31,6,8,272
53057940700,1593,1372,69,6,6,20,0,16,221
53057940801,1472,1287,54,9,30,23,1,5,185
53057940802,1756,866,60,11,681,18,2,6,890
53057950100,948,827,41,4,11,9,3,7,121
53057950801,2051,1677,210,7,5,21,3,13,374
53057950802,3004,2482,261,11,33,48,0,9,522
53057950803,1513,1260,117,10,12,37,4,5,253
53057950900,4447,3514,346,29,239,37,3,36,933
53057951000,3086,2642,211,6,16,24,1,19,444
53057951101,1900,1655,66,10,34,16,2,18,245
53057951102,3199,2705,176,3,105,26,6,11,494
53057951200,3604,2989,278,19,25,55,4,26,615
53057951300,2155,1759,201,10,20,14,3,21,396
53057951400,4480,3355,701,21,40,37,9,27,1125
53057951501,3421,2477,642,12,37,19,9,7,944
53057951502,3457,2560,562,13,49,50,15,31,897
53057951503,3968,2831,780,28,34,62,27,30,1137
53057951600,4573,2763,1407,29,32,71,24,27,1810
53057951700,3885,2505,1025,32,26,68,8,27,1380
53057951800,4969,2482,1914,62,75,160,23,19,2487
53057951900,3874,3250,292,5,21,86,1,28,624
53057952100,3521,2625,623,11,55,46,0,13,896
53057952200,4560,2307,1715,48,47,146,35,24,2253
53057952301,4922,1753,2762,40,37,130,53,3,3169
53057952303,3832,1894,1588,36,14,87,38,24,1938
53057952304,6657,4327,1337,66,40,478,36,43,2330
53057952401,2914,1878,844,13,20,43,3,12,1036
53057952403,5814,4164,988,42,37,240,4,27,1650
53057952404,1899,546,1253,7,8,25,5,4,1353
53057952405,1121,702,320,10,15,40,0,0,419
53057952500,2830,1721,785,35,29,59,12,24,1109
53057952600,4031,2969,716,24,45,59,7,11,1062
53057952700,3873,3251,292,9,20,58,8,35,622
53057990100,0,0,0,0,0,0,0,0,0
53059950100,104,92,3,0,0,3,0,0,12
53059950200,5048,4238,238,63,80,67,20,44,810
53059950300,2015,1752,96,0,27,24,1,9,263
53059950400,2279,1891,192,6,27,16,8,15,388
53059950500,2590,2087,236,3,36,10,0,11,503
53061040100,4372,3298,367,183,25,192,5,13,1074
53061040200,5538,3122,1086,224,49,356,234,47,2416
53061040300,3108,2358,328,72,39,99,6,24,750
53061040400,4564,3024,603,257,58,213,33,15,1540
53061040500,2556,1788,368,43,47,70,25,12,768
53061040700,4542,3090,455,254,66,218,86,27,1452
53061040800,3327,2376,314,112,49,191,32,20,951
53061040900,3052,2268,256,69,13,205,22,7,784
53061041000,5904,4036,774,241,49,274,41,42,1868
53061041100,5036,3267,767,191,56,371,17,29,1769
53061041201,3439,2077,521,93,33,398,14,31,1362
53061041202,5980,3418,1008,325,42,648,87,29,2562
53061041301,5646,4101,337,105,35,615,9,32,1545
53061041303,4886,2804,933,200,14,491,82,24,2082
53061041304,3005,2170,180,70,21,318,23,13,835
53061041400,6219,3635,1169,292,49,493,56,32,2584
53061041500,2055,1343,207,92,10,227,7,8,712
53061041601,6205,3826,619,215,37,957,37,55,2379
53061041605,6006,3883,636,207,33,739,33,44,2123
53061041606,7143,3905,955,389,31,1220,79,46,3238
53061041607,3829,2685,263,74,14,477,9,25,1144
53061041609,3436,2393,235,55,24,478,12,18,1043
53061041610,4020,2593,309,132,19,644,14,22,1427
53061041701,5850,3087,791,448,24,1005,105,21,2763
53061041703,7305,3692,924,290,27,1771,31,42,3613
53061041704,6652,3737,936,414,30,892,51,42,2915
53061041805,6354,3031,1302,440,29,1085,48,42,3323
53061041808,4539,2381,1106,159,24,549,49,34,2158
53061041809,5609,2399,1442,571,35,704,58,33,3210
53061041810,5362,2270,1372,629,53,613,61,22,3092
53061041812,6450,2840,981,530,28,1592,81,31,3610
53061041813,4360,1927,1167,295,28,651,39,20,2433
53061041814,4542,2298,899,328,36,661,45,13,2244
53061041815,3893,1652,880,392,21,600,54,28,2241
53061041816,5070,2007,407,461,12,1742,43,32,3063
53061041901,6645,2970,1162,633,32,1329,59,26,3675
53061041904,6104,2333,2056,437,64,649,146,24,3771
53061041905,5999,2798,1296,622,43,792,69,34,3201
53061041906,3844,1519,1388,288,38,297,83,19,2325
53061041907,3899,1772,968,247,22,511,98,12,2127
53061042001,6030,4087,428,87,23,876,22,44,1943
53061042003,3338,2440,214,63,15,363,5,22,898
53061042004,4952,2760,364,308,37,1109,22,27,2192
53061042005,5377,3226,235,85,12,1440,9,25,2151
53061042006,5143,2628,586,235,17,1276,11,66,2515
53061050101,2861,1914,197,146,26,307,18,37,947
53061050102,6100,3110,798,488,25,1072,65,58,2990
53061050200,4387,3325,272,56,7,335,5,24,1062
53061050300,5552,4476,309,54,28,271,11,20,1076
53061050402,5693,4007,395,263,26,531,53,33,1686
53061050403,3912,3075,239,57,13,275,6,23,837
53061050404,3567,2195,515,214,19,349,14,15,1372
53061050501,3704,3173,133,15,12,157,0,10,531
53061050502,3714,3108,136,24,14,206,8,13,606
53061050600,1286,1018,39,8,3,133,1,5,268
53061050700,6596,4743,571,208,26,494,12,43,1853
53061050800,6619,4421,488,286,52,786,27,35,2198
53061050900,3497,1892,522,268,18,527,31,17,1605
53061051000,4663,2562,779,340,31,494,48,25,2101
53061051100,4182,2572,503,147,32,543,25,31,1610
53061051200,4613,2676,657,210,19,577,43,55,1937
53061051301,3935,2387,373,188,42,601,41,31,1548
53061051302,3473,2257,314,152,27,371,38,17,1216
53061051401,4239,1825,1070,362,39,675,20,22,2414
53061051402,4224,1774,852,465,18,781,19,24,2450
53061051500,5707,3028,970,377,31,880,55,34,2679
53061051601,5552,2722,1018,333,22,1014,29,26,2830
53061051602,4214,2702,464,195,16,517,14,31,1512
53061051701,6015,3021,923,504,44,1072,47,39,2994
53061051702,5129,2655,513,382,26,1213,29,30,2474
53061051802,6942,2936,737,452,40,2230,67,38,4006
53061051803,6998,3082,1261,704,39,1256,82,82,3916
53061051804,6172,2495,590,656,18,1883,72,65,3677
53061051912,2373,1848,191,19,7,144,3,9,525
53061051913,4574,3197,273,80,20,575,12,29,1377
53061051914,4306,3131,273,45,6,466,14,31,1175
53061051916,4504,2987,369,76,28,713,9,26,1517
53061051917,4223,3066,200,70,17,538,12,16,1157
53061051918,6077,3761,452,70,20,1349,18,30,2316
53061051921,5941,2954,897,194,25,1421,26,28,2987
53061051922,6110,3277,548,223,18,1569,9,33,2833
53061051926,6079,3026,251,48,14,2373,9,33,3053
53061051927,6072,3309,451,181,14,1636,52,20,2763
53061051928,5808,2646,821,325,18,1402,72,59,3162
53061051929,5026,2399,670,558,36,919,40,29,2627
53061051930,4660,2628,563,287,29,806,10,26,2032
53061051931,4474,2462,281,153,19,1154,24,14,2012
53061051932,4083,2754,435,87,15,459,6,30,1329
53061051933,3382,1490,491,199,14,795,29,54,1892
53061051934,3974,2164,359,123,15,993,28,23,1810
53061051935,3477,2015,262,56,8,861,10,11,1462
53061051936,4524,2007,787,215,18,1164,6,67,2517
53061051937,4901,2215,236,90,14,2051,6,25,2686
53061051938,4820,2190,312,114,28,1820,12,41,2630
53061052004,6540,4104,484,161,20,1231,30,43,2436
53061052005,5892,3974,375,108,15,1029,9,26,1918
53061052006,4291,2716,279,82,10,854,7,16,1575
53061052007,5408,2855,554,159,15,1360,17,49,2553
53061052008,4665,2357,308,130,10,1549,19,26,2308
53061052009,4196,1268,193,81,17,2407,8,14,2928
53061052010,3955,1841,319,139,7,1351,17,27,2114
53061052104,3891,2643,444,88,23,360,22,24,1248
53061052105,1977,1544,292,13,20,27,2,2,433
53061052107,8325,3471,508,135,17,3663,23,48,4854
53061052108,6124,4954,414,27,29,224,6,32,1170
53061052112,2795,2287,154,8,18,128,4,23,508
53061052113,3163,2591,172,15,17,117,3,19,572
53061052114,4903,3591,276,42,15,576,1,20,1312
53061052119,3192,2035,286,77,21,501,6,14,1157
53061052120,3496,2581,293,66,6,285,14,6,915
53061052121,3737,2563,246,99,21,441,19,22,1174
53061052122,3697,2802,247,23,11,331,7,16,895
53061052203,7170,5439,659,89,39,431,16,54,1731
53061052204,5450,3758,919,52,11,235,5,38,1692
53061052206,5244,4363,352,46,23,90,3,12,881
53061052207,6014,4950,438,30,31,176,2,37,1064
53061052208,4367,2592,1331,49,16,78,15,21,1775
53061052210,2060,1258,592,19,26,37,4,15,802
53061052211,3162,1830,496,478,93,29,2,4,1332
53061052301,5309,4358,495,15,39,81,7,28,951
53061052302,4175,3534,258,2,28,53,11,44,641
53061052401,4151,3398,373,19,26,74,13,13,753
53061052402,4132,3192,484,27,25,71,31,32,940
53061052502,5336,4299,423,43,31,140,7,35,1037
53061052504,2999,2382,201,23,11,129,4,22,617
53061052505,5301,3550,649,145,12,467,33,24,1751
53061052506,5058,3495,621,108,45,342,28,26,1563
53061052603,2881,2324,208,15,9,77,4,19,557
53061052604,5747,4058,686,137,27,333,20,22,1689
53061052605,6316,5083,437,68,38,149,22,35,1233
53061052606,5618,4418,432,101,10,178,28,23,1200
53061052607,6670,5123,551,80,31,263,22,37,1547
53061052701,2080,1614,220,27,24,61,0,8,466
53061052706,6111,4030,934,203,25,360,45,45,2081
53061052707,5112,3444,577,147,35,421,18,48,1668
53061052708,5330,3624,540,137,64,476,37,26,1706
53061052709,3624,2581,366,67,40,219,17,9,1043
53061052710,4502,3113,490,111,62,373,25,29,1389
53061052711,5031,3237,561,158,27,598,14,14,1794
53061052803,6245,4095,940,166,76,408,56,28,2150
53061052805,4443,3121,627,66,36,270,15,21,1322
53061052807,4205,2796,628,83,84,199,43,22,1409
53061052808,4215,2748,589,70,59,307,26,28,1467
53061052809,3794,2263,618,93,58,417,23,16,1531
53061052810,3835,2685,530,61,51,192,38,19,1150
53061052903,4386,2702,854,87,140,184,67,19,1684
53061052904,5382,3636,758,121,92,318,31,22,1746
53061052905,4606,2783,988,110,118,241,59,16,1823
53061052906,4788,3347,719,73,65,269,32,28,1441
53061053101,5527,3900,574,171,95,204,71,26,1627
53061053102,5498,4404,446,54,85,132,7,22,1094
53061053201,4289,3557,291,39,43,73,7,31,732
53061053202,4609,3854,225,26,47,77,9,31,755
53061053301,7462,5972,678,67,74,134,37,45,1490
53061053302,6654,5507,464,56,46,97,4,37,1147
53061053400,6058,5213,234,19,95,99,6,35,845
53061053505,5889,4934,349,16,46,103,19,37,955
53061053506,5952,5104,323,21,57,47,8,25,848
53061053507,5296,4061,460,70,38,255,20,16,1235
53061053508,3575,2821,332,21,44,89,13,17,754
53061053509,4164,2867,751,47,60,101,29,32,1297
53061053510,3704,2856,406,36,59,56,6,31,848
53061053511,3540,2686,442,24,36,78,21,15,854
53061053603,4358,3707,267,18,30,53,7,31,651
53061053604,5251,4175,443,49,60,123,6,10,1076
53061053605,3035,2638,144,17,18,33,6,19,397
53061053606,3788,3217,166,20,38,42,25,30,571
53061053700,3282,2808,135,8,66,30,3,22,474
53061053801,3813,3103,288,25,42,26,4,42,710
53061053802,6122,4547,833,52,48,148,13,23,1575
53061053803,5907,4651,717,39,54,71,7,23,1256
53061940001,6476,3824,639,68,1223,178,22,32,2652
53061940002,4493,2618,295,26,1111,66,25,16,1875
53061990002,0,0,0,0,0,0,0,0,0
53061990100,0,0,0,0,0,0,0,0,0
53063000201,3020,2329,230,79,40,50,53,23,691
53063000202,1749,1338,139,46,35,33,4,5,411
53063000301,2791,2015,255,77,50,82,91,19,776
53063000302,2921,2055,272,118,51,97,48,6,866
53063000400,4189,2987,370,132,103,145,71,22,1202
53063000500,3544,2786,254,69,43,126,7,18,758
53063000600,3075,2387,219,69,45,41,12,5,688
53063000700,5213,4223,291,69,70,69,10,25,990
53063000800,5398,4448,288,57,43,135,37,29,950
53063000900,6333,5173,395,99,99,75,20,27,1160
53063001000,5561,4650,298,59,46,64,2,12,911
53063001100,3612,2887,278,60,63,49,5,11,725
53063001200,2374,1888,134,57,52,45,15,19,486
53063001300,3510,2737,238,100,53,43,26,20,773
53063001400,6647,4873,500,193,167,239,115,36,1774
53063001500,5684,4278,428,121,129,85,86,29,1406
53063001600,3703,2571,257,143,89,121,149,25,1132
53063001800,2992,2341,202,98,63,30,42,12,651
53063001900,3712,2912,241,74,67,55,33,26,800
53063002000,4443,3291,389,135,83,73,59,30,1152
53063002100,2507,1933,201,41,57,36,26,10,574
53063002300,5494,4226,411,144,119,71,58,44,1268
53063002400,3078,2281,230,185,96,51,34,15,797
53063002501,3326,2384,302,131,86,115,74,22,942
53063002502,2545,1811,255,109,54,96,39,19,734
53063002503,3067,2121,503,25,21,95,41,0,946
53063002600,5711,3797,496,301,138,174,276,29,1914
53063002900,3320,2527,265,101,40,105,10,30,793
53063003000,2636,1635,238,145,48,232,63,11,1001
53063003100,5114,3762,320,229,112,142,143,26,1352
53063003200,2574,2005,203,62,43,82,14,20,569
53063003500,3786,2616,396,134,306,47,18,22,1170
53063003601,2813,1992,246,106,44,105,14,16,821
53063003602,2646,2040,203,72,59,55,4,23,606
53063003800,1894,1520,110,52,15,48,0,10,374
53063003900,2188,1866,107,18,22,48,0,10,322
53063004001,2699,2062,181,129,28,90,29,15,637
53063004002,2449,1833,205,80,34,36,62,23,616
53063004100,2198,1889,89,29,17,35,4,8,309
53063004200,4865,4248,228,34,15,65,1,17,617
53063004300,3582,3124,136,22,11,63,13,22,458
53063004400,4359,3615,264,58,19,59,13,25,744
53063004500,3785,3239,153,31,23,78,0,34,546
53063004601,4071,3408,185,105,32,113,13,16,663
53063004602,3308,2659,205,97,29,82,4,21,649
53063004701,3325,2478,248,108,47,147,20,15,847
53063004702,3731,3035,205,66,17,137,9,11,696
53063004800,4411,3509,273,116,28,180,4,23,902
53063004900,5803,4810,350,104,25,160,6,38,993
53063005000,5104,4007,313,156,33,158,19,23,1097
53063010101,3693,3231,165,17,21,52,3,17,462
53063010102,2640,2335,88,8,18,31,0,14,305
53063010201,4437,3981,141,10,27,30,3,33,456
53063010203,4509,3971,149,25,25,49,1,16,538
53063010204,2861,2544,105,12,14,15,0,6,317
53063010301,5049,4398,200,47,54,33,14,26,651
53063010303,3462,3011,117,14,38,18,3,12,451
53063010304,6241,5552,244,16,81,34,9,21,689
53063010305,7363,6402,275,41,65,106,7,54,961
53063010401,9185,5983,1076,439,370,369,184,48,3202
53063010403,3913,3303,221,28,44,63,2,28,610
53063010404,3771,3326,131,13,43,20,1,26,445
53063010504,3801,3326,169,25,21,47,2,28,475
53063010505,3715,3107,197,49,22,75,6,22,608
53063010506,6252,5174,359,85,49,108,76,26,1078
53063010507,5334,4464,359,51,29,101,10,14,870
53063010508,4115,3555,146,40,23,93,6,7,560
53063010601,3603,3023,187,40,41,47,3,18,580
53063010603,4658,3926,218,56,55,108,5,24,732
53063010604,3843,3216,193,68,32,76,13,18,627
53063010701,4681,3751,257,59,42,260,13,12,930
53063010702,4001,3338,181,40,36,170,9,19,663
53063010800,2308,1774,142,58,34,46,28,7,534
53063010901,2081,1654,153,45,23,50,8,5,427
53063010902,3388,2686,176,87,30,142,43,9,702
53063011000,3756,2983,270,66,47,77,27,24,773
53063011102,3874,2783,290,90,64,149,128,14,1091
53063011103,3242,2354,231,128,55,164,94,25,888
53063011104,2886,1853,303,104,62,74,222,7,1033
53063011202,4267,3565,256,14,43,27,20,19,702
53063011203,5547,4053,360,184,93,309,104,33,1494
53063011204,2312,1661,133,64,20,247,27,17,651
53063011301,4341,3642,208,35,43,114,9,13,699
53063011302,4681,3805,256,117,25,107,39,20,876
53063011400,6075,5104,355,37,59,136,2,28,971
53063011500,1520,1300,77,8,15,15,2,8,220
53063011600,1881,1608,96,23,9,18,8,1,273
53063011701,2490,1986,227,44,14,48,7,6,504
53063011702,7444,5444,801,195,119,109,125,32,2000
53063011800,5616,4418,437,146,93,83,45,17,1198
53063011900,4592,3568,405,88,39,64,63,22,1024
53063012000,4190,3432,279,63,46,71,8,32,758
53063012100,2833,2241,241,61,32,39,20,27,592
53063012200,2474,2021,121,39,48,30,28,18,453
53063012300,6317,4949,462,166,86,175,40,45,1368
53063012401,4898,4270,202,44,30,51,6,21,628
53063012402,7631,6572,384,77,45,135,12,26,1059
53063012500,4212,3271,391,158,55,44,45,3,941
53063012600,4246,3397,352,91,47,62,41,11,849
53063012701,4120,3358,266,69,39,45,90,10,762
53063012702,2257,1980,82,26,17,26,5,5,277
53063012801,4259,3456,300,57,35,55,26,22,803
53063012802,3444,2925,145,52,35,51,12,20,519
53063012901,3327,2728,253,27,44,61,13,3,599
53063012902,7427,6193,406,89,66,176,28,44,1234
53063013001,1723,1490,86,1,12,57,1,5,233
53063013002,3081,2383,292,70,31,82,45,18,698
53063013003,6582,5387,398,66,33,296,20,41,1195
53063013101,8336,7021,519,53,51,213,13,31,1315
53063013102,6186,5259,329,48,41,105,22,34,927
53063013201,7708,6655,356,36,46,98,27,42,1053
53063013203,3545,3030,186,26,25,75,6,7,515
53063013204,5574,4723,292,41,37,153,5,31,851
53063013205,3494,3022,192,20,18,91,12,16,472
53063013300,3450,3117,90,11,6,20,2,14,333
53063013401,5649,4668,215,120,25,203,8,17,981
53063013501,1850,1627,98,2,14,21,5,13,223
53063013502,2355,2097,72,9,4,31,3,11,258
53063013503,6104,5167,305,77,37,167,5,27,937
53063013600,4933,4043,278,58,67,89,14,27,890
53063013700,4026,2929,371,136,116,176,70,8,1097
53063013800,2695,1614,531,167,9,67,21,14,1081
53063013900,5686,4684,295,86,72,78,14,33,1002
53063014001,6005,4130,778,268,85,254,69,32,1875
53063014002,6551,4601,887,222,91,154,20,24,1950
53063014100,6984,5877,373,82,46,115,7,35,1107
53063014200,3795,3213,195,30,33,40,5,29,582
53063014300,3417,3000,108,17,67,26,0,19,417
53063014400,4917,3684,354,111,85,241,117,16,1233
53063014500,2770,1833,313,149,140,85,50,20,937
53065941000,2541,322,98,8,1944,4,0,4,2219
53065950101,4782,4161,158,14,91,34,1,50,621
53065950102,3153,2781,120,14,37,26,3,33,372
53065950200,4076,3651,123,5,43,20,14,13,425
53065950300,2639,2212,162,6,51,14,0,10,427
53065950500,2536,2179,108,5,33,28,6,13,357
53065950600,2403,2150,77,11,29,12,3,3,253
53065950700,2398,2031,131,6,48,16,6,9,367
53065950800,3427,3090,64,5,35,10,5,18,337
53065950900,1659,1471,52,7,11,7,0,2,188
53065951100,3931,3385,172,20,65,24,6,33,546
53065951301,3061,2710,101,4,42,13,5,25,351
53065951302,1578,1428,49,2,18,7,0,13,150
53065951401,3488,3020,81,17,59,18,14,30,468
53065951402,4773,4131,189,17,52,47,21,32,642
53067010100,3601,2767,296,83,37,85,19,36,834
53067010200,5228,4139,358,65,40,151,21,43,1089
53067010300,5482,4003,702,126,59,105,24,29,1479
53067010400,3528,2967,195,29,13,81,3,15,561
53067010510,3366,2338,404,160,46,147,34,12,1028
53067010520,6728,4535,665,324,97,409,60,38,2193
53067010600,6474,4532,578,156,77,523,31,63,1942
53067010700,6244,4517,452,117,33,591,25,41,1727
53067010801,2368,1696,282,72,23,71,19,16,672
53067010802,4823,3688,328,84,44,235,19,12,1135
53067010910,8137,5540,823,252,97,623,58,54,2597
53067010920,5331,4129,422,144,69,183,39,21,1202
53067011000,5085,4105,359,30,54,130,14,34,980
53067011100,4577,3186,378,140,28,383,20,38,1391
53067011200,5624,3310,831,290,54,399,259,36,2314
53067011300,4597,3254,579,130,43,212,35,24,1343
53067011410,5395,3423,780,178,61,337,127,20,1972
53067011421,3227,2118,332,188,26,227,59,14,1109
53067011422,4061,2717,465,168,46,169,116,15,1344
53067011500,6138,3417,968,360,73,571,144,38,2721
53067011622,4443,2741,580,193,62,317,134,27,1702
53067011623,6352,3747,772,433,52,555,93,38,2605
53067011624,4191,2726,595,132,57,209,91,22,1465
53067011625,3602,1985,449,328,26,300,164,21,1617
53067011626,4912,3198,563,237,38,403,73,38,1714
53067011627,2358,1454,274,100,29,212,65,15,904
53067011628,5734,3960,522,262,32,351,72,28,1774
53067011720,6185,4791,402,85,71,268,42,28,1394
53067011721,5419,3790,344,118,33,698,28,13,1629
53067011722,3564,2635,227,63,15,326,8,24,929
53067011810,3694,3069,216,19,37,60,11,11,625
53067011821,5208,4030,538,58,41,137,10,36,1178
53067011822,4432,3532,300,69,46,164,27,16,900
53067011901,1845,1531,90,16,34,37,0,18,314
53067011902,5521,4662,253,40,81,97,10,22,859
53067012001,5531,3791,460,185,59,649,19,28,1740
53067012002,2850,2370,117,38,20,110,1,4,480
53067012100,4478,3775,229,22,26,108,1,16,703
53067012211,2717,2024,237,35,35,131,8,47,693
53067012221,7351,4915,660,315,73,653,99,40,2436
53067012223,4134,2838,369,188,50,295,48,29,1296
53067012224,3621,2029,290,132,56,679,49,26,1592
53067012225,5988,4200,493,228,46,484,82,17,1788
53067012226,6208,3504,676,355,36,956,61,36,2704
53067012320,3305,1874,362,78,478,206,28,13,1431
53067012330,6104,2959,1409,441,80,477,149,25,3145
53067012331,5505,3341,503,368,47,589,88,27,2164
53067012332,5391,2750,791,352,42,665,204,34,2641
53067012412,6081,4434,618,121,123,112,110,54,1647
53067012420,4336,3426,318,51,80,89,14,41,910
53067012421,3251,2179,413,96,37,136,85,38,1072
53067012422,7089,4990,861,173,108,211,100,58,2099
53067012510,3733,2790,360,76,41,65,36,29,943
53067012530,4648,3791,283,44,47,75,18,27,857
53067012531,4480,3656,348,35,56,39,6,42,824
53067012532,3558,2760,336,42,23,59,7,47,798
53067012610,6344,5354,342,29,59,88,14,49,990
53067012620,4773,3960,293,42,59,36,10,33,813
53067012710,2407,1873,251,10,29,36,13,17,534
53067012720,6670,4887,1025,43,126,100,22,28,1783
53067012730,6766,5283,658,145,111,64,15,21,1483
53067990100,0,0,0,0,0,0,0,0,0
53069950100,4422,3817,183,21,55,43,2,24,605
53071920000,5718,3472,1945,26,47,37,4,14,2246
53071920100,5077,4076,628,20,30,21,3,37,1001
53071920200,4700,3185,1205,35,11,63,6,15,1515
53071920301,3596,2475,782,30,12,50,11,23,1121
53071920302,5434,3588,1213,126,30,103,42,32,1846
53071920400,2392,1315,396,440,98,1,0,3,1077
53071920500,2656,1015,1469,20,21,25,2,11,1641
53071920600,6639,3859,2282,68,48,101,18,22,2780
53071920701,3540,2558,647,40,17,54,5,11,982
53071920702,4699,3425,843,21,22,63,4,40,1274
53071920801,5070,3327,1264,51,32,60,14,17,1743
53071920802,3300,2463,403,62,12,176,7,2,837
53071920901,3843,2797,704,19,11,57,15,23,1046
53071920902,5920,5025,425,23,27,107,3,30,895
53073000101,3616,3018,202,4,35,91,2,34,598
53073000102,7271,4677,744,130,88,1093,19,50,2594
53073000201,4273,2985,512,60,111,232,34,44,1288
53073000202,3759,2558,414,37,55,414,17,18,1201
53073000203,3914,2553,597,78,60,353,24,13,1361
53073000301,4884,3591,563,72,40,238,15,27,1293
53073000302,3073,1629,864,62,50,246,16,26,1444
53073000401,3321,2796,197,20,8,59,8,37,525
53073000402,3382,2877,175,18,16,85,0,21,505
53073000501,5393,4383,367,33,45,159,7,23,1010
53073000502,2981,2285,283,53,28,87,17,14,696
53073000600,1939,1417,187,54,38,58,4,8,522
53073000700,6881,4509,1063,134,95,461,24,39,2372
53073000803,6859,5411,506,79,47,346,19,48,1448
53073000804,7017,5736,314,42,37,343,22,39,1281
53073000805,5306,4427,272,54,30,134,7,33,879
53073000807,2877,2385,199,11,35,53,4,8,492
53073000808,2568,2032,214,23,19,80,3,11,536
53073000809,2739,2204,189,27,41,63,3,16,535
53073000902,6594,5258,368,52,42,368,14,39,1336
53073000903,4867,3414,558,98,87,287,28,15,1453
53073000904,2942,2459,138,20,4,111,2,21,483
53073001000,8065,5932,721,175,34,414,21,47,2133
53073001101,4223,3589,162,20,14,167,2,18,634
53073001102,2680,2378,75,20,7,69,1,20,302
53073001202,3842,3353,135,16,27,95,10,11,489
53073001203,3030,2371,206,34,15,140,18,9,659
53073001204,3710,2722,359,62,37,216,9,22,988
53073010101,2434,2020,164,18,22,24,4,13,414
53073010102,3851,2932,399,19,69,40,13,22,919
53073010103,2304,1776,111,10,223,14,11,6,528
53073010201,3734,2928,487,11,28,37,3,41,806
53073010202,5348,3823,1081,20,51,106,9,49,1525
53073010301,7434,5783,1161,33,28,111,16,22,1651
53073010302,5111,4127,505,42,19,182,3,22,984
53073010303,7639,5686,1140,77,35,307,25,40,1953
53073010405,3879,3274,195,26,24,153,7,15,605
53073010406,1977,1540,193,31,30,38,15,5,437
53073010407,3487,2757,369,6,39,72,2,31,730
53073010408,2908,2442,244,8,19,51,5,9,466
53073010409,4001,2907,382,56,48,268,79,26,1094
53073010410,2440,1914,151,26,26,139,7,22,526
53073010411,3632,2730,306,48,52,183,8,50,902
53073010503,5977,4428,681,55,99,302,22,17,1549
53073010504,3370,2660,239,28,32,174,12,33,710
53073010505,5299,3655,898,34,84,289,26,50,1644
53073010506,3710,2480,598,62,103,180,28,19,1230
53073010600,7057,5179,962,36,47,395,8,40,1878
53073010701,6594,5115,829,33,50,252,0,39,1479
53073010702,4782,3283,703,18,388,61,8,21,1499
53073010900,934,829,27,1,6,10,0,10,105
53073011000,1191,1013,57,3,3,51,4,7,178
53073940001,2025,1402,135,18,290,19,1,11,623
53073940002,3723,753,224,14,2499,32,6,7,2970
53075000100,6684,4960,723,159,36,336,23,11,1724
53075000201,4576,3307,413,122,14,392,19,29,1269
53075000202,2563,1907,257,61,19,144,3,23,656
53075000300,6049,4455,390,144,21,574,10,45,1594
53075000400,4160,3189,285,96,24,257,1,23,971
53075000500,2896,1710,421,117,12,399,10,2,1186
53075000601,4574,2349,610,248,20,939,48,55,2225
53075000602,3486,2000,548,162,19,471,13,24,1486
53075000700,3517,3203,81,11,27,16,2,10,314
53075000800,3503,3137,122,14,19,50,3,11,366
53075000900,3841,3410,146,14,49,23,7,16,431
53075001000,2124,1930,56,15,6,15,0,9,194
53077000100,2628,873,1449,68,103,26,0,14,1755
53077000200,5741,1121,4253,94,94,16,9,14,4620
53077000301,3019,1413,1392,49,46,42,1,14,1606
53077000302,2027,1052,812,28,52,18,0,1,975
53077000401,5812,4254,1060,60,66,93,14,34,1558
53077000402,2439,1788,411,13,9,96,10,23,651
53077000500,5196,2788,1990,71,47,40,2,25,2408
53077000600,6406,1103,4929,81,111,34,4,18,5303
53077000700,7195,2401,4258,89,107,43,10,48,4794
53077000800,4707,3188,1089,47,51,64,0,33,1519
53077000902,4257,2404,1442,53,43,93,4,18,1853
53077000903,3627,2254,1084,44,26,68,8,9,1373
53077000904,4139,2792,948,38,47,93,5,17,1347
53077001000,6193,3318,2269,67,77,104,10,29,2875
53077001100,7437,3763,3012,85,111,96,6,23,3674
53077001201,4183,1166,2699,53,76,38,4,23,3017
53077001202,6724,1740,4628,50,64,47,26,22,4984
53077001300,2901,1118,1604,16,42,18,2,14,1783
53077001400,3779,1268,2270,31,79,18,4,8,2511
53077001502,2513,376,2039,20,21,3,0,11,2137
53077001503,4718,480,3980,97,60,12,0,19,4238
53077001504,2773,369,2263,23,40,7,0,10,2404
53077001601,2506,1751,587,11,5,16,0,10,755
53077001602,8969,5782,2316,66,105,228,8,43,3187
53077001701,3356,1981,1135,13,75,10,2,14,1375
53077001702,6979,3296,3215,37,80,63,14,32,3683
53077001801,4521,1360,3002,5,27,9,0,19,3161
53077001802,2770,832,1858,4,6,19,1,3,1938
53077001901,3662,383,3206,3,18,9,2,9,3279
53077001902,6662,1002,5515,15,13,36,0,21,5660
53077002003,5358,485,4804,0,14,9,0,9,4873
53077002004,2828,202,2578,14,8,9,0,2,2626
53077002005,2965,394,2478,5,9,37,2,15,2571
53077002006,6352,938,5282,11,20,26,2,21,5414
53077002101,2022,762,1188,3,14,4,0,19,1260
53077002103,2976,658,2239,0,24,7,3,6,2318
53077002104,4805,660,3999,11,72,1,3,20,4145
53077002201,5196,2458,2319,17,176,23,5,20,2738
53077002202,2751,885,1706,7,50,7,3,7,1866
53077002701,3010,336,2634,2,9,4,0,2,2674
53077002801,5808,4393,966,21,37,50,5,28,1415
53077002803,6577,4464,1439,49,75,222,5,27,2113
53077002804,3777,2706,678,25,26,143,7,27,1071
53077002900,6788,3307,3126,11,38,40,0,27,3481
53077003002,3941,2888,822,16,34,12,0,25,1053
53077003003,1623,1377,152,4,14,13,1,5,246
53077003004,3044,2465,397,8,21,15,3,3,579
53077003100,5900,4334,1113,27,45,46,7,23,1566
53077003200,7103,4752,1745,48,63,93,8,55,2351
53077003400,4964,3780,797,16,68,55,7,20,1184
53077940001,6540,1422,3155,30,1439,254,1,27,5118
53077940002,5188,637,2293,9,1999,66,0,25,4551
53077940003,3553,896,759,19,1686,15,2,7,2657
53077940005,4928,433,3977,6,415,9,6,11,4495
53077940006,4500,229,3741,12,440,8,1,12,4271
53077940007,4185,189,3216,4,594,105,1,14,3996
53077940008,2207,112,1731,12,266,53,3,10,2095
54001965500,3663,3534,22,13,3,3,0,1,129
54001965600,3408,2889,108,228,8,22,0,9,519
54001965700,4902,4638,38,14,14,3,0,0,264
54001965800,3492,3318,24,4,12,4,0,0,174
54003971101,6962,5316,429,558,17,133,1,36,1646
54003971103,1973,1696,100,58,0,23,4,4,277
54003971104,3865,3448,91,65,2,35,1,7,417
54003971105,4221,3395,219,299,13,73,1,19,826
54003971203,3468,3160,88,39,8,2,0,22,308
54003971204,3098,2826,50,38,11,17,2,16,272
54003971205,4519,3744,182,239,9,60,1,20,775
54003971206,7768,6236,533,392,8,137,4,16,1532
54003971301,5884,3976,497,918,21,64,0,24,1908
54003971302,4503,3622,267,254,7,52,2,21,881
54003971401,3888,3364,107,145,21,29,2,19,524
54003971402,6094,4268,395,820,17,77,0,34,1826
54003971500,3808,2640,224,598,11,27,2,17,1168
54003971600,4835,3467,371,596,14,41,4,19,1368
54003971700,5500,3944,378,667,20,68,0,26,1556
54003971801,4220,3788,110,57,7,32,1,3,432
54003971802,4420,4063,122,43,9,9,0,12,357
54003971901,6158,4987,334,409,15,21,6,27,1171
54003971902,4676,3466,327,448,14,148,0,19,1210
54003972001,5939,4097,511,762,8,124,1,55,1842
54003972002,3814,2590,320,557,11,40,0,18,1224
54003972003,4154,3323,258,226,11,34,0,24,831
54003972101,6141,5146,307,287,8,53,4,17,995
54003972103,4178,3393,206,248,8,51,5,11,785
54003972104,4228,3578,202,200,8,45,2,20,650
54003972105,3762,3026,265,195,6,50,0,5,736
54005958200,3687,3527,38,5,4,2,1,1,160
54005958300,3781,3632,20,16,1,2,0,2,149
54005958400,2046,1922,10,6,5,22,0,0,124
54005958501,2666,2572,10,10,11,1,0,0,94
54005958502,3346,3135,17,47,5,7,0,7,211
54005958600,1861,1769,18,12,3,2,1,1,92
54005958700,1546,1469,8,2,3,0,0,0,77
54005958800,2876,2686,12,37,7,0,0,7,190
54007967900,4828,4631,34,34,9,9,7,11,197
54007968000,3788,3662,27,5,2,7,0,1,126
54007968100,3831,3646,24,11,8,7,4,3,185
54009031102,4288,3994,50,23,1,6,0,13,294
54009031103,2578,2284,47,87,2,10,0,6,294
54009031104,2399,2216,32,27,2,24,0,2,183
54009031200,3216,2985,39,24,4,0,0,16,231
54009031401,1988,1809,35,49,1,3,0,9,179
54009031402,2263,2135,8,15,6,2,0,7,128
54009031600,3503,3200,58,126,9,7,0,2,303
54009031700,2324,2169,18,14,11,3,0,15,155
54011000101,1617,1486,26,25,0,1,0,12,131
54011000102,1975,1651,61,121,1,22,0,9,324
54011000200,2709,2388,47,99,11,0,1,3,321
54011000300,2485,2114,36,139,16,43,3,6,371
54011000400,2308,1758,92,201,16,73,1,7,550
54011000500,2936,2302,77,342,7,106,1,6,634
54011000600,1234,927,29,95,3,110,0,6,307
54011000900,1509,1278,17,76,2,5,0,13,231
54011001000,2083,1793,34,83,8,13,0,10,290
54011001100,1888,1623,40,96,7,6,0,3,265
54011001200,2606,2130,58,236,6,34,1,9,476
54011001300,2713,2154,91,229,6,59,2,25,559
54011001400,2352,1411,52,676,0,42,4,15,941
54011001500,2084,1240,30,648,8,5,0,9,844
54011001600,1084,729,30,251,6,2,0,4,355
54011001800,3444,2679,72,405,10,11,0,31,765
54011001900,2153,1887,43,93,3,32,0,4,266
54011002000,3273,2889,61,97,3,46,0,10,384
54011002100,3252,2953,48,93,3,47,4,11,299
54011010103,2884,2750,16,8,0,8,0,2,134
54011010104,2934,2677,24,65,5,34,0,11,257
54011010202,4267,3800,72,105,7,78,1,9,467
54011010203,4113,3557,96,101,4,119,0,16,556
54011010204,1620,1381,25,59,0,101,0,7,239
54011010300,3044,2859,29,18,0,39,0,5,185
54011010401,3372,3056,37,126,0,44,0,9,316
54011010402,3169,2865,36,41,4,97,0,8,304
54011010500,5628,5392,47,16,15,11,0,5,236
54011010600,4223,3980,16,18,9,43,0,8,243
54011010701,3127,3008,29,9,8,8,0,2,119
54011010702,4087,3876,43,15,3,33,2,6,211
54011010801,2156,2054,35,5,0,8,0,3,102
54011010802,4221,3984,57,19,6,20,0,10,237
54011010900,1800,1464,56,141,8,28,0,4,336
54013962600,3009,2873,32,9,5,8,0,0,136
54013962700,3220,3103,16,4,7,4,2,2,117
54015957900,3195,3053,18,1,9,3,0,0,142
54015958000,2908,2745,24,3,6,10,0,1,163
54015958100,1948,1853,10,7,14,0,0,0,95
54017965000,4038,3802,47,60,12,8,0,4,236
54017965100,3770,3488,30,114,3,7,0,11,282
54019020101,4145,3823,97,68,11,10,0,3,322
54019020102,1627,1553,21,2,1,3,0,5,74
54019020201,3813,3195,62,306,15,16,0,12,618
54019020202,3652,3279,63,106,17,20,0,7,373
54019020300,2733,2419,61,81,6,7,0,1,314
54019020400,3873,3330,63,248,12,9,1,11,543
54019020500,1606,1192,29,259,2,2,0,13,414
54019020600,1782,1684,12,15,1,3,0,6,98
54019020700,3167,2669,37,291,5,22,0,16,498
54019020800,4429,3905,37,264,14,3,0,18,524
54019020900,4068,3888,25,11,9,4,0,14,180
54019021000,2827,2713,13,5,2,3,0,3,114
54019021100,2766,2658,5,6,5,3,0,5,108
54021967701,4092,3931,32,4,7,5,0,0,161
54021967800,1876,1702,42,47,3,22,0,0,174
54021980000,1440,393,170,872,1,3,0,1,1047
54023969400,2986,2887,6,9,6,3,0,7,99
54023969500,3671,3545,19,16,5,4,0,5,126
54023969600,4319,4031,66,58,10,17,0,8,288
54025950101,1706,1397,54,153,0,17,0,10,309
54025950102,2932,2704,22,101,1,10,0,4,228
54025950200,3479,3251,41,37,8,7,2,6,228
54025950300,3575,3324,71,36,11,6,1,9,251
54025950401,3127,2991,28,4,7,5,2,3,136
54025950402,4351,4059,73,64,6,19,0,3,292
54025950500,3132,2917,44,35,6,13,0,10,215
54025950600,4806,4211,114,196,11,82,0,22,595
54025950701,3961,3543,103,127,2,33,0,18,418
54025950702,1908,1802,21,13,3,0,0,3,106
54027968201,2392,2227,39,11,2,11,1,3,165
54027968202,2885,2696,45,13,1,14,0,12,189
54027968301,2777,2613,36,41,4,6,0,4,164
54027968302,2539,2391,36,13,2,9,1,11,148
54027968401,2366,2150,53,42,11,3,0,11,216
54027968402,1572,1499,17,9,3,5,1,4,73
54027968500,3379,3208,36,26,0,3,1,5,171
54027968601,1924,1804,19,2,5,3,0,15,120
54027968602,3259,3067,56,21,2,7,0,9,192
54029020600,4261,3933,62,69,4,27,0,8,328
54029020700,4339,3845,91,136,5,36,1,22,494
54029020900,2677,2513,39,9,3,7,0,3,164
54029021100,3759,3490,38,24,2,2,4,14,269
54029021200,3256,3046,40,11,4,3,1,4,210
54029021300,3233,2762,62,191,6,9,0,5,471
54029021400,3439,2984,45,232,4,4,1,9,455
54029021500,4131,3911,47,23,3,22,1,9,220
54031970101,2708,2525,42,29,1,11,0,7,183
54031970102,2119,1986,26,20,0,5,0,0,133
54031970201,2670,1945,348,260,6,31,0,8,725
54031970202,2535,2339,88,27,5,3,0,6,196
54031970300,4267,3890,155,67,4,3,0,10,377
54033030100,3162,2724,91,136,10,37,4,15,438
54033030200,2702,2402,83,63,14,10,0,5,300
54033030300,2035,1728,54,95,0,5,1,8,307
54033030400,2983,2491,87,189,5,14,0,6,492
54033030501,1293,1224,22,8,4,0,0,4,69
54033030502,3341,3057,69,41,8,13,1,6,284
54033030601,2334,2122,45,36,3,3,1,9,212
54033030603,2001,1829,38,22,6,17,3,8,172
54033030604,3545,3145,107,105,5,12,6,8,400
54033030700,2158,2050,18,10,0,1,0,2,108
54033030801,2112,1904,70,19,7,11,0,2,208
54033030802,2282,2135,10,3,7,5,0,6,147
54033031000,3224,2901,78,67,3,9,4,8,323
54033031100,2321,2128,58,26,7,17,0,0,193
54033031200,2207,2058,41,20,6,6,0,1,149
54033031300,2761,2616,53,6,0,6,1,7,145
54033031400,2252,2124,40,3,9,6,0,13,128
54033031500,1270,1192,20,2,2,9,0,3,78
54033031600,2212,1993,52,74,4,9,0,2,219
54033031700,1698,1617,21,3,7,0,0,0,81
54033031800,2175,2030,26,10,2,2,2,2,145
54033031900,2335,2171,31,38,1,8,2,4,164
54033032000,2762,2607,27,16,3,4,0,4,155
54033032103,6482,5749,154,72,7,204,0,15,733
54033032104,4274,3865,108,40,15,81,3,14,409
54035963200,4151,3999,22,6,8,8,0,2,152
54035963300,4674,4325,85,33,12,20,1,11,349
54035963400,3802,3602,24,13,1,13,0,15,200
54035963500,2850,2682,16,10,6,7,0,11,168
54035963600,4529,4331,34,7,6,24,0,15,198
54035963701,3555,3405,19,14,6,15,0,8,150
54035963702,4230,4067,30,17,4,4,1,0,163
54037972201,5169,4132,229,410,11,75,0,27,1037
54037972203,2488,2073,98,141,4,24,1,5,415
54037972204,2438,2126,99,64,3,22,0,14,312
54037972300,4569,3786,252,212,16,33,0,28,783
54037972401,2718,1702,404,316,5,54,0,19,1016
54037972402,4461,3220,418,361,14,103,0,26,1241
54037972501,5313,4162,472,297,10,78,1,20,1151
54037972503,4049,2896,468,312,8,90,2,22,1153
54037972505,2705,1881,259,348,0,35,0,14,824
54037972506,4131,2948,437,394,7,116,1,15,1183
54037972601,1950,1688,75,71,4,10,0,10,262
54037972602,4633,3813,328,156,2,88,0,24,820
54037972701,2770,2419,168,25,7,6,1,5,351
54037972702,4243,3759,175,36,6,21,0,31,484
54037972800,6064,5179,255,236,7,62,4,44,885
54039000100,1303,807,29,320,6,7,2,16,496
54039000200,2317,1621,23,497,7,6,1,7,696
54039000300,2573,2268,46,102,17,16,1,9,305
54039000500,2152,1707,38,239,8,15,0,6,445
54039000600,4008,2729,59,871,11,27,0,34,1279
54039000700,2196,958,45,979,6,7,0,18,1238
54039000800,1943,1065,64,644,1,22,5,19,878
54039000900,1158,702,34,308,0,27,2,7,456
54039001100,4705,3423,82,808,17,81,0,25,1282
54039001200,1595,908,41,511,7,5,0,12,687
54039001300,2497,1819,78,340,8,57,2,12,678
54039001500,4578,3742,98,324,5,187,1,20,836
54039001700,1608,1277,37,121,3,56,0,6,331
54039001800,2686,2120,39,272,5,73,0,21,566
54039001901,3672,3226,40,73,3,192,4,26,446
54039001902,3666,3171,57,54,2,201,2,14,495
54039002000,2894,2449,65,152,2,74,0,14,445
54039002100,4783,3703,90,454,10,180,0,23,1080
54039010100,3822,2860,66,524,8,81,2,15,962
54039010200,2126,1703,42,223,3,18,1,2,423
54039010300,2217,1656,41,355,13,9,1,9,561
54039010400,1509,545,49,807,1,12,0,8,964
54039010500,5163,4368,121,314,3,81,0,22,795
54039010601,2864,2544,42,99,9,9,0,22,320
54039010602,2416,2101,63,80,20,37,1,12,315
54039010701,5031,4247,93,371,8,55,0,13,784
54039010702,4655,4258,65,126,4,10,1,8,397
54039010802,2932,2824,19,8,2,0,0,7,108
54039010803,4421,4179,51,14,6,13,1,9,242
54039010804,2283,2185,17,13,5,6,0,3,98
54039010900,2125,2034,13,7,4,3,0,0,91
54039011000,4453,4123,49,59,8,30,1,19,330
54039011100,4247,4082,20,8,1,5,2,9,165
54039011200,3633,3476,23,2,6,6,2,7,157
54039011301,2768,2606,22,32,6,10,0,6,162
54039011302,5327,5044,59,22,8,15,0,11,283
54039011401,2740,2445,39,75,12,55,0,4,295
54039011402,3131,2952,27,16,2,13,0,2,179
54039011500,4008,3094,57,582,5,11,0,25,914
54039011800,4292,3993,25,81,3,3,0,20,299
54039012100,3861,3404,28,168,6,12,1,23,457
54039012200,4352,4005,37,118,12,7,0,1,347
54039012301,4483,4076,60,106,12,92,0,12,407
54039012302,2138,1996,31,23,0,5,2,6,142
54039012800,4198,3622,64,238,1,44,4,19,576
54039012900,1234,940,32,140,6,26,0,8,294
54039013001,2094,1780,41,160,10,17,1,16,314
54039013002,2384,2082,49,83,3,66,0,7,302
54039013100,4270,3302,80,548,2,40,3,22,968
54039013200,3494,3215,27,76,11,11,0,11,279
54039013300,2543,2271,49,99,0,15,0,12,272
54039013400,1993,1650,49,139,8,12,0,11,343
54039013500,2752,2428,39,114,2,15,0,9,324
54039013600,4787,4250,60,197,9,25,1,18,537
54039013701,2108,1948,15,20,5,12,2,7,160
54039013702,5306,4795,72,159,13,20,1,17,511
54039013800,2251,1957,19,141,2,4,0,12,294
54041967200,3640,3493,24,6,3,12,3,0,147
54041967300,4120,3915,47,9,7,8,0,0,205
54041967400,2696,2505,54,8,1,17,0,9,191
54041967500,3040,2812,46,42,2,20,3,14,228
54041967600,3537,3363,20,1,6,1,1,0,174
54043955401,3232,3069,47,3,2,3,0,8,163
54043955402,2886,2783,23,8,7,6,0,6,103
54043955500,3465,3344,16,8,1,0,0,1,121
54043955600,4396,4264,20,7,10,5,0,1,132
54043955700,3098,3010,28,1,0,4,0,3,88
54043955800,3386,3232,37,17,2,8,0,2,154
54045956102,2810,2684,25,10,2,10,0,2,126
54045956103,4002,3863,36,17,3,24,0,4,139
54045956104,2684,2607,10,3,1,3,0,1,77
54045956200,3478,3186,25,168,0,6,0,1,292
54045956400,3224,3028,24,73,6,0,0,3,196
54045956500,2052,1936,10,36,5,0,0,4,116
54045956600,4381,4168,17,60,5,9,0,4,213
54045956700,3617,3359,30,113,10,4,1,5,258
54045956800,4228,4080,30,18,5,3,0,9,148
54045956900,2091,1874,17,82,4,4,0,1,217
54047953600,879,586,10,249,0,0,1,0,293
54047953800,2495,2303,12,87,1,0,0,2,192
54047953900,1957,1909,8,3,0,0,0,3,48
54047954000,1930,1853,5,6,0,0,0,2,77
54047954200,1527,1406,4,66,2,3,3,2,121
54047954501,1721,1407,3,222,7,0,0,9,314
54047954503,4755,2843,338,1390,10,17,0,22,1912
54047954504,3847,3564,10,116,0,0,0,5,283
54049020100,1051,791,33,147,2,3,0,3,260
54049020200,3046,2383,106,262,25,17,0,16,663
54049020300,3788,3311,85,119,5,33,26,11,477
54049020400,1921,1726,22,53,2,42,0,10,195
54049020500,2036,1226,37,580,7,3,2,5,810
54049020600,1539,1362,23,44,1,12,3,0,177
54049020700,3901,3548,62,61,5,9,3,7,353
54049020800,3241,2840,48,110,0,11,0,2,401
54049020900,4257,3887,54,74,9,20,2,12,370
54049021001,3190,2993,40,30,10,5,2,3,197
54049021002,2124,2006,29,7,3,0,0,3,118
54049021100,2588,2350,48,51,0,14,2,5,238
54049021201,3557,3216,63,66,9,52,0,9,341
54049021202,2422,2228,43,25,2,14,0,3,194
54049021300,3589,3282,32,97,2,1,2,5,307
54049021400,1848,1701,22,32,11,2,0,5,147
54049021500,3359,3082,24,51,11,2,1,1,277
54049021601,2178,2062,28,13,2,0,0,2,116
54049021602,2056,1947,18,10,2,9,0,12,109
54049021700,1872,1754,42,4,8,1,0,2,118
54049021800,2642,2528,16,8,3,6,0,0,114
54051020200,1806,1694,29,7,4,10,0,2,112
54051020500,991,874,20,33,0,4,0,0,117
54051020601,2177,2036,20,15,0,11,0,5,141
54051020702,1384,1298,25,9,3,10,0,1,86
54051020800,4183,3974,26,18,9,0,0,2,209
54051020900,5049,4759,44,95,8,7,2,7,290
54051021001,1474,1387,12,3,5,2,0,11,87
54051021002,4487,4207,61,28,2,24,0,2,280
54051021100,4830,4556,70,23,3,8,2,5,274
54051021300,4210,3884,47,29,0,32,3,29,326
54053954801,3119,2922,23,42,4,14,0,13,197
54053954802,3811,3687,20,17,8,6,0,0,124
54053954901,2589,2514,9,5,3,3,0,0,75
54053954902,4382,4143,33,60,5,10,5,7,239
54053955000,4375,4142,30,46,8,33,0,0,233
54053955101,2456,2365,14,10,2,7,0,0,91
54053955102,4721,4549,41,13,2,1,0,0,172
54055000900,3202,3066,25,7,5,5,0,0,136
54055001000,4455,4231,36,22,12,3,0,3,224
54055001100,6056,5562,58,174,6,53,3,5,494
54055001200,3596,3261,56,109,7,10,0,7,335
54055001300,3728,3265,80,150,9,20,1,15,463
54055001400,1981,1676,29,148,6,20,1,7,305
54055001500,5472,4750,68,303,11,61,0,13,722
54055001600,1445,1358,10,16,2,3,0,3,87
54055001700,4938,4541,49,125,11,4,0,8,397
54055001800,5581,5118,53,172,6,18,0,8,463
54055001900,1491,1006,21,390,9,1,0,10,485
54055002000,2419,1579,40,643,12,0,0,7,840
54055002100,2931,2179,37,533,10,14,0,14,752
54055002200,4429,3552,39,603,18,29,1,18,877
54055002300,5146,4556,65,233,28,44,0,19,590
54055002400,2794,2564,39,66,7,7,0,2,230
54057010100,2367,2203,20,25,4,7,0,1,164
54057010200,3522,3337,32,22,5,12,0,5,185
54057010300,4991,4734,46,20,5,17,0,15,257
54057010400,4275,4068,44,25,4,13,1,0,207
54057010500,4701,4248,52,151,6,26,0,19,453
54057010600,5175,4375,88,330,11,36,4,6,800
54057010700,1907,1638,27,138,1,2,0,4,269
54059957100,3680,3554,33,12,2,2,0,0,126
54059957200,3323,3227,21,8,4,0,0,10,96
54059957300,2971,2860,20,4,4,1,0,0,111
54059957400,3817,3285,32,288,15,23,0,11,532
54059957500,3341,3145,25,35,5,3,0,9,196
54059957600,3020,2872,12,56,3,3,0,1,148
54059957700,3416,3350,21,2,0,0,0,2,66
54061010101,1471,1249,57,63,2,34,2,3,222
54061010103,3355,2767,112,154,6,106,3,16,588
54061010104,2967,2292,181,131,1,164,6,11,675
54061010202,4519,3736,234,177,3,131,1,6,783
54061010203,3235,2380,166,177,5,337,4,19,855
54061010204,2720,2056,97,185,5,227,2,14,664
54061010400,3825,3092,125,231,4,160,2,11,733
54061010601,4199,2994,206,290,2,481,3,20,1205
54061010602,2221,1574,78,129,2,314,1,20,647
54061010700,3682,2982,132,242,12,73,0,23,700
54061010800,4643,3935,140,152,8,145,0,12,708
54061010901,2884,2327,130,157,17,56,2,24,557
54061010902,3323,2839,121,122,9,57,0,4,484
54061011000,4106,3050,207,523,3,86,4,22,1056
54061011100,2918,2449,82,131,8,49,0,13,469
54061011200,2992,2527,101,162,5,17,1,9,465
54061011300,4133,3812,53,34,9,7,2,4,321
54061011400,3612,3508,18,5,3,0,0,1,104
54061011500,5322,4807,74,112,5,22,2,16,515
54061011601,2769,2106,105,189,3,212,0,20,663
54061011602,4144,3469,126,170,10,178,0,10,675
54061011700,4483,3896,133,97,4,122,0,11,587
54061011803,3905,3582,54,44,0,44,0,5,323
54061011804,4527,4187,77,42,2,39,2,17,340
54061011805,4444,3998,99,68,3,69,3,2,446
54061011806,5763,5145,142,70,7,133,3,21,618
54061011900,4422,4074,81,26,3,34,0,10,348
54061012000,5238,4126,177,185,6,432,20,38,1112
54063950100,2664,2533,25,15,10,0,0,9,131
54063950200,3938,3713,27,42,9,1,0,8,225
54063950300,5774,5493,42,56,7,10,0,13,281
54065970701,3828,3559,63,16,5,23,0,13,269
54065970702,2356,2186,24,22,1,16,0,5,170
54065970800,3499,3274,44,21,14,10,0,20,225
54065970900,2385,2226,30,17,5,9,0,1,159
54065971001,3074,2867,38,15,0,19,0,6,207
54065971002,1921,1784,37,17,5,6,0,8,137
54067950100,3170,3022,28,4,5,8,4,3,148
54067950201,2437,2283,29,10,7,14,0,5,154
54067950202,3785,3596,34,8,7,28,3,0,189
54067950300,1141,1085,11,1,4,0,0,0,56
54067950400,4611,4407,27,15,11,3,0,1,204
54067950500,1397,1340,2,9,0,4,0,1,57
54067950600,4834,4682,32,4,8,8,0,1,152
54067950700,3229,3110,10,5,2,7,0,4,119
54069000200,3284,2944,72,68,0,11,0,9,340
54069000300,1664,1390,33,122,2,20,0,7,274
54069000400,958,743,19,119,8,6,0,3,215
54069000500,1359,1089,26,101,1,8,0,12,270
54069000600,1025,761,20,134,0,15,0,6,264
54069000700,879,567,22,198,2,14,1,6,312
54069001300,1220,1143,14,12,0,8,0,0,77
54069001400,2969,2620,42,152,1,30,2,18,349
54069001500,2647,2335,52,88,7,40,1,0,312
54069001600,2313,2132,31,39,4,38,4,3,181
54069001700,1679,1540,20,17,0,39,0,2,139
54069001800,5148,4575,74,197,4,42,4,14,573
54069001901,2565,2379,37,26,10,21,0,5,186
54069002000,4922,4574,49,61,4,25,7,13,348
54069002100,3846,3569,49,61,9,18,1,21,277
54069002200,2743,2548,32,36,6,30,0,2,195
54069002600,2208,1851,24,110,6,11,0,7,357
54069002700,996,799,31,115,3,11,0,6,197
54071970400,1414,1372,13,5,2,0,2,0,42
54071970500,3093,2914,23,58,5,0,0,10,179
54071970600,1636,1549,21,18,0,0,0,3,87
54073962100,3425,3215,17,76,13,8,0,7,210
54073962200,4228,4000,46,19,9,9,0,3,228
54075960101,1156,1090,13,2,3,2,0,6,66
54075960102,1168,1108,19,5,2,3,0,3,60
54075960201,1835,1742,22,6,5,3,0,4,93
54075960202,1620,1537,26,5,3,1,0,7,83
54075960300,2090,1978,27,33,10,0,0,5,112
54077963801,4751,2305,427,1903,43,17,1,0,2446
54077963802,3263,3083,41,8,4,7,2,0,180
54077963900,4063,3866,29,10,2,5,1,5,197
54077964000,4045,3803,41,20,1,12,0,3,242
54077964101,2055,1978,16,4,1,0,0,1,77
54077964102,1063,999,15,11,1,0,0,9,64
54077964103,1513,1455,15,2,1,3,0,2,58
54077964200,3716,3573,37,12,5,1,0,9,143
54077964300,4053,3867,38,17,5,5,1,1,186
54077964400,3151,2995,16,6,1,3,0,7,156
54077964500,2543,2424,20,8,5,0,0,0,119
54079020100,4950,4758,29,14,5,6,0,12,192
54079020200,5329,5035,65,12,10,24,0,5,294
54079020300,5575,5236,50,57,4,44,0,14,339
54079020400,6685,6178,89,91,10,56,1,18,507
54079020500,5925,5503,97,79,17,5,0,13,422
54079020601,5984,5430,129,54,9,138,0,12,554
54079020604,2884,2456,46,147,1,61,0,10,428
54079020606,4453,4082,59,36,0,91,0,8,371
54079020607,3423,3065,54,51,2,85,2,25,358
54079020608,4871,4482,66,69,7,37,4,16,389
54079020609,3123,2885,77,18,10,19,0,11,238
54079020700,4238,4029,50,18,6,11,0,8,209
54081000200,3352,1995,89,1004,4,45,1,18,1357
54081000300,3948,2768,68,826,16,25,3,20,1180
54081000400,3318,2239,81,718,10,53,7,8,1079
54081000500,4428,3621,86,295,0,226,0,8,807
54081000600,4410,3365,118,611,10,29,0,5,1045
54081000700,2937,2637,29,116,8,14,0,5,300
54081000802,6233,4697,167,1211,16,10,0,8,1536
54081000803,4714,4339,60,58,8,95,0,7,375
54081000804,5193,4822,77,49,10,17,0,18,371
54081000900,5469,5216,36,36,5,12,0,5,253
54081001001,4745,4492,50,38,1,16,0,3,253
54081001002,2789,2601,29,37,2,14,0,3,188
54081001100,5317,5014,31,78,11,6,0,2,303
54081001200,4109,3941,37,9,14,7,0,8,168
54081001300,4643,4071,75,227,2,65,4,5,572
54081001400,4919,4332,92,181,9,47,1,14,587
54081001500,4067,3360,72,296,6,138,0,19,707
54083965900,3861,3662,40,14,3,5,0,9,199
54083966000,4151,3825,55,48,7,28,0,7,326
54083966100,3676,3267,68,136,16,37,1,9,409
54083966200,3566,3306,55,30,5,8,0,16,260
54083966300,2703,2573,22,1,6,0,0,8,130
54083966400,5775,5499,43,27,13,18,0,14,276
54083966500,4200,3901,29,168,6,0,0,22,299
54085962300,3393,3256,29,3,1,5,3,4,137
54085962400,2440,2361,20,4,5,2,1,0,79
54085962500,2611,2499,31,9,0,12,3,4,112
54087962800,2428,2293,24,2,4,15,0,0,135
54087962901,2221,2105,17,4,0,3,0,0,116
54087962902,1946,1841,15,6,7,0,0,0,105
54087963000,3526,3292,56,18,2,16,0,9,234
54087963100,3907,3700,40,5,15,4,0,0,207
54089000500,2556,2379,26,43,6,3,0,7,177
54089000600,4797,4179,107,317,8,20,0,7,618
54089000700,1307,1176,17,26,5,5,0,5,131
54089000800,3299,3089,35,14,14,5,0,2,210
54091964600,4771,4471,43,22,1,14,0,15,300
54091964700,4807,4478,68,19,4,13,0,0,329
54091964800,4748,4436,48,60,14,7,0,7,312
54091964900,2379,2251,20,11,0,7,0,0,128
54093965200,1814,1756,9,0,0,0,0,0,58
54093965300,2229,2112,24,9,0,5,1,0,117
54093965400,2719,2564,23,11,4,1,0,10,155
54095961800,3305,3131,31,1,2,2,0,13,174
54095961900,3322,3208,9,3,9,1,0,0,114
54095962000,1686,1625,13,0,4,0,0,0,61
54097966600,4443,4190,64,20,1,16,0,7,253
54097966700,3077,2701,87,136,18,43,2,2,376
54097966800,4161,3920,61,24,5,2,0,4,241
54097966900,2896,2684,39,17,2,14,2,5,212
54097967000,4796,4590,35,7,6,3,1,10,206
54097967100,4443,4264,30,7,5,9,0,0,179
54099005100,1963,1813,32,21,1,12,2,7,150
54099005200,1956,1808,17,16,12,1,0,5,148
54099020100,2270,2102,38,28,6,13,1,4,168
54099020300,4591,4355,58,23,7,6,1,5,236
54099020400,5876,5607,55,32,8,16,0,5,269
54099020500,4746,4537,22,18,6,10,3,2,209
54099020600,4663,4459,37,12,6,13,0,8,204
54099020700,3514,3372,19,7,2,9,0,3,142
54099020800,4150,4026,21,7,0,0,2,7,124
54099020900,2437,2376,11,1,5,0,1,4,61
54099021000,2816,2744,9,3,0,3,0,6,72
54101970101,2556,2470,11,3,3,1,1,6,86
54101970102,1758,1699,10,0,4,0,1,0,59
54101970200,2122,2035,12,5,7,3,0,0,87
54101970300,1942,1882,17,2,0,0,0,1,60
54103004900,3589,3401,33,15,6,25,0,7,188
54103030400,2476,2348,21,3,2,2,0,1,128
54103030500,3225,3081,22,3,0,0,0,3,144
54103030700,3927,3718,48,9,9,12,0,0,209
54103030800,1225,1156,24,4,1,11,0,0,69
54105030101,3072,2955,14,5,0,0,3,2,117
54105030102,2122,2044,8,1,4,0,1,6,78
54107000100,3418,3058,70,34,8,62,0,21,360
54107000300,2761,2481,53,69,3,11,0,3,280
54107000400,2181,2031,17,45,1,10,0,9,150
54107000500,4166,3628,84,136,9,17,2,14,538
54107000701,2613,2204,40,113,24,12,0,7,409
54107000702,1528,1385,21,19,4,11,1,8,143
54107000801,1347,1236,12,20,3,5,0,7,111
54107000802,3336,3082,58,20,0,13,0,14,254
54107000901,1381,1282,15,8,5,7,0,14,99
54107000902,1383,1297,19,8,2,7,0,0,86
54107000903,4216,3945,70,73,2,11,0,9,271
54107010101,1911,1775,9,20,4,10,0,3,136
54107010102,2040,1823,31,48,2,30,1,9,217
54107010200,3051,2909,28,11,6,11,0,3,142
54107010300,4556,4138,48,47,8,90,2,9,418
54107010400,1686,1564,21,11,0,34,4,6,122
54107010501,1590,1421,33,21,0,19,0,2,169
54107010502,4261,3812,91,58,8,93,0,10,449
54107010601,4724,4423,49,30,5,12,0,2,301
54107010602,4371,4075,39,52,7,9,2,16,296
54107010703,4617,4375,45,22,6,25,0,3,242
54107010704,3102,2965,22,14,8,10,0,5,137
54107010705,2178,2063,19,5,6,5,0,3,115
54107010706,3650,3378,103,19,9,13,0,4,272
54107010800,3041,2955,18,0,2,3,0,2,86
54107010901,4703,4477,34,12,6,12,0,16,226
54107010902,3773,3522,48,33,5,9,0,2,251
54107011000,2712,2414,77,68,5,13,5,8,298
54109002800,2319,2179,53,13,6,0,0,2,140
54109002901,4062,3939,33,12,0,0,1,1,123
54109002902,3536,3422,17,8,10,4,0,0,114
54109003000,2255,2217,11,2,6,0,0,1,38
54109003100,4884,4717,21,17,3,2,0,4,167
54109003200,4326,4065,35,55,5,5,0,12,261
55001950100,3242,3082,48,6,12,12,1,9,160
55001950201,1386,1286,28,7,7,0,0,5,100
55001950203,935,858,35,3,5,0,0,0,77
55001950204,1646,1565,44,2,2,0,4,1,81
55001950400,4491,4088,179,39,14,22,0,15,403
55001950501,1418,1348,27,1,2,5,1,0,70
55001950502,3775,2805,253,482,92,28,2,18,970
55001950700,3761,3340,183,53,31,17,0,12,421
55003940000,2066,784,75,5,1132,0,1,1,1282
55003950300,2735,2255,87,30,200,28,2,0,480
55003950400,2267,1820,67,22,211,24,1,8,447
55003950500,2212,2020,33,3,61,10,0,0,192
55003950600,1356,1281,11,2,23,4,0,0,75
55003950700,2043,1921,30,8,15,6,0,3,122
55003950800,3348,2597,80,42,357,10,5,10,751
55003990000,0,0,0,0,0,0,0,0,0
55005000100,3931,3718,49,7,41,9,0,8,213
55005000200,4079,3586,157,12,168,18,0,14,493
55005000300,4182,3793,150,12,60,25,0,6,389
55005000400,5669,4450,231,671,41,63,0,8,1219
55005000500,4677,4241,151,25,29,69,1,7,436
55005000601,2466,2212,76,28,5,45,1,6,254
55005000602,3689,3319,150,20,31,21,0,6,370
55005000800,5527,5143,104,18,14,44,1,19,384
55005000900,4961,4617,106,10,13,27,1,21,344
55005001001,1935,1850,22,4,11,3,1,4,85
55005001003,1607,1509,28,2,3,5,0,0,98
55005001004,3988,3772,53,4,20,16,0,0,216
55007960100,3241,1645,98,11,1291,8,0,6,1596
55007960200,1902,1761,34,2,25,1,0,6,141
55007960300,3671,3202,77,22,158,11,0,17,469
55007960401,2080,1882,30,6,35,4,2,11,198
55007960402,3094,2815,24,10,93,8,0,11,279
55007960600,2232,2140,16,3,10,4,0,5,92
55007990000,0,0,0,0,0,0,0,0,0
55009000100,2596,1489,396,242,119,157,0,4,1107
55009000200,6093,4579,524,257,207,241,4,21,1514
55009000302,4722,3179,551,267,179,326,1,13,1543
55009000303,2806,1857,243,292,103,157,0,9,949
55009000401,4880,3092,611,396,192,300,8,16,1788
55009000402,2206,1839,134,21,24,91,0,4,367
55009000500,2949,1768,442,243,120,137,9,17,1181
55009000600,3822,3183,199,72,50,142,0,0,639
55009000700,4896,3361,653,237,179,154,6,20,1535
55009000800,1653,824,267,240,103,64,0,10,829
55009000900,4008,1332,1882,331,132,147,0,12,2676
55009001000,1504,1089,97,151,78,42,1,10,415
55009001100,2113,810,907,145,61,66,2,2,1303
55009001200,2196,1004,585,261,109,73,0,1,1192
55009001300,2943,2008,354,204,125,74,0,26,935
55009001400,3925,2367,944,183,70,136,0,11,1558
55009001600,6696,2697,2824,376,118,413,2,11,3999
55009001701,3719,1426,1635,230,88,215,3,9,2293
55009001702,3519,1596,1295,287,65,131,2,12,1923
55009001801,5835,4344,632,308,162,167,6,16,1491
55009001802,6515,5235,404,441,35,163,10,9,1280
55009002001,8553,5872,1641,182,78,459,8,10,2681
55009002002,5166,3541,941,65,48,381,2,8,1625
55009002003,3858,3034,378,67,18,227,0,15,824
55009010100,6506,5889,185,82,49,80,0,1,617
55009010201,4601,3785,304,151,86,126,26,5,816
55009010202,5453,4690,217,141,94,94,0,4,763
55009010300,7289,6417,299,76,67,123,4,17,872
55009020100,5817,5547,81,10,28,22,0,4,270
55009020203,7028,6512,110,26,42,79,0,15,516
55009020204,5792,5419,88,18,21,46,0,11,373
55009020502,5425,4388,312,186,91,190,4,8,1037
55009020504,6270,5726,132,57,36,105,0,12,544
55009020505,5400,4850,157,46,60,83,0,10,550
55009020506,2855,2601,82,18,18,42,0,4,254
55009020600,5632,5290,114,13,14,41,0,10,342
55009020702,7600,6850,221,54,13,149,0,23,750
55009020703,7598,6556,374,56,40,316,0,20,1042
55009020704,8337,5985,1366,125,85,467,0,29,2352
55009020800,2351,1945,164,58,26,42,0,24,406
55009020900,2800,2356,206,26,20,80,0,10,444
55009021000,2841,2441,154,51,12,60,0,12,400
55009021200,5102,4415,263,59,55,104,1,17,687
55009021301,2954,2499,85,56,73,84,0,9,455
55009021302,6209,5370,211,91,129,151,3,4,839
55009021303,3776,2939,312,117,84,168,1,4,837
55009021304,2206,1859,99,40,45,64,0,2,347
55009021400,8174,7292,455,53,24,92,0,14,882
55009021500,3248,2993,139,7,16,7,2,3,255
55009021600,6441,5923,165,21,61,33,0,12,518
55009940002,4698,3571,244,64,487,106,3,9,1127
55009940003,3715,2508,237,106,549,70,0,8,1207
55009940004,2817,1903,237,83,338,71,0,16,914
55009940005,7279,5637,268,43,899,178,0,14,1642
55009940006,4378,3877,81,27,151,109,1,14,501
55009940007,3808,3400,89,12,22,170,2,7,408
55009940008,6105,5187,146,38,90,428,3,19,918
55009980000,1062,294,80,645,41,2,0,0,768
55011960100,2622,2526,27,5,0,7,0,0,96
55011960200,2979,2766,84,15,8,9,5,2,213
55011960300,2050,1939,50,9,13,1,2,0,111
55011960400,2471,2358,47,7,4,0,1,4,113
55011960500,3195,2988,119,7,6,2,4,2,207
55013970400,4323,3818,42,16,227,8,2,6,505
55013970600,2082,1628,21,5,289,3,4,2,454
55013970700,2600,2353,32,9,90,2,0,2,247
55013970800,2468,2235,54,16,41,17,2,13,233
55013970900,3036,2753,66,15,40,17,1,4,283
55013971000,2017,1871,39,4,10,6,1,5,146
55015020100,4912,4381,315,17,27,21,2,7,531
55015020200,3840,3378,304,12,31,6,0,3,462
55015020303,3762,2858,334,89,18,350,4,7,904
55015020304,3591,2721,346,128,24,232,3,3,870
55015020306,7047,6519,176,27,17,77,3,12,528
55015020308,4943,4389,191,13,6,179,0,22,554
55015020400,3459,3266,91,1,9,6,2,10,193
55015020500,5155,4497,452,23,14,21,15,11,658
55015020600,5076,4714,162,30,24,14,9,15,362
55015020700,4448,4112,110,10,4,97,0,6,336
55015020800,6209,5221,376,69,15,266,4,28,988
55017010100,3142,2609,51,34,15,274,0,15,533
55017010200,7331,6575,178,36,59,149,0,15,756
55017010300,5494,5016,102,54,18,56,2,11,478
55017010400,5490,5026,98,31,6,138,3,16,464
55017010500,5854,5075,168,194,62,99,1,28,779
55017010700,7892,7295,133,33,27,106,0,16,597
55017010800,7428,6340,212,571,82,39,2,8,1088
55017010900,5131,4807,95,37,14,30,1,9,324
55017011001,3404,3220,54,8,9,9,1,4,184
55017011002,4091,3883,51,10,6,25,0,8,208
55017011100,4216,4006,35,8,6,15,3,12,210
55017011200,6824,6539,80,24,19,19,1,11,285
55019950100,4923,3760,1017,21,11,18,0,7,1163
55019950200,4657,4137,376,9,22,11,0,15,520
55019950300,4705,4459,114,21,9,22,1,10,246
55019950400,4021,3880,57,6,13,6,0,3,141
55019950500,4920,4657,163,7,7,9,3,9,263
55019950600,4773,4467,170,10,7,8,0,10,306
55019950700,3542,3314,99,29,10,19,0,7,228
55019950800,3118,2892,102,0,38,13,0,11,226
55021970100,4099,3762,218,8,4,13,0,14,337
55021970200,5921,5510,130,34,23,30,0,14,411
55021970300,4046,3618,223,65,32,15,0,10,428
55021970401,2968,2112,225,460,47,40,0,8,856
55021970402,3878,3409,207,50,32,24,2,6,469
55021970500,4334,3789,209,68,25,58,0,7,545
55021970600,4818,4577,60,13,25,23,0,18,241
55021970700,4386,4090,89,30,24,23,0,6,296
55021970800,5770,5352,168,14,23,41,3,13,418
55021970900,4823,4558,106,16,11,10,3,3,265
55021971000,3937,3736,69,14,8,25,0,8,201
55021971100,3733,3366,145,21,8,28,0,3,367
55021971200,5777,5158,290,73,8,46,3,12,619
55023960100,2869,2709,41,16,4,7,0,2,160
55023960200,2324,2225,20,7,0,7,0,8,99
55023960300,2510,2420,27,4,5,4,0,4,90
55023960400,2942,2801,35,4,4,17,0,3,141
55023960500,1747,1623,35,5,0,6,0,4,124
55023960600,3721,3240,102,229,28,27,1,13,481
55025000100,2813,2157,200,110,5,202,0,9,656
55025000201,2179,1816,95,63,5,95,0,11,363
55025000202,3120,2405,187,111,1,249,1,10,715
55025000204,5436,3185,415,645,8,936,2,19,2251
55025000205,5271,4333,207,94,6,396,4,24,938
55025000301,3718,1946,196,164,5,1282,3,16,1772
55025000302,2176,1696,83,31,4,234,0,19,480
55025000401,3705,3136,173,53,8,128,1,16,569
55025000402,2641,2095,162,80,2,192,2,5,546
55025000406,3882,2744,211,141,13,614,1,18,1138
55025000407,5712,3094,848,1047,24,384,5,15,2618
55025000408,1989,1521,171,148,6,100,0,4,468
55025000409,4422,2414,526,443,8,831,8,16,2008
55025000410,1790,1206,198,80,3,237,0,11,584
55025000501,4893,3368,524,461,13,249,1,38,1525
55025000504,7139,5037,788,449,16,514,2,34,2102
55025000505,3931,2597,493,433,9,228,0,12,1334
55025000506,3535,1718,770,605,6,224,7,6,1817
55025000600,5821,1711,2621,974,23,288,1,29,4110
55025000700,3359,2864,166,70,2,81,1,14,495
55025000800,3933,3102,217,104,8,267,1,26,831
55025000901,2246,1908,72,23,0,80,2,14,338
55025000902,5695,4503,235,68,1,592,1,38,1192
55025001000,2518,2214,81,39,3,45,0,9,304
55025001101,5511,3323,209,193,14,1550,2,24,2188
55025001102,4556,3107,257,68,15,851,2,15,1449
55025001200,6436,4939,375,332,10,469,12,17,1497
55025001300,2399,1926,140,104,15,71,0,16,473
55025001401,6037,1894,1989,993,30,831,4,35,4143
55025001402,5429,2668,1027,1162,12,238,1,14,2761
55025001404,5312,2822,1027,903,15,284,0,27,2490
55025001405,3380,2387,459,230,0,157,0,4,993
55025001501,2377,1353,466,328,0,84,2,8,1024
55025001502,5614,2278,1730,1001,13,274,3,31,3336
55025001603,6733,4085,419,103,45,1758,0,26,2648
55025001604,6598,4907,472,133,16,730,3,27,1691
55025001605,3324,2525,209,101,5,308,4,11,799
55025001606,7514,5458,488,208,15,972,19,25,2056
55025001704,4154,3160,175,332,3,324,1,14,994
55025001706,2788,2109,204,132,8,164,5,13,679
55025001707,1680,1262,132,54,7,139,0,4,418
55025001802,3705,2970,223,164,11,163,1,10,735
55025001804,4431,3218,302,402,11,273,0,34,1213
55025001901,4232,3521,179,202,17,93,0,18,711
55025001902,2805,2357,129,78,14,86,0,8,448
55025002000,6332,4857,503,483,22,157,0,20,1475
55025002100,4761,3683,379,260,20,93,0,38,1078
55025002200,4313,2828,330,717,10,142,5,23,1485
55025002301,3189,1520,361,834,13,241,1,13,1669
55025002302,1851,1373,79,234,14,75,4,8,478
55025002401,3387,2589,220,258,8,125,0,10,798
55025002402,3756,2102,381,664,4,371,0,10,1654
55025002500,2409,1115,519,457,11,142,0,6,1294
55025002601,1847,1201,226,247,2,67,0,9,646
55025002602,6036,3460,1120,680,27,367,8,16,2576
55025002603,5409,3019,772,774,15,545,0,35,2390
55025002700,3427,2875,205,119,8,51,2,13,552
55025002800,2196,1860,155,49,4,29,2,16,336
55025002900,3315,2487,343,192,1,115,0,23,828
55025003001,4775,3755,259,334,8,175,0,27,1020
55025003002,3558,1827,625,703,6,157,3,16,1731
55025003100,6228,4738,495,443,36,161,1,23,1490
55025003200,2436,771,232,130,8,1136,0,19,1665
55025010100,2135,1609,110,49,1,232,0,6,526
55025010200,1335,1230,37,9,1,10,0,0,105
55025010300,3804,3329,198,66,8,49,3,20,475
55025010400,3569,3139,148,86,9,40,4,11,430
55025010501,4132,3087,298,261,25,194,1,22,1045
55025010503,5090,4613,102,36,12,138,3,4,477
55025010504,3591,3136,159,74,8,58,2,1,455
55025010600,5111,4640,195,29,8,56,5,20,471
55025010701,6351,5236,341,182,8,280,0,12,1115
55025010702,9079,7243,514,254,15,631,4,27,1836
55025010801,6654,5222,434,227,12,472,1,3,1432
55025010802,5415,4674,246,78,12,152,0,36,741
55025010903,4530,3500,157,74,5,630,3,15,1030
55025010905,5288,3988,278,105,2,741,1,31,1300
55025010906,4849,3202,157,82,8,1175,6,8,1647
55025010907,5614,4739,178,63,1,365,0,28,875
55025010908,5221,4487,166,93,4,270,0,15,734
55025011000,4566,3841,222,72,7,241,0,22,725
55025011101,5107,3571,652,366,19,202,5,16,1536
55025011103,5382,4290,343,173,15,289,0,17,1092
55025011104,4415,3584,139,48,5,441,0,11,831
55025011201,3967,3462,173,61,1,114,0,7,505
55025011202,6464,5687,254,57,6,161,0,26,777
55025011301,7366,6583,277,85,1,151,2,25,783
55025011302,3035,2609,211,41,4,49,0,6,426
55025011403,2925,2225,177,218,7,141,0,7,700
55025011404,7833,5912,363,294,18,927,0,29,1921
55025011405,4990,3472,305,259,20,712,10,22,1518
55025011406,4865,3504,327,502,4,278,2,36,1361
55025011407,1929,1556,109,100,11,50,0,9,373
55025011504,4989,3402,386,331,9,548,1,27,1587
55025011505,4400,2746,467,657,12,174,0,35,1654
55025011506,6815,4934,446,642,30,400,0,33,1881
55025011507,5397,4340,194,296,5,265,0,19,1057
55025011508,4288,3659,114,100,10,196,6,10,629
55025011600,7398,5945,412,346,16,310,2,45,1453
55025011700,4431,3910,201,65,6,105,0,10,521
55025011800,5828,4701,666,132,24,65,3,16,1127
55025011900,7172,6476,253,119,11,73,1,30,696
55025012002,4864,4494,106,35,4,56,0,21,370
55025012003,6548,5668,253,145,23,239,0,15,880
55025012004,2676,2370,110,44,0,54,1,4,306
55025012100,2834,2553,161,9,6,20,5,1,281
55025012201,1945,1771,60,23,0,37,0,3,174
55025012202,6751,5980,255,148,13,89,0,13,771
55025012300,5765,5125,201,93,11,84,1,16,640
55025012400,4980,4604,149,41,9,21,3,1,376
55025012501,6657,5999,236,95,17,64,1,19,658
55025012502,6958,5807,332,417,35,94,1,25,1151
55025012600,4460,4120,151,33,1,27,0,4,340
55025012700,4215,3953,87,14,7,31,0,14,262
55025012800,8313,7560,257,71,15,74,0,37,753
55025012900,3929,3739,82,5,3,20,0,5,190
55025013000,4708,4254,156,45,10,45,1,13,454
55025013100,4845,4468,108,42,14,34,0,18,377
55025013201,3879,3476,203,25,1,57,3,1,403
55025013202,8000,6986,313,165,13,181,4,32,1014
55025013301,5104,4386,252,123,5,166,1,3,718
55025013302,5472,4762,255,103,22,108,0,11,710
55025013700,7107,6064,364,97,14,290,0,11,1043
55025991702,0,0,0,0,0,0,0,0,0
55025991703,0,0,0,0,0,0,0,0,0
55027960100,6240,5731,280,49,14,21,0,12,509
55027960200,3006,2853,62,3,7,2,1,22,153
55027960300,8155,5913,402,1483,140,50,0,12,2242
55027960400,4426,3941,298,17,8,35,0,13,485
55027960500,4078,3111,231,606,29,30,0,0,967
55027960600,4046,3687,215,28,12,17,0,10,359
55027960700,4698,4036,382,85,7,59,0,9,662
55027960800,3588,3039,370,38,4,30,0,3,549
55027960900,4364,3520,606,57,13,40,0,8,844
55027961000,4590,3591,651,96,10,26,0,18,999
55027961100,4389,3896,302,64,14,10,0,11,493
55027961200,3436,3057,205,26,14,14,2,5,379
55027961300,5373,4864,259,25,13,32,2,8,509
55027961400,4033,3795,104,9,8,13,0,0,238
55027961500,5261,4941,125,6,8,15,3,28,320
55027961600,4278,3982,103,25,32,14,0,10,296
55027961700,3137,2904,105,15,13,40,1,10,233
55027961800,4471,4113,186,22,10,3,0,9,358
55027961900,5548,4913,393,29,10,51,0,13,635
55027962000,2279,1958,211,18,5,9,2,3,321
55029100100,2554,2415,42,5,5,16,0,4,139
55029100300,2975,2776,100,4,2,9,0,4,199
55029100400,3118,2860,172,9,16,8,0,8,258
55029100500,3601,3389,108,5,4,13,0,8,212
55029100600,3356,3088,112,4,10,14,0,5,268
55029100700,4894,4254,307,52,32,33,0,15,640
55029100800,5554,5000,186,50,42,35,0,22,554
55029100900,1775,1645,58,7,6,3,0,3,130
55029101000,2239,2097,53,4,5,5,0,7,142
55029990000,0,0,0,0,0,0,0,0,0
55031020300,2918,2376,77,74,98,59,2,5,542
55031020400,3228,2890,49,40,32,30,2,14,338
55031020500,2906,2440,76,67,75,37,4,7,466
55031020600,4226,3557,119,108,103,25,4,13,669
55031020700,4230,3823,57,45,54,35,0,14,407
55031020800,3492,3161,71,42,43,14,0,12,331
55031020900,2291,2081,25,14,25,17,1,10,210
55031021000,1863,1612,52,34,44,13,3,4,251
55031021100,2139,1771,51,71,71,22,0,4,368
55031030101,4164,3845,41,17,44,11,0,8,319
55031030102,2083,1900,37,10,20,1,0,7,183
55031030200,5247,4881,36,9,74,10,1,11,366
55031030301,3143,2930,44,9,38,3,0,22,213
55031030302,2365,2150,33,36,42,9,1,8,215
55031990000,0,0,0,0,0,0,0,0,0
55033970100,3903,3700,59,15,6,12,1,13,203
55033970200,4783,4481,90,14,12,10,2,12,302
55033970300,6129,5631,127,44,39,83,3,1,498
55033970400,6601,5965,164,22,15,237,0,11,636
55033970500,6813,6119,146,66,23,225,2,14,694
55033970600,4043,3807,93,9,2,51,2,1,236
55033970700,6875,5735,174,100,29,586,0,10,1140
55033970801,2790,2413,92,53,15,116,2,7,377
55033970802,3503,3061,90,65,16,131,1,19,442
55035000100,5094,4829,101,12,24,7,0,13,265
55035000200,4834,4533,86,5,5,19,0,29,301
55035000301,3883,3559,74,28,10,82,2,13,324
55035000302,8369,7414,264,81,25,274,0,20,955
55035000401,2637,2418,35,26,6,58,0,11,219
55035000402,5814,5080,225,77,17,137,1,14,734
55035000501,4940,4362,99,30,17,251,1,11,578
55035000502,4939,4288,105,52,32,243,0,3,651
55035000600,4900,3950,184,130,30,303,31,11,950
55035000700,5110,4415,166,79,20,175,12,5,695
55035000801,3779,3371,74,27,7,163,2,4,408
55035000802,3944,3368,172,48,12,218,5,12,576
55035000803,6265,5050,358,152,26,378,9,9,1215
55035000900,5056,4211,202,69,32,319,0,26,845
55035001101,2041,1784,56,50,18,64,1,4,257
55035001200,5318,4640,203,85,33,179,0,8,678
55035001300,5689,4760,170,58,29,454,1,14,929
55035001401,3449,2936,68,34,10,237,3,6,513
55035001402,3989,3331,163,69,55,222,6,0,658
55035001500,3859,3423,65,26,11,202,4,13,436
55035001600,6547,6059,99,13,5,134,2,14,488
55035001700,5254,4573,149,62,16,246,3,11,681
55037190101,1234,1160,17,3,14,0,2,5,74
55037190102,1465,1379,27,6,6,0,0,2,86
55037190200,1859,1757,22,0,10,5,2,4,102
55039040100,4118,3600,217,80,4,51,0,10,518
55039040200,2835,2143,300,158,23,76,0,2,692
55039040300,5954,4031,1069,303,39,198,1,36,1923
55039040400,2877,2444,168,80,9,76,1,0,433
55039040500,3933,2771,400,465,25,46,2,10,1162
55039040700,5522,4626,409,141,21,100,2,20,896
55039040800,4506,3735,359,148,21,39,0,13,771
55039040900,3380,2945,188,81,10,36,0,12,435
55039041000,3013,2542,238,69,4,52,0,3,471
55039041101,4999,4352,267,129,9,93,0,22,647
55039041102,5171,4466,322,115,14,92,3,4,705
55039041300,6919,5628,856,89,26,89,0,11,1291
55039041400,5848,5498,141,14,12,22,0,11,350
55039041500,3346,2974,246,22,5,15,0,2,372
55039041600,5831,4972,446,132,10,63,13,22,859
55039041700,3881,3606,176,13,4,6,5,2,275
55039041800,4922,4559,173,28,11,27,2,13,363
55039041901,3733,3506,98,8,6,18,0,2,227
55039041902,3397,3130,160,6,7,10,1,5,267
55039042001,3036,2825,76,10,5,40,0,0,211
55039042002,6397,5761,184,204,68,65,0,1,636
55039042100,4547,4357,100,11,12,6,0,6,190
55039042200,5989,5679,124,15,10,21,1,7,310
55041950100,1322,1234,22,2,21,6,0,2,88
55041950200,2532,2098,32,1,266,11,7,0,434
55041950300,2669,2065,56,24,403,0,0,1,604
55041950400,2656,1974,45,5,497,0,0,0,682
55043960100,3770,3554,88,12,10,8,1,1,216
55043960200,4464,3881,130,272,20,20,1,7,583
55043960300,4441,4141,149,15,3,21,0,4,300
55043960400,3373,3142,117,17,13,9,0,0,231
55043960500,3630,3486,62,4,6,13,0,5,144
55043960600,3871,3720,59,25,3,12,0,8,151
55043960700,4130,3903,68,36,1,18,3,5,227
55043960800,2990,2859,40,15,1,19,0,2,131
55043960900,5062,4460,182,123,14,110,0,7,602
55043961000,7538,6847,213,137,7,152,2,14,691
55043961100,4372,4181,58,17,11,22,0,0,191
55043961200,4297,4151,70,6,6,7,1,5,146
55045960100,6670,6157,167,47,8,29,0,14,513
55045960200,5953,5607,127,28,5,25,1,16,346
55045960300,4878,4609,78,22,6,18,0,4,269
55045960400,4359,3852,334,32,5,39,0,7,507
55045960500,3843,3345,313,19,3,11,0,8,498
55045960600,3262,2912,179,24,5,29,1,4,350
55045960700,3828,3600,83,7,7,8,0,11,228
55045960800,4300,3878,219,22,10,11,1,12,422
55047100100,3175,2623,364,30,14,23,0,5,552
55047100200,3052,2636,256,15,17,31,0,5,416
55047100300,3068,2857,73,25,5,18,0,10,211
55047100400,2803,2625,67,11,5,14,0,6,178
55047100500,3128,2984,60,11,1,4,0,3,144
55047100600,3792,3530,159,14,7,11,0,10,262
55049950100,3858,3614,60,14,5,29,0,13,244
55049950200,3002,2793,64,13,3,9,0,4,209
55049950300,3062,2887,84,8,3,9,1,8,175
55049950400,5407,4942,110,36,13,102,0,7,465
55049950500,4842,4593,82,26,2,14,10,16,249
55049950600,3538,3374,55,17,0,15,1,2,164
55051180100,2616,2460,33,4,37,9,0,14,156
55051180200,1352,1281,14,3,8,0,0,0,71
55051180300,2169,2068,25,4,18,4,0,13,101
55051990000,0,0,0,0,0,0,0,0,0
55053960100,4293,2838,167,367,763,24,0,5,1455
55053960200,3286,2870,194,17,69,6,0,12,416
55053960300,4302,4029,100,5,45,12,0,7,273
55053960400,4497,4251,76,8,26,8,0,11,246
55053960500,4767,3951,141,43,416,23,0,10,816
55055100100,5396,4541,446,102,16,50,2,13,855
55055100200,3586,2884,491,63,20,23,0,8,702
55055100301,3737,3281,298,21,9,29,1,8,456
55055100302,2358,1845,364,38,7,16,1,6,513
55055100400,5921,4919,711,63,11,40,2,14,1002
55055100500,6837,6131,389,37,15,47,1,14,706
55055100601,1656,1586,28,5,1,3,0,1,70
55055100602,3437,3208,96,18,6,15,0,6,229
55055100700,4982,4252,446,29,10,58,0,22,730
55055100800,4038,3789,88,13,6,10,2,18,249
55055100900,3801,3502,155,9,11,18,1,5,299
55055101000,3678,3193,294,26,9,2,0,10,485
55055101100,4373,3417,629,77,11,30,0,8,956
55055101201,2277,2134,54,13,1,6,0,0,143
55055101202,1678,1551,51,3,11,10,0,5,127
55055101300,6017,5201,442,53,10,74,0,9,816
55055101400,3355,2586,554,38,8,30,0,12,769
55055101500,3976,3416,373,41,11,25,0,7,560
55055101600,6844,5423,922,175,26,122,4,13,1421
55055101701,1434,1302,86,9,0,6,3,7,132
55055101702,5519,5164,151,31,7,32,2,16,355
55057100100,2819,2570,113,8,14,15,0,8,249
55057100200,3586,3352,66,11,14,34,0,7,234
55057100301,1450,1361,25,3,9,5,1,3,89
55057100302,2087,1966,20,6,9,7,0,2,121
55057100400,5134,4292,157,370,84,36,0,14,842
55057100500,4186,3695,161,113,42,26,0,12,491
55057100600,3270,3046,71,19,13,13,0,5,224
55057100700,4186,3726,114,18,170,11,0,1,460
55059000101,1793,1266,257,148,6,23,0,8,527
55059000102,3863,2680,437,479,10,78,1,9,1183
55059000300,5167,3508,788,497,14,56,3,25,1659
55059000400,3603,2687,541,155,4,25,0,3,916
55059000501,2794,2073,395,161,5,24,0,7,721
55059000502,2713,2129,244,180,4,49,0,8,584
55059000601,6496,4838,849,365,18,193,4,26,1658
55059000603,3779,2890,422,221,3,92,0,4,889
55059000604,3898,2857,491,266,0,123,0,10,1041
55059000700,5369,2323,1716,1042,17,19,2,12,3046
55059000800,2763,1055,1033,500,4,17,4,15,1708
55059000900,4058,1564,1600,659,12,24,0,23,2494
55059001000,2623,1628,452,396,7,33,2,7,995
55059001100,3502,1177,1190,915,16,13,6,11,2325
55059001200,4020,2135,1162,441,13,31,2,12,1885
55059001300,3981,2227,976,486,13,51,3,18,1754
55059001401,2612,2029,333,105,2,25,1,8,583
55059001402,4570,3354,680,243,13,84,1,14,1216
55059001500,3709,2417,785,226,12,28,0,13,1292
55059001600,3350,1246,1114,732,6,25,3,28,2104
55059001700,2697,1580,650,305,3,14,1,2,1117
55059001800,2201,1202,527,307,8,15,0,0,999
55059001900,2351,1890,215,123,2,19,0,10,461
55059002000,5731,4599,567,144,13,93,0,19,1132
55059002100,4983,3074,1009,505,20,61,11,11,1909
55059002200,3570,2757,446,161,6,20,4,6,813
55059002300,5706,4441,671,272,11,56,0,10,1265
55059002400,4644,3820,485,106,17,42,0,6,824
55059002500,3352,2673,334,157,8,46,2,8,679
55059002603,4909,3132,626,398,0,477,4,27,1777
55059002604,3939,2714,481,228,4,291,1,7,1225
55059002605,5916,4628,539,220,15,225,3,39,1288
55059002606,4624,3803,377,119,6,126,1,10,821
55059002700,6533,5702,344,77,11,123,0,21,831
55059002801,3410,3126,124,11,3,20,1,0,284
55059002802,2803,2590,133,7,3,10,0,0,213
55059002903,3197,2861,152,22,9,11,1,11,336
55059002904,5300,4680,342,16,10,29,5,15,620
55059002905,3776,3340,231,12,12,19,0,12,436
55059002906,5247,4577,328,39,12,45,1,19,670
55059003001,4541,4141,195,13,4,23,0,20,400
55059003002,5058,4523,305,21,15,15,0,14,535
55059990000,0,0,0,0,0,0,0,0,0
55061960100,3227,2950,95,22,16,10,2,11,277
55061960200,2506,2335,98,5,5,4,0,4,171
55061960401,5116,4722,234,6,4,18,0,15,394
55061960402,3785,3487,187,5,16,14,0,3,298
55061960500,5929,5498,220,19,14,18,0,8,431
55061990000,0,0,0,0,0,0,0,0,0
55063000100,4715,3867,153,132,23,301,0,22,848
55063000200,4997,3568,212,334,50,570,0,13,1429
55063000300,2495,2011,111,180,12,71,0,1,484
55063000401,2498,1998,114,119,21,136,0,9,500
55063000402,3135,2813,85,68,18,64,2,9,322
55063000500,5272,4693,224,30,5,113,1,45,579
55063000600,2125,1924,68,18,5,43,0,7,201
55063000700,4453,3979,114,44,12,168,1,10,474
55063000800,3013,2609,111,63,5,78,2,28,404
55063000900,3870,2979,193,177,18,310,0,11,891
55063001000,3661,3080,82,113,16,186,0,15,581
55063001101,2155,1919,42,30,19,66,1,2,236
55063001102,4064,3547,79,53,10,196,0,18,517
55063001200,4207,3625,82,88,26,213,0,15,582
55063010101,5766,5384,119,13,22,82,0,24,382
55063010102,5112,4669,130,26,23,65,0,6,443
55063010202,8261,7438,125,38,13,457,5,15,823
55063010203,1961,1854,38,6,6,5,0,2,107
55063010204,5235,4502,92,35,8,429,0,6,733
55063010205,5387,5012,41,22,11,162,0,9,375
55063010300,4462,4032,78,43,23,135,2,10,430
55063010401,5712,5088,138,28,16,245,0,18,624
55063010403,5757,4693,155,74,13,538,2,20,1064
55063010404,3927,3242,128,37,12,300,0,23,685
55063010500,5733,4899,120,73,17,441,0,10,834
55063010600,3756,3448,56,31,6,92,0,17,308
55063010700,5744,5301,103,44,25,113,0,15,443
55063010800,3311,3133,58,8,5,20,0,5,178
55065970100,2954,2835,45,0,0,4,0,2,119
55065970200,3970,3204,635,11,12,16,1,7,766
55065970300,3426,3164,195,4,0,4,3,0,262
55065970400,3050,2859,120,1,0,6,0,7,191
55065970500,3211,3019,94,11,8,6,0,3,192
55067960101,1163,1101,14,1,16,1,0,4,62
55067960102,1499,1428,14,3,9,2,0,5,71
55067960300,2466,2323,52,4,22,6,0,5,143
55067960400,3864,3596,63,8,37,9,0,6,268
55067960500,1821,1685,52,15,11,5,1,2,136
55067960600,4450,3975,160,42,67,28,0,9,475
55067960700,4228,3852,104,32,73,16,3,5,376
55069960100,2283,2176,43,2,3,11,0,0,107
55069960200,2634,2433,53,5,23,14,0,8,201
55069960300,1851,1771,32,0,2,6,0,0,80
55069960400,1883,1794,31,0,6,7,0,2,89
55069960500,1914,1821,40,0,2,5,0,0,93
55069960600,4438,4286,46,9,5,9,0,3,152
55069960700,3845,3610,50,70,5,28,2,0,235
55069960800,3468,3190,92,24,16,21,0,7,278
55069960900,2637,2423,57,29,31,8,0,5,214
55069961000,3462,3230,85,9,15,8,0,10,232
55071000100,5731,4842,399,116,28,147,1,11,889
55071000200,2432,2141,107,23,1,79,0,4,291
55071000300,5649,5190,145,45,13,116,4,12,459
55071000400,4194,3497,275,116,29,64,0,17,697
55071000500,2731,1937,308,103,17,183,0,18,794
55071000600,5459,4383,329,85,23,473,1,16,1076
55071000700,6037,4574,500,136,46,532,0,11,1463
55071000800,4145,3166,453,141,38,170,0,14,979
55071005100,2231,2027,42,25,22,37,3,0,204
55071005200,4477,4102,94,29,17,73,0,11,375
55071005300,2006,1728,108,42,11,45,0,1,278
55071005400,2971,2374,175,58,17,153,2,13,597
55071010100,4405,4144,108,5,20,18,0,13,261
55071010200,5721,5413,87,17,24,33,1,30,308
55071010300,4378,4092,151,2,18,12,1,10,286
55071010400,6083,5628,286,6,15,23,0,6,455
55071010500,3562,3313,68,40,8,30,1,8,249
55071010600,5056,4576,293,16,11,41,0,10,480
55071010700,4091,3824,122,22,13,18,1,7,267
55071990000,0,0,0,0,0,0,0,0,0
55073000100,3118,2155,231,119,35,348,3,14,963
55073000200,2766,2159,115,25,17,329,0,3,607
55073000300,5198,4465,134,60,21,332,0,12,733
55073000400,6219,4679,253,104,32,920,0,25,1540
55073000500,2992,2075,150,64,15,549,0,12,917
55073000601,1925,1296,77,32,10,445,1,4,629
55073000602,3795,2520,212,88,41,723,3,11,1275
55073000700,5771,4461,254,104,37,582,5,13,1310
55073000800,3557,3169,82,26,19,118,4,7,388
55073000900,2189,1885,69,25,8,108,3,1,304
55073001000,3673,3211,73,31,13,208,1,9,462
55073001103,5313,4091,189,69,23,733,4,12,1222
55073001104,6112,4934,253,83,45,582,0,20,1178
55073001105,2487,2241,60,12,8,110,0,3,246
55073001106,6358,5473,97,31,15,542,0,24,885
55073001202,5622,5256,118,15,14,37,0,21,366
55073001203,5244,4590,100,27,23,337,0,8,654
55073001204,4215,3874,74,15,14,101,0,5,341
55073001300,7302,6479,118,19,7,459,0,14,823
55073001401,3702,3164,117,23,11,210,0,27,538
55073001402,3565,3119,68,16,11,219,2,13,446
55073001500,4281,3927,70,20,6,140,0,10,354
55073001600,6194,5748,120,18,38,91,0,12,446
55073001700,3593,3348,122,7,16,8,0,4,245
55073001800,5565,5326,63,16,6,33,0,15,239
55073001900,5963,5644,122,7,13,44,0,4,319
55073002000,3836,3584,127,9,15,13,3,2,252
55073002101,4349,4074,168,9,7,7,0,5,275
55073002102,2792,2559,50,39,0,73,0,13,233
55073002200,3540,2852,591,6,8,14,0,7,688
55073002301,3328,3153,108,9,2,1,0,5,175
55073002302,3449,3272,68,13,16,15,0,5,177
55075960100,3008,2793,65,13,5,4,0,4,215
55075960200,3796,3580,59,12,14,8,0,9,216
55075960600,2462,2331,39,3,11,6,0,5,131
55075960700,3301,3133,45,6,20,4,0,7,168
55075960800,2813,2606,80,2,22,4,0,1,207
55075960900,2661,2544,20,6,8,5,0,1,117
55075961000,4027,3667,198,12,27,5,0,17,360
55075961100,5348,5030,84,8,17,39,0,14,318
55075961200,2733,2577,50,8,7,12,0,4,156
55075961300,3093,2732,127,45,15,32,1,6,361
55075961400,4839,4331,195,50,29,35,3,6,508
55075961500,3791,3430,117,27,28,26,4,22,361
55075990000,0,0,0,0,0,0,0,0,0
55077960100,2762,2642,35,7,10,9,1,4,120
55077960200,2544,2397,56,8,12,5,0,7,147
55077960300,4069,3799,87,11,16,17,1,17,270
55077960400,2631,2396,139,3,8,9,3,2,235
55077960500,3586,3243,171,15,14,11,0,15,343
55078940101,1351,27,42,2,1266,1,1,0,1324
55078940103,1342,80,38,0,1205,0,1,0,1262
55078940104,1562,376,56,0,1078,1,0,0,1186
55079000101,4535,902,240,2971,8,229,0,24,3633
55079000102,3711,678,157,2508,6,209,2,13,3033
55079000201,5272,555,788,3561,11,162,0,35,4717
55079000202,6109,1688,397,3246,9,454,3,33,4421
55079000301,1377,959,63,228,7,67,0,4,418
55079000302,2874,284,176,2172,10,118,1,14,2590
55079000303,1820,592,173,768,5,168,0,9,1228
55079000304,3435,909,155,1565,2,661,0,25,2526
55079000400,2555,660,162,1438,10,154,1,22,1895
55079000501,3343,968,256,1628,18,283,0,21,2375
55079000502,4296,476,224,2982,10,412,0,16,3820
55079000600,6158,1054,274,3226,6,1372,0,17,5104
55079000700,3572,712,233,2253,6,222,3,7,2860
55079000800,4906,848,273,3088,15,389,1,21,4058
55079000900,3534,483,188,2470,6,226,2,11,3051
55079001000,3336,406,195,2531,5,52,0,16,2930
55079001100,2648,185,80,2219,7,54,0,11,2463
55079001200,2888,121,112,1962,4,612,0,3,2767
55079001300,3684,283,158,2585,28,456,0,33,3401
55079001400,2280,214,80,1472,3,394,0,4,2066
55079001500,3176,313,100,1889,12,760,2,8,2863
55079001600,2786,273,128,2128,1,186,1,4,2513
55079001700,4399,595,243,2980,13,387,5,20,3804
55079001800,2256,249,125,1652,2,157,0,5,2007
55079001900,3260,325,136,2523,8,167,1,22,2935
55079002000,2319,147,131,1911,2,17,1,19,2172
55079002100,2228,119,83,1936,1,20,0,3,2109
55079002200,1802,504,158,989,3,46,0,7,1298
55079002300,3919,120,186,3473,21,15,0,17,3799
55079002400,2150,64,88,1871,4,26,0,24,2086
55079002500,2041,104,101,1711,15,16,2,15,1937
55079002600,2659,89,153,2308,7,10,0,2,2570
55079002700,1984,116,86,1629,10,46,2,5,1868
55079002800,2121,122,86,1714,13,100,0,8,1999
55079002900,2146,160,90,1659,4,151,0,5,1986
55079003000,3712,400,212,2735,15,206,0,24,3312
55079003100,3415,253,133,2592,4,322,0,24,3162
55079003200,2662,262,89,1871,16,336,0,7,2400
55079003300,5117,690,222,3450,8,516,1,34,4427
55079003400,5745,1415,261,3431,17,363,0,18,4330
55079003500,3213,292,119,2494,6,220,0,0,2921
55079003600,1697,115,68,1417,4,34,1,9,1582
55079003700,2305,264,106,1770,10,42,1,19,2041
55079003800,2060,117,90,1754,6,32,2,8,1943
55079003900,2587,75,92,2307,11,21,0,10,2512
55079004000,2475,73,45,2253,5,39,0,11,2402
55079004100,2493,74,126,2156,7,29,0,2,2419
55079004200,2689,48,100,2432,4,5,0,11,2641
55079004300,4931,144,173,4423,6,11,0,10,4787
55079004400,2682,475,184,1839,4,77,0,6,2207
55079004500,2179,37,86,1976,1,7,0,3,2142
55079004600,2683,47,59,2472,8,17,2,13,2636
55079004700,3599,44,66,3352,4,15,0,10,3555
55079004800,3525,100,131,3147,8,17,0,25,3425
55079004900,4256,599,195,3212,5,79,0,29,3657
55079005000,4591,950,231,3111,7,100,3,37,3641
55079005100,3369,342,98,2618,6,158,0,17,3027
55079005200,1660,625,103,705,3,124,6,16,1035
55079005300,2022,956,130,691,8,63,5,21,1066
55079005400,3660,2087,231,975,8,116,1,31,1573
55079005500,3333,2200,237,587,12,105,1,12,1133
55079005600,2065,1612,113,169,11,43,0,14,453
55079005700,2393,1635,123,472,2,37,0,4,758
55079005800,3358,1845,192,1097,7,36,2,14,1513
55079005900,3408,732,298,2088,12,106,0,31,2676
55079006000,2428,150,124,2003,10,34,0,8,2278
55079006100,2216,192,132,1769,0,28,0,12,2024
55079006200,2339,46,79,2098,5,27,0,15,2293
55079006300,1910,34,69,1729,0,5,2,11,1876
55079006400,1962,29,102,1734,7,15,0,26,1933
55079006500,2068,35,62,1886,10,17,0,9,2033
55079006600,2292,44,48,2132,3,3,0,5,2248
55079006700,1094,50,26,983,7,2,0,0,1044
55079006800,2164,82,112,1884,18,5,0,1,2082
55079006900,2147,82,328,1658,12,2,0,12,2065
55079007000,2507,209,302,1842,3,8,0,7,2298
55079007100,1838,1222,250,216,6,33,0,16,616
55079007200,2727,1681,279,542,15,26,0,7,1046
55079007300,2949,2324,204,111,4,127,1,79,625
55079007400,3512,2882,189,53,3,79,0,227,630
55079007500,2669,2209,155,70,2,98,0,37,460
55079007600,3304,2626,203,188,12,131,2,19,678
55079007700,4035,2891,299,358,9,296,6,19,1144
55079007800,3475,2739,219,162,16,143,0,37,736
55079007900,2212,1693,161,159,5,24,0,62,519
55079008000,1792,1183,287,181,9,18,1,14,609
55079008100,1238,194,226,750,0,11,0,10,1044
55079008400,951,42,47,793,3,8,0,11,909
55079008500,1159,63,43,997,1,4,0,3,1096
55079008600,1131,11,37,1047,0,0,0,3,1120
55079008700,1174,11,34,1080,2,7,0,2,1163
55079008800,1826,81,41,1636,2,11,0,4,1745
55079008900,1271,35,122,1030,1,21,1,7,1236
55079009000,2396,37,54,2073,9,135,2,11,2359
55079009100,2218,164,126,1769,11,75,1,8,2054
55079009200,1638,401,100,994,3,52,0,8,1237
55079009300,2368,1169,199,764,7,71,0,4,1199
55079009400,2421,1779,202,264,13,35,0,10,642
55079009500,1995,1356,122,366,5,24,0,7,639
55079009600,2187,93,140,1581,4,287,1,7,2094
55079009700,1785,40,77,923,10,682,1,11,1745
55079009800,1575,20,73,1039,5,363,0,10,1555
55079009900,1162,36,102,884,1,101,2,2,1126
55079010600,1114,360,179,500,3,13,0,6,754
55079010700,2341,1619,258,293,6,44,1,4,722
55079010800,2660,2042,192,168,5,118,0,38,618
55079011000,3418,2435,265,440,7,115,0,20,983
55079011100,1641,1284,124,95,6,62,0,9,357
55079011200,2711,1998,179,307,8,77,2,9,713
55079011300,2941,2215,178,242,0,179,0,30,726
55079011400,1500,1010,111,256,7,49,1,6,490
55079012200,2149,177,204,991,6,699,0,4,1972
55079012300,1047,161,149,527,5,145,0,6,886
55079012400,2478,1216,259,657,16,173,0,11,1262
55079012500,1904,1461,140,131,17,50,0,3,443
55079012600,2213,1582,227,219,14,35,0,19,631
55079012700,1307,1005,129,71,1,34,0,17,302
55079012800,3052,2158,326,271,18,110,1,23,894
55079012900,3002,1717,797,240,41,39,1,9,1285
55079013000,1804,916,463,234,18,42,0,13,888
55079013300,1002,336,190,294,11,76,2,8,666
55079013400,2313,245,424,1356,17,152,2,11,2068
55079013500,1901,318,294,1145,20,15,2,9,1583
55079013600,2033,357,141,1375,34,45,1,4,1676
55079013700,1459,135,168,941,5,152,0,3,1324
55079014100,2103,490,125,1373,2,30,0,4,1613
55079014300,2549,2003,160,121,5,150,1,16,546
55079014400,3282,2398,210,167,7,377,0,26,884
55079014600,3257,1937,363,557,6,268,0,17,1320
55079014700,3694,2211,307,708,10,299,8,20,1483
55079014800,2484,983,287,958,6,162,0,4,1501
55079014900,1418,469,214,541,9,89,2,12,949
55079015700,2943,284,2331,213,13,55,0,11,2659
55079015800,2631,269,1886,341,6,66,2,6,2362
55079015900,3590,465,2459,419,36,108,2,11,3125
55079016000,3084,443,2023,288,30,190,2,7,2641
55079016100,3169,417,2463,117,25,73,2,19,2752
55079016200,3296,570,2246,164,22,202,3,11,2726
55079016300,4779,433,3539,461,25,195,1,18,4346
55079016400,4220,301,3292,360,41,152,2,16,3919
55079016500,2362,265,1776,191,27,47,0,11,2097
55079016600,1757,300,1107,266,6,39,0,9,1457
55079016700,3114,305,2202,344,26,150,0,10,2809
55079016800,3025,212,2367,265,13,111,0,8,2813
55079016900,3823,423,2883,287,31,76,0,13,3400
55079017000,5697,747,4279,315,44,208,0,17,4950
55079017100,2780,330,2225,70,9,94,0,11,2450
55079017200,2589,349,2067,58,12,69,0,2,2240
55079017300,3706,507,2916,105,19,67,3,5,3199
55079017400,2878,378,2094,228,31,91,2,5,2500
55079017500,4034,408,2993,332,23,172,2,6,3626
55079017600,2798,352,2048,176,25,135,0,10,2446
55079017900,2879,2015,521,123,27,70,0,9,864
55079018000,2726,2007,426,74,16,68,1,10,719
55079018100,1589,1347,131,10,10,22,0,10,242
55079018200,1563,1333,111,40,5,15,0,5,230
55079018300,2260,1800,240,42,11,30,1,14,460
55079018400,1300,982,192,31,1,13,0,12,318
55079018500,1661,1100,410,38,5,19,2,5,561
55079018600,2672,362,1928,155,20,118,7,10,2310
55079018700,3597,432,2667,172,23,231,0,13,3165
55079018800,2023,205,1576,126,5,61,0,12,1818
55079018900,1696,387,1112,108,5,36,0,3,1309
55079019000,4758,2285,1806,249,32,229,0,20,2473
55079019100,3685,1654,1278,338,18,233,1,12,2031
55079019200,3455,2023,973,146,28,106,6,18,1432
55079019300,2806,1816,702,75,19,81,0,6,990
55079019400,3679,2528,578,235,23,113,0,23,1151
55079019500,3243,2279,588,129,24,72,0,15,964
55079019600,3602,2357,731,175,17,163,1,8,1245
55079019700,5644,3510,1087,287,30,406,1,20,2134
55079019800,5158,3014,1453,262,32,193,2,12,2144
55079019900,3802,2248,1045,151,27,151,0,20,1554
55079020000,3658,1072,1393,375,26,642,0,21,2586
55079020100,3807,914,2214,339,15,220,0,24,2893
55079020200,3483,1178,1551,146,25,488,0,12,2305
55079020300,4156,1550,2028,90,28,353,0,12,2606
55079020400,3266,550,2351,103,8,175,1,12,2716
55079020500,3074,653,2104,59,20,181,1,5,2421
55079020600,3325,2439,565,73,20,49,1,8,886
55079020700,4145,3214,554,118,17,40,0,20,931
55079020800,2920,2392,280,36,12,43,1,15,528
55079020900,2559,1852,447,88,16,32,1,3,707
55079021000,2122,1470,431,44,17,69,3,1,652
55079021100,1385,1005,291,21,6,18,2,4,380
55079021200,2093,1326,443,118,11,71,0,5,767
55079021300,1670,820,467,116,16,203,0,6,850
55079021400,3432,1157,1052,564,18,507,4,18,2275
55079021500,2969,1682,667,54,11,426,0,2,1287
55079021600,4686,2406,981,305,14,752,1,35,2280
55079021700,6241,3903,1417,223,43,394,0,24,2338
55079021800,2187,1326,457,111,16,210,0,6,861
55079030100,4378,3567,192,210,4,224,3,13,811
55079035100,2306,1998,75,47,1,82,0,5,308
55079035200,4628,3811,207,177,3,230,4,30,817
55079040100,1602,1239,68,109,0,112,0,2,363
55079050101,6061,2799,348,1948,24,629,7,38,3262
55079050103,3509,1468,181,1495,5,190,0,15,2041
55079050104,2937,1243,163,1221,8,157,0,13,1694
55079060101,4106,2822,187,692,8,196,1,16,1284
55079060102,3262,2394,169,407,5,105,3,20,868
55079060200,5989,3934,311,1233,10,217,5,26,2055
55079070100,4666,4064,200,51,4,148,3,21,602
55079070200,5389,4736,174,45,5,179,0,27,653
55079070300,4899,3672,266,318,8,392,5,24,1227
55079080100,2781,2136,151,145,0,211,0,4,645
55079080200,3745,2899,247,161,6,214,0,7,846
55079080300,3900,3296,157,74,3,152,1,13,604
55079080400,3433,2584,199,183,7,276,0,15,849
55079090100,4118,2985,227,525,0,156,5,12,1133
55079090200,2249,1758,100,180,1,108,1,7,491
55079090300,3613,2378,253,461,17,282,2,7,1235
55079090600,4647,3719,264,330,7,128,0,22,928
55079090700,3234,2917,78,53,0,44,1,14,317
55079090800,2351,2076,80,71,2,36,0,4,275
55079090900,3674,3007,141,254,4,80,0,6,667
55079091000,4402,3649,220,280,3,66,0,16,753
55079091100,4252,3852,137,53,11,47,1,15,400
55079091200,5371,4371,229,234,15,256,1,20,1000
55079091300,3703,3280,118,65,0,117,3,11,423
55079091400,2124,1788,113,64,7,33,3,13,336
55079100100,3852,1938,1250,345,34,47,0,12,1914
55079100200,3821,2021,1101,340,60,89,3,25,1800
55079100300,2884,1896,567,187,27,42,3,8,988
55079100400,2718,1930,401,190,32,29,1,11,788
55079100500,3476,2386,514,245,60,58,0,11,1090
55079100600,2033,1552,260,69,17,33,0,12,481
55079100700,2857,2217,363,46,14,71,0,15,640
55079100800,2914,2460,218,70,9,55,0,5,454
55079100900,3744,2457,485,282,32,292,1,18,1287
55079101000,5161,3700,555,445,15,172,1,27,1461
55079101100,1779,1333,197,123,12,69,0,4,446
55079101200,3040,2522,272,74,10,39,0,14,518
55079101300,3096,2382,365,97,13,85,0,22,714
55079101400,3686,2704,554,168,18,83,2,13,982
55079101500,4511,2884,951,296,42,59,1,14,1627
55079101600,4603,2855,1142,275,62,89,4,7,1748
55079101700,3468,2313,678,183,30,74,1,22,1155
55079101800,2682,1999,338,105,10,129,0,4,683
55079110100,4114,1752,1465,564,26,102,0,23,2362
55079120101,4482,3548,343,141,7,267,0,5,934
55079120102,3930,3250,274,111,9,164,1,8,680
55079120201,3666,2883,390,140,6,135,0,12,783
55079120202,3234,2249,595,101,20,130,2,6,985
55079120203,3916,2712,603,221,32,173,0,10,1204
55079120300,2134,1421,464,57,15,79,1,14,713
55079120400,6760,4303,1303,379,37,427,0,36,2457
55079120501,4076,2800,586,120,25,366,0,13,1276
55079120502,5350,3851,607,193,24,492,3,15,1499
55079130100,4865,4005,413,130,9,96,0,16,860
55079130200,2855,2520,191,24,5,40,0,4,335
55079140100,3197,2775,136,20,6,162,0,3,422
55079140201,5694,4684,465,101,26,206,2,17,1010
55079140202,5963,4787,556,104,16,263,5,18,1176
55079150100,9519,7123,831,249,31,975,0,23,2396
55079150301,6039,5152,356,49,19,243,0,22,887
55079150303,5010,4298,211,61,12,287,0,13,712
55079150304,3991,3156,211,119,7,355,0,8,835
55079160101,4344,3522,372,105,19,185,1,5,822
55079160102,2595,1745,418,135,21,184,0,4,850
55079160202,7596,5846,732,233,37,456,0,11,1750
55079160203,6654,4975,612,304,32,468,0,15,1679
55079160205,3368,2399,385,216,8,218,6,30,969
55079160206,1942,1108,158,65,5,513,0,3,834
55079160301,5523,4605,422,85,30,220,0,6,918
55079160302,4475,3599,349,85,3,264,0,15,876
55079170100,2595,2143,271,62,20,24,0,4,452
55079170200,3750,2903,495,114,13,78,0,7,847
55079170300,2713,2132,341,66,11,38,0,12,581
55079170400,3200,2662,296,58,5,65,1,13,538
55079170500,2420,1860,333,108,7,23,0,5,560
55079170600,3513,2459,591,178,53,45,0,28,1054
55079170700,2604,1903,377,98,22,45,0,4,701
55079180100,2970,2360,325,62,18,40,0,10,610
55079180200,4503,3129,878,153,55,69,0,16,1374
55079180300,3534,2255,675,303,28,60,4,11,1279
55079180400,2704,2140,330,65,16,35,0,10,564
55079180500,4493,3483,590,172,15,84,0,6,1010
55079185100,4438,3514,435,158,31,98,2,26,924
55079185200,4723,3536,709,154,32,78,0,14,1187
55079185300,4649,3608,259,270,6,306,0,13,1041
55079185400,1271,11,72,1135,0,7,0,9,1260
55079185500,1420,40,43,1288,8,10,0,7,1380
55079185600,1636,293,89,1124,2,18,0,13,1343
55079185700,2158,181,152,1688,7,5,1,24,1977
55079185800,1410,22,155,1030,3,139,0,8,1388
55079185900,1031,35,45,826,0,73,0,9,996
55079186000,1711,165,100,1385,5,4,1,2,1546
55079186100,2021,94,158,1389,6,261,0,10,1927
55079186200,1382,87,84,1050,12,126,0,5,1295
55079186300,3749,2085,279,1018,23,174,0,31,1664
55079186400,1423,969,207,88,5,96,2,6,454
55079186500,2217,744,975,337,17,37,0,11,1473
55079186600,2310,721,1262,202,15,29,2,13,1589
55079186800,1736,497,688,437,7,27,5,7,1239
55079186900,2502,2080,101,114,2,125,0,14,422
55079187000,3895,2958,250,295,3,202,0,24,937
55079187200,5724,3543,410,1279,6,332,1,22,2181
55079187300,6533,5229,446,98,23,539,1,19,1304
55079187400,3976,3311,207,157,9,161,1,8,665
55079980000,3,0,2,0,0,0,0,0,3
55079990000,0,0,0,0,0,0,0,0,0
55081950100,4533,4005,131,33,160,21,0,16,528
55081950200,5237,4733,194,97,10,44,9,8,504
55081950300,6693,5342,855,95,54,73,14,11,1351
55081950400,4506,3948,287,50,14,21,9,1,558
55081950500,6309,5437,230,185,87,91,8,15,872
55081950600,4227,3523,240,115,101,45,16,17,704
55081950700,4608,4341,73,14,38,24,4,14,267
55081950800,4385,3972,265,13,7,11,1,22,413
55081950900,5776,5307,285,18,22,22,2,7,469
55083100300,2938,2803,30,1,34,6,0,3,135
55083100500,2301,2170,43,2,19,8,0,2,131
55083100600,2770,2467,73,0,87,6,0,6,303
55083100700,2803,2492,120,4,54,3,0,13,311
55083100800,2559,2367,94,7,17,7,0,3,192
55083100900,2887,2612,76,20,52,15,0,2,275
55083101000,4113,3804,101,10,51,8,0,2,309
55083101100,4691,4435,79,5,35,8,0,9,256
55083101200,4204,3844,110,34,45,16,0,10,360
55083101301,5329,5102,44,4,24,17,0,11,227
55083101302,4370,4074,78,4,45,16,0,5,296
55083990000,0,0,0,0,0,0,0,0,0
55085970101,1804,1743,12,3,2,3,0,6,61
55085970103,1065,1014,5,2,16,1,0,4,51
55085970104,2540,2430,33,0,8,8,0,3,110
55085970400,2944,2800,16,14,32,7,0,2,144
55085970500,1788,1684,29,6,11,13,0,4,104
55085970601,1983,1883,25,14,12,3,0,0,100
55085970603,1985,1856,28,5,27,11,1,1,129
55085970604,1842,1773,24,6,8,6,1,4,69
55085970800,2389,2171,49,1,71,15,3,8,218
55085970900,2582,2416,34,39,18,4,2,9,166
55085971001,1320,1269,9,2,6,4,0,4,51
55085971002,2693,2510,48,4,44,12,1,21,183
55085971100,2013,1897,20,7,11,3,0,7,116
55085971300,2077,1894,28,4,36,35,2,19,183
55085971400,3980,3568,111,25,64,42,4,4,412
55085971500,4840,4356,104,73,75,28,4,21,484
55087010100,2814,2074,217,215,51,115,5,15,740
55087010200,4175,3208,349,112,22,243,4,10,967
55087010300,2467,1891,205,133,27,86,2,12,576
55087010501,2505,2072,136,49,14,84,14,10,433
55087010502,1943,1532,69,94,49,140,0,6,411
55087010601,3623,2695,351,121,29,256,3,9,928
55087010602,4081,3235,299,74,22,294,0,9,846
55087010700,4713,3691,418,111,23,248,0,11,1022
55087010800,1446,1238,78,25,14,31,0,4,208
55087010900,2240,1846,123,88,6,78,3,6,394
55087011001,2744,1927,369,142,20,164,6,4,817
55087011002,2763,2094,273,120,40,107,14,10,669
55087011101,4921,3613,479,148,36,440,0,25,1308
55087011103,3524,3012,141,52,9,174,0,4,512
55087011104,3859,2848,328,158,25,348,0,4,1011
55087011200,2987,2228,216,46,25,357,9,7,759
55087011300,3129,2614,160,54,19,103,0,13,515
55087011400,5454,4356,313,92,22,440,18,15,1098
55087011501,3348,2746,208,38,12,224,2,2,602
55087011502,4565,3616,271,90,29,368,0,14,949
55087011600,7390,6626,243,87,23,178,2,9,764
55087011700,2696,2314,121,46,12,68,0,9,382
55087011800,1945,1752,79,14,6,20,0,3,193
55087011901,3138,2656,240,35,23,71,3,6,482
55087011902,4614,4202,143,38,33,53,0,9,412
55087012000,6669,6201,150,34,18,76,1,13,468
55087012101,4192,3878,102,37,23,29,2,19,314
55087012102,4239,3793,161,33,24,73,1,6,446
55087012200,1965,1676,76,32,25,44,0,5,289
55087012300,1616,1384,70,32,11,28,0,3,232
55087012400,3091,2724,143,21,29,13,0,8,367
55087012503,3836,3304,130,53,1,217,1,5,532
55087012504,4094,3631,119,32,7,174,2,4,463
55087012505,5511,4831,222,42,18,196,0,8,680
55087012506,4464,3644,212,84,21,353,12,14,820
55087012602,5308,5059,89,14,13,44,0,4,249
55087012603,5489,5080,126,38,13,81,2,6,409
55087012604,4759,4163,353,20,16,92,0,9,596
55087012700,6648,6023,283,47,14,72,0,9,625
55087012800,7874,7315,247,19,28,48,0,11,559
55087012902,3764,3514,54,13,15,48,0,9,250
55087012903,3455,3235,94,13,28,9,0,3,220
55087012904,3077,2861,66,9,6,48,0,1,216
55087013100,5937,5433,120,27,114,34,0,20,504
55087013200,3807,3383,249,18,25,9,0,17,424
55087013300,9247,8399,260,85,35,200,0,13,848
55087940000,4579,2262,268,44,1668,10,6,2,2317
55089610101,4357,3991,189,43,8,11,1,8,366
55089610102,3871,3462,208,25,7,57,0,7,409
55089620100,5796,5238,250,52,16,58,2,18,558
55089630100,2664,2388,98,32,5,26,0,3,276
55089630201,4565,4210,167,39,10,22,2,9,355
55089630202,6055,5348,222,180,17,86,0,19,707
55089640101,3141,2869,88,22,8,72,2,8,272
55089640102,2909,2638,106,29,8,21,0,7,271
55089640201,2460,2201,86,41,0,52,0,13,259
55089640202,6357,5707,147,35,20,272,3,24,650
55089650102,2721,2496,74,11,2,48,0,4,225
55089650103,2269,2033,73,39,2,38,1,5,236
55089650104,4369,4050,121,21,9,57,0,2,319
55089650200,5128,4618,130,69,5,96,2,16,510
55089650300,6305,5888,123,44,9,62,0,17,417
55089660100,3290,2871,134,44,11,118,0,4,419
55089660201,4511,3709,155,151,8,318,1,9,802
55089660202,6658,5412,243,284,10,333,0,143,1246
55089660301,5787,5058,192,127,4,236,0,5,729
55089660303,5133,4453,186,132,5,174,0,16,680
55089660304,3157,2770,106,63,3,126,0,6,387
55089990000,0,0,0,0,0,0,0,0,0
55091950100,3973,3716,102,12,23,17,0,0,257
55091950200,3345,3150,55,8,10,5,0,7,195
55093960100,2837,2664,53,11,7,18,0,8,173
55093960200,6174,5724,169,40,8,25,0,21,450
55093960300,5707,4818,274,172,97,71,8,26,889
55093960400,5964,5314,194,100,20,77,0,19,650
55093960500,7977,7362,218,32,38,42,2,22,615
55093960600,4988,4672,82,14,16,27,0,5,316
55093960700,4873,4521,124,25,13,11,0,8,352
55093960800,3692,3460,106,8,10,18,0,30,232
55095960100,3741,3439,100,18,37,18,0,22,302
55095960200,3812,3579,74,11,6,30,0,13,233
55095960301,1935,1821,22,2,5,5,0,7,114
55095960302,2246,2091,40,8,16,2,0,5,155
55095960303,1217,983,24,1,141,0,0,3,234
55095960500,2832,2664,57,10,9,4,0,3,168
55095960600,2218,2074,30,7,49,2,0,7,144
55095960701,3821,3572,84,13,12,27,0,6,249
55095960702,2109,1924,51,11,6,13,1,0,185
55095960800,6858,6416,157,28,14,39,1,21,442
55095960901,3065,2828,93,4,14,18,0,15,237
55095960902,2397,2273,20,1,12,9,0,5,124
55095961000,4852,4517,113,32,25,23,3,9,335
55095961100,3874,3591,82,13,24,15,2,14,283
55097960100,4619,4372,112,6,6,16,0,10,247
55097960200,4758,4534,90,10,6,34,0,4,224
55097960300,4059,3389,192,94,13,182,0,11,670
55097960400,6595,5330,278,321,87,413,8,8,1265
55097960500,7185,6516,198,43,27,181,1,10,669
55097960600,5497,5214,81,12,12,20,0,9,283
55097960701,5502,4904,147,35,9,255,3,3,598
55097960702,3484,3089,95,15,6,196,2,0,395
55097960800,5246,4571,183,69,7,245,1,12,675
55097960900,3135,2637,135,71,12,137,0,12,498
55097961000,2268,1905,116,53,8,73,0,7,363
55097961101,3904,3400,165,47,4,182,0,12,504
55097961102,2984,2614,84,41,8,107,0,8,370
55097961200,6257,5397,380,73,27,193,0,16,860
55097961300,4884,4340,364,13,10,18,1,20,544
55099970100,2652,2503,18,0,33,12,15,0,149
55099970200,2679,2410,45,10,11,23,88,5,269
55099970400,1843,1729,35,1,7,12,4,14,114
55099970500,2171,2018,31,13,16,11,15,4,153
55099970600,2246,2168,11,4,6,3,0,14,78
55099970700,2463,2329,40,3,10,6,2,1,134
55101000200,4902,1867,1162,1573,17,26,2,33,3035
55101000400,3804,805,1564,1209,1,11,0,31,2999
55101000500,4825,624,2000,1969,7,11,0,21,4201
55101000600,5640,2595,1393,1282,16,37,0,26,3045
55101000700,5662,2809,1418,1040,8,22,3,13,2853
55101000800,4526,2340,1205,690,1,42,0,17,2186
55101000901,3714,2106,912,435,9,61,1,18,1608
55101000903,4150,2921,370,540,16,96,2,22,1229
55101000904,5283,3461,588,825,16,126,2,26,1822
55101001001,2736,1245,445,863,4,32,0,21,1491
55101001002,2687,1596,572,385,11,12,0,3,1091
55101001003,3847,2173,692,654,8,6,0,21,1674
55101001101,3916,2681,578,397,11,52,1,19,1235
55101001102,2434,1666,340,262,8,29,0,14,768
55101001201,3689,1931,804,662,7,29,2,21,1758
55101001202,6758,2967,1817,1496,36,46,0,44,3791
55101001301,3728,2309,786,382,11,16,1,18,1419
55101001302,4021,1881,1000,890,15,15,0,22,2140
55101001401,3606,2408,579,376,7,29,2,13,1198
55101001402,3396,2324,421,426,2,38,0,26,1072
55101001501,3790,3123,374,61,14,49,2,13,667
55101001504,3062,2193,266,354,2,77,0,10,869
55101001505,4282,3029,436,479,9,120,1,21,1253
55101001506,4122,3411,334,133,19,51,0,5,711
55101001507,2854,2227,272,146,14,25,2,8,627
55101001601,6193,5231,491,83,15,107,4,36,962
55101001602,3129,2595,255,83,3,62,0,20,534
55101001701,3715,2093,464,745,14,172,0,16,1622
55101001702,6998,4690,711,1151,46,129,4,24,2308
55101001703,4578,3773,392,155,15,76,0,8,805
55101001705,5828,4698,477,249,8,135,2,15,1130
55101001706,3916,3042,273,326,10,104,0,20,874
55101001801,5076,4456,265,60,9,48,0,25,620
55101001802,2976,2696,158,12,2,16,0,18,280
55101001900,3926,3477,245,19,17,17,0,19,449
55101002001,2934,2688,119,7,5,15,0,9,246
55101002002,4982,4617,165,10,12,38,0,13,365
55101002100,3343,3086,112,12,0,16,0,5,257
55101002401,5964,5127,541,42,8,48,4,15,837
55101002402,5320,4429,575,69,6,65,3,9,891
55101002600,5810,5297,248,22,17,29,1,10,513
55101002701,3932,3582,185,10,2,32,1,12,350
55101002702,6305,5795,265,22,12,43,5,5,510
55101002800,6022,5586,167,19,14,23,0,12,436
55101002900,4407,966,1442,1773,13,19,2,15,3441
55101980000,939,717,33,133,41,9,0,0,222
55101990000,0,0,0,0,0,0,0,0,0
55103970100,2763,2621,46,3,9,6,0,0,142
55103970200,4572,4386,58,6,6,7,0,4,186
55103970300,2468,2237,101,25,2,16,0,4,231
55103970400,3454,3037,203,44,10,47,0,2,417
55103970500,4047,3733,118,14,15,19,0,14,314
55105000100,899,693,70,79,4,2,0,2,206
55105000200,2851,2415,203,63,3,28,0,2,436
55105000300,2854,1769,384,290,12,118,3,17,1085
55105000400,3700,2804,383,214,15,76,0,13,896
55105000500,4347,3658,298,121,6,51,7,12,689
55105000600,3364,2774,255,130,17,25,0,11,590
55105000700,3939,3196,334,125,10,87,0,12,743
55105000800,3928,3329,268,89,11,59,1,21,599
55105000900,2878,2540,118,43,4,47,3,7,338
55105001000,3380,2571,478,97,9,51,0,5,809
55105001100,5423,4468,441,165,11,62,0,11,955
55105001201,5709,5177,165,76,7,57,1,5,532
55105001202,6280,5573,214,182,14,78,1,5,707
55105001302,6499,5814,252,122,13,71,2,25,685
55105001303,4990,4511,122,35,7,121,0,13,479
55105001305,3560,3211,143,28,8,52,0,5,349
55105001306,5142,4216,360,228,4,96,0,13,926
55105001400,5871,4824,558,114,9,51,0,25,1047
55105001500,2321,1259,319,360,8,240,14,50,1062
55105001600,4694,2174,1380,788,17,17,0,16,2520
55105001700,5096,2612,1241,803,18,44,0,6,2484
55105001800,4249,1324,1459,1133,5,16,0,35,2925
55105001900,2688,1553,585,345,13,25,2,5,1135
55105002000,3837,2612,699,229,13,10,2,20,1225
55105002100,3766,2666,468,365,7,23,0,15,1100
55105002200,2296,1903,159,81,15,24,0,7,393
55105002300,1870,1137,380,249,5,13,0,5,733
55105002400,3663,3063,273,121,8,41,0,7,600
55105002500,2646,1610,464,413,7,28,1,12,1036
55105002601,5470,3674,813,546,22,101,0,56,1796
55105002602,4175,3273,448,184,5,87,4,4,902
55105002700,2490,2334,64,14,7,6,0,0,156
55105002800,5164,4848,112,28,4,8,0,6,316
55105002901,3762,3364,181,25,3,29,4,13,398
55105002902,4972,4509,220,35,12,28,0,9,463
55105003001,5323,4717,309,51,14,26,0,16,606
55105003002,5692,5270,183,13,10,34,1,11,422
55105003101,2786,2588,76,5,7,44,1,5,198
55105003102,4953,4557,202,21,10,25,0,11,396
55105003200,2577,2215,290,6,3,10,0,3,362
55105003300,3583,2991,429,44,9,11,3,7,592
55107960100,3496,3334,43,3,6,2,3,11,162
55107960200,1993,1856,29,6,5,3,0,4,137
55107960300,2287,2152,37,0,12,8,1,4,135
55107960400,2905,2743,43,6,16,10,0,11,162
55107960500,3507,3202,98,29,19,30,1,6,305
55109120100,2038,1863,73,12,2,11,2,8,175
55109120201,6018,5504,165,42,6,73,7,17,514
55109120202,5344,4908,81,31,7,116,0,25,436
55109120300,5777,5299,156,23,30,71,2,15,478
55109120401,7148,6505,242,30,29,57,1,23,643
55109120402,4340,4048,96,19,5,30,0,19,292
55109120501,6382,5701,176,121,20,74,0,27,681
55109120502,6338,5748,201,52,23,44,1,28,590
55109120601,2866,2638,68,11,3,29,3,21,228
55109120602,5533,5185,85,16,12,27,0,11,348
55109120700,4766,4473,88,19,12,31,5,17,293
55109120801,3733,3331,165,35,8,24,0,9,402
55109120802,5150,4803,126,19,15,28,0,14,347
55109120901,4582,4236,130,24,14,36,0,3,346
55109120904,4443,4126,116,5,5,55,2,11,317
55109120905,7179,6127,416,130,23,126,5,22,1052
55109120906,3966,3662,72,19,4,57,3,23,304
55109121000,7933,7300,223,27,15,95,2,16,633
55111000101,1458,1344,57,6,15,6,1,0,114
55111000102,1759,1296,298,50,36,17,4,2,463
55111000103,2776,2177,221,25,258,8,0,6,599
55111000104,1530,858,534,46,15,32,0,5,672
55111000200,5169,4698,137,25,130,13,0,3,471
55111000301,3629,3023,343,32,39,29,0,0,606
55111000302,1400,1221,78,16,7,4,3,10,179
55111000303,2358,2092,117,43,17,30,0,4,266
55111000401,5572,4972,196,61,70,59,0,18,600
55111000402,3252,2867,138,42,29,31,0,15,385
55111000500,3645,3096,371,27,8,10,1,8,549
55111000601,1577,1475,50,1,6,6,3,0,102
55111000602,1958,1708,159,5,8,10,0,2,250
55111000603,3368,3085,140,17,11,22,0,2,283
55111000700,2874,2522,200,16,1,13,1,20,352
55111000800,3929,3676,111,13,15,18,0,7,253
55111000901,2250,2116,62,16,9,3,1,7,134
55111000902,1414,1354,19,11,3,3,0,0,60
55111000903,1291,1234,18,2,1,1,0,15,57
55111001002,3094,2547,357,47,26,17,1,9,547
55111001003,2086,1834,117,13,26,10,0,0,252
55111001004,3042,2698,184,49,12,18,0,11,344
55111001005,2095,1909,73,6,19,20,0,4,186
55111001100,4237,4066,70,9,3,14,0,0,171
55113100300,4925,4004,144,26,457,33,0,16,921
55113100400,2557,2321,43,8,75,10,0,14,236
55113100501,1647,1528,14,8,31,4,0,4,119
55113100502,2204,2046,26,6,39,4,0,12,158
55113100700,1767,1537,30,8,60,7,0,1,230
55113100800,1753,1570,48,32,32,5,0,2,183
55113940001,2045,400,34,3,1496,0,2,4,1645
55113940002,1176,411,19,5,671,0,0,1,765
55115100100,2784,2528,133,2,60,0,0,2,256
55115100200,1776,1612,45,0,69,4,0,1,164
55115100300,3697,3272,96,15,181,4,0,3,425
55115100400,4407,3387,175,20,532,20,6,15,1020
55115100500,5100,3715,215,34,819,43,0,16,1385
55115100600,4162,2308,112,10,1344,6,0,4,1854
55115100700,3074,2814,136,4,44,3,0,2,260
55115100800,4567,4074,127,14,134,15,0,5,493
55115100900,3732,3557,23,0,48,13,0,0,175
55115101000,3674,3475,52,17,53,11,0,10,199
55115101100,3908,3662,62,1,25,46,0,1,246
55117000100,3650,2935,302,59,11,173,2,8,715
55117000201,2908,1686,519,136,17,426,1,13,1222
55117000202,4415,3163,483,121,17,431,2,27,1252
55117000300,7248,5262,655,102,19,933,1,28,1986
55117000400,4344,3249,366,69,10,492,0,13,1095
55117000500,3627,2144,555,228,11,532,4,8,1483
55117000800,5299,3017,1196,268,28,540,1,13,2282
55117000900,5538,3810,776,157,26,565,3,16,1728
55117001000,7545,5314,717,208,21,1039,0,15,2231
55117001100,3750,2775,395,114,15,307,1,12,975
55117010100,1429,1324,40,0,0,43,0,0,105
55117010200,4718,4161,270,63,5,46,0,18,557
55117010300,3080,2952,27,1,4,17,0,3,128
55117010400,2989,2569,135,196,22,18,0,6,420
55117010502,3798,3500,112,37,13,46,0,6,298
55117010503,3526,3215,125,16,12,38,2,16,311
55117010504,4440,4166,87,22,15,41,0,18,274
55117010601,5517,5006,227,40,15,68,1,20,511
55117010602,4373,3904,193,36,3,119,2,4,469
55117010700,9192,7909,320,95,11,593,0,24,1283
55117010800,3676,3246,156,17,19,123,0,12,430
55117010900,3100,2896,92,15,2,45,0,9,204
55117011000,2715,2479,119,4,4,14,0,11,236
55117011100,3664,3146,103,311,36,18,0,2,518
55117011200,3511,3246,142,6,9,28,0,12,265
55117011301,4409,4060,172,14,6,27,0,25,349
55117011302,3024,2801,110,7,5,14,0,11,223
55117011400,2549,1902,268,92,6,139,1,10,647
55117990000,0,0,0,0,0,0,0,0,0
55119960100,4190,3885,174,17,6,14,0,5,305
55119960200,1990,1902,19,2,6,0,0,8,88
55119960300,2873,2737,41,6,3,2,0,0,136
55119960400,4602,4369,109,13,7,19,0,0,233
55119960500,2926,2669,128,19,7,16,0,1,257
55119960600,3332,3151,96,7,10,11,5,0,181
55121100100,3423,3268,64,4,13,11,0,5,155
55121100200,3346,3077,162,9,10,9,0,10,269
55121100300,2555,1928,574,7,2,6,0,1,627
55121100400,4050,3623,278,18,15,2,0,12,427
55121100500,3038,2797,151,7,15,5,0,5,241
55121100600,4858,2219,2555,13,5,15,0,9,2639
55121100700,5599,5261,115,14,14,29,0,8,338
55121100800,3891,3657,58,9,8,32,0,2,234
55123960100,4399,4196,73,18,7,6,0,12,203
55123960200,4319,4123,92,5,4,13,1,21,196
55123960300,4509,4276,72,8,4,22,4,11,233
55123960400,5017,4654,105,53,4,24,2,13,363
55123960500,3583,3391,41,15,9,8,0,20,192
55123960600,4800,4646,37,6,4,13,0,2,154
55123960700,4087,3893,44,16,9,3,2,17,194
55125940000,3573,1339,92,7,2002,0,0,8,2234
55125950201,2952,2782,59,0,20,11,0,5,170
55125950202,1481,1377,21,2,6,1,0,9,104
55125950501,3060,2852,83,2,29,7,0,6,208
55125950502,3191,2921,86,32,49,5,0,6,270
55125950601,2693,2574,35,0,14,8,0,12,119
55125950602,1738,1667,21,0,10,8,0,8,71
55125950700,4359,4057,62,6,51,17,0,7,302
55127000102,2633,2412,110,11,4,11,0,11,221
55127000103,2758,2492,129,35,9,8,0,16,266
55127000104,3510,3331,88,13,3,11,0,7,179
55127000201,3681,3444,103,9,8,19,0,1,237
55127000202,2888,2712,92,8,0,6,0,12,176
55127000301,3038,2799,124,13,14,5,0,6,239
55127000303,3457,3132,159,20,5,15,0,16,325
55127000304,2864,2541,216,9,10,13,0,8,323
55127000400,4007,3091,625,93,0,61,0,6,916
55127000501,4092,3242,312,282,21,141,0,6,850
55127000502,3771,2960,529,84,6,65,3,10,811
55127000600,5496,4189,1007,38,4,22,0,18,1307
55127000701,4200,2640,1343,66,9,23,2,10,1560
55127000702,4652,3102,1282,49,7,47,0,11,1550
55127000801,1810,1413,302,10,5,12,0,5,397
55127000802,2707,2315,272,13,2,25,0,0,392
55127000901,6115,5081,660,49,11,64,0,13,1034
55127000902,3587,2775,610,22,9,49,0,2,812
55127001000,5036,4533,289,33,8,37,0,12,503
55127001501,3485,2994,296,9,9,50,0,15,491
55127001503,2369,1703,555,12,1,28,0,7,666
55127001504,3044,2489,390,12,3,45,0,13,555
55127001603,2923,2607,194,14,14,32,0,6,316
55127001605,4180,3345,520,46,5,85,0,8,835
55127001606,2462,2242,125,11,6,4,0,8,220
55127001607,3656,3142,297,92,6,70,2,3,514
55127001608,2819,2216,465,23,4,21,0,2,603
55127001701,5918,4709,881,66,18,17,3,13,1209
55127001702,5320,4453,575,24,28,16,0,23,867
55129950100,2116,1921,48,10,19,13,1,4,195
55129950200,1870,1759,22,2,23,4,0,1,111
55129950300,2925,2692,38,5,52,6,0,4,233
55129950501,2753,2496,72,5,34,17,0,11,257
55129950502,2292,2144,35,6,18,11,3,0,148
55129950600,4667,4336,84,2,36,8,0,16,331
55131400102,3691,3417,128,44,10,11,0,8,274
55131400103,3645,3436,122,15,7,12,0,6,209
55131400104,5949,5486,147,53,16,55,0,20,463
55131410100,5427,4986,159,52,9,34,3,10,441
55131420104,5177,4706,227,42,6,42,1,16,471
55131420105,4544,3964,252,106,16,37,1,9,580
55131420106,3490,3119,184,36,6,25,1,3,371
55131420107,3412,3073,146,33,0,67,0,10,339
55131420108,2435,2339,23,0,5,9,2,4,96
55131420200,5545,4932,212,66,17,93,2,25,613
55131420300,5765,5050,323,118,24,21,3,24,715
55131420401,2417,2142,109,55,5,22,0,2,275
55131420402,2085,1922,97,16,6,24,0,3,163
55131430100,5646,5283,183,5,15,38,1,26,363
55131440103,5181,4693,230,42,8,49,0,16,488
55131440104,6507,5610,490,96,15,68,3,17,897
55131440105,3843,3597,84,6,6,21,1,27,246
55131440106,3825,3620,58,3,8,14,0,20,205
55131440200,3856,3398,263,29,7,20,1,25,458
55131450103,5477,5123,121,36,7,36,1,8,354
55131450105,3014,2834,77,16,2,35,0,2,180
55131450106,6144,5602,194,38,10,65,1,18,542
55131450107,3587,3298,87,35,1,52,4,18,289
55131450108,3202,2980,70,29,1,42,0,15,222
55131460101,6320,5958,82,46,6,85,0,18,362
55131460102,5419,5114,95,21,3,69,1,12,305
55131470100,5790,5111,161,130,25,176,0,16,679
55131470202,6124,5442,151,119,10,193,1,8,682
55131470203,5028,4013,253,248,9,306,0,20,1015
55131470204,4216,3607,99,137,12,222,1,1,609
55133200101,4513,3789,166,139,14,215,1,13,724
55133200102,5440,4611,221,176,8,215,4,11,829
55133200103,3017,2583,127,95,1,93,0,2,434
55133200201,3639,3246,74,122,2,91,0,5,393
55133200202,4493,3681,110,203,7,308,0,21,812
55133200300,5288,4371,158,119,10,404,4,10,917
55133200400,7375,5988,203,406,22,490,0,30,1387
55133200500,6069,4856,223,187,19,589,0,21,1213
55133200600,1787,1439,79,117,12,54,1,5,348
55133200700,4168,3259,126,129,6,465,2,16,909
55133200801,5308,4632,147,30,5,321,0,14,676
55133200803,4806,3882,139,83,12,509,0,17,924
55133200804,4192,3135,128,78,7,699,0,10,1057
55133200901,4364,3697,145,85,7,270,1,6,667
55133200902,4326,3668,170,47,13,247,0,5,658
55133201001,2557,2290,85,18,0,69,3,2,267
55133201002,4057,3618,144,33,5,89,0,18,439
55133201101,5233,3986,206,105,6,703,1,31,1247
55133201102,3167,2624,169,26,3,224,2,12,543
55133201201,2064,1687,103,48,5,144,0,11,377
55133201203,3485,2615,131,92,0,528,0,17,870
55133201204,2736,1905,97,81,4,534,0,7,831
55133201205,4313,3330,149,80,1,588,3,23,983
55133201300,4821,4130,278,62,9,196,2,19,691
55133201402,4760,4101,255,60,26,172,3,6,659
55133201403,4308,3596,198,98,12,235,5,25,712
55133201404,3850,3382,160,46,4,153,0,12,468
55133201504,6084,5216,260,32,11,364,3,14,868
55133201505,2820,2595,87,9,0,54,0,4,225
55133201506,5564,4822,217,85,14,270,0,11,742
55133201507,3455,2966,129,9,7,241,0,6,489
55133201508,2976,2436,142,97,4,219,0,2,540
55133201600,5466,4922,250,22,18,104,1,22,544
55133201701,4597,4190,173,11,9,41,1,4,407
55133201703,5666,5187,193,11,12,77,0,20,479
55133201704,5307,4891,185,19,8,41,3,12,416
55133201800,1540,1441,36,4,0,4,0,6,99
55133201900,6402,5799,235,26,15,120,0,21,603
55133202001,5291,4901,143,21,8,42,0,18,390
55133202002,4077,3756,109,19,13,14,0,20,321
55133202101,4211,3704,173,38,4,135,0,9,507
55133202102,4799,4058,408,49,6,116,0,16,741
55133202103,3388,2874,217,83,3,115,6,5,514
55133202201,4211,3584,367,41,5,82,0,15,627
55133202203,2230,1487,447,137,5,56,0,15,743
55133202204,3437,2539,520,100,12,140,0,9,898
55133202301,4576,3725,457,130,15,76,3,7,851
55133202303,3398,1957,893,327,7,59,2,8,1441
55133202304,3134,1987,747,229,17,32,0,12,1147
55133202400,5018,3903,684,121,8,104,4,9,1115
55133202500,4088,3135,653,81,8,55,0,17,953
55133202600,2887,2108,480,102,14,49,0,22,779
55133202700,1844,1362,223,54,3,123,3,2,482
55133202800,3827,2295,1151,133,13,66,5,14,1532
55133202901,4250,2955,400,168,13,534,3,6,1295
55133202902,3420,2943,204,51,6,134,1,8,477
55133203000,2298,1727,284,184,7,32,1,10,571
55133203103,4516,3273,820,125,20,68,2,13,1243
55133203104,3164,2467,290,94,7,159,9,2,697
55133203105,3385,2944,217,43,7,59,3,7,441
55133203106,3554,2852,432,79,9,60,0,7,702
55133203107,3892,3307,267,43,4,126,0,10,585
55133203200,4210,3903,65,9,16,68,0,10,307
55133203303,3712,3388,99,22,1,85,0,9,324
55133203304,5588,4782,196,58,0,387,0,16,806
55133203305,4685,4230,155,31,10,97,1,12,455
55133203307,3068,2457,153,80,6,271,0,8,611
55133203308,3342,2677,153,95,5,313,4,5,665
55133203402,3941,3484,116,51,5,149,0,5,457
55133203403,5770,5215,149,31,12,208,4,12,555
55133203404,3587,3081,181,108,3,91,1,7,506
55133203405,4252,3880,98,29,0,98,4,17,372
55133203406,6885,6342,190,27,17,63,1,41,543
55133203501,3921,3659,85,21,4,38,0,5,262
55133203502,2676,2475,55,10,4,55,0,1,201
55133203601,4072,3604,174,29,13,106,0,8,468
55133203602,5940,5386,227,29,20,81,8,9,554
55133203702,4796,4402,176,33,5,60,0,0,394
55133203703,3430,3179,66,19,3,37,1,7,251
55133203704,4766,4307,148,27,8,107,2,14,459
55133203802,6125,5618,201,20,8,29,1,6,507
55133203803,4033,3736,123,11,18,22,1,18,297
55133203805,4996,4411,223,53,2,143,0,3,585
55133203806,2834,2634,98,10,6,12,0,9,200
55133203901,4884,4369,220,21,6,64,1,22,515
55133203902,4345,3934,185,23,14,43,0,23,411
55133204002,5545,5141,179,35,12,29,0,20,404
55133204003,3894,3559,168,17,14,21,0,1,335
55133204004,4227,3955,98,4,10,26,0,13,272
55133204100,5365,4937,179,34,8,49,0,19,428
55133204201,2896,2588,169,19,10,13,0,2,308
55133204202,4294,3938,109,35,3,61,0,6,356
55133204301,6697,6098,223,37,12,85,2,16,599
55133204302,4030,3568,255,39,6,34,0,15,462
55133204400,2242,2118,38,8,2,25,1,1,124
55133204501,2664,2489,64,12,4,21,0,8,175
55133204503,3466,3253,63,10,8,23,7,12,213
55133204504,2892,2716,70,9,0,26,0,6,176
55135100100,3719,3495,77,2,25,8,0,11,224
55135100200,2758,2653,43,1,8,9,0,3,105
55135100300,3741,3585,35,1,0,7,0,13,156
55135100400,4516,4259,120,7,20,15,0,4,257
55135100500,2841,2680,48,15,24,24,0,7,161
55135100600,4989,4621,143,11,17,36,0,12,368
55135100700,3375,3067,194,6,15,6,0,0,308
55135100800,4720,4486,117,8,8,13,0,4,234
55135100900,6051,5283,490,58,37,39,0,17,768
55135101000,6349,5706,247,66,26,61,2,22,643
55135101100,5028,4449,239,24,57,23,2,10,579
55135101200,3725,3500,111,3,5,13,0,2,225
55137960100,2959,2807,52,3,6,11,1,14,152
55137960201,1207,1141,32,4,2,1,1,2,66
55137960202,2666,2540,46,14,3,2,3,2,126
55137960300,3331,2733,453,7,12,16,1,7,598
55137960400,3490,3221,173,1,15,5,0,7,269
55137960600,2027,1890,59,3,10,12,0,1,137
55137960700,4425,3597,251,345,54,37,6,5,828
55137960800,4415,3623,627,12,19,14,2,12,792
55139000100,2895,2461,153,59,17,69,0,10,434
55139000200,2612,2125,147,115,24,51,0,12,487
55139000300,4120,3338,142,199,31,232,3,10,782
55139000400,3047,2438,133,190,9,149,0,14,609
55139000501,2838,2272,172,208,23,58,0,13,566
55139000502,3424,2695,184,208,21,122,5,4,729
55139000700,4777,3544,280,422,84,296,8,0,1233
55139000800,3131,2598,139,85,29,141,2,3,533
55139000900,3389,2784,98,123,11,227,1,10,605
55139001000,2620,2167,90,124,8,115,1,16,453
55139001100,4255,3370,310,145,27,222,2,0,885
55139001200,2054,1765,100,52,5,48,1,2,289
55139001300,2699,2299,145,91,7,75,0,2,400
55139001400,3866,3436,129,65,13,87,1,5,430
55139001500,3092,2585,136,110,8,74,1,14,507
55139001600,4154,3197,127,457,60,206,0,10,957
55139001700,5336,3953,233,645,77,295,0,6,1383
55139001801,5446,4810,114,92,22,209,0,11,636
55139001803,6075,5327,166,46,19,340,1,0,748
55139001804,4725,4338,84,20,6,171,0,7,387
55139001900,5332,4910,99,27,19,134,0,20,422
55139002001,3105,2774,152,23,7,41,0,3,331
55139002002,4204,3908,121,16,22,22,0,12,296
55139002100,3608,3427,72,21,4,6,0,3,181
55139002201,5134,4884,69,17,5,20,1,11,250
55139002202,2997,2879,32,2,6,9,2,3,118
55139002300,5691,5323,104,27,11,81,3,15,368
55139002401,5045,4513,198,48,9,107,0,12,532
55139002402,5657,4729,336,59,21,303,2,12,928
55139002500,4876,3316,543,355,34,371,0,4,1560
55139002601,3918,3160,438,56,12,117,1,9,758
55139002602,4585,3477,513,97,22,240,0,12,1108
55139002700,2426,1991,237,39,12,52,0,3,435
55139002800,4569,3566,561,109,47,129,0,16,1003
55139002900,2212,1780,208,65,13,35,1,3,432
55139003000,1641,1345,132,32,15,24,0,16,296
55139003100,2046,1765,93,28,11,45,0,12,281
55139003200,2353,2061,82,24,19,47,0,0,292
55139003300,2608,2254,148,37,15,35,2,8,354
55139003400,4259,3591,263,114,33,83,2,0,668
55139003500,2871,2308,214,82,27,79,2,10,563
55139003600,4191,3769,132,30,4,92,5,14,422
55139003701,3813,3138,259,92,23,97,4,13,675
55139003703,6371,5831,127,36,28,151,1,2,540
55139003704,3663,3380,113,39,15,53,1,0,283
55141010100,4552,4336,99,6,13,8,0,11,216
55141010200,4800,4452,133,19,6,85,1,12,348
55141010300,2878,2609,115,23,5,40,2,7,269
55141010400,3459,3157,94,33,8,47,0,3,302
55141010500,3236,2919,96,30,11,63,2,1,317
55141010600,4527,3914,182,69,18,168,7,21,613
55141010700,5085,4759,89,20,9,85,2,12,326
55141010800,2744,2622,50,4,17,7,0,2,122
55141010900,3951,3521,144,8,148,25,6,17,430
55141011000,5695,4985,233,72,56,151,2,17,710
55141011100,3536,3156,137,25,24,69,0,9,380
55141011200,3964,3328,220,55,26,135,1,9,636
55141011300,4477,3899,182,49,24,163,2,11,578
55141011400,5754,5071,202,57,40,190,0,17,683
55141011500,5975,5635,79,27,24,70,3,20,340
55141011600,5037,4677,139,24,46,18,1,9,360
55141011700,4537,4015,182,26,74,58,0,12,522
56001962700,3371,2794,363,9,22,14,2,11,577
56001962800,3169,2398,551,41,18,4,1,15,771
56001962900,1705,1113,421,15,33,15,3,11,592
56001963000,2219,1723,252,25,35,42,0,20,496
56001963101,3599,2972,278,28,18,131,2,24,627
56001963102,3790,3037,346,45,21,152,7,3,753
56001963400,3100,2418,234,45,19,216,0,25,682
56001963500,2515,1969,247,39,18,126,1,16,546
56001963600,4319,3601,397,36,14,75,0,10,718
56001963700,7122,5628,730,93,76,239,14,41,1494
56001963900,2157,1931,91,8,8,14,0,12,226
56003962600,2487,2184,162,6,34,10,1,7,303
56003962700,3372,2834,405,6,13,12,2,17,538
56003962800,5662,4866,502,10,51,22,3,20,796
56005000101,1779,1596,89,0,14,1,0,0,183
56005000102,5829,5168,340,20,44,28,4,29,661
56005000103,2126,1812,194,1,19,1,0,3,314
56005000200,7786,6531,685,61,89,48,1,38,1255
56005000300,5089,4197,531,19,98,47,2,13,892
56005000400,3901,2959,602,39,58,32,2,18,942
56005000500,6961,5995,501,29,47,91,0,37,966
56005000600,5219,4203,644,33,79,40,7,19,1016
56005000701,1723,1549,83,6,9,1,1,3,174
56005000702,6613,5591,614,11,52,31,8,28,1022
56007967600,2076,1624,278,46,60,3,1,4,452
56007967700,3939,2534,1132,39,50,41,3,9,1405
56007967800,3888,2734,907,33,28,37,6,20,1154
56007968000,3229,2880,191,8,13,7,0,20,349
56007968100,1405,1234,92,4,4,1,5,7,171
56009956400,4769,4042,469,14,24,32,0,15,727
56009956500,3277,2795,308,15,21,6,0,19,482
56009956600,3102,2838,134,3,11,8,0,6,264
56009956700,2603,2321,151,7,16,9,0,1,282
56011950200,4628,4357,70,0,36,6,4,10,271
56011950300,2553,2409,42,0,7,3,3,6,144
56013000100,3976,3179,255,11,262,56,0,10,797
56013000200,3620,2989,223,28,153,16,0,19,631
56013000301,2653,2358,72,10,49,29,0,6,295
56013000302,1621,1409,94,3,37,1,0,8,212
56013000400,1783,1652,31,3,8,15,0,10,131
56013940100,3529,457,124,2,2797,4,0,2,3072
56013940201,4079,3260,220,31,255,12,1,36,819
56013940202,4648,1590,190,8,2628,6,0,3,3058
56013940301,1859,1130,187,6,440,2,0,5,729
56013940302,3322,2380,342,31,364,22,3,2,942
56013940400,5783,4466,458,26,520,22,3,26,1317
56013940500,2361,1716,225,7,285,20,0,9,645
56015957700,1715,1603,62,3,4,3,0,3,112
56015957800,3415,2783,453,25,17,22,0,12,632
56015957900,4580,3854,476,44,46,21,0,17,726
56015958000,2788,2455,221,4,16,0,0,10,333
56017967800,2695,2425,111,9,21,14,0,15,270
56017967900,1926,1717,66,0,21,4,3,1,209
56019955100,2578,2383,88,2,13,0,1,15,195
56019955201,2263,2041,105,12,16,12,2,10,222
56019955202,3606,3216,154,12,40,3,4,3,390
56021000200,4584,2823,1285,151,50,57,5,17,1761
56021000300,4012,2386,1148,174,27,40,6,6,1626
56021000401,4959,3378,1132,75,50,29,3,23,1581
56021000403,3530,2108,1058,111,22,28,3,25,1422
56021000404,2650,1749,554,79,23,57,5,14,901
56021000502,3111,2267,522,64,14,43,5,9,844
56021000503,4875,3396,996,124,31,46,6,26,1479
56021000601,2594,1876,454,78,21,18,5,4,718
56021000602,3382,2532,544,79,8,36,5,12,850
56021000701,2894,2141,450,68,42,27,10,15,753
56021000702,1274,889,207,76,15,16,0,9,385
56021000800,1738,1345,235,14,13,7,5,24,393
56021000900,2757,2248,322,20,8,24,0,9,509
56021001000,2842,2068,441,94,26,36,2,20,774
56021001100,2863,1693,568,277,29,54,6,12,1170
56021001200,5142,4267,470,64,12,96,15,24,875
56021001301,3031,2318,382,68,13,48,7,27,713
56021001302,5532,4559,534,69,11,92,3,23,973
56021001401,3841,2949,502,102,16,72,15,11,892
56021001402,2655,2132,267,40,21,37,2,13,523
56021001501,5735,4337,875,112,30,73,2,29,1398
56021001502,5360,4028,795,108,37,79,13,30,1332
56021001901,5582,4803,377,39,15,54,3,51,779
56021001902,4862,4251,299,22,20,31,1,26,611
56021002001,4571,3894,434,19,12,39,1,17,677
56021002002,6124,4842,743,73,30,89,8,42,1282
56021980801,12,0,8,0,0,0,0,0,12
56023978001,3938,3523,227,8,14,18,3,22,415
56023978002,4460,3951,305,0,11,30,1,27,509
56023978100,6419,5936,212,21,38,25,9,27,483
56023978200,1722,1602,48,1,12,5,7,6,120
56023978400,3042,2725,167,4,26,18,1,9,317
56025000200,3730,2667,677,79,84,30,3,19,1063
56025000300,3882,3236,354,30,37,24,8,11,646
56025000400,4106,3219,527,36,66,21,3,17,887
56025000501,6087,5097,478,66,68,94,5,22,990
56025000502,2647,2130,255,28,43,35,0,8,517
56025000601,2778,2235,253,47,16,55,0,6,543
56025000602,4715,3908,432,56,24,33,2,7,807
56025000700,2637,2137,274,16,26,15,2,21,500
56025000800,3623,2978,385,28,43,18,1,8,645
56025000901,5077,4277,437,55,31,36,4,19,800
56025000902,3719,3282,200,36,19,19,4,11,437
56025001000,4584,3860,402,36,42,35,6,24,724
56025001100,3153,2639,297,28,31,10,0,11,514
56025001200,1804,1509,173,4,25,7,0,10,295
56025001401,6195,5286,468,27,39,38,12,28,909
56025001602,7661,6383,693,72,69,83,12,23,1278
56025001603,3797,3299,222,15,24,31,0,13,498
56025001700,5044,4355,374,28,43,18,7,19,689
56025001801,2328,2010,136,22,18,17,0,24,318
56025001802,2388,2107,132,20,19,14,9,5,281
56027957200,2467,2255,76,6,27,12,5,0,212
56029965100,5292,4650,363,5,16,31,0,47,642
56029965200,6408,5391,632,21,34,55,10,38,1017
56029965301,3401,3161,119,3,5,19,0,9,240
56029965302,4053,3745,93,6,30,18,1,16,308
56029965401,2586,2356,117,5,3,14,0,18,230
56029965402,3701,3305,180,8,16,34,0,13,396
56029965500,4183,3708,193,11,16,40,6,7,475
56031959100,2176,1899,188,5,23,5,2,4,277
56031959401,4633,4006,351,12,32,37,2,20,627
56031959402,1796,1564,156,2,12,1,0,9,232
56033000100,5763,5044,292,31,70,41,5,25,719
56033000200,3231,2835,160,16,30,22,3,17,396
56033000300,3775,3302,235,13,25,25,2,8,473
56033000400,5369,4665,332,11,57,39,7,15,704
56033000501,3078,2871,76,1,6,1,0,5,207
56033000502,4102,3778,106,9,44,21,0,22,324
56033000600,5603,5014,215,29,92,31,0,34,589
56035000101,2978,2652,181,9,13,5,5,9,326
56035000103,2688,2336,209,0,13,26,3,21,352
56035000104,3062,2663,246,8,18,15,2,15,399
56037970500,2354,1803,380,11,30,15,0,9,551
56037970601,3862,2981,662,10,20,17,2,5,881
56037970602,3247,2617,385,7,10,22,16,7,630
56037970700,3816,3144,401,29,25,14,2,6,672
56037970800,5202,3447,1360,58,51,22,8,26,1755
56037970902,5060,3961,727,64,21,65,3,29,1099
56037970903,2582,1700,602,62,17,25,17,13,882
56037970904,2469,2047,321,5,16,1,0,10,422
56037970905,5308,4009,911,45,32,48,8,17,1299
56037971000,1757,1230,414,10,9,17,0,7,527
56037971100,2772,2232,357,36,7,24,4,5,540
56037971200,2421,1974,304,10,11,13,1,13,447
56037971600,1422,1217,133,4,10,0,0,0,205
56039967601,2458,2136,210,3,0,19,1,1,322
56039967602,2621,2370,106,8,7,25,0,29,251
56039967701,2289,1722,423,4,0,39,0,12,567
56039967703,2074,1876,92,5,0,38,0,5,198
56039967704,4505,3644,606,8,11,84,0,22,861
56039967801,3650,2686,785,4,25,29,2,12,964
56039967802,5734,4320,1073,17,23,75,0,18,1414
56041975201,2713,2515,100,3,7,16,0,3,198
56041975202,3807,3544,128,0,20,8,8,14,263
56041975301,2750,2113,486,7,22,5,0,7,637
56041975302,5004,4212,492,13,30,43,10,21,792
56041975401,2798,2392,233,9,13,25,7,14,406
56041975402,3378,2668,547,18,30,11,2,17,710
56043000200,3139,2717,294,6,17,11,0,9,422
56043000301,2339,1756,463,3,14,16,1,6,583
56043000302,2207,1795,313,3,14,6,0,28,412
56045951100,3336,2977,164,20,53,10,5,14,359
56045951300,3502,3129,131,8,39,16,4,20,373
72001956300,3868,8,3853,1,0,0,0,2,3860
72001956400,2645,8,2636,0,0,0,0,1,2637
72001956500,2762,3,2757,0,0,0,0,1,2759
72001956600,2088,2,2086,0,0,0,0,0,2086
72001956700,2034,5,2023,0,0,0,0,3,2029
72001956800,4623,13,4606,0,0,0,0,2,4610
72003430100,4930,43,4883,0,0,2,0,1,4887
72003430200,4886,35,4848,0,0,2,0,0,4851
72003430300,2200,18,2173,2,0,4,0,0,2182
72003430401,4350,16,4328,2,0,0,0,3,4334
72003430402,4421,17,4396,5,0,0,0,0,4404
72003430501,5983,11,5962,0,1,0,0,6,5972
72003430502,4204,8,4189,0,2,0,0,0,4196
72003430601,4153,28,4117,2,0,0,0,3,4125
72003430602,3009,41,2964,1,0,2,0,0,2968
72003990000,0,0,0,0,0,0,0,0,0
72005400100,5495,93,5366,14,0,5,0,8,5402
72005400300,2923,239,2636,14,0,11,1,11,2684
72005400400,3891,40,3831,10,0,4,0,0,3851
72005400501,3264,31,3224,1,2,3,0,0,3233
72005400502,5137,37,5087,2,0,2,0,1,5100
72005400600,2474,22,2437,6,0,3,0,4,2452
72005400700,2618,28,2571,4,1,3,0,6,2590
72005400800,1151,7,1141,3,0,0,0,0,1144
72005400900,1971,8,1961,0,0,2,0,0,1963
72005401200,3907,12,3879,6,0,8,0,0,3895
72005401301,3903,17,3877,0,0,8,0,0,3886
72005401303,3025,21,2988,6,1,4,0,0,3004
72005401304,3132,12,3115,2,1,0,0,0,3120
72005401401,4620,14,4592,9,0,0,0,1,4606
72005401402,4889,25,4855,8,0,0,0,1,4864
72005401500,2701,22,2667,5,0,2,0,0,2679
72005990000,0,0,0,0,0,0,0,0,0
72007230100,3446,15,3428,1,0,1,0,0,3431
72007230200,5396,32,5356,1,0,3,0,2,5364
72007230300,2482,6,2468,4,0,1,0,1,2476
72007230400,4391,12,4375,1,0,0,0,2,4379
72007230501,4333,15,4311,2,1,0,0,3,4318
72007230502,4175,13,4153,3,0,1,0,4,4162
72009250100,5597,39,5538,6,0,2,0,6,5558
72009250200,4927,17,4908,0,0,0,0,2,4910
72009250300,2639,31,2601,2,0,0,0,2,2608
72009250400,3193,25,3149,4,0,0,0,8,3168
72009250500,4052,14,4010,4,0,1,0,18,4038
72009250600,4229,14,4204,3,0,0,0,1,4215
72011810100,3081,18,3059,1,0,0,0,2,3063
72011810200,7239,63,7158,6,0,0,1,4,7176
72011810300,1871,12,1851,0,0,0,0,7,1859
72011810400,1070,5,1060,2,0,0,0,0,1065
72011810500,5253,15,5232,4,0,0,1,1,5238
72011810600,4342,19,4305,5,0,4,1,3,4323
72011810700,2740,52,2679,2,0,1,1,0,2688
72011990000,0,0,0,0,0,0,0,0,0
72013300101,5077,31,5033,4,0,1,0,4,5046
72013300102,5326,17,5303,0,0,5,0,1,5309
72013300200,3537,20,3515,2,0,0,0,0,3517
72013300301,2874,17,2853,3,0,0,0,0,2857
72013300302,5315,26,5273,8,0,1,0,4,5289
72013300400,1687,10,1675,0,0,1,0,0,1677
72013300500,798,6,789,3,0,0,0,0,792
72013300700,1103,15,1079,1,0,6,0,1,1088
72013300800,4831,37,4775,6,0,7,0,6,4794
72013301000,4845,41,4800,0,0,2,0,1,4804
72013301100,6844,24,6805,3,0,6,0,4,6820
72013301200,3300,14,3285,0,0,0,0,0,3286
72013301300,2985,20,2954,7,0,1,0,1,2965
72013301400,855,4,844,2,0,2,0,1,851
72013301500,5566,47,5512,1,0,4,0,1,5519
72013301600,3868,12,3843,5,0,4,0,3,3856
72013301700,4757,17,4723,3,0,0,0,11,4740
72013301800,1637,8,1628,0,0,0,0,1,1629
72013301900,4244,32,4207,3,0,0,0,2,4212
72013302000,2698,8,2688,0,0,0,0,1,2690
72013302100,5318,9,5300,5,0,0,0,3,5309
72013302201,2568,6,2562,0,0,0,0,0,2562
72013302202,4617,19,4587,2,0,5,0,4,4598
72013302300,3104,15,3084,4,0,0,0,0,3089
72013992900,0,0,0,0,0,0,0,0,0
72015280101,1858,0,1846,3,0,2,0,1,1858
72015280102,5254,20,5213,9,0,1,0,9,5234
72015280201,3716,28,3665,9,1,3,0,6,3688
72015280202,5015,21,4984,5,0,1,0,2,4994
72015991500,0,0,0,0,0,0,0,0,0
72017590100,6501,31,6464,0,3,0,0,3,6470
72017590200,3697,7,3680,2,6,0,0,1,3690
72017590300,7295,18,7264,0,0,2,0,6,7277
72017590400,5164,15,5134,7,3,1,0,1,5149
72017990000,0,0,0,0,0,0,0,0,0
72019952201,4215,9,4199,3,0,0,0,3,4206
72019952202,5369,5,5357,0,0,1,0,4,5364
72019952301,3771,4,3762,0,0,2,0,3,3767
72019952302,6319,5,6307,3,0,0,3,0,6314
72019952400,2038,5,2029,0,1,1,0,2,2033
72019952500,7271,20,7251,0,0,0,0,0,7251
72021030101,5275,74,5179,9,0,7,0,4,5201
72021030103,3940,38,3873,3,0,17,0,3,3902
72021030104,3895,31,3831,9,0,18,0,3,3864
72021030105,2607,149,2432,19,1,2,0,0,2458
72021030200,3197,26,3165,0,0,0,0,1,3171
72021030300,4281,45,4216,4,0,7,0,4,4236
72021030700,1252,6,1242,2,0,0,0,0,1246
72021030800,1096,3,1084,2,0,0,0,6,1093
72021030901,1703,17,1679,5,0,1,0,0,1686
72021030902,2106,4,2094,0,0,0,0,3,2102
72021030903,1449,0,1443,4,0,0,0,2,1449
72021030904,2042,9,2020,5,0,3,0,5,2033
72021031004,2369,17,2341,1,1,6,0,1,2352
72021031005,2847,20,2816,4,3,0,0,4,2827
72021031011,3537,28,3492,5,0,4,1,1,3509
72021031021,3056,13,3036,0,0,6,0,0,3043
72021031023,3507,18,3482,3,0,0,0,2,3489
72021031031,4054,34,3991,13,0,13,0,1,4020
72021031032,2179,12,2155,2,0,1,0,1,2167
72021031033,3878,23,3848,0,1,4,0,2,3855
72021031034,3350,14,3334,0,0,1,0,0,3336
72021031035,3691,20,3640,6,0,14,0,5,3671
72021031101,2284,12,2264,1,0,5,0,2,2272
72021031113,3360,19,3326,2,0,12,0,0,3341
72021031114,3290,3,3272,3,0,5,0,7,3287
72021031121,3676,22,3646,2,3,0,0,3,3654
72021031122,2855,15,2828,5,1,0,0,4,2840
72021031123,2631,7,2622,0,0,1,0,0,2624
72021031124,1745,5,1735,5,0,0,0,0,1740
72021031125,2741,19,2713,0,4,2,0,3,2722
72021031201,2790,3,2779,3,0,2,0,1,2787
72021031202,1630,12,1613,2,1,0,0,1,1618
72021031203,1848,10,1833,2,0,0,0,2,1838
72021031301,5562,18,5539,1,0,0,0,3,5544
72021031304,2407,17,2381,2,0,0,0,3,2390
72021031305,4291,28,4248,6,1,0,0,2,4263
72021031306,3385,28,3327,6,0,15,0,2,3357
72021031307,2096,13,2074,5,0,0,0,3,2083
72021031401,2322,15,2302,0,0,0,0,4,2307
72021031402,2662,13,2640,3,0,0,0,5,2649
72021031403,2640,4,2630,3,0,0,0,3,2636
72021031501,2449,16,2422,4,0,0,2,5,2433
72021031502,1749,50,1688,0,3,0,0,1,1699
72021031503,1784,9,1771,4,0,0,0,0,1775
72021031611,2271,16,2247,2,0,4,0,2,2255
72021031612,4596,10,4581,3,0,2,0,0,4586
72021031621,2253,19,2230,1,0,0,0,0,2234
72021031622,2450,7,2436,4,0,2,0,1,2443
72021031631,2085,13,2055,1,0,12,0,3,2072
72021031632,1951,13,1933,2,0,2,0,0,1938
72021031641,2244,11,2229,2,1,0,0,0,2233
72021031651,2376,19,2354,1,0,1,0,1,2357
72021031701,3564,16,3536,9,0,1,0,1,3548
72021031702,4104,22,4066,9,0,3,0,4,4082
72021031703,3540,24,3515,0,0,0,0,0,3516
72021031704,5184,25,5135,10,1,0,1,11,5159
72021031800,5612,23,5574,7,0,0,0,2,5589
72021031900,5246,28,5207,2,0,2,0,2,5218
72021032000,1611,7,1598,2,0,0,0,4,1604
72021032100,2620,8,2608,0,0,0,0,3,2612
72021032200,2521,11,2507,1,1,0,0,0,2510
72021032301,2995,18,2964,5,0,1,0,3,2977
72021032302,2456,3,2442,9,0,0,0,1,2453
72023830101,4642,30,4600,1,0,0,0,3,4612
72023830102,4709,21,4676,7,0,3,0,2,4688
72023830201,3966,49,3909,2,1,3,0,2,3917
72023830202,3304,21,3273,4,0,5,0,0,3283
72023830300,4336,55,4252,2,0,10,0,13,4281
72023830400,4268,23,4225,2,0,5,0,11,4245
72023830502,3646,64,3572,3,0,2,0,4,3582
72023830503,5755,44,5701,0,1,3,0,1,5711
72023830504,3024,13,3006,4,1,0,0,0,3011
72023830605,2897,44,2844,6,0,0,0,1,2853
72023830606,1723,20,1699,4,0,0,0,0,1703
72023830607,3478,32,3437,5,0,3,0,1,3446
72023830608,1399,11,1386,0,0,0,0,1,1388
72023980000,11,0,9,1,0,0,0,0,11
72023990000,0,0,0,0,0,0,0,0,0
72025200100,6434,33,6373,12,0,2,3,1,6401
72025200200,4634,22,4607,0,0,1,0,1,4612
72025200302,6668,25,6613,2,0,7,0,14,6643
72025200304,5988,30,5950,2,0,3,0,2,5958
72025200305,6428,26,6377,0,0,12,0,7,6402
72025200306,4094,41,4036,2,0,9,1,0,4053
72025200400,2740,19,2710,5,0,0,0,0,2721
72025200500,4869,32,4821,1,0,8,0,0,4837
72025200600,3329,11,3312,1,0,3,0,0,3318
72025200700,3563,16,3540,3,0,1,0,0,3547
72025200800,2590,9,2565,5,0,0,0,8,2581
72025200900,1449,4,1442,0,0,0,0,3,1445
72025201000,2209,14,2181,11,0,0,0,3,2195
72025201200,2988,11,2973,4,0,0,0,0,2977
72025201300,2380,14,2357,3,1,2,0,3,2366
72025201400,2067,8,2042,3,0,0,0,12,2059
72025201500,2251,9,2234,0,0,4,0,3,2242
72025201600,1954,10,1934,0,4,0,0,3,1944
72025201700,1888,10,1875,1,0,0,1,0,1878
72025201800,2994,13,2973,2,0,0,0,5,2981
72025201900,1085,1,1082,0,0,0,0,1,1084
72025202000,3077,23,3041,3,4,0,1,4,3054
72025202100,3028,11,3003,4,0,0,0,2,3017
72025202200,1474,6,1460,2,0,2,0,3,1468
72025202300,3080,14,3058,6,0,0,0,0,3066
72025202402,5813,16,5778,0,0,10,0,4,5797
72025202403,3732,14,3711,1,0,0,0,5,3718
72025202404,4817,22,4788,6,1,0,0,0,4795
72025202500,4133,16,4105,1,0,8,0,3,4117
72025202601,5198,18,5167,3,0,0,0,7,5180
72025202602,7080,23,7024,6,0,9,0,16,7057
72025202701,5163,18,5130,4,0,1,0,8,5145
72025202702,4611,13,4592,3,1,0,0,2,4598
72025202800,3436,10,3416,3,0,4,0,3,3426
72027320100,2320,28,2284,3,0,1,0,3,2292
72027320200,6816,46,6757,1,2,3,0,2,6770
72027320300,7569,56,7509,0,0,0,0,3,7513
72027320401,4024,26,3989,2,1,0,0,1,3998
72027320402,3421,22,3392,1,0,1,0,5,3399
72027320500,4279,43,4235,1,0,0,0,0,4236
72027320600,4398,29,4359,0,0,0,0,7,4369
72027990000,0,0,0,0,0,0,0,0,0
72029100101,3155,5,3142,6,0,2,0,0,3150
72029100103,2611,14,2587,4,0,5,0,1,2597
72029100104,4122,14,4067,26,0,3,0,4,4108
72029100200,1952,5,1942,2,0,0,0,0,1947
72029100400,5681,21,5640,7,0,2,0,8,5660
72029100502,2977,9,2953,13,0,0,0,0,2968
72029100503,6102,17,6067,11,2,3,0,2,6085
72029100504,3589,18,3554,4,1,6,0,5,3571
72029100601,3094,8,3072,7,0,1,0,2,3086
72029100602,2992,11,2979,2,0,0,0,0,2981
72029100700,4495,0,4488,4,0,1,0,1,4495
72029100800,1567,10,1553,2,0,1,0,0,1557
72031050105,2665,20,2632,12,0,0,0,0,2645
72031050106,1385,111,1242,8,0,13,0,0,1274
72031050107,1963,168,1769,8,0,8,0,3,1795
72031050110,3092,32,3039,8,0,1,0,5,3060
72031050111,1125,71,1037,9,0,4,0,1,1054
72031050112,1242,61,1161,6,1,7,0,1,1181
72031050113,3441,151,3221,19,0,35,0,3,3290
72031050211,3283,27,3240,5,0,6,0,4,3256
72031050212,3941,24,3903,8,0,0,0,3,3917
72031050221,4773,63,4685,5,1,12,0,7,4710
72031050222,3827,25,3796,3,0,0,0,3,3802
72031050231,2461,9,2435,8,0,4,0,3,2452
72031050232,4527,49,4449,13,1,5,0,4,4478
72031050241,4318,24,4276,8,0,4,0,5,4294
72031050242,4280,63,4193,19,0,0,0,3,4217
72031050302,2959,19,2931,4,0,1,0,3,2940
72031050311,2645,23,2605,5,0,7,0,0,2622
72031050321,3998,15,3954,12,0,9,0,4,3983
72031050331,1646,17,1625,1,0,1,0,1,1629
72031050341,3413,11,3387,6,0,3,0,5,3402
72031050403,4940,25,4889,5,1,11,3,2,4915
72031050404,2978,22,2944,0,0,9,0,2,2956
72031050405,5435,59,5313,10,0,41,2,7,5376
72031050503,4752,21,4713,9,0,1,0,6,4731
72031050504,6592,34,6540,10,0,0,0,1,6558
72031050505,2550,43,2478,2,1,10,0,14,2507
72031050506,4026,25,3991,0,2,5,2,0,4001
72031050600,5425,29,5358,14,0,16,1,7,5396
72031050700,1275,0,1271,0,0,0,0,0,1275
72031050803,3573,27,3529,10,0,1,0,6,3546
72031050811,3751,30,3703,13,0,5,0,0,3721
72031050812,3456,25,3414,3,0,1,1,6,3431
72031050821,4012,26,3967,6,1,1,0,7,3986
72031050822,3063,19,3023,10,0,5,0,3,3044
72031050831,4085,15,4063,4,2,0,0,0,4070
72031050841,2610,14,2578,13,0,0,2,3,2596
72031050901,5380,24,5344,5,0,5,0,1,5356
72031050902,5772,16,5743,9,0,3,0,0,5756
72031051001,4428,19,4405,2,0,1,0,0,4409
72031051002,3117,5,3107,2,0,1,0,2,3112
72031051102,4167,23,4132,6,0,3,0,1,4144
72031051103,4849,35,4793,11,0,0,0,10,4814
72031051104,3579,17,3525,2,0,32,0,2,3562
72031980003,16,0,14,0,0,1,0,0,16
72031990000,0,0,0,0,0,0,0,0,0
72033020200,3218,19,3176,17,0,0,0,4,3199
72033020302,1793,9,1780,2,0,0,0,1,1784
72033020422,2205,8,2193,2,0,0,0,2,2197
72033020423,3539,29,3493,2,0,11,2,2,3510
72033020425,2123,10,2111,1,0,0,0,1,2113
72033020426,1807,5,1798,2,0,0,0,1,1802
72033020428,4995,10,4973,8,0,1,0,3,4985
72033020500,3426,32,3352,9,0,19,5,4,3394
72033980001,3,0,3,0,0,0,0,0,3
72033980002,0,0,0,0,0,0,0,0,0
72033980003,0,0,0,0,0,0,0,0,0
72033980004,0,0,0,0,0,0,0,0,0
72033980005,35,0,35,0,0,0,0,0,35
72033980006,5,0,5,0,0,0,0,0,5
72033980007,6,1,4,1,0,0,0,0,5
72033990201,0,0,0,0,0,0,0,0,0
72035260100,8782,36,8730,12,4,0,0,0,8746
72035260201,3117,12,3097,1,0,2,0,1,3105
72035260202,3906,11,3882,2,0,1,1,0,3895
72035260300,3821,16,3801,0,0,3,0,0,3805
72035260400,4143,12,4127,2,1,0,0,0,4131
72035260500,3716,13,3697,0,0,3,0,0,3703
72035260600,2633,10,2619,3,1,0,0,0,2623
72035260700,1995,10,1979,3,0,2,0,1,1985
72035260800,2509,5,2489,2,0,8,0,4,2504
72035260901,3482,18,3449,3,0,0,1,7,3464
72035260902,3548,14,3530,0,0,1,0,0,3534
72037160201,4484,76,4382,11,0,6,0,6,4408
72037160202,2999,49,2936,7,2,3,0,2,2950
72037160400,3824,20,3781,6,2,2,0,10,3804
72037990000,0,0,0,0,0,0,0,0,0
72039955600,4581,20,4544,1,1,10,0,3,4561
72039955700,3286,6,3268,4,1,4,0,3,3280
72039955800,5023,15,5004,0,0,0,0,2,5008
72039955900,4094,10,4075,0,1,0,0,7,4084
72041240101,5143,37,5094,6,0,0,0,6,5106
72041240102,3995,25,3964,3,0,0,0,0,3970
72041240201,4239,12,4221,0,0,0,0,3,4227
72041240202,4300,14,4277,3,0,0,0,4,4286
72041240300,1901,4,1893,2,0,0,0,1,1897
72041240401,4646,11,4634,0,0,0,0,1,4635
72041240402,3332,20,3312,0,0,0,0,0,3312
72041240500,3407,8,3390,0,0,0,0,7,3399
72041240601,4776,14,4758,1,0,0,0,1,4762
72041240602,4231,10,4219,1,0,0,0,1,4221
72043953900,2759,2,2747,0,1,2,0,6,2757
72043954000,3129,3,3117,3,0,0,0,6,3126
72043954100,1656,3,1646,1,0,0,1,0,1653
72043954200,5023,9,4998,2,0,7,0,2,5014
72043954300,1736,8,1727,0,0,0,0,1,1728
72043954400,1669,11,1650,0,0,0,0,8,1658
72043954500,7331,18,7290,6,0,0,1,10,7313
72043954600,4255,21,4221,4,2,2,0,4,4234
72043954700,7110,20,7068,1,0,3,1,16,7090
72045951700,4725,15,4705,1,0,0,0,2,4710
72045951800,5211,26,5173,0,0,0,0,11,5185
72045951900,2232,0,2231,1,0,0,0,0,2232
72045952000,1989,1,1984,3,0,0,0,1,1988
72045952100,4726,1,4719,3,0,0,0,2,4725
72047530100,3304,5,3291,1,0,3,2,0,3299
72047530200,5519,9,5502,1,0,3,1,2,5510
72047530300,3770,7,3751,5,0,1,0,4,3763
72047530400,7151,30,7101,4,0,2,2,12,7121
72047530500,7600,26,7551,7,0,3,3,8,7574
72047530600,7227,17,7200,2,0,0,3,4,7210
72049950500,1792,176,1599,0,0,3,0,4,1616
72049990501,0,0,0,0,0,0,0,0,0
72051540100,2541,16,2518,1,0,1,0,1,2525
72051540200,4293,303,3944,11,1,11,0,7,3990
72051540300,1813,5,1794,2,0,3,1,8,1808
72051540401,3130,115,2975,4,0,12,1,10,3015
72051540402,5770,404,5249,21,1,48,0,5,5366
72051540500,7875,29,7819,14,0,2,0,4,7846
72051540600,4887,38,4839,5,0,0,0,2,4849
72051540700,5570,13,5528,9,2,11,0,0,5557
72051990021,0,0,0,0,0,0,0,0,0
72053150102,2342,9,2318,7,3,0,0,2,2333
72053150105,2767,21,2731,7,3,3,0,2,2746
72053150106,1088,26,1052,1,0,7,0,2,1062
72053150200,4807,48,4696,43,2,5,1,5,4759
72053150301,3357,24,3290,12,2,1,0,25,3333
72053150302,1997,14,1963,14,0,3,0,2,1983
72053150400,3676,52,3590,12,0,2,0,14,3624
72053150500,4005,16,3973,5,0,2,0,6,3989
72053150601,2403,8,2387,0,1,2,0,0,2395
72053150602,5682,92,5554,11,3,2,1,9,5590
72053990103,0,0,0,0,0,0,0,0,0
72054580100,5522,21,5493,1,0,2,0,4,5501
72054580200,6170,18,6144,3,0,0,0,3,6152
72055960900,4097,35,4053,2,0,0,0,3,4062
72055961000,2148,5,2142,0,0,0,0,1,2143
72055961100,2207,23,2179,5,0,0,0,0,2184
72055961200,906,0,903,0,0,0,0,2,906
72055961300,1249,5,1239,4,0,0,0,1,1244
72055961400,1032,4,1026,2,0,0,0,0,1028
72055961500,2148,23,2121,0,0,0,0,3,2125
72055990000,0,0,0,0,0,0,0,0,0
72057270100,4565,15,4535,2,0,0,0,9,4550
72057270201,5164,26,5126,4,2,0,0,3,5138
72057270202,3895,14,3868,1,0,1,0,4,3881
72057270300,5104,19,5070,9,0,2,2,2,5085
72057270400,1681,8,1665,2,0,5,0,0,1673
72057270500,4708,20,4676,0,0,2,0,8,4688
72057270600,2638,11,2622,0,0,0,1,1,2627
72057270700,2789,7,2777,0,0,2,0,3,2782
72057270800,6070,22,6032,0,0,8,0,4,6048
72057992600,0,0,0,0,0,0,0,0,0
72059740101,2326,7,2318,0,0,0,0,0,2319
72059740102,3643,4,3631,0,0,1,0,3,3639
72059740200,4376,8,4360,0,0,0,0,0,4368
72059740300,2780,8,2767,1,0,0,1,0,2772
72059740400,4659,2,4645,2,0,0,1,5,4657
72059990001,0,0,0,0,0,0,0,0,0
72061040101,1661,9,1633,3,1,2,0,8,1652
72061040102,1755,13,1723,7,0,7,0,5,1742
72061040103,1602,5,1590,0,2,0,0,5,1597
72061040200,5139,268,4670,171,0,11,0,6,4871
72061040301,1758,37,1709,3,0,5,0,2,1721
72061040302,2418,38,2351,4,1,18,0,1,2380
72061040303,2196,28,2148,4,1,5,0,5,2168
72061040304,5395,150,5228,7,1,1,0,6,5245
72061040411,4544,81,4428,8,0,12,2,8,4463
72061040412,1654,18,1627,0,1,1,0,0,1636
72061040422,2634,51,2553,21,0,9,0,0,2583
72061040432,2332,36,2287,2,0,0,0,2,2296
72061040442,3295,50,3228,2,0,4,2,3,3245
72061040443,5476,59,5395,6,0,8,0,6,5417
72061040444,3142,70,3057,1,0,6,0,3,3072
72061040445,3199,25,3147,3,0,19,0,4,3174
72061040446,3785,34,3735,3,0,0,0,6,3751
72061040500,3439,24,3390,4,2,10,0,3,3415
72061040601,3846,11,3824,3,0,4,0,2,3835
72061040603,3696,51,3618,15,0,5,0,3,3645
72061040604,4120,50,4034,3,0,22,0,1,4070
72061040701,2935,6,2923,2,0,1,0,0,2929
72061040702,5957,42,5903,4,0,3,1,1,5915
72061040800,3385,18,3364,0,0,1,0,2,3367
72061040900,3876,15,3847,2,0,8,0,0,3861
72061041000,2241,6,2232,1,0,1,0,1,2235
72061041100,4300,31,4250,7,0,2,0,6,4269
72063210100,3768,10,3752,6,0,0,0,0,3758
72063210201,2804,5,2790,4,1,0,0,3,2799
72063210203,4131,10,4105,1,1,1,0,12,4121
72063210204,4476,20,4451,2,1,0,0,0,4456
72063210300,1591,9,1580,0,2,0,0,0,1582
72063210400,3292,20,3248,9,1,4,0,4,3272
72063210503,2674,13,2657,0,0,0,0,0,2661
72063210504,6855,42,6798,8,0,3,0,4,6813
72063210505,3982,24,3942,5,1,0,0,2,3958
72063210506,2974,23,2943,3,1,0,0,2,2951
72063210507,4075,17,4050,3,3,1,0,0,4058
72065310100,7421,55,7347,12,0,2,0,0,7366
72065310200,4463,50,4402,3,0,7,0,1,4413
72065310300,5857,19,5824,12,1,1,0,0,5838
72065310400,8023,30,7960,14,1,3,0,6,7993
72065310500,6988,27,6951,0,0,4,0,0,6961
72065310600,5734,35,5687,4,0,4,0,0,5699
72065990016,0,0,0,0,0,0,0,0,0
72067820101,4500,24,4466,5,0,0,0,3,4476
72067820102,2787,15,2767,2,0,0,0,2,2772
72067820300,4455,25,4415,4,0,3,0,4,4430
72067820400,1655,1,1647,4,1,1,0,0,1654
72067820500,2257,13,2241,0,0,3,0,0,2244
72069180100,3534,16,3487,22,0,0,0,4,3518
72069180201,2700,17,2676,3,0,0,0,3,2683
72069180202,5411,25,5368,4,0,0,0,6,5386
72069180301,2348,6,2337,2,0,0,0,0,2342
72069180302,4487,15,4461,8,0,0,0,2,4472
72069180400,4026,36,3981,5,0,4,0,0,3990
72069180500,5135,25,5071,4,0,31,0,3,5110
72069180600,4281,36,4237,2,0,4,0,0,4245
72069180700,3650,13,3622,6,0,2,0,3,3637
72069180800,4796,37,4738,14,0,3,0,1,4759
72069180901,4421,27,4380,6,0,4,0,2,4394
72069180903,3382,461,2858,13,0,21,0,8,2921
72069180904,2725,23,2687,6,0,5,0,3,2702
72069991800,0,0,0,0,0,0,0,0,0
72071410100,5724,45,5662,1,0,0,1,9,5679
72071410200,2588,37,2545,1,0,0,0,0,2551
72071410300,2349,44,2298,1,0,3,0,0,2305
72071410401,3505,134,3353,10,0,1,0,4,3371
72071410403,4875,29,4820,8,1,0,0,6,4846
72071410404,2868,9,2850,2,0,6,0,1,2859
72071410500,5849,45,5790,0,0,5,0,6,5804
72071410600,5295,21,5267,6,0,1,0,0,5274
72071410701,2469,14,2433,10,0,7,0,2,2455
72071410703,3881,23,3852,3,0,0,0,2,3858
72071410704,3540,7,3525,1,0,0,0,5,3533
72071990000,0,0,0,0,0,0,0,0,0
72073956200,6078,22,6045,3,0,2,0,6,6056
72073956304,4838,7,4825,2,0,1,0,2,4831
72073956305,3863,26,3833,4,0,0,0,0,3837
72075710102,4549,29,4497,16,0,0,0,7,4520
72075710200,4414,2,4402,2,0,2,0,4,4412
72075710301,5212,44,5163,0,1,0,0,1,5168
72075710302,4528,9,4510,2,0,0,0,4,4519
72075710400,1918,2,1912,0,0,0,0,4,1916
72075710500,1237,6,1230,0,0,0,0,0,1231
72075710600,1863,7,1852,4,0,0,0,0,1856
72075710700,1684,10,1666,4,0,1,0,1,1674
72075710800,5456,12,5439,3,0,0,0,1,5444
72075710901,4619,8,4602,5,0,2,0,0,4611
72075710902,7708,21,7670,4,0,5,0,4,7687
72075711002,3350,5,3342,1,0,0,0,2,3345
72075990001,0,0,0,0,0,0,0,0,0
72077500100,7487,27,7436,10,0,0,0,9,7460
72077500200,5337,15,5303,9,0,0,0,10,5322
72077500302,7126,24,7092,6,1,0,0,3,7102
72077500303,3828,19,3806,0,1,0,0,2,3809
72077500304,3412,9,3395,4,0,0,0,3,3403
72077500401,5760,28,5719,1,3,0,0,8,5732
72077500402,4062,10,4043,0,0,0,0,6,4052
72079850101,2230,9,2218,3,0,0,0,0,2221
72079850102,6809,11,6795,0,0,1,0,0,6798
72079850200,4423,24,4385,5,0,4,0,5,4399
72079850300,4863,31,4813,8,0,1,0,7,4832
72079850400,5009,51,4949,2,0,1,0,6,4958
72079991100,0,0,0,0,0,0,0,0,0
72081957700,4550,24,4503,2,0,0,0,16,4526
72081957800,7118,43,7060,1,0,4,0,8,7075
72081957900,3734,6,3714,3,2,1,0,4,3728
72081958001,3403,11,3381,0,1,4,0,6,3392
72081958100,1678,7,1666,0,0,0,0,5,1671
72081958200,3191,6,3177,0,2,0,0,5,3185
72081958300,2441,7,2434,0,0,0,0,0,2434
72081958400,1990,9,1974,1,0,0,0,5,1981
72083959700,2269,9,2252,4,0,0,0,1,2260
72083959800,1443,2,1435,4,0,0,0,0,1441
72083959900,5162,31,5116,1,0,4,0,3,5131
72085190101,6510,17,6488,1,0,0,0,4,6493
72085190103,4112,14,4095,0,0,2,0,0,4098
72085190104,5053,19,5002,8,0,13,0,7,5034
72085190201,3719,15,3703,0,0,0,0,0,3704
72085190202,2826,12,2810,3,0,1,0,0,2814
72085190302,4621,19,4591,7,0,0,0,1,4602
72085190303,5574,21,5545,5,0,0,0,3,5553
72085190304,2765,9,2749,1,0,0,0,4,2756
72087110101,2171,0,2161,7,0,3,0,0,2171
72087110102,1836,0,1827,6,0,0,0,3,1836
72087110200,1852,10,1836,6,0,0,0,0,1842
72087110301,3184,10,3161,10,1,1,0,0,3174
72087110302,3601,2,3595,2,0,0,0,1,3599
72087110303,2373,13,2357,1,0,0,0,1,2360
72087110304,3358,7,3330,8,0,5,0,1,3351
72087110400,2177,2,2163,10,0,2,0,0,2175
72087110500,1054,0,1045,7,0,2,0,0,1054
72087110600,2087,0,2074,13,0,0,0,0,2087
72087990000,0,0,0,0,0,0,0,0,0
72089140101,3373,86,3256,10,2,7,1,5,3287
72089140102,3099,46,3043,5,0,0,0,0,3053
72089140201,2482,135,2315,21,0,4,1,4,2347
72089140202,3990,63,3900,12,3,1,1,8,3927
72089140300,4837,54,4749,14,1,9,0,4,4783
72089990001,0,0,0,0,0,0,0,0,0
72091570100,5996,34,5954,2,0,1,0,2,5962
72091570201,5642,44,5584,11,0,0,0,1,5598
72091570202,4018,14,3997,0,0,2,0,5,4004
72091570300,2837,9,2810,6,0,8,0,3,2828
72091570400,3148,20,3124,1,0,1,0,1,3128
72091570500,4434,27,4391,2,0,6,0,6,4407
72091570600,2786,8,2773,1,0,1,0,3,2778
72091570700,4046,18,4012,6,0,1,0,8,4028
72091570800,6585,26,6553,4,0,0,0,0,6559
72091990025,0,0,0,0,0,0,0,0,0
72093960100,3160,12,3144,0,0,2,0,1,3148
72093960200,1595,7,1585,0,0,0,0,0,1588
72095951400,6572,17,6537,11,0,2,0,0,6555
72095951500,2375,4,2366,5,0,0,0,0,2371
72095951600,1642,10,1627,3,0,0,0,1,1632
72095990000,0,0,0,0,0,0,0,0,0
72097080100,874,8,861,4,0,0,0,0,866
72097080200,985,6,975,0,0,2,0,0,979
72097080300,1768,4,1758,5,0,0,0,1,1764
72097080600,1346,10,1331,4,0,1,0,0,1336
72097080800,2496,9,2483,0,0,4,0,0,2487
72097080900,1098,7,1088,1,0,2,0,0,1091
72097081200,4499,30,4459,4,3,0,0,1,4469
72097081300,2049,8,2040,0,0,1,0,0,2041
72097081501,3765,224,3477,27,0,15,0,11,3541
72097081522,3547,23,3490,7,0,20,0,6,3524
72097081523,3040,37,2993,4,0,4,0,2,3003
72097081524,2009,4,2003,0,0,0,0,0,2005
72097081601,4378,53,4304,13,0,1,0,4,4325
72097081602,3506,14,3486,1,0,1,0,4,3492
72097081700,2717,33,2675,1,0,4,0,4,2684
72097081800,3452,62,3367,9,0,4,0,2,3390
72097081900,4874,31,4838,1,1,1,0,2,4843
72097082001,5219,32,5167,6,0,7,0,4,5187
72097082012,4820,16,4793,3,0,6,0,0,4804
72097082022,3551,22,3529,0,0,0,0,0,3529
72097082102,3290,13,3268,3,0,6,0,0,3277
72097082103,4082,24,4045,8,0,4,0,0,4058
72097082104,2364,12,2348,0,0,0,0,0,2352
72097082200,1598,2,1592,3,0,1,0,0,1596
72097082300,1750,5,1737,2,0,0,0,0,1745
72097990000,0,0,0,0,0,0,0,0,0
72099420100,6402,18,6368,7,2,1,0,4,6384
72099420200,6639,12,6614,1,0,8,0,0,6627
72099420302,4141,8,4123,3,0,5,0,2,4133
72099420303,3090,4,3083,0,0,0,0,3,3086
72099420304,2501,6,2487,6,0,2,0,0,2495
72099420401,3877,10,3862,4,0,0,0,0,3867
72099420402,4597,6,4585,1,0,0,0,3,4591
72099420500,6213,16,6194,0,0,0,0,1,6197
72101955201,4251,10,4239,0,0,0,0,1,4241
72101955202,5377,21,5348,0,0,2,0,3,5356
72101955301,4513,7,4497,0,2,0,0,3,4506
72101955302,3371,13,3355,0,0,0,1,1,3358
72101955401,6128,19,6102,0,0,2,0,1,6109
72101955402,3140,10,3125,0,0,1,0,4,3130
72101955500,1947,6,1938,1,0,1,0,1,1941
72103170100,4883,23,4843,4,0,5,0,5,4860
72103170200,6623,34,6573,9,0,0,0,2,6589
72103170300,5555,50,5491,3,0,4,0,3,5505
72103170400,6325,29,6283,0,0,5,0,7,6296
72103990013,0,0,0,0,0,0,0,0,0
72105520100,5209,7,5199,1,1,0,0,0,5202
72105520200,5442,13,5421,2,1,0,0,0,5429
72105520300,2520,7,2509,2,0,1,0,0,2513
72105520400,7717,27,7681,5,0,0,0,2,7690
72105520500,8353,30,8321,1,0,0,0,0,8323
72107954801,4475,14,4454,3,4,0,0,0,4461
72107954802,1912,2,1903,1,0,2,0,4,1910
72107954901,3533,13,3516,0,1,0,0,3,3520
72107954902,2214,5,2206,3,0,0,0,0,2209
72107955001,4552,21,4526,2,1,0,0,0,4531
72107955002,2219,7,2209,3,0,0,0,0,2212
72107955100,2529,2,2524,2,0,1,0,0,2527
72109290100,3542,15,3524,1,0,0,0,0,3527
72109290200,5590,16,5556,6,0,0,0,8,5574
72109290300,3756,18,3730,4,0,0,0,0,3738
72109290400,3097,17,3068,6,0,0,0,0,3080
72109990000,0,0,0,0,0,0,0,0,0
72111730100,4656,20,4626,3,0,2,0,5,4636
72111730200,2284,14,2268,2,0,0,0,0,2270
72111730300,6057,14,6042,0,0,1,0,0,6043
72111730400,2020,0,2013,6,0,1,0,0,2020
72111730700,3807,7,3791,1,0,3,0,3,3800
72111730800,1575,12,1559,1,0,1,0,2,1563
72111990000,0,0,0,0,0,0,0,0,0
72113070100,4302,45,4248,0,0,7,0,2,4257
72113070201,2435,11,2418,3,1,0,0,1,2424
72113070202,1094,3,1088,1,0,2,0,0,1091
72113070300,2052,20,2025,3,0,3,0,1,2032
72113070400,2628,8,2617,0,0,0,0,1,2620
72113070502,3647,22,3616,3,0,5,0,1,3625
72113070503,3667,43,3601,2,3,13,0,2,3624
72113070513,2462,8,2448,2,0,0,0,1,2454
72113070514,2390,8,2378,0,1,0,0,0,2382
72113070522,3073,18,3049,0,0,0,0,1,3055
72113070800,1293,10,1280,2,0,0,0,0,1283
72113070900,1789,0,1786,2,0,1,0,0,1789
72113071000,1258,4,1248,0,1,0,0,4,1254
72113071200,2075,14,2058,0,0,0,0,3,2061
72113071300,3354,11,3335,1,0,0,0,7,3343
72113071401,2100,6,2083,7,0,3,0,0,2094
72113071402,3825,14,3794,2,0,13,0,0,3811
72113071500,3044,13,3022,5,0,0,0,2,3031
72113071601,2229,18,2195,0,0,14,0,0,2211
72113071602,3210,9,3197,0,0,0,0,2,3201
72113071700,1567,36,1523,5,0,0,0,0,1531
72113071800,1671,10,1651,6,0,0,0,3,1661
72113071900,3488,16,3454,5,0,4,0,2,3472
72113072000,1801,8,1785,0,0,6,0,1,1793
72113072101,1306,6,1294,0,0,2,0,4,1300
72113072102,4707,48,4646,2,0,3,0,2,4659
72113072201,3827,13,3805,2,0,2,0,5,3814
72113072202,4492,36,4442,6,0,3,0,3,4456
72113072300,1092,5,1087,0,0,0,0,0,1087
72113072400,8050,46,7974,9,0,12,0,4,8004
72113072500,6827,24,6792,7,0,2,0,1,6803
72113072600,3066,2,3058,0,1,0,1,0,3064
72113072701,2517,16,2496,2,0,1,0,0,2501
72113072703,4636,36,4588,9,0,2,0,0,4600
72113072704,2585,8,2571,2,0,1,0,2,2577
72113072900,5807,40,5742,6,6,0,0,12,5767
72113073001,2923,8,2908,7,0,0,0,0,2915
72113073002,4351,21,4324,1,0,0,0,1,4330
72113073003,1225,8,1214,2,0,0,0,0,1217
72113073004,3759,43,3709,2,1,3,0,1,3716
72113073005,2640,18,2618,0,0,0,0,1,2622
72113073006,2746,15,2725,0,0,5,0,1,2731
72113073009,4213,9,4190,3,0,0,0,5,4204
72113073010,3330,14,3314,0,0,0,0,0,3316
72113980001,2938,28,2904,6,0,0,0,0,2910
72113993000,0,0,0,0,0,0,0,0,0
72115330100,7697,87,7589,6,0,4,0,5,7610
72115330200,5086,15,5064,0,0,2,0,2,5071
72115330300,5211,22,5177,2,0,1,2,0,5189
72115330400,5644,29,5611,0,0,0,0,1,5615
72115990000,0,0,0,0,0,0,0,0,0
72117959401,3257,363,2849,6,5,4,0,11,2894
72117959402,1871,14,1853,1,1,0,0,0,1857
72117959500,3357,110,3233,7,0,3,0,1,3247
72117959601,2439,43,2392,0,0,2,0,1,2396
72117959602,4263,161,4082,9,0,2,0,5,4102
72117990400,0,0,0,0,0,0,0,0,0
72119130101,5085,52,5015,10,0,4,0,3,5033
72119130102,5222,78,5100,10,0,15,0,6,5144
72119130200,2031,36,1975,7,1,8,0,4,1995
72119130300,3054,21,3025,7,1,0,0,0,3033
72119130401,3570,16,3541,10,0,0,0,2,3554
72119130402,4567,23,4540,1,1,0,0,2,4544
72119130500,5187,11,5161,11,2,0,0,0,5176
72119130601,3199,9,3177,1,0,0,0,10,3190
72119130602,3654,64,3579,4,1,0,0,0,3590
72119130701,4521,35,4478,1,0,0,0,6,4486
72119130703,2495,17,2454,19,0,3,0,1,2478
72119130704,4475,19,4439,10,0,2,0,3,4456
72119992700,0,0,0,0,0,0,0,0,0
72121960300,6194,27,6161,2,0,1,0,3,6167
72121960400,4295,18,4266,5,0,0,0,4,4277
72121960500,968,6,961,0,0,0,0,0,962
72121960600,2317,11,2296,3,0,3,0,1,2306
72121960700,4776,12,4760,1,1,0,0,1,4764
72121960800,4179,18,4158,1,0,0,0,2,4161
72123952600,2816,2,2807,2,0,0,0,3,2814
72123952700,1964,13,1947,1,0,0,0,2,1951
72123952800,5843,39,5800,0,0,0,0,4,5804
72123952901,3586,48,3523,12,0,0,0,0,3538
72123952902,3953,10,3935,6,0,0,0,0,3943
72123953000,2247,14,2228,0,0,0,0,5,2233
72123953100,1744,10,1729,1,0,0,0,3,1734
72123953200,3636,25,3608,1,0,0,0,0,3611
72123992800,0,0,0,0,0,0,0,0,0
72125840100,4136,13,4121,1,0,0,0,0,4123
72125840200,6558,37,6504,8,0,4,0,2,6521
72125840300,4837,17,4816,1,0,0,0,2,4820
72125840400,5064,22,5032,2,0,7,0,1,5042
72125840500,3790,44,3718,12,0,5,0,8,3746
72125840600,4157,16,4133,5,0,0,1,0,4141
72125840700,3337,13,3315,2,1,0,0,2,3324
72127000400,1073,58,993,9,0,2,3,4,1015
72127000506,1344,149,1153,20,0,10,0,10,1195
72127000600,1978,119,1835,5,0,13,0,0,1859
72127000700,1952,150,1740,8,0,35,0,6,1802
72127000900,2724,328,2254,25,1,93,0,14,2396
72127001001,3876,376,3383,15,0,67,0,14,3500
72127001002,2064,244,1748,9,1,28,0,6,1820
72127001100,1811,240,1531,8,1,18,0,4,1571
72127001200,1869,215,1627,11,0,5,0,7,1654
72127001301,1873,9,1853,4,0,2,0,0,1864
72127001302,3889,22,3847,9,1,2,0,4,3867
72127001400,943,17,909,10,0,0,0,4,926
72127001500,1919,71,1818,18,2,4,0,2,1848
72127001600,3463,267,3099,20,1,38,0,20,3196
72127001800,2045,100,1912,5,0,15,0,1,1945
72127001900,3468,143,3299,10,0,10,1,2,3325
72127002002,874,18,835,13,1,3,0,0,856
72127002100,1257,38,1180,23,0,15,0,1,1219
72127002200,1327,31,1281,10,1,3,0,0,1296
72127002300,1263,17,1233,11,0,2,0,0,1246
72127002400,2577,34,2515,15,2,0,0,4,2543
72127002500,1373,11,1337,20,0,2,0,1,1362
72127002600,2152,10,2128,11,0,2,0,1,2142
72127002800,1971,13,1936,16,1,1,0,0,1958
72127002900,1193,4,1183,1,0,0,0,2,1189
72127003000,1188,2,1169,14,0,1,0,0,1186
72127003100,2319,7,2292,9,0,0,0,6,2312
72127003200,1712,7,1695,8,0,0,0,2,1705
72127003300,1291,6,1273,12,0,0,0,0,1285
72127003400,2127,7,2104,10,2,1,0,1,2120
72127003501,4392,7,4359,14,0,1,0,2,4385
72127003502,1332,6,1318,7,1,0,0,0,1326
72127003600,999,2,988,8,0,0,0,0,997
72127003701,1334,9,1315,6,0,0,0,3,1325
72127003702,1431,6,1413,7,0,0,0,0,1425
72127003800,1843,4,1823,13,0,0,0,0,1839
72127003902,3604,44,3516,33,0,5,0,6,3560
72127004200,1962,28,1901,15,0,8,0,2,1934
72127004306,2056,6,2045,1,0,0,0,3,2050
72127004400,1573,4,1560,3,1,0,0,3,1569
72127004500,1449,13,1428,3,0,0,0,2,1436
72127004600,2368,7,2350,10,0,0,0,1,2361
72127004700,4351,12,4324,8,0,0,0,3,4339
72127004800,2516,5,2489,17,0,0,0,3,2511
72127004900,3312,10,3289,11,0,2,0,0,3302
72127005000,3925,17,3886,12,0,1,0,3,3908
72127005101,1758,4,1739,10,0,0,0,4,1754
72127005102,2101,11,2075,11,0,0,0,0,2090
72127005103,2695,10,2679,3,0,1,0,0,2685
72127005201,2085,12,2055,5,1,6,0,6,2073
72127005202,2514,21,2479,8,0,0,0,2,2493
72127005204,1733,17,1711,0,0,2,0,0,1716
72127005214,4832,27,4779,18,0,3,0,2,4805
72127005215,2309,26,2275,2,0,1,0,3,2283
72127005300,2322,22,2288,4,0,1,0,0,2300
72127005402,1204,1,1199,1,1,0,0,1,1203
72127005403,5699,34,5650,6,0,6,0,0,5665
72127005404,2062,17,2040,3,0,0,0,0,2045
72127005405,5208,36,5145,7,0,7,0,9,5172
72127005500,4641,19,4606,13,1,0,0,1,4622
72127005601,2696,22,2661,7,0,3,0,3,2674
72127005602,3706,15,3675,3,0,3,0,2,3691
72127005800,2242,23,2203,9,1,3,0,1,2219
72127005900,1550,5,1539,3,0,0,0,2,1545
72127006000,1617,3,1593,13,0,0,0,1,1614
72127006101,3550,26,3507,11,0,1,1,2,3524
72127006102,1227,11,1209,2,0,5,0,0,1216
72127006200,1634,7,1617,5,5,0,0,0,1627
72127006301,2631,20,2582,5,0,6,0,1,2611
72127006302,2870,34,2794,16,1,17,0,0,2836
72127006500,1601,21,1562,8,0,3,0,2,1580
72127006600,2045,17,1998,10,0,16,0,1,2028
72127006701,1815,38,1760,9,1,3,0,1,1777
72127006702,2341,54,2265,5,3,9,0,0,2287
72127006800,5427,57,5305,11,0,41,0,8,5370
72127006900,2297,18,2262,12,0,1,0,0,2279
72127007004,2104,18,2070,8,0,7,0,0,2086
72127007100,1567,1,1548,12,2,1,0,1,1566
72127007300,3251,33,3192,7,1,11,0,3,3218
72127007400,1635,6,1600,14,1,2,0,5,1629
72127007500,1743,3,1731,6,0,3,0,0,1740
72127007600,2071,13,2043,2,0,9,0,1,2058
72127007700,2629,8,2602,14,0,0,1,4,2621
72127007800,4780,28,4738,6,0,1,0,6,4752
72127007900,2505,22,2472,7,0,1,0,0,2483
72127008001,3656,29,3615,5,1,0,0,3,3627
72127008002,3719,25,3677,4,0,8,0,1,3694
72127008100,2158,32,2113,7,0,0,0,3,2126
72127008201,2225,4,2216,3,0,0,0,0,2221
72127008202,2751,12,2729,2,0,2,0,3,2739
72127008300,2066,14,2046,3,0,2,0,0,2052
72127008400,3851,27,3791,17,0,4,0,4,3824
72127008500,3873,19,3817,13,0,15,0,7,3854
72127008601,1869,36,1820,3,0,8,0,0,1833
72127008602,3744,43,3677,6,0,9,0,2,3701
72127008603,1538,16,1515,1,0,0,0,4,1522
72127008700,1634,25,1574,20,2,5,0,6,1609
72127008900,2049,13,2015,7,0,0,0,5,2036
72127009000,1641,17,1601,13,0,0,0,0,1624
72127009111,3208,40,3144,7,6,6,0,0,3168
72127009112,3883,20,3836,8,1,14,0,4,3863
72127009121,3411,30,3363,7,0,0,0,3,3381
72127009122,6048,67,5962,3,1,2,0,8,5981
72127009123,2069,1,2064,1,0,3,0,0,2068
72127009300,2583,9,2551,14,0,1,0,3,2574
72127009400,1677,8,1667,1,0,1,0,0,1669
72127009601,1346,13,1317,1,0,10,0,5,1333
72127009602,1849,13,1829,0,0,0,0,3,1836
72127009603,2339,30,2283,11,4,9,0,0,2309
72127009614,1814,19,1779,3,0,5,0,6,1795
72127009624,4071,35,4002,6,0,17,0,5,4036
72127009800,5325,83,5228,0,2,7,0,2,5242
72127009901,3492,41,3442,1,0,2,0,4,3451
72127009902,4182,21,4142,12,0,4,0,0,4161
72127009903,4927,43,4864,6,0,2,0,5,4884
72127009904,1977,13,1951,6,0,2,0,3,1964
72127010002,5012,69,4924,3,0,12,0,0,4943
72127010012,5192,44,5144,2,0,0,0,2,5148
72127010022,3241,35,3181,5,1,12,0,0,3206
72127010032,5461,28,5409,8,0,8,0,2,5433
72127010043,2192,10,2161,5,0,7,0,4,2182
72127010044,4228,51,4161,5,1,9,0,1,4177
72127010045,3804,20,3766,6,3,5,0,3,3784
72127010046,3592,11,3574,1,0,0,0,5,3581
72127010100,7645,65,7557,6,0,6,0,6,7580
72127010200,5659,34,5608,5,1,5,0,4,5625
72127010500,5142,62,5023,8,1,31,0,5,5080
72127980000,6,0,6,0,0,0,0,0,6
72127980101,0,0,0,0,0,0,0,0,0
72127980102,0,0,0,0,0,0,0,0,0
72127980103,8,0,7,1,0,0,0,0,8
72127980104,3,0,3,0,0,0,0,0,3
72127980105,2,0,2,0,0,0,0,0,2
72127980107,4,0,4,0,0,0,0,0,4
72127980108,4,2,1,1,0,0,0,0,2
72127980200,30,0,26,1,0,1,1,0,30
72127980300,0,0,0,0,0,0,0,0,0
72127990000,0,0,0,0,0,0,0,0,0
72129220100,8216,33,8167,1,0,5,0,7,8183
72129220200,2499,0,2496,2,0,0,0,0,2499
72129220300,1530,10,1518,0,1,0,0,0,1520
72129220401,4864,19,4833,0,2,2,0,8,4845
72129220402,4993,22,4963,0,0,2,0,3,4971
72129220501,3147,2,3142,1,0,1,0,0,3145
72129220502,4221,10,4202,0,0,1,0,5,4211
72129220600,3166,7,3156,0,1,0,0,1,3159
72129220700,5057,6,5043,0,0,2,0,4,5051
72131009200,2309,4,2297,2,3,0,0,2,2305
72131958500,4296,18,4274,0,0,0,0,3,4278
72131958700,5270,28,5239,1,0,0,0,1,5242
72131958800,6537,35,6486,1,0,0,0,11,6502
72131958900,2529,8,2515,0,1,0,0,5,2521
72131959000,3632,17,3612,1,0,0,0,2,3615
72131959200,5415,21,5379,0,0,2,0,11,5394
72131959300,4154,9,4135,5,0,0,0,3,4145
72131959500,5203,26,5173,3,0,1,0,0,5177
72133953300,4322,15,4296,2,0,0,0,1,4307
72133953500,4321,9,4300,0,0,8,0,4,4312
72133953600,5176,17,5141,5,2,4,0,3,5159
72133953700,1875,6,1862,2,0,1,0,4,1869
72133953800,4587,15,4567,2,0,1,1,0,4572
72133990000,0,0,0,0,0,0,0,0,0
72135510101,8815,29,8771,2,0,4,0,3,8786
72135510102,4567,21,4535,4,0,4,0,1,4546
72135510200,8112,44,8035,10,0,12,1,8,8068
72135510300,2648,5,2636,2,0,0,0,0,2643
72135510400,4622,7,4606,3,0,0,0,2,4615
72135510502,3858,11,3838,0,0,3,0,0,3847
72135510503,7874,18,7830,4,1,10,0,9,7856
72135510504,3871,15,3851,3,0,1,0,1,3856
72135510505,3530,19,3503,1,0,1,0,4,3511
72135510601,5058,15,5026,3,0,5,0,8,5043
72135510602,5345,16,5322,1,0,0,0,3,5329
72135510701,3777,15,3751,5,2,1,0,3,3762
72135510702,4775,20,4749,0,1,0,0,0,4755
72137120200,3427,18,3386,9,0,9,0,3,3409
72137120300,1972,11,1952,4,0,2,0,1,1961
72137120400,1510,12,1491,5,0,0,0,0,1498
72137120500,1134,8,1121,0,0,3,0,2,1126
72137120600,2848,22,2811,11,0,4,0,0,2826
72137120900,2902,19,2864,4,0,11,0,2,2883
72137121001,3441,23,3405,5,0,7,0,0,3418
72137121002,3225,18,3203,2,0,0,0,2,3207
72137121200,3018,9,2997,6,1,0,0,4,3009
72137121400,4689,187,4478,12,0,1,0,4,4502
72137121701,3025,7,3002,10,0,2,0,4,3018
72137121702,4683,14,4655,8,0,1,0,4,4669
72137121801,4529,26,4490,10,0,0,0,1,4503
72137121802,5034,25,4985,15,0,3,0,5,5009
72137121900,3085,14,3064,1,0,1,0,4,3071
72137122001,4254,10,4234,7,0,0,0,0,4244
72137122002,3754,7,3736,0,0,3,0,3,3747
72137122100,2241,2,2234,3,1,0,0,0,2239
72137122201,3052,1,3044,6,0,0,0,0,3051
72137122202,2022,13,1997,7,0,0,0,4,2009
72137122400,1661,6,1650,4,0,0,0,0,1655
72137122500,4472,22,4434,5,0,9,0,0,4450
72137122600,5315,5,5282,14,0,0,0,11,5310
72137990000,0,0,0,0,0,0,0,0,0
72139060102,3232,29,3194,2,0,3,0,3,3203
72139060103,2701,8,2684,1,0,0,0,2,2693
72139060104,7137,38,7083,3,0,8,0,2,7099
72139060212,4511,30,4466,6,0,6,0,3,4481
72139060213,2548,34,2499,7,0,0,0,3,2514
72139060222,4460,25,4417,8,0,0,0,6,4435
72139060223,3686,14,3667,3,0,2,0,0,3672
72139060224,2492,5,2478,3,0,2,0,2,2487
72139060225,2469,9,2456,2,0,0,0,1,2460
72139060226,1059,2,1054,1,0,0,0,1,1057
72139060301,5111,19,5074,3,0,9,0,3,5092
72139060302,7785,40,7730,1,0,1,0,10,7745
72139060401,3891,7,3877,6,0,0,0,0,3884
72139060403,3971,45,3899,10,0,2,0,5,3926
72139060404,3988,66,3908,4,0,0,0,0,3922
72139060501,4882,19,4845,6,0,0,0,8,4863
72139060502,3817,15,3795,4,0,0,0,0,3802
72141956900,3289,19,3262,0,0,4,0,3,3270
72141957000,4559,22,4533,0,1,0,0,2,4537
72141957100,4546,48,4491,0,0,3,0,2,4498
72141957200,4432,29,4396,5,1,0,1,0,4403
72141957300,3492,19,3469,1,0,2,0,0,3473
72141957400,1983,5,1974,2,0,1,1,0,1978
72141957500,2532,2,2530,0,0,0,0,0,2530
72141957600,3454,28,3417,1,0,3,1,4,3426
72143550101,3019,73,2918,8,1,12,0,6,2946
72143550102,1520,0,1520,0,0,0,0,0,1520
72143550103,4850,88,4708,18,2,15,0,14,4762
72143550200,5026,5,5007,2,1,5,0,6,5021
72143550300,4658,9,4640,5,0,0,0,3,4649
72143550400,3507,13,3487,7,0,0,0,0,3494
72143550500,5017,47,4942,3,1,13,0,9,4970
72143550601,4713,10,4678,6,1,1,0,14,4703
72143550602,3085,9,3067,8,0,0,0,1,3076
72143990000,0,0,0,0,0,0,0,0,0
72145560100,4340,12,4315,4,1,1,0,0,4328
72145560201,5209,40,5160,1,1,1,0,0,5169
72145560204,3243,35,3200,5,0,0,0,1,3208
72145560300,3984,21,3957,3,0,0,0,1,3963
72145560401,3318,18,3296,0,1,0,0,0,3300
72145560402,5119,19,5090,2,0,0,0,6,5100
72145560500,1677,7,1663,0,0,4,0,0,1670
72145560600,5572,18,5541,1,2,2,0,6,5554
72145560701,5282,32,5239,4,0,1,0,2,5250
72145560702,6073,34,6022,9,1,0,0,3,6039
72145560801,2590,11,2568,0,0,2,0,3,2579
72145560802,3113,11,3095,2,2,0,0,1,3102
72145560900,4894,21,4866,0,1,0,0,0,4873
72145990000,0,0,0,0,0,0,0,0,0
72147950500,4748,232,4451,23,7,2,0,32,4516
72147950600,3501,301,3135,24,8,1,0,23,3200
72147990000,0,0,0,0,0,0,0,0,0
72149720100,4585,18,4565,0,1,1,0,0,4567
72149720300,5384,6,5370,1,1,0,0,4,5378
72149720400,1717,6,1709,0,2,0,0,0,1711
72149720502,3167,8,3156,1,0,0,0,1,3159
72149720503,3984,13,3969,0,0,0,0,1,3971
72149720504,3256,14,3239,1,1,0,0,0,3242
72151950601,2603,2,2593,0,0,3,0,4,2601
72151950602,4001,20,3978,1,0,0,0,2,3981
72151950700,4750,11,4728,0,1,0,0,8,4739
72151950800,3469,10,3455,1,0,0,0,1,3459
72151950900,4654,15,4632,4,0,2,0,1,4639
72151951000,2011,9,1996,2,0,0,1,0,2002
72151951100,2005,14,1985,1,0,1,0,1,1991
72151951200,3102,11,3087,1,0,2,1,0,3091
72151951300,3831,23,3804,2,0,0,0,1,3808
72151990000,0,0,0,0,0,0,0,0,0
72153750101,2326,6,2315,1,0,2,0,2,2320
72153750102,3070,7,3063,0,0,0,0,0,3063
72153750201,2791,8,2777,2,0,0,0,2,2783
72153750202,4319,29,4281,3,0,5,0,1,4290
72153750300,3724,11,3711,1,0,0,1,0,3713
72153750400,3019,16,2996,1,0,3,0,0,3003
72153750501,3968,18,3941,2,0,0,0,3,3950
72153750502,1845,1,1837,0,0,4,0,1,1844
72153750503,2155,4,2147,1,0,0,1,0,2151
72153750601,4368,20,4343,0,3,1,0,1,4348
72153750602,2587,16,2571,0,0,0,0,0,2571
4001942600,1549,8,10,1,1522,0,0,2,1541
4001942700,4491,56,61,7,4288,29,7,0,4435
4001944000,5348,133,98,18,4945,56,0,5,5215
4001944100,5495,300,126,7,4946,16,0,5,5195
4001944201,4021,190,76,22,3611,63,0,0,3831
4001944202,3608,51,26,13,3456,31,0,0,3557
4001944301,3789,45,53,0,3658,1,0,5,3744
4001944302,2685,1,16,0,2636,0,0,0,2684
4001944901,3369,22,50,7,3219,32,2,0,3347
4001944902,4201,28,57,8,4035,3,0,0,4173
4001945001,4133,83,63,2,3907,1,1,1,4050
4001945002,3589,26,78,4,3426,3,2,2,3563
4001945100,2132,127,53,17,1857,11,1,5,2005
4001970201,2569,2073,340,9,46,18,0,17,496
4001970202,2610,2125,250,8,43,4,3,34,485
4001970300,3216,1916,966,42,171,12,1,4,1300
4001970501,4449,3077,1043,10,168,21,0,24,1372
4001970502,4767,3530,495,9,575,6,1,11,1237
4003000101,1071,502,503,1,9,5,0,0,569
4003000102,745,587,104,7,3,3,0,1,158
4003000201,3098,1618,1317,8,17,15,2,7,1480
4003000202,3382,1294,1908,26,29,28,3,14,2088
4003000203,2540,1976,432,13,15,12,0,13,564
4003000301,4029,2814,826,48,29,31,20,20,1215
4003000303,3400,2632,439,19,18,19,15,35,768
4003000304,2328,1801,329,15,22,11,2,10,527
4003000305,2681,2284,232,9,16,19,0,22,397
4003000400,2084,1609,318,4,13,8,0,7,475
4003000501,1924,1353,461,10,22,9,0,5,571
4003000502,921,681,177,10,11,6,0,9,240
4003000503,2063,834,826,296,92,4,2,2,1229
4003000600,2600,565,1948,22,16,11,0,10,2035
4003000700,4833,320,4434,18,6,15,2,9,4513
4003000800,5130,361,4628,21,15,71,0,5,4769
4003000901,3305,144,3121,8,2,11,0,3,3161
4003000902,2684,138,2493,16,5,10,1,11,2546
4003001000,1464,1096,263,23,5,10,2,16,368
4003001100,3103,1649,1293,12,16,12,1,22,1454
4003001200,2753,1288,1275,6,17,10,4,11,1465
4003001301,2333,1723,414,33,17,24,5,20,610
4003001302,2788,1951,526,73,22,39,8,22,837
4003001401,3437,1491,935,510,39,222,38,33,1946
4003001402,1802,944,375,214,8,114,4,18,858
4003001501,3329,1741,948,269,25,105,28,38,1588
4003001502,3633,1721,1251,240,40,76,33,52,1912
4003001601,5280,2837,1295,395,31,203,36,38,2443
4003001602,3038,1653,805,178,20,131,29,14,1385
4003001701,4355,2515,1044,319,13,131,17,20,1840
4003001702,3658,1967,990,255,26,131,17,16,1691
4003001703,5039,3094,1121,275,23,189,21,29,1945
4003001801,5649,3823,909,261,13,286,31,44,1826
4003001802,3372,2196,648,176,12,139,36,17,1176
4003001900,7114,4896,1084,321,20,319,27,47,2218
4003002001,5453,3595,1278,155,28,79,18,23,1858
4003002002,4295,3067,862,42,17,24,5,27,1228
4003002100,4734,3496,803,63,30,55,14,35,1238
4005000100,3873,3006,409,24,144,38,15,10,867
4005000200,4097,2890,458,50,342,108,1,36,1207
4005000301,3957,1612,1350,41,747,29,6,18,2345
4005000302,2819,1001,959,35,645,27,1,13,1818
4005000400,5343,2946,1283,62,728,55,8,30,2397
4005000500,5007,2116,1673,61,867,70,6,15,2891
4005000601,2010,1611,163,17,29,48,4,24,399
4005000602,3395,2266,414,37,368,97,15,15,1129
4005000700,4143,2576,660,57,508,126,8,10,1567
4005000800,6313,3320,1321,277,845,136,31,32,2993
4005000901,5033,3439,662,42,428,164,8,36,1594
4005000902,3539,1900,615,82,698,59,2,12,1639
4005001000,10422,6285,2345,397,378,477,54,24,4137
4005001101,5229,3823,642,46,212,173,2,38,1406
4005001103,5208,2679,1492,89,629,84,17,12,2529
4005001104,4937,3123,761,85,428,217,16,38,1814
4005001201,2738,2174,270,33,87,32,1,15,564
4005001301,5375,3703,754,22,593,29,13,33,1672
4005001302,5547,3876,732,21,552,35,2,37,1671
4005001500,3528,2872,325,4,180,14,2,25,656
4005001601,1787,1527,146,10,7,31,0,16,260
4005001602,1223,1021,101,6,7,27,0,0,202
4005001700,3347,1913,1100,48,58,51,2,23,1434
4005002000,1918,1562,79,6,195,16,0,5,356
4005002101,3870,1937,431,25,1147,66,1,18,1933
4005002102,3562,1281,218,21,1810,55,11,7,2281
4005002201,4081,3062,575,24,167,68,3,17,1019
4005002202,2928,2226,356,22,154,27,0,23,702
4005002301,3947,2240,730,70,692,86,1,13,1707
4005002302,3234,2594,360,33,62,12,14,14,640
4005942201,3678,21,44,3,3495,2,0,6,3657
4005942202,3696,17,39,4,3600,2,1,0,3679
4005944900,3888,145,104,16,3416,110,5,1,3743
4005945000,4006,36,60,2,3850,3,0,0,3970
4005945100,3342,29,42,0,3201,1,3,0,3313
4005945200,4056,60,44,5,3873,7,1,0,3996
4005980000,25,15,2,0,1,0,0,0,10
4005980100,0,0,0,0,0,0,0,0,0
4005980200,0,0,0,0,0,0,0,0,0
4007000100,2908,2553,164,5,41,5,7,27,355
4007000200,2132,1827,188,4,9,8,1,13,305
4007000301,5775,4584,702,30,111,73,5,21,1191
4007000302,3042,2534,320,12,21,15,5,13,508
4007000400,5307,4484,518,18,52,31,7,18,823
4007000500,5706,4598,617,13,228,37,2,10,1108
4007000600,1569,1392,84,20,24,4,0,4,177
4007000700,1695,1537,83,12,12,4,0,0,158
4007000800,1099,686,344,3,19,6,0,3,413
4007000900,2502,1129,1152,29,83,13,3,20,1373
4007001000,4605,2687,1491,37,160,17,0,24,1918
4007001100,3660,1861,1352,30,197,87,2,16,1799
4007001200,4872,2528,1384,19,670,87,3,28,2344
4007001300,1044,285,730,4,7,3,2,0,759
4007940200,1825,21,27,3,1719,37,2,3,1804
4007940400,5531,51,127,0,5302,0,6,3,5480
4009940500,4720,22,101,4,4558,0,0,2,4698
4009961100,4849,3575,1055,15,60,3,3,12,1274
4009961201,3918,2890,798,19,95,19,0,0,1028
4009961202,4102,2801,1135,15,35,21,4,11,1301
4009961300,3083,1552,1316,34,57,20,3,7,1531
4009961400,5293,2669,2340,46,69,35,5,12,2624
4009961500,4702,2947,1566,21,31,8,1,27,1755
4009961600,2563,1247,883,190,136,41,0,18,1316
4009961700,5303,2695,2234,109,102,22,0,13,2608
4011960100,2951,1072,1698,16,79,10,0,15,1879
4011960200,4084,1765,1911,57,175,55,1,13,2319
4011960300,2528,1609,767,7,21,3,0,6,919
4012020101,935,475,394,0,9,15,2,1,460
4012020102,1028,822,134,2,11,10,14,8,206
4012020201,1773,1385,231,11,41,17,0,12,388
4012020202,581,510,45,0,4,8,0,0,71
4012020501,1419,1157,172,6,2,7,15,6,262
4012020503,1043,849,118,5,9,2,0,5,194
4012020504,820,726,50,1,0,0,2,1,94
4012020505,939,816,74,6,10,1,0,2,123
4012020602,983,602,310,8,6,4,1,2,381
4012940200,3414,1101,1433,58,614,34,3,1,2313
4012940300,3622,618,1236,5,1648,13,4,5,3004
4012980000,0,0,0,0,0,0,0,0,0
4013010102,5592,5138,192,30,20,76,1,22,454
4013010103,3779,3277,244,41,17,68,5,12,502
4013010104,2989,2851,46,11,8,18,1,7,138
4013030401,4882,4447,207,43,16,56,2,10,435
4013030402,3913,3402,290,10,6,51,4,12,511
4013040502,4820,3701,791,51,46,30,1,4,1119
4013040506,5809,5443,135,82,20,35,1,15,366
4013040507,6362,5983,142,68,13,46,0,15,379
4013040512,1732,1657,23,10,2,23,0,5,75
4013040513,3071,2931,66,4,8,23,0,0,140
4013040514,3315,3114,77,13,0,29,1,13,201
4013040515,4189,3089,875,14,34,27,1,22,1100
4013040516,7427,6267,614,156,36,105,2,26,1160
4013040522,4230,3994,81,33,16,42,0,12,236
4013040523,3333,3075,67,64,3,39,1,9,258
4013040524,1662,1552,31,29,0,21,1,0,110
4013040525,3037,2837,64,40,2,40,0,3,200
4013040526,2431,2286,68,23,3,18,0,5,145
4013040527,4434,3560,417,156,27,66,0,12,874
4013040528,6026,5701,127,46,9,55,0,6,325
4013040529,3603,3441,50,36,3,30,0,5,162
4013040530,3729,2500,699,200,26,98,12,12,1229
4013040531,3757,2967,372,177,21,94,9,5,790
4013040532,6632,4923,1001,150,35,145,0,14,1709
4013040533,2500,1695,480,59,10,104,11,8,805
4013040534,3431,3184,96,54,7,28,0,8,247
4013040535,5823,4632,619,103,27,152,0,34,1191
4013040536,6248,4626,850,181,9,208,12,17,1622
4013040537,2223,1770,217,60,0,85,0,5,453
4013040538,4385,3040,788,206,21,79,8,15,1345
4013040539,6356,4738,1053,116,59,75,22,38,1618
4013040540,5684,3197,1789,262,20,99,17,29,2487
4013040541,4309,2977,1003,47,38,28,4,29,1332
4013050603,4592,2597,1687,36,59,14,0,58,1995
4013050604,3871,1834,1737,31,44,25,0,13,2037
4013050609,6343,3210,2273,463,39,95,15,42,3133
4013050611,7114,2658,3437,502,51,87,37,34,4456
4013050612,9560,3647,4638,605,85,161,29,54,5913
4013050613,5523,2368,2564,257,53,54,0,38,3155
4013050614,5040,2017,2241,406,67,71,27,17,3023
4013050615,5624,2161,2698,421,47,83,13,21,3463
4013050616,3676,1550,1599,248,16,39,8,25,2126
4013050617,5312,2122,2384,396,26,101,31,33,3190
4013050618,6427,4143,1424,220,45,195,19,35,2284
4013050619,7507,4799,2063,166,45,121,11,23,2708
4013050620,7835,4467,2208,473,52,161,8,32,3368
4013050621,8644,4298,3187,597,59,96,14,27,4346
4013050701,7711,2746,3843,570,85,101,11,73,4965
4013050702,6555,2212,3500,407,89,65,15,42,4343
4013060801,5282,1384,3356,333,27,29,12,17,3898
4013060802,3306,1438,1381,250,27,76,14,4,1868
4013060901,5053,2070,2158,378,49,89,21,22,2983
4013060902,3514,530,2631,209,25,13,6,11,2984
4013060903,5505,1548,3234,395,43,65,13,20,3957
4013060904,3915,1081,2272,251,38,58,9,20,2834
4013061010,6267,4379,1129,188,26,244,4,28,1888
4013061011,7598,3005,2850,768,64,487,16,35,4593
4013061013,6049,2523,2168,502,46,505,6,29,3526
4013061014,6517,2306,2728,645,68,334,30,120,4211
4013061015,6037,2586,2465,449,64,157,39,27,3451
4013061017,3288,1808,902,262,259,25,10,1,1480
4013061018,5301,4904,129,107,7,73,4,11,397
4013061020,3865,2011,1104,252,37,217,9,12,1854
4013061021,2024,887,634,117,3,280,10,10,1137
4013061024,2391,861,1160,148,14,58,16,30,1530
4013061026,5922,3880,1207,305,39,143,15,29,2042
4013061027,5496,3531,1114,332,49,107,4,17,1965
4013061028,3182,2005,693,209,12,75,6,26,1177
4013061029,5174,3360,1128,286,32,97,10,12,1814
4013061031,6566,4155,1385,363,50,217,17,19,2411
4013061032,6108,3794,1390,307,35,162,16,25,2314
4013061033,6360,4005,1399,362,46,165,30,34,2355
4013061034,7464,4394,1678,508,46,281,33,46,3070
4013061035,7099,4303,1690,437,41,241,19,31,2796
4013061036,5176,3114,1067,413,23,257,11,34,2062
4013061037,6238,3945,1337,273,34,225,11,23,2293
4013061038,4992,2826,1281,373,41,115,10,35,2166
4013061039,6004,3656,1328,332,30,314,7,15,2348
4013061040,4567,1994,1787,316,57,133,14,40,2573
4013061041,4734,1837,2095,359,67,127,41,20,2897
4013061042,2384,1405,712,111,30,29,3,12,979
4013061043,2827,1075,1396,137,30,62,12,7,1752
4013061044,9294,5875,2165,472,66,172,21,45,3419
4013061045,7940,5095,1870,314,42,212,7,34,2845
4013061046,5844,2243,2366,538,61,239,32,41,3601
4013061047,3885,1718,1215,364,24,325,8,22,2167
4013061048,4079,2166,1142,282,45,231,22,18,1913
4013061049,5826,2451,2392,479,29,211,21,28,3375
4013061050,6465,2740,2505,539,48,261,14,47,3725
4013061051,4010,1645,1602,331,32,193,25,29,2365
4013061052,7060,2555,3173,691,58,171,15,36,4505
4013061053,7287,2742,3007,821,87,231,14,25,4545
4013061054,8264,5006,1822,498,51,524,11,41,3258
4013061055,6157,3060,1664,464,29,509,17,26,3097
4013061056,3074,1797,857,175,16,82,11,16,1277
4013061057,4309,1882,1760,266,21,168,17,20,2427
4013061058,3567,1423,1507,314,19,112,19,4,2144
4013061059,4843,3198,855,275,39,119,15,21,1645
4013061060,3575,2041,893,275,28,53,12,27,1534
4013061061,3568,2260,708,238,11,110,1,30,1308
4013061062,6953,4433,1289,369,33,303,20,30,2520
4013061063,1743,447,1021,167,21,12,6,5,1296
4013061064,2964,1562,741,205,9,280,6,9,1402
4013061100,2659,1445,465,353,21,107,26,12,1214
4013061200,6746,1243,4562,519,92,100,19,29,5503
4013061300,2050,580,1291,71,15,20,3,12,1470
4013061401,2167,276,1616,202,26,5,10,3,1891
4013061402,6154,692,4596,574,59,87,26,27,5462
4013071503,4959,4571,182,66,5,44,4,19,388
4013071504,3721,3462,105,59,10,34,3,5,259
4013071505,6537,5670,386,185,26,81,1,17,867
4013071506,4183,3852,135,59,13,35,0,13,331
4013071509,5603,3746,1012,204,31,310,5,20,1857
4013071510,4402,2992,779,134,31,228,8,27,1410
4013071511,3890,2454,850,142,36,223,3,16,1436
4013071512,6246,4156,1327,186,43,260,10,15,2090
4013071513,1758,1220,313,38,6,91,2,25,538
4013071514,3896,2788,625,163,27,153,7,20,1108
4013071515,3704,2765,508,131,23,121,0,23,939
4013071516,4561,3143,746,315,36,118,1,18,1418
4013071517,3961,2571,855,134,5,159,16,4,1390
4013071600,4192,2019,1789,170,42,37,2,20,2173
4013071701,3009,1509,1017,130,45,136,3,18,1500
4013071702,3555,3098,241,78,17,40,4,3,457
4013071801,5090,4299,422,143,23,54,4,13,791
4013071802,3575,3098,233,96,13,45,3,13,477
4013071903,6435,3806,1978,192,55,157,0,18,2629
4013071906,6331,2596,2798,335,68,230,5,25,3735
4013071909,4178,2312,1222,269,45,148,3,19,1866
4013071910,7132,3379,2726,462,89,169,9,29,3753
4013071911,3246,1614,992,231,53,129,5,18,1632
4013071912,2695,1233,1146,94,62,46,4,19,1462
4013071913,5423,2455,1696,621,80,230,23,21,2968
4013071914,3245,1156,1763,106,37,47,3,30,2089
4013071915,3617,1827,1372,181,24,72,1,12,1790
4013082002,6542,1781,3684,548,73,155,13,15,4761
4013082007,4398,730,3281,183,35,67,0,11,3668
4013082008,5378,607,4283,231,40,101,11,14,4771
4013082009,5183,570,4229,201,51,34,19,16,4613
4013082010,4342,561,3355,193,80,45,14,13,3781
4013082012,7092,1648,4206,641,31,295,30,25,5444
4013082016,3275,680,1756,402,30,275,11,16,2595
4013082017,5160,756,2967,922,57,275,12,22,4404
4013082018,5151,567,3922,383,41,124,18,16,4584
4013082019,2485,1057,935,189,28,149,0,7,1428
4013082020,4027,1612,1704,273,24,248,1,31,2415
4013082021,2365,643,1326,182,20,93,4,7,1722
4013082022,4739,1400,2419,410,100,169,30,13,3339
4013082023,5888,1947,2798,486,47,348,27,31,3941
4013082024,5154,1390,2607,598,73,268,20,24,3764
4013082025,3006,853,1477,344,32,142,14,19,2153
4013082026,6384,1738,3193,786,81,306,30,26,4646
4013082027,5051,1061,2765,724,67,228,26,34,3990
4013082028,4641,550,3459,317,69,110,12,34,4091
4013082204,7339,835,5161,881,80,121,30,40,6504
4013082205,5947,813,4216,582,46,97,37,25,5134
4013082206,4900,514,3530,517,75,130,19,24,4386
4013082207,3436,581,2484,159,33,47,4,16,2855
4013082208,3890,521,2940,248,48,22,8,40,3369
4013082209,2864,191,2567,56,11,6,0,15,2673
4013082210,5348,967,3503,549,45,61,7,36,4381
4013082211,7701,1599,4643,750,89,280,36,51,6102
4013082212,5836,804,3803,775,46,182,17,53,5032
4013082213,6642,843,4677,696,53,173,1,50,5799
4013083000,7216,712,5712,500,63,97,0,34,6504
4013092305,4286,2130,1608,158,48,120,8,24,2156
4013092306,6363,3391,1892,291,75,347,37,28,2972
4013092307,6486,2777,2388,426,116,484,22,27,3709
4013092308,7108,3406,2696,365,88,262,26,25,3702
4013092309,5566,2822,1944,281,61,184,14,21,2744
4013092311,3313,1053,1402,538,94,60,5,21,2260
4013092312,6380,2837,1886,655,136,498,31,24,3543
4013092401,4635,1613,2182,470,104,89,1,16,3022
4013092402,3679,1304,1730,337,36,113,19,21,2375
4013092500,5616,1840,2813,379,56,336,10,32,3776
4013092600,3209,749,2044,230,34,37,0,10,2460
4013092705,4609,1026,2454,562,65,338,9,23,3583
4013092708,2000,974,645,200,33,46,2,7,1026
4013092709,5044,2232,1965,252,52,261,5,30,2812
4013092710,5199,1667,2675,294,111,249,0,22,3532
4013092711,3537,1117,1814,228,66,217,6,10,2420
4013092712,5499,1301,3094,478,46,336,12,35,4198
4013092713,5080,1152,3146,290,57,264,21,26,3928
4013092715,4674,788,3178,394,25,138,8,31,3886
4013092716,4206,722,3045,232,38,84,3,21,3484
4013092717,5393,877,2992,883,97,319,7,28,4516
4013092718,4016,765,2338,472,56,230,8,15,3251
4013092719,4950,1547,2246,631,99,171,20,37,3403
4013092720,5829,2163,2473,514,127,249,13,33,3666
4013092721,3593,1358,1274,232,20,521,4,17,2235
4013092723,4397,2277,1405,286,66,110,7,11,2120
4013092724,4473,2481,1448,144,33,114,4,19,1992
4013092801,5374,904,3486,569,68,186,0,32,4470
4013092802,5636,771,3910,579,74,162,5,13,4865
4013092900,3027,406,2283,206,49,38,3,4,2621
4013093001,6328,1425,3303,946,122,267,11,39,4903
4013093002,4510,897,2852,444,67,110,0,18,3613
4013093101,4984,1030,3225,388,53,115,15,33,3954
4013093104,5537,813,3533,860,95,85,11,19,4724
4013093105,5816,1112,3692,713,72,51,5,12,4704
4013093106,4459,655,3302,268,43,54,6,14,3804
4013093200,4211,1301,1851,585,107,144,10,21,2910
4013103205,2799,2293,269,10,3,72,3,3,506
4013103206,2433,2006,235,12,4,50,0,14,427
4013103207,2389,1993,183,32,14,46,2,8,396
4013103208,3995,3306,284,68,14,169,6,18,689
4013103209,5312,4420,353,63,11,204,8,25,892
4013103210,6470,4245,995,251,107,519,12,43,2225
4013103211,4342,3474,478,65,20,109,1,8,868
4013103212,4030,3380,329,22,12,123,5,16,650
4013103214,3759,3131,295,19,4,127,4,27,628
4013103215,3027,2355,228,59,19,200,9,14,672
4013103216,4992,3703,449,100,14,487,3,21,1289
4013103217,6244,4273,516,106,36,1054,2,27,1971
4013103219,3361,2714,271,42,7,183,1,12,647
4013103220,2951,2187,251,52,14,309,3,21,764
4013103302,6376,3652,2052,112,90,152,19,55,2724
4013103303,3646,2591,670,77,41,108,10,14,1055
4013103304,5174,1065,3502,243,68,146,5,19,4109
4013103305,3536,752,2602,39,33,27,1,12,2784
4013103306,4537,1285,2537,373,59,124,5,14,3252
4013103400,4617,3141,1074,47,38,76,25,16,1476
4013103501,3128,2010,733,115,26,129,1,17,1118
4013103502,6138,4398,1066,117,71,160,8,30,1740
4013103604,4544,2404,1342,163,53,383,0,31,2140
4013103605,6128,4925,613,69,19,176,6,43,1203
4013103606,4396,2834,990,107,37,232,6,12,1562
4013103607,4427,3193,658,81,58,184,6,40,1234
4013103608,4435,2035,822,286,75,952,9,22,2400
4013103609,5820,3092,1462,607,170,123,17,33,2728
4013103611,5240,3976,531,197,43,303,9,20,1264
4013103612,4995,3527,752,284,56,125,5,23,1468
4013103614,3077,2163,624,74,34,55,0,2,914
4013103615,5170,1496,2713,554,108,106,8,25,3674
4013103701,4895,2987,1126,259,79,207,8,36,1908
4013103702,3151,2034,717,125,47,78,4,26,1117
4013103900,6350,3059,2359,339,187,119,4,19,3291
4013104000,7434,3360,2524,627,190,301,28,72,4074
4013104100,7141,3768,2264,462,98,197,6,39,3373
4013104202,5361,3474,1239,190,47,142,12,17,1887
4013104203,6615,3367,2227,377,97,220,25,31,3248
4013104204,3535,2005,1066,155,28,138,7,9,1530
4013104205,5715,2471,1956,568,222,174,16,32,3244
4013104206,4240,1803,1790,231,78,138,7,33,2437
4013104207,4380,2845,898,208,43,189,3,12,1535
4013104212,6357,3675,1729,244,60,301,11,44,2682
4013104214,2167,1595,389,26,13,16,3,43,572
4013104215,4371,3106,812,112,45,88,2,13,1265
4013104216,4976,3339,952,210,55,161,17,11,1637
4013104217,5604,3696,1224,230,51,99,5,47,1908
4013104218,4293,2498,1069,248,92,168,1,19,1795
4013104219,3738,2315,900,194,51,88,23,31,1423
4013104221,6125,3532,1650,291,86,248,19,27,2593
4013104222,6058,3491,1613,409,66,140,7,41,2567
4013104223,1798,1270,282,40,9,96,1,17,528
4013104224,6118,3618,1355,420,75,343,5,37,2500
4013104225,3760,2693,663,99,52,53,12,8,1067
4013104226,4873,2981,1096,276,70,212,4,15,1892
4013104227,2350,1308,684,140,32,57,6,11,1042
4013104301,3805,1926,1482,107,19,102,0,2,1879
4013104302,3963,1912,1025,556,127,87,1,21,2051
4013104401,5144,2210,2002,494,137,97,17,10,2934
4013104402,2637,896,539,370,154,521,5,13,1741
4013104501,3972,1138,2152,404,98,34,2,28,2834
4013104502,5491,1137,3608,406,139,63,9,16,4354
4013104600,4065,1860,1647,248,79,60,0,31,2205
4013104701,2741,1619,757,174,48,28,0,14,1122
4013104702,4520,2028,1913,266,109,43,5,21,2492
4013104801,3747,2853,506,105,37,97,11,15,894
4013104802,5921,4598,693,163,45,126,3,25,1323
4013104900,4284,3321,512,63,19,113,2,11,963
4013105002,2608,2187,144,22,2,144,6,8,421
4013105003,4544,3630,266,20,3,413,2,18,914
4013105004,3026,2504,128,12,3,227,0,19,522
4013105101,4557,3797,329,44,10,132,1,28,760
4013105102,4851,3780,508,90,25,212,1,27,1071
4013105103,2905,2363,173,21,9,221,3,23,542
4013105200,5939,3344,1819,209,85,160,12,40,2595
4013105300,5224,3223,1415,234,35,89,6,22,2001
4013105400,3887,2706,691,174,66,72,1,35,1181
4013105501,2587,769,1133,319,130,106,1,14,1818
4013105502,1915,564,555,486,150,41,4,8,1351
4013105503,3835,1297,1273,743,195,63,6,30,2538
4013105601,4262,1187,2643,101,91,139,0,11,3075
4013105602,6810,2006,2472,1436,166,393,2,32,4804
4013105701,3605,1450,1522,209,64,199,16,10,2155
4013105702,4290,1401,2194,207,101,182,10,22,2889
4013105800,7245,2298,3706,374,97,511,18,37,4947
4013105900,5991,2222,2487,546,90,407,12,31,3769
4013106001,1843,549,926,214,68,16,1,7,1294
4013106002,3039,1121,1125,418,157,37,6,29,1918
4013106003,3628,1242,1614,390,121,105,1,14,2386
4013106100,5788,3748,1095,438,139,105,4,22,2040
4013106200,3498,2801,381,28,19,94,0,13,697
4013106300,5393,3756,851,261,118,124,5,26,1637
4013106400,2996,2079,499,91,69,82,7,21,917
4013106501,3346,2303,617,106,48,68,3,44,1043
4013106502,3652,2496,678,101,59,82,5,42,1156
4013106600,3916,2914,503,148,67,92,3,15,1002
4013106701,4556,1366,1169,1137,196,387,5,32,3190
4013106702,1277,738,290,79,55,43,0,14,539
4013106703,2234,1399,534,78,42,74,6,12,835
4013106801,4785,1085,2024,1016,174,273,10,37,3700
4013106802,3569,1419,1588,210,123,99,11,13,2150
4013106900,7793,1697,4711,393,123,684,10,27,6096
4013107001,4391,928,2723,274,69,276,4,7,3463
4013107002,4151,1020,2376,212,66,348,21,9,3131
4013107101,4505,764,3105,228,48,239,8,40,3741
4013107102,5963,719,4005,643,131,305,9,42,5244
4013107201,8139,3169,2757,740,493,467,31,63,4970
4013107202,5180,707,3747,254,85,264,11,20,4473
4013107300,6769,1584,3815,618,161,281,5,109,5185
4013107401,2726,1541,655,234,40,77,6,26,1185
4013107402,1496,402,799,162,40,39,0,4,1094
4013107403,2007,597,757,404,90,47,1,14,1410
4013107404,883,182,209,285,48,95,4,6,701
4013107500,3653,2779,490,99,25,81,0,17,874
4013107601,3332,2059,741,201,95,105,0,19,1273
4013107602,2650,1722,517,126,64,77,7,15,928
4013107700,4498,2961,765,231,132,168,1,20,1537
4013107800,2598,2261,155,37,3,72,5,14,337
4013107900,3682,2924,340,90,9,170,0,8,758
4013108000,3477,2926,235,19,13,137,1,8,551
4013108100,2329,1933,214,34,5,51,0,11,396
4013108200,3307,2562,434,74,16,76,3,18,745
4013108301,3661,2930,363,67,19,106,0,10,731
4013108302,3196,2374,492,85,31,71,1,14,822
4013108400,6054,3870,1258,310,106,217,6,33,2184
4013108501,2575,1395,738,151,50,110,0,14,1180
4013108502,3612,2291,696,172,43,230,8,11,1321
4013108601,2443,827,1127,180,127,49,4,17,1616
4013108602,6215,2805,2000,524,313,239,5,26,3410
4013108802,2073,1267,489,115,34,70,0,14,806
4013108901,2524,1245,821,195,75,56,10,17,1279
4013108902,5098,1919,1794,591,189,355,7,32,3179
4013109001,4379,562,2453,816,162,205,0,77,3817
4013109002,4165,826,2014,620,96,463,3,27,3339
4013109003,5677,859,3781,633,138,91,4,28,4818
4013109101,3425,390,2723,75,28,150,2,9,3035
4013109102,5645,616,4291,444,77,94,16,15,5029
4013109200,4338,715,2626,606,85,196,9,31,3623
4013109300,4767,426,3997,158,33,82,2,9,4341
4013109401,4422,407,3501,300,91,52,3,9,4015
4013109402,4049,636,3078,170,32,36,4,14,3413
4013109500,5432,769,4234,229,48,40,5,29,4663
4013109601,5240,609,4203,242,35,22,3,14,4631
4013109602,6567,622,5282,412,60,69,1,17,5945
4013109603,4780,536,3924,160,52,29,0,12,4244
4013109604,4188,438,3428,150,48,37,11,7,3750
4013109702,5288,592,4394,170,42,24,6,8,4696
4013109703,2973,258,2469,126,35,20,12,6,2715
4013109704,2401,235,2059,49,12,16,2,12,2166
4013109705,1889,161,1621,63,12,3,1,2,1728
4013109706,2486,157,2136,96,19,27,1,6,2329
4013109707,5280,395,3999,610,99,71,5,16,4885
4013109801,4344,339,3542,297,68,36,3,6,4005
4013109802,4913,500,4122,161,35,23,2,8,4413
4013109900,7653,574,6418,373,100,65,6,14,7079
4013110001,4620,363,4065,95,29,14,3,13,4257
4013110002,4467,435,3724,179,56,32,0,11,4032
4013110100,6730,425,5781,285,76,71,1,29,6305
4013110400,5239,2445,1906,306,139,169,1,48,2794
4013110501,4685,2447,1010,526,184,254,21,19,2238
4013110502,3203,1702,764,237,115,214,0,16,1501
4013110600,5003,2440,1736,271,159,131,0,34,2563
4013110701,2447,885,1171,146,80,73,0,9,1562
4013110702,4052,1554,1940,188,92,99,11,15,2498
4013110801,4699,1941,1833,417,176,99,26,31,2758
4013110802,2257,1248,747,75,33,45,4,9,1009
4013110901,3281,1916,878,229,29,77,8,15,1365
4013110902,4203,2136,1452,228,122,89,1,7,2067
4013111000,4749,3342,816,126,65,136,3,27,1407
4013111100,4660,3391,677,142,61,128,5,31,1269
4013111201,5701,2509,2114,509,160,132,6,33,3192
4013111202,2150,510,1125,256,118,44,10,15,1640
4013111203,1614,510,307,516,99,86,8,2,1104
4013111204,2454,947,710,373,143,115,14,22,1507
4013111300,5590,2523,2019,416,156,169,58,38,3067
4013111401,4405,794,3222,148,106,31,3,19,3611
4013111402,3956,1187,2044,374,113,92,27,18,2769
4013111501,2077,221,1692,64,31,10,0,16,1856
4013111502,6317,1320,4301,296,115,108,1,23,4997
4013111601,2956,771,1938,71,54,29,1,17,2185
4013111602,4569,800,3389,192,66,22,10,6,3769
4013111700,5203,2746,1790,179,62,143,4,26,2457
4013111800,4964,3380,822,214,117,195,3,29,1584
4013111900,2370,1625,504,39,16,54,3,18,745
4013112100,3729,229,3349,35,26,34,3,14,3500
4013112201,4363,306,3849,95,40,21,4,8,4057
4013112202,4375,546,3409,208,62,53,4,14,3829
4013112301,5197,337,4357,285,62,78,6,30,4860
4013112302,7063,690,5208,806,78,138,17,25,6373
4013112401,5581,434,4751,229,40,53,3,14,5147
4013112402,5167,329,4580,111,81,25,0,7,4838
4013112502,5294,380,4642,147,51,20,1,9,4914
4013112504,3909,290,3163,353,16,19,0,20,3619
4013112507,2554,183,1953,277,49,29,6,8,2371
4013112508,2862,265,2477,65,19,7,0,8,2597
4013112510,4681,540,3543,308,64,72,14,20,4141
4013112512,566,109,358,71,0,4,6,3,457
4013112514,5044,851,2733,994,74,241,6,21,4193
4013112515,4680,557,3330,560,58,53,9,23,4123
4013112516,4305,461,3267,361,43,57,0,24,3844
4013112517,5477,648,3859,558,75,157,19,15,4829
4013112518,4287,742,2784,431,26,150,35,28,3545
4013112519,4773,341,4174,106,48,17,6,5,4432
4013112520,4265,348,3503,213,38,67,13,11,3917
4013112521,3373,314,2258,492,104,78,19,26,3059
4013112522,4485,391,3838,177,17,27,0,10,4094
4013112523,4666,694,2435,1029,120,161,28,25,3972
4013112524,4925,756,2617,1101,156,78,47,22,4169
4013112601,3084,291,2349,275,63,53,1,10,2793
4013112602,7359,304,6812,133,41,10,4,28,7055
4013112700,6933,496,6036,213,57,39,0,47,6437
4013112900,4660,1783,2208,353,73,58,6,38,2877
4013113000,3531,2169,699,201,48,196,14,27,1362
4013113100,4996,2827,999,505,159,233,3,15,2169
4013113201,2314,435,1669,72,51,14,2,35,1879
4013113202,1706,425,1074,81,33,21,3,11,1281
4013113204,2695,755,1616,115,72,35,0,19,1940
4013113301,3915,649,2569,450,116,28,5,20,3266
4013113502,2881,164,2082,531,23,5,0,12,2717
4013113503,4543,519,3398,380,106,30,10,16,4024
4013113601,3912,814,2260,392,137,107,58,22,3098
4013113602,3988,387,2625,781,82,33,9,13,3601
4013113701,6353,1406,3069,1092,335,134,44,35,4947
4013113702,2082,575,859,489,24,80,0,8,1507
4013113800,3059,1037,1326,350,87,122,14,8,2022
4013113900,1527,247,865,281,60,21,4,15,1280
4013114000,2306,927,785,332,26,129,3,14,1379
4013114100,3294,1523,788,665,152,73,0,15,1771
4013114200,1075,178,781,76,8,7,0,0,897
4013114301,1189,472,348,263,56,12,3,4,717
4013114302,2965,247,1630,867,59,62,15,19,2718
4013114401,1778,108,1485,134,11,7,0,5,1670
4013114402,2095,358,1496,150,41,7,0,1,1737
4013114500,4071,263,3609,98,13,21,0,6,3808
4013114600,1988,155,1717,67,15,7,4,5,1833
4013114704,1761,268,1325,86,73,5,0,0,1493
4013114705,4360,2776,510,810,217,1,1,2,1584
4013114800,3459,227,2745,346,36,28,0,5,3232
4013114900,2771,241,1906,368,53,138,2,6,2530
4013115200,3227,403,1778,574,127,42,202,29,2824
4013115300,2821,289,1800,604,19,9,9,8,2532
4013115400,1995,161,1689,84,23,7,2,8,1834
4013115500,3894,440,3259,76,45,24,5,12,3454
4013115600,4481,325,2956,917,49,102,2,32,4156
4013115700,6779,448,5617,417,83,68,5,22,6331
4013115801,4054,301,3019,480,134,27,1,8,3753
4013115802,3674,294,2902,366,33,14,11,4,3380
4013115900,5860,622,4110,822,76,95,16,22,5238
4013116000,6765,1048,3326,1796,112,284,3,22,5717
4013116100,4902,485,2908,1089,88,135,29,14,4417
4013116202,5126,905,3411,443,97,100,39,11,4221
4013116203,6261,2162,2067,1106,158,410,78,43,4099
4013116204,3728,751,2377,271,104,71,20,20,2977
4013116205,4394,1214,2092,638,120,113,27,25,3180
4013116300,6155,632,3820,1358,96,75,10,28,5523
4013116400,5666,650,4123,647,42,58,6,17,5016
4013116500,4953,370,4094,345,51,19,10,6,4583
4013116605,7187,1233,3447,1510,135,420,21,63,5954
4013116606,6682,938,3815,1250,93,290,34,42,5744
4013116607,4338,557,2383,934,74,203,7,32,3781
4013116610,6912,1406,3132,1498,146,428,35,42,5506
4013116611,3929,1296,1790,449,60,154,12,21,2633
4013116612,7130,1584,3353,1342,147,371,13,49,5546
4013116614,3766,465,2516,515,46,118,5,31,3301
4013116615,4546,319,3122,812,66,87,14,18,4227
4013116616,4942,1055,2522,784,139,237,13,17,3887
4013116617,3391,980,1677,401,12,144,8,40,2411
4013116618,5073,1017,2548,999,93,190,20,22,4056
4013116619,4567,1158,2111,821,68,224,14,29,3409
4013116620,8015,1660,3954,1598,140,319,28,50,6355
4013116621,5456,1047,2467,1257,95,310,12,46,4409
4013116703,5194,1314,2701,741,57,165,4,30,3880
4013116707,2730,2011,428,47,26,68,4,25,719
4013116708,5370,3860,699,320,100,172,9,19,1510
4013116709,2543,1207,604,275,113,174,16,17,1336
4013116710,4728,3591,517,82,27,241,8,24,1137
4013116711,2052,1030,424,244,136,80,6,20,1022
4013116712,7907,4261,1585,641,194,703,13,52,3646
4013116713,5996,3935,902,306,113,419,14,26,2061
4013116714,3382,2153,549,141,29,321,1,15,1229
4013116715,1984,1355,379,76,22,62,10,3,629
4013116717,3404,1475,722,540,302,163,6,10,1929
4013116718,2795,1469,561,340,150,139,10,14,1326
4013116719,6689,3755,1204,458,97,796,2,50,2934
4013116720,3892,2301,706,305,143,168,37,21,1591
4013116721,3588,2548,469,100,31,216,2,20,1040
4013116725,5035,3354,737,295,56,338,9,12,1681
4013116727,4095,2868,508,173,7,280,0,19,1227
4013116728,4792,3360,526,190,25,375,2,30,1432
4013116729,4008,3016,444,79,19,250,8,9,992
4013116730,1974,1222,315,106,6,208,2,18,752
4013116731,3629,2428,583,158,25,216,5,13,1201
4013116732,4376,1226,2480,314,92,98,12,29,3150
4013116733,11,6,2,0,0,0,0,0,5
4013116734,1748,362,1086,187,32,22,3,14,1386
4013116735,3923,471,2863,416,68,35,9,7,3452
4013116736,3154,445,2105,417,77,29,9,6,2709
4013116737,3428,1312,1117,628,44,166,21,24,2116
4013116738,6273,2750,1774,770,77,558,7,39,3523
4013116800,2559,859,1486,87,37,26,4,6,1700
4013116900,2493,328,2011,71,42,15,0,10,2165
4013117000,6234,1567,3003,944,138,388,1,23,4667
4013117100,2986,1560,812,224,123,100,3,31,1426
4013117200,949,89,773,32,21,4,2,5,860
4013117300,1924,146,1393,310,15,4,1,14,1778
4013216806,3106,2611,230,16,13,98,7,15,495
4013216807,5140,4340,355,38,7,195,7,8,800
4013216809,4890,3903,301,79,15,370,0,22,987
4013216810,1567,1285,114,14,1,81,0,8,282
4013216813,4443,3830,270,57,4,139,3,19,613
4013216816,6861,5602,429,115,16,360,3,38,1259
4013216819,6020,5349,298,39,15,129,2,23,671
4013216820,4356,3756,267,48,25,96,1,21,600
4013216821,5952,5287,265,67,7,148,2,17,665
4013216822,4448,4011,170,39,1,95,4,18,437
4013216826,4727,3883,318,66,14,252,1,23,844
4013216829,5320,4798,191,68,4,146,2,15,522
4013216830,3238,2363,343,124,21,199,2,24,875
4013216831,2896,2412,178,23,5,137,1,13,484
4013216832,2447,2179,110,25,1,74,0,0,268
4013216833,4808,3771,349,73,18,410,0,16,1037
4013216834,2345,2035,157,11,1,73,0,7,310
4013216835,2782,2314,202,33,18,104,9,10,468
4013216836,3690,3018,266,49,15,162,5,7,672
4013216837,5344,3745,551,177,39,529,12,15,1599
4013216838,4907,3728,389,54,24,473,2,20,1179
4013216839,4176,3481,248,44,7,276,1,12,695
4013216840,4775,4046,274,57,3,225,6,9,729
4013216841,4355,3641,279,67,4,221,0,14,714
4013216842,3461,2900,207,33,3,161,0,23,561
4013216843,3592,3254,124,43,4,74,0,10,338
4013216844,4228,3558,237,94,16,209,5,4,670
4013216845,3449,2367,234,123,3,437,9,141,1082
4013216849,6263,5207,314,33,1,424,0,31,1056
4013216850,4190,3057,345,147,29,429,9,22,1133
4013216851,4593,4048,212,28,7,141,0,30,545
4013216852,3001,2247,272,104,12,221,3,11,754
4013216853,4870,3587,371,93,6,577,2,19,1283
4013216854,4356,3456,320,63,3,327,0,15,900
4013216855,3890,3287,231,20,8,198,1,21,603
4013216856,2819,2470,122,30,18,80,0,4,349
4013216857,4673,4014,290,81,35,97,4,23,659
4013216858,0,0,0,0,0,0,0,0,0
4013216859,6531,5166,364,72,9,665,0,22,1365
4013216860,2246,1654,209,30,0,254,0,5,592
4013216861,4279,3541,224,45,11,253,0,13,738
4013216901,3544,2960,278,43,11,127,4,11,584
4013216902,3843,3033,413,80,22,103,0,11,810
4013217001,4305,3697,317,51,22,102,5,15,608
4013217002,5307,4226,608,53,26,118,11,24,1081
4013217101,2627,2030,355,21,29,68,3,12,597
4013217102,2746,2153,276,52,23,77,9,11,593
4013217201,2451,1885,215,105,18,109,0,14,566
4013217203,3376,2773,275,78,12,117,4,13,603
4013217204,2987,1918,636,133,69,99,4,13,1069
4013217300,4781,3950,295,82,5,203,5,27,831
4013217400,3301,2607,343,64,13,87,0,14,694
4013217501,3093,1423,1246,124,101,82,10,17,1670
4013217502,3629,2545,580,141,37,137,3,21,1084
4013217600,5036,3304,1049,171,109,158,12,22,1732
4013217700,4750,3605,621,70,30,157,7,32,1145
4013217800,6047,4265,1109,176,104,139,9,15,1782
4013217900,3682,2630,590,112,40,141,8,17,1052
4013218000,5613,3603,1223,238,120,171,6,38,2010
4013218100,1973,1191,533,50,45,72,1,5,782
4013218200,6897,3842,1981,272,191,264,12,34,3055
4013218300,4616,3193,738,210,83,198,0,27,1423
4013318400,5840,2806,1797,270,155,453,12,25,3034
4013318501,3317,1946,859,99,71,126,26,16,1371
4013318700,5937,3381,1059,384,69,680,10,39,2556
4013318800,7468,3780,1768,612,272,593,28,56,3688
4013318900,6427,3785,1456,383,143,280,29,18,2642
4013319001,2731,1646,510,125,23,303,3,4,1085
4013319002,4058,2448,795,177,50,363,8,25,1610
4013319101,4634,2256,705,238,65,1145,2,25,2378
4013319103,5390,2214,770,321,83,1748,18,38,3176
4013319104,7240,2874,1325,420,148,2111,21,25,4366
4013319201,7038,2642,2472,663,188,615,64,25,4396
4013319202,3680,1770,741,413,130,324,9,30,1910
4013319300,2425,932,881,169,77,230,13,20,1493
4013319401,6404,3830,1289,356,130,387,34,33,2574
4013319402,4085,2710,772,141,61,173,2,27,1375
4013319403,4709,2639,1053,388,180,182,16,41,2070
4013319404,3750,2879,470,99,47,126,5,10,871
4013319500,6177,3736,1165,318,136,446,14,32,2441
4013319600,5632,3524,980,177,99,464,48,33,2108
4013319705,3297,1645,1015,200,146,109,18,15,1652
4013319706,5644,1538,2764,431,221,461,18,22,4106
4013319707,2,0,2,0,0,0,0,0,2
4013319708,4025,1967,1168,301,120,294,6,18,2058
4013319709,0,0,0,0,0,0,0,0,0
4013319710,2670,1367,645,209,67,203,21,18,1303
4013319801,3513,1557,922,528,114,150,32,28,1956
4013319802,3321,1726,816,324,87,118,38,15,1595
4013319902,2762,1568,679,178,66,119,6,24,1194
4013319903,5675,3726,935,264,124,289,4,28,1949
4013319904,4928,3303,975,149,56,179,15,18,1625
4013319905,4827,3178,969,162,62,194,17,15,1649
4013319906,3349,2293,477,148,46,234,10,19,1056
4013319907,2155,1630,260,43,12,123,0,16,525
4013319908,2258,1248,561,130,93,87,15,6,1010
4013319909,2312,1687,291,58,22,146,3,8,625
4013319910,4587,2875,577,155,38,682,3,20,1712
4013320001,7287,2762,1776,1052,471,767,43,46,4525
4013320002,5322,198,3124,123,1760,42,6,25,5124
4013320007,6643,2572,1948,739,332,642,52,32,4071
4013320100,3591,2210,681,155,69,264,6,11,1381
4013420104,5447,4315,739,87,35,73,5,28,1132
4013420105,6299,4944,784,87,57,124,19,28,1355
4013420107,6775,5544,579,121,16,221,9,0,1231
4013420108,1596,1329,121,19,4,42,1,14,267
4013420109,5598,4469,577,98,42,128,5,24,1129
4013420110,5799,4727,682,48,45,94,4,7,1072
4013420111,4082,2626,1198,32,33,37,7,25,1456
4013420112,3342,2447,622,62,18,47,9,23,895
4013420113,3758,2324,745,357,49,54,22,18,1434
4013420114,4009,2219,1415,59,49,96,10,25,1790
4013420115,3169,1861,1050,59,30,37,8,13,1308
4013420116,3004,2368,447,33,26,30,2,11,636
4013420202,5307,3804,945,153,58,100,6,33,1503
4013420206,3726,3215,270,68,33,14,0,29,511
4013420207,2768,2316,241,28,20,65,0,1,452
4013420208,5614,3601,1416,122,61,117,26,25,2013
4013420209,4220,3243,631,86,23,70,11,24,977
4013420210,5328,3958,866,127,34,58,3,23,1370
4013420211,4380,3340,642,54,49,79,3,25,1040
4013420212,2957,2353,336,39,25,71,1,9,604
4013420213,1382,1300,29,6,8,4,0,0,82
4013420214,4363,3046,777,231,32,104,0,18,1317
4013420215,3114,2036,691,71,38,97,22,23,1078
4013420216,4264,3306,527,87,50,92,7,16,958
4013420301,2250,1706,302,31,30,87,2,17,544
4013420302,4778,3760,543,80,52,107,17,20,1018
4013420303,4314,2948,945,75,34,106,9,30,1366
4013420304,1149,926,105,8,6,62,0,12,223
4013420401,4574,1842,2138,133,272,49,0,7,2732
4013420402,4862,3775,559,70,59,223,6,4,1087
4013420503,3428,1725,1073,257,156,65,10,24,1703
4013420504,3438,2043,954,120,63,87,7,17,1395
4013420505,3235,1179,1521,117,173,77,18,28,2056
4013420506,3636,1445,1432,265,233,62,22,15,2191
4013420602,4937,3416,1107,70,73,67,43,19,1521
4013420603,3972,2988,590,77,69,38,30,24,984
4013420604,4658,3526,755,46,52,59,9,37,1132
4013420704,5060,3499,967,202,62,77,22,23,1561
4013420705,3693,2912,367,51,22,203,6,11,781
4013420706,5096,3656,805,82,59,195,25,34,1440
4013420707,2397,1795,292,139,41,28,3,13,602
4013420708,3688,2533,726,221,56,18,11,6,1155
4013420709,2925,2289,329,103,44,41,0,4,636
4013420710,3354,1914,984,173,36,98,7,13,1440
4013420800,5275,2932,1755,164,74,68,39,25,2343
4013420901,3676,1495,1552,230,210,25,17,12,2181
4013420902,3492,1982,1154,117,48,30,13,15,1510
4013421001,4125,2155,1347,262,166,32,27,13,1970
4013421002,3208,1517,1016,360,112,38,10,8,1691
4013421101,4713,2117,1859,202,225,102,11,34,2596
4013421102,5988,3041,1953,388,269,62,21,53,2947
4013421201,4837,2568,1179,259,172,360,20,15,2269
4013421202,3990,1942,1479,171,123,89,5,21,2048
4013421302,6346,1881,3442,443,187,136,38,17,4465
4013421303,5610,1966,2606,305,200,197,26,28,3644
4013421304,3343,1268,1079,383,267,178,7,7,2075
4013421400,2793,1551,846,165,52,42,8,14,1242
4013421501,3980,1159,2454,145,63,27,9,20,2821
4013421502,3506,1206,1984,125,49,36,4,23,2300
4013421601,3460,1325,1826,110,50,23,21,23,2135
4013421602,4398,1036,3021,122,69,27,30,6,3362
4013421701,4947,2267,1727,398,168,84,34,35,2680
4013421702,3822,1704,1764,133,61,40,13,13,2118
4013421801,2719,905,1575,69,22,25,6,19,1814
4013421802,4942,1374,3114,161,57,35,54,17,3568
4013421901,4023,967,2742,93,66,47,13,17,3056
4013421902,6188,995,4816,126,85,60,24,14,5193
4013422001,3994,567,3110,83,83,37,10,12,3427
4013422002,3970,950,2660,131,78,19,14,24,3020
4013422102,4408,1475,2308,173,141,131,11,12,2933
4013422103,5294,2008,1478,687,550,179,87,44,3286
4013422104,6024,2480,2026,474,296,356,77,42,3544
4013422105,3165,1096,1589,146,87,117,10,25,2069
4013422106,5947,2018,2508,659,318,108,39,41,3929
4013422107,4292,1643,1388,559,326,117,15,37,2649
4013422203,5759,2720,1621,527,312,209,36,48,3039
4013422209,7386,3597,1986,738,253,355,8,44,3789
4013422210,5417,3355,1338,154,67,214,16,22,2062
4013422211,2672,1880,434,59,13,154,0,19,792
4013422212,4265,3143,559,112,22,193,8,23,1122
4013422213,2527,1615,577,55,61,72,10,9,912
4013422215,2158,1166,597,126,49,100,8,31,992
4013422216,6000,3755,1200,278,137,316,25,28,2245
4013422217,3607,2152,882,196,76,126,1,8,1455
4013422218,3016,1773,755,127,53,121,9,14,1243
4013422219,3059,1763,697,190,80,131,8,21,1296
4013422220,2054,1405,323,67,21,107,2,6,649
4013422221,4292,2557,1006,214,107,166,21,18,1735
4013422222,2185,1460,425,89,29,78,14,5,725
4013422223,3210,1841,674,275,129,91,21,13,1369
4013422224,0,0,0,0,0,0,0,0,0
4013422225,0,0,0,0,0,0,0,0,0
4013422226,0,0,0,0,0,0,0,0,0
4013422227,1436,934,313,34,23,30,8,9,502
4013422301,6454,1948,3579,292,162,162,54,20,4506
4013422302,5041,2795,1593,141,102,120,9,29,2246
4013422304,2935,1469,737,303,77,173,8,3,1466
4013422305,5935,3910,834,233,55,551,15,19,2025
4013422307,4400,2529,1010,260,71,293,22,8,1871
4013422308,5513,3410,1226,152,50,410,21,26,2103
4013422309,5662,3243,1140,220,53,651,31,42,2419
4013422401,3850,2322,943,145,50,142,4,14,1528
4013422402,4735,3009,1149,126,71,119,11,15,1726
4013422403,5245,3368,1138,173,36,267,5,27,1877
4013422404,4737,3287,855,141,26,145,15,18,1450
4013422501,6078,3580,1897,164,71,79,4,36,2498
4013422502,5925,3454,1727,219,98,131,63,29,2471
4013422503,6792,3445,2434,236,144,129,49,25,3347
4013422504,4927,3201,1037,191,98,179,7,19,1726
4013422506,5094,3551,876,141,46,168,20,28,1543
4013422507,4406,3310,537,65,47,208,10,24,1096
4013422508,3680,2573,740,86,43,72,5,23,1107
4013422509,5399,3565,993,166,77,251,10,21,1834
4013422510,3474,2499,564,62,15,163,4,12,975
4013422511,3181,2201,584,74,39,132,4,8,980
4013422512,4984,3398,942,115,31,239,4,29,1586
4013422513,4441,3314,763,115,26,58,11,15,1127
4013422514,4933,3074,1139,244,46,192,10,9,1859
4013422607,4499,3866,329,129,29,54,0,14,633
4013422609,4276,2905,1006,89,46,76,5,11,1371
4013422610,3139,2841,176,32,7,15,3,9,298
4013422615,6986,4752,1271,264,102,227,32,26,2234
4013422617,6141,4177,1236,148,71,156,48,33,1964
4013422618,2984,2870,61,10,3,16,0,0,114
4013422620,3261,2339,503,90,23,153,8,10,922
4013422621,4933,3361,857,125,35,308,11,8,1572
4013422622,4229,2983,717,124,39,181,9,29,1246
4013422623,8259,5649,1258,310,60,597,7,28,2610
4013422624,2404,2152,125,43,15,14,2,2,252
4013422625,4405,3039,1002,125,41,47,6,16,1366
4013422626,2719,2235,351,32,17,19,0,3,484
4013422627,3576,2079,1243,40,34,27,16,23,1497
4013422628,4065,2266,1243,201,77,44,5,19,1799
4013422629,3577,2319,835,113,70,40,17,27,1258
4013422630,4783,3055,1399,47,51,35,14,5,1728
4013422632,4098,2949,833,79,47,55,7,12,1149
4013422633,3075,1795,674,181,52,197,4,7,1280
4013422634,5457,2991,2022,88,41,89,7,19,2466
4013422636,3267,2019,654,168,55,193,24,17,1248
4013422637,3597,2496,694,107,45,70,4,12,1101
4013422638,4260,2460,978,245,56,229,34,34,1800
4013422639,3687,3335,135,55,8,77,4,5,352
4013422640,5077,3568,839,157,49,166,31,18,1509
4013422642,5886,4185,976,221,28,206,7,33,1701
4013422643,5862,4065,1150,127,47,138,14,22,1797
4013422647,9208,6271,1478,369,26,483,18,25,2937
4013422648,5827,3971,937,185,32,326,32,39,1856
4013422649,6397,4367,1261,207,51,190,20,12,2030
4013422650,2900,2318,382,44,4,43,14,4,582
4013422651,5260,3612,889,217,30,245,3,12,1648
4013422652,2781,2662,64,7,3,11,0,5,119
4013422653,4602,3040,1060,127,71,124,8,18,1562
4013422654,5858,3897,1139,142,43,226,41,26,1961
4013422655,3529,2240,817,129,26,88,16,16,1289
4013422656,5166,4064,466,60,8,330,14,21,1102
4013422657,4482,3333,622,52,23,226,13,27,1149
4013422658,3652,2509,441,85,8,392,0,11,1143
4013422659,1890,1379,294,96,17,26,7,11,511
4013422660,4871,3213,1016,195,30,149,22,6,1658
4013522801,5,0,3,0,1,0,0,0,5
4013522802,1289,518,291,227,49,105,3,2,771
4013522901,5029,2574,1303,438,104,350,23,30,2455
4013522903,5123,858,3707,287,51,109,6,11,4265
4013522904,5070,1195,3002,281,95,342,5,11,3875
4013523002,5970,1639,3661,234,85,134,9,27,4331
4013523005,5041,2955,1091,202,73,419,10,25,2086
4013523006,5689,2770,1850,298,93,393,9,25,2919
4013523007,3379,1359,1402,207,70,174,2,15,2020
4013523008,3520,1625,1242,188,49,214,9,6,1895
4013523102,5752,1590,2834,583,120,309,32,16,4162
4013523103,6567,3199,1402,642,180,728,18,26,3368
4013523104,6782,2474,2796,572,137,487,24,30,4308
4013610001,2404,2027,196,22,22,34,2,8,377
4013610002,6672,4602,1075,308,188,203,19,13,2070
4013610100,696,539,103,4,7,19,0,4,157
4013610201,4325,3670,322,65,27,62,2,12,655
4013610202,3795,3291,222,43,8,104,1,24,504
4013610301,3956,3024,465,108,20,125,1,16,932
4013610302,5438,4212,562,118,30,121,12,36,1226
4013610400,5676,4433,657,97,5,147,15,21,1243
4013610500,7316,6247,600,45,32,85,8,28,1069
4013610600,6367,4862,712,202,17,175,25,55,1505
4013610700,7705,6629,660,54,25,44,8,31,1076
4013610800,6842,4980,767,195,31,533,5,29,1862
4013610901,5541,4109,676,90,23,364,4,28,1432
4013610902,5035,3422,662,132,21,514,11,15,1613
4013610903,3818,2942,413,72,12,198,3,20,876
4013611000,3187,2394,369,58,12,202,3,25,793
4013611100,3943,2941,462,80,20,236,5,18,1002
4013611200,6566,4854,821,125,23,399,14,11,1712
4013611300,7346,5142,833,309,79,518,14,43,2204
4013611400,6675,5054,684,132,20,467,8,21,1621
4013611500,7896,5161,722,205,27,1331,7,39,2735
4013611600,3099,2364,386,35,16,182,4,12,735
4013611700,6545,5090,656,145,33,356,3,27,1455
4013611800,6761,5229,930,93,47,109,4,47,1532
4013611900,3238,2285,479,89,23,200,3,7,953
4013612000,4400,3407,427,126,11,222,5,17,993
4013612200,6533,4518,612,124,38,886,7,33,2015
4013612301,4031,2583,403,195,53,589,1,53,1448
4013612302,4950,3303,508,153,17,764,4,4,1647
4013612401,4496,3418,461,78,2,284,4,26,1078
4013612402,4190,3001,406,59,0,494,1,31,1189
4013612500,4440,3878,286,27,11,91,3,7,562
4013612600,2397,2064,187,15,3,62,0,4,333
4013612700,2239,1913,147,20,8,54,5,7,326
4013612800,2444,1998,181,33,3,105,0,11,446
4013612900,2618,2183,229,18,6,68,1,11,435
4013613000,6109,5173,336,54,12,224,4,28,936
4013613100,2893,2664,96,23,5,38,3,12,229
4013613200,3762,3256,229,30,28,67,4,21,506
4013613300,6892,5596,536,103,15,295,7,41,1296
4013613400,3870,3156,398,81,20,49,4,12,714
4013613500,4321,3167,569,170,18,185,20,16,1154
4013613601,4128,2959,606,77,22,300,2,5,1169
4013613602,5831,3829,704,105,13,914,7,10,2002
4013613700,5646,4253,751,122,16,240,6,16,1393
4013613800,4199,3273,516,73,10,140,1,23,926
4013613900,6253,4733,736,132,21,326,5,43,1520
4013614000,4270,3274,546,53,28,163,11,13,996
4013614100,6700,4712,835,173,30,673,12,20,1988
4013614200,4732,3565,490,113,21,339,2,17,1167
4013614300,3023,2265,273,32,10,324,6,15,758
4013614400,4016,2594,874,112,37,196,12,22,1422
4013614500,4696,2958,1155,91,47,216,3,38,1738
4013614601,3521,2317,591,154,52,180,11,22,1204
4013614602,3102,1897,614,157,35,209,14,19,1205
4013614700,3094,1842,570,261,62,113,6,10,1252
4013614800,4194,2760,770,96,66,306,13,15,1434
4013614900,4213,3035,486,146,29,326,0,27,1178
4013615001,5840,4287,350,105,7,803,6,17,1553
4013615002,5033,3727,423,101,9,513,2,22,1306
4013615100,4714,3496,365,107,8,494,0,17,1218
4013615201,5839,3940,599,208,33,706,6,158,1899
4013615202,3854,3077,287,83,3,252,0,18,777
4013615300,2085,1765,211,14,16,23,4,4,320
4013615400,2756,2559,85,21,5,26,0,3,197
4013615500,2988,2785,84,37,4,33,0,4,203
4013615600,3891,3302,288,87,15,99,5,3,589
4013615700,3073,2292,382,115,7,148,2,15,781
4013615800,5088,3770,619,186,30,251,0,35,1318
4013615900,4328,3060,565,121,14,323,0,14,1268
4013616000,2408,1593,315,58,27,287,7,12,815
4013616100,3905,2721,672,120,34,128,4,18,1184
4013616200,3353,2334,610,116,15,120,2,11,1019
4013616300,2125,1542,367,39,7,80,3,7,583
4013616400,6300,3519,675,140,61,1622,4,63,2781
4013616500,3838,2358,887,164,69,126,20,30,1480
4013616600,5698,3712,1377,179,63,129,6,22,1986
4013616700,5315,3628,987,169,50,195,16,40,1687
4013616800,5865,3911,1414,133,39,92,27,18,1954
4013616900,4396,2981,622,220,73,307,3,17,1415
4013617001,8,5,2,1,0,0,0,0,3
4013617002,6177,4037,1388,155,38,297,8,17,2140
4013617100,2275,1732,268,56,3,95,2,17,543
4013617200,2521,1899,264,48,7,158,1,14,622
4013617300,3018,2068,332,77,10,379,2,11,950
4013617400,7573,6280,639,197,40,145,3,29,1293
4013617500,3977,3423,263,84,10,75,0,16,554
4013617600,6285,4551,968,216,52,205,8,32,1734
4013617700,3473,2049,698,322,38,182,18,17,1424
4013617800,2661,2122,328,28,9,66,2,7,539
4013617900,2742,2088,314,51,28,141,2,4,654
4013618000,4476,3172,724,106,22,194,16,18,1304
4013618100,4415,3300,632,92,38,96,2,21,1115
4013618200,3928,2652,782,149,38,88,6,11,1276
4013618300,3119,2240,569,61,33,41,2,9,879
4013618400,4022,2501,1059,127,51,89,0,25,1521
4013618500,4026,2295,1018,321,83,68,7,23,1731
4013618600,4938,2806,1360,250,49,204,11,37,2132
4013618700,3005,1581,1097,64,38,90,0,19,1424
4013618800,5349,2280,2000,598,128,55,40,32,3069
4013618900,6858,4292,1491,381,116,239,6,35,2566
4013619000,3068,2291,381,119,21,107,9,17,777
4013619100,3893,1862,993,611,65,116,16,39,2031
4013619200,6078,3064,1542,607,139,395,16,30,3014
4013619300,4666,2648,1413,184,58,177,5,15,2018
4013619400,4884,2463,1551,308,76,252,3,19,2421
4013619500,5561,3172,1669,187,68,202,3,30,2389
4013619601,0,0,0,0,0,0,0,0,0
4013619602,1906,1343,376,25,13,46,0,11,563
4013619700,3404,2333,599,93,21,150,4,8,1071
4013619800,4774,2894,534,108,24,1023,6,20,1880
4013619900,6066,4107,417,67,36,1223,3,26,1959
4013723304,6439,3555,2498,88,61,37,3,44,2884
4013723305,2486,410,1587,8,412,14,0,1,2076
4013723306,4662,1669,2212,517,229,18,4,4,2993
4013723307,2146,1527,329,106,3,58,7,11,619
4013723309,3035,2079,625,120,28,59,3,23,956
4013723310,2909,2060,419,153,24,92,0,22,849
4013723311,5781,3883,1187,307,12,104,8,33,1898
4013810000,3251,1701,501,254,41,555,6,24,1550
4013810100,6352,4555,698,113,34,637,6,33,1797
4013810200,3546,1890,573,198,71,607,19,9,1656
4013810300,5954,3482,1069,267,74,762,20,30,2472
4013810400,5413,2974,917,404,118,692,16,34,2439
4013810500,5118,2845,808,228,62,875,0,20,2273
4013810600,6794,3953,1049,284,132,974,14,26,2841
4013810700,7543,3946,1471,646,210,812,32,42,3597
4013810800,4365,2299,757,178,100,819,6,19,2066
4013810900,5752,3531,1069,258,91,561,11,18,2221
4013811000,2793,1852,534,78,26,145,3,6,941
4013811100,3673,1897,885,296,88,326,5,9,1776
4013811200,3511,1597,852,357,114,392,21,13,1914
4013811300,3026,1700,651,150,30,327,4,13,1326
4013811400,5325,3219,1029,259,55,470,10,46,2106
4013811500,2892,1639,456,161,28,477,9,11,1253
4013811600,4450,2615,1038,169,33,415,1,17,1835
4013811700,4646,2569,1300,204,54,255,21,21,2077
4013811800,1910,1023,159,82,1,548,2,19,887
4013811900,5838,3469,926,307,71,734,15,18,2369
4013812000,4939,2036,1751,326,77,507,10,14,2903
4013812100,7106,3662,1453,643,110,786,8,50,3444
4013812200,7700,3948,1280,375,97,1557,16,54,3752
4013812300,4961,2781,714,301,82,845,11,18,2180
4013812400,7909,4189,1274,594,79,1342,6,17,3720
4013812500,2232,1279,303,105,7,407,17,13,953
4013812600,6396,4022,898,336,74,725,13,60,2374
4013812700,6773,3766,871,347,59,1358,14,43,3007
4013812801,3303,1821,413,98,13,741,13,22,1482
4013812802,6012,3123,761,296,15,1470,6,28,2889
4013812900,3363,1898,339,101,25,846,0,21,1465
4013813000,6077,3856,512,122,17,1315,5,10,2221
4013813100,3708,1984,428,97,18,1012,5,15,1724
4013813200,4852,2774,626,181,7,1015,9,23,2078
4013813300,6713,4207,780,236,19,1163,6,19,2506
4013813400,4825,2863,774,291,31,567,0,29,1962
4013813500,3905,2422,523,142,15,605,11,19,1483
4013813600,4786,3210,596,151,7,570,4,8,1576
4013813700,2510,2346,64,32,5,13,1,8,164
4013813800,2913,2700,72,40,7,39,3,6,213
4013813900,6104,3883,1131,289,80,348,10,28,2221
4013814000,2736,2334,178,59,22,61,1,10,402
4013814100,6160,3890,1141,383,41,317,5,28,2270
4013814200,2703,1798,342,109,17,273,2,10,905
4013814300,4595,2954,882,141,48,347,4,18,1641
4013814400,5533,3632,1035,187,36,349,14,17,1901
4013814500,5232,3527,974,172,52,217,11,8,1705
4013814600,5755,3607,1249,252,68,228,8,37,2148
4013814700,4576,3269,721,119,25,209,3,15,1307
4013814801,3629,2287,602,207,40,249,14,14,1342
4013814802,6047,3508,1186,537,34,368,14,24,2539
4013814900,3143,2190,538,84,19,154,10,16,953
4013815000,4236,3111,614,69,16,241,0,13,1125
4013815100,5506,3475,1080,183,40,378,16,30,2031
4013815201,5551,3378,1081,312,62,346,23,37,2173
4013815202,3341,1980,616,197,16,306,7,8,1361
4013815203,3778,2464,529,232,23,342,2,17,1314
4013815300,4031,2877,438,115,16,344,7,17,1154
4013815401,3849,2929,402,99,13,250,6,12,920
4013815402,6512,3854,1109,311,51,763,36,41,2658
4013815501,4502,2898,705,198,46,379,6,17,1604
4013815502,2640,1639,481,180,27,144,3,21,1001
4013815601,1246,848,171,36,9,100,1,3,398
4013815602,5736,3717,1029,265,32,362,17,27,2019
4013815700,5644,3640,1111,235,58,271,9,30,2004
4013815800,6465,4373,1096,283,47,275,7,31,2092
4013815901,6438,3723,893,234,53,1205,5,27,2715
4013815902,5394,3643,716,149,33,627,1,13,1751
4013816001,4030,2821,605,92,1,318,0,10,1209
4013816002,3964,2824,562,97,7,266,3,17,1140
4013816003,2643,1669,302,85,7,457,0,17,974
4013816004,6839,4371,1156,263,26,596,20,31,2468
4013816005,4670,3135,705,217,17,333,12,30,1535
4013816100,7437,5142,1377,216,50,269,12,50,2295
4013816200,4059,2642,716,208,38,175,24,22,1417
4013816301,3085,2899,78,28,4,36,0,6,186
4013816302,4315,2902,624,117,15,411,6,12,1413
4013816401,3912,2607,632,160,27,231,11,25,1305
4013816402,4878,3448,685,198,20,207,13,50,1430
4013816501,2220,1741,243,48,5,64,5,18,479
4013816502,2318,1687,427,53,3,40,1,12,631
4013816600,5354,3867,831,165,21,207,7,25,1487
4013816700,2634,1874,445,60,15,102,5,6,760
4013816800,7767,5605,1275,203,68,184,21,26,2162
4013816901,5903,4093,1053,233,33,145,16,14,1810
4013816902,2514,1944,322,55,16,49,3,4,570
4013816903,3039,2106,553,108,22,66,12,16,933
4013816904,3310,2386,545,81,32,82,0,8,924
4013817000,3955,3060,516,104,23,108,8,4,895
4013817101,3591,2606,605,106,21,71,3,22,985
4013817102,3286,1942,808,231,45,85,0,7,1344
4013817103,5401,3718,1139,168,24,103,3,51,1683
4013817200,7797,5650,1577,140,32,80,5,33,2147
4013817300,5561,5265,90,63,5,64,7,7,296
4013817400,3070,2809,127,33,13,32,3,5,261
4013817500,2847,2650,74,45,4,25,1,5,197
4013817600,6885,4846,1119,225,31,343,8,25,2039
4013940700,88,0,2,0,85,0,0,0,88
4013941000,3540,37,469,9,2968,0,0,5,3503
4013941100,43,6,10,0,21,0,0,0,37
4013941200,1152,70,156,2,875,0,0,0,1082
4013941300,6334,812,1048,32,4228,12,2,6,5522
4013980100,1,1,0,0,0,0,0,0,0
4013980400,14,6,4,0,0,3,0,0,8
4013980500,0,0,0,0,0,0,0,0,0
4013980700,0,0,0,0,0,0,0,0,0
4013980900,26,15,7,0,0,0,0,0,11
4013981000,803,445,201,114,26,3,1,1,358
4015940400,1250,11,67,4,1151,4,0,3,1239
4015940501,2736,2042,402,19,118,11,20,17,694
4015950101,3187,2238,801,18,45,13,0,6,949
4015950102,2463,2405,22,0,1,1,0,1,58
4015950103,2367,2103,30,6,182,3,0,1,264
4015950401,1781,1272,366,14,13,13,6,10,509
4015950403,1831,1609,121,10,16,12,2,1,222
4015950404,2308,1976,124,22,85,14,0,3,332
4015950500,1363,1088,200,13,6,8,2,6,275
4015950601,3487,2814,371,29,29,40,1,13,673
4015950602,2818,2211,376,22,26,35,2,9,607
4015950603,3122,2442,369,15,32,20,14,20,680
4015950703,4055,3114,609,28,62,18,5,11,941
4015950705,4117,3107,663,13,38,40,16,8,1010
4015950706,3776,2942,471,48,71,24,7,11,834
4015950707,2690,2066,359,27,31,58,12,8,624
4015950708,4345,3547,431,36,48,42,5,6,798
4015951401,4132,3149,638,92,32,59,7,13,983
4015951403,2275,1731,334,36,13,51,9,0,544
4015951404,2181,1630,353,38,28,15,0,5,551
4015951501,4157,3031,761,47,41,54,2,6,1126
4015951503,2052,1725,189,25,9,23,1,9,327
4015951504,3819,2848,553,74,31,118,3,15,971
4015951601,3768,2392,1077,33,34,55,6,14,1376
4015951602,4153,2523,1324,43,24,36,2,20,1630
4015951701,3013,1558,1211,35,28,22,16,21,1455
4015951702,2350,1396,792,13,21,16,1,16,954
4015951800,3431,1927,1238,38,28,25,18,13,1504
4015951900,4204,2839,1019,49,44,60,12,9,1365
4015952001,1871,1321,377,19,12,51,2,0,550
4015952003,4617,3277,977,54,36,68,6,10,1340
4015952004,4172,3034,754,57,37,86,3,24,1138
4015952005,1225,1032,111,5,17,4,2,3,193
4015952006,3215,2323,591,35,38,54,6,8,892
4015952007,3970,3054,580,49,27,56,5,7,916
4015952400,3176,2593,379,12,28,31,5,5,583
4015952501,3161,2615,319,13,21,51,8,9,546
4015952502,2533,2127,271,10,5,14,5,8,406
4015952600,3427,2504,710,12,26,46,0,6,923
4015952701,2526,1778,596,20,11,15,11,2,748
4015952702,2816,2121,493,30,17,21,0,10,695
4015952801,3459,2886,357,11,23,13,10,11,573
4015952802,3650,2989,433,13,25,46,2,12,661
4015952901,2166,1558,378,15,18,50,0,15,608
4015952902,3493,2795,492,9,18,25,2,8,698
4015953001,2304,1828,345,13,20,28,0,2,476
4015953002,3466,2754,484,25,21,27,1,12,712
4015953100,3315,2600,502,30,22,38,8,0,715
4015953200,2998,2534,261,11,12,47,6,9,464
4015953301,3215,2628,360,6,17,27,2,22,587
4015953302,3320,2644,430,19,36,34,5,10,676
4015953403,2590,2112,323,26,20,24,1,6,478
4015953404,3175,2471,469,17,25,31,4,14,704
4015953405,3280,2745,388,13,10,30,2,4,535
4015953406,2631,2120,330,18,24,50,2,6,511
4015953602,2718,2079,366,73,33,28,7,13,639
4015953603,4292,3174,634,52,82,52,7,16,1118
4015953604,6675,5282,783,40,72,152,6,30,1393
4015953800,6659,4898,1087,104,112,92,17,27,1761
4015953901,4203,2979,705,50,64,166,24,19,1224
4015953902,4203,3062,694,31,65,88,13,23,1141
4015954801,2630,2204,210,24,46,27,0,13,426
4015954802,5653,3650,1334,220,154,37,4,26,2003
4015954900,4048,3205,473,49,38,73,7,16,843
4015955001,2280,1641,436,7,66,16,7,4,639
4015955002,2904,1812,423,24,468,12,6,5,1092
4017940008,1258,5,11,0,1242,0,0,0,1253
4017940010,2642,31,12,4,2513,3,0,0,2611
4017940011,3040,25,20,5,2936,14,0,2,3015
4017940012,2643,23,19,4,2568,9,0,0,2620
4017940013,3790,67,49,11,3622,17,0,3,3723
4017940014,2382,15,44,0,2286,2,0,1,2367
4017940015,4071,23,74,4,3887,3,2,1,4048
4017940100,4282,105,53,8,4033,22,0,4,4177
4017940301,4597,17,32,3,4506,6,0,0,4580
4017940302,3116,22,27,0,3042,3,0,0,3094
4017942300,2231,12,14,3,2155,1,0,0,2219
4017942400,2682,19,24,0,2624,1,0,0,2663
4017942500,4808,118,49,5,4547,0,0,0,4690
4017960100,1813,643,423,17,602,16,4,5,1170
4017960200,3498,1428,840,76,974,18,4,18,2070
4017960400,3580,1433,911,75,945,26,1,16,2147
4017960500,3618,1626,1162,179,533,5,5,14,1992
4017960600,4453,1183,1156,105,1780,40,3,9,3270
4017961300,3454,2465,639,16,197,30,0,9,989
4017961701,3414,2442,572,13,184,38,0,9,972
4017961702,3664,2845,472,19,112,53,3,21,819
4017962501,1567,1092,265,6,84,26,1,4,475
4017962502,1286,1033,141,2,46,12,2,6,253
4017963300,5090,3963,593,11,276,23,18,14,1127
4017963400,3478,2924,285,13,74,6,7,27,554
4017963700,1855,1599,164,4,23,15,0,5,256
4017963800,4508,3658,537,18,173,20,0,7,850
4017964201,1864,1587,191,5,28,5,1,3,277
4017964202,1559,1372,96,4,21,0,8,12,187
4017964801,2724,2340,181,11,25,27,0,18,384
4017964802,1872,1512,225,6,34,14,4,5,360
4017964901,1047,660,208,7,108,8,2,1,387
4017964902,947,831,55,4,11,13,1,2,116
4017965201,2446,1978,250,5,101,18,0,6,468
4017965202,2763,1926,558,3,142,27,0,3,837
4017965301,1525,1200,164,11,79,14,1,0,325
4017965302,3150,2564,371,17,59,13,1,7,586
4019000100,930,560,217,48,5,46,0,6,370
4019000200,4035,1167,2308,116,83,211,0,33,2868
4019000300,1449,672,536,64,48,56,0,8,777
4019000401,2486,1610,501,56,32,104,1,15,876
4019000402,1267,779,273,56,15,76,0,3,488
4019000501,5138,3424,729,250,49,438,0,4,1714
4019000502,5876,4250,867,235,77,291,1,14,1626
4019000600,4522,3195,734,97,17,234,6,21,1327
4019000700,4981,2328,2043,160,96,135,9,17,2653
4019000800,2053,963,830,58,41,70,0,17,1090
4019001100,2591,364,2074,35,59,16,1,0,2227
4019001200,3575,565,2201,262,411,35,4,12,3010
4019001302,2089,792,881,160,89,72,8,22,1297
4019001303,2925,874,1638,135,108,85,2,11,2051
4019001304,5244,1868,2376,368,218,182,22,21,3376
4019001400,5146,2614,1414,300,79,445,6,35,2532
4019001500,5292,3316,1017,175,68,481,9,28,1976
4019001600,3608,2532,669,99,31,93,3,23,1076
4019001700,2909,1898,676,62,38,84,6,13,1011
4019001801,5540,2719,1505,608,124,148,117,35,2821
4019001802,2278,1378,547,94,46,82,0,17,900
4019001900,3850,2569,791,72,18,209,14,16,1281
4019002000,6640,1766,4296,203,112,95,4,53,4874
4019002100,6205,596,4802,461,126,75,10,15,5609
4019002201,3151,396,2528,88,53,37,1,5,2755
4019002202,3500,384,2516,331,128,46,5,24,3116
4019002300,4613,514,3527,97,356,32,3,9,4099
4019002400,5397,468,4558,80,191,23,1,17,4929
4019002503,4097,829,3022,54,98,20,6,25,3268
4019002504,5518,1303,3996,44,58,32,10,16,4215
4019002505,6876,789,5424,161,257,122,7,11,6087
4019002507,3079,521,2236,74,120,34,9,6,2558
4019002508,4896,614,3810,127,206,51,12,10,4282
4019002509,4276,587,3423,70,95,20,2,20,3689
4019002602,5199,2491,1813,302,104,227,8,28,2708
4019002603,3210,950,1494,344,166,115,8,21,2260
4019002604,3707,1330,1572,302,112,224,25,9,2377
4019002702,4992,3090,1122,196,56,279,11,34,1902
4019002703,3484,1866,980,172,90,144,15,23,1618
4019002704,2307,1168,867,79,19,45,6,19,1139
4019002801,2206,993,862,143,81,21,0,12,1213
4019002802,3885,1925,1251,293,131,81,3,28,1960
4019002803,2311,1240,675,142,32,56,22,15,1071
4019002901,5829,3239,1583,467,95,140,4,32,2590
4019002904,3448,2523,613,87,31,72,3,13,925
4019002905,4554,2615,1122,264,56,202,15,59,1939
4019002906,2266,1627,376,47,9,115,1,12,639
4019003002,4686,2913,1126,242,56,109,8,27,1773
4019003003,4523,2665,1067,350,83,87,18,30,1858
4019003004,2053,1308,420,120,21,65,12,8,745
4019003102,3900,2083,1184,297,32,89,15,33,1817
4019003103,2855,1426,895,200,68,65,46,11,1429
4019003104,2741,1396,802,257,57,101,18,13,1345
4019003201,3044,1898,809,82,22,82,15,22,1146
4019003202,2832,1463,760,273,53,88,11,14,1369
4019003302,4130,2398,1175,190,46,90,12,13,1732
4019003303,4088,2435,1036,191,35,141,27,34,1653
4019003304,3411,1758,970,244,43,208,4,18,1653
4019003400,5537,2962,1910,190,58,174,3,30,2575
4019003502,4327,1881,1559,434,59,153,8,32,2446
4019003503,4342,1573,1913,440,73,65,23,24,2769
4019003504,2884,1178,1183,210,16,130,17,11,1706
4019003505,4475,1512,2113,440,76,112,13,32,2963
4019003506,3941,1088,1954,484,133,91,16,50,2853
4019003601,4566,2431,1099,431,20,173,54,37,2135
4019003702,6997,548,6098,103,145,14,3,12,6449
4019003704,4375,286,3763,99,160,13,5,6,4089
4019003705,5315,409,4581,111,116,31,6,5,4906
4019003706,5426,548,4548,154,86,22,4,21,4878
4019003707,3679,320,3052,124,106,29,0,7,3359
4019003801,3610,234,3185,36,95,11,2,4,3376
4019003802,4839,260,4312,42,139,29,2,11,4579
4019003901,1993,92,1792,12,73,1,0,2,1901
4019003902,2676,200,2371,12,36,3,6,12,2476
4019003903,3144,235,2760,21,77,6,6,9,2909
4019004008,4799,2480,1611,303,38,101,26,40,2319
4019004010,4021,2046,1340,235,39,154,7,18,1975
4019004026,5600,3806,1100,167,31,205,1,26,1794
4019004029,4355,2221,1517,216,28,139,2,11,2134
4019004030,1820,1431,241,16,8,30,0,6,389
4019004031,4069,2887,745,121,42,106,0,17,1182
4019004032,3704,2433,752,142,32,129,7,15,1271
4019004033,4152,1842,1442,379,57,171,29,21,2310
4019004034,3667,1656,1293,347,53,102,3,12,2011
4019004035,3582,2095,906,195,29,130,15,19,1487
4019004036,3071,1619,972,194,22,88,6,13,1452
4019004037,2826,1417,980,180,11,96,4,5,1409
4019004038,3040,1544,923,266,23,117,9,18,1496
4019004039,2438,1722,438,107,26,56,2,17,716
4019004042,4966,3376,958,171,28,162,11,25,1590
4019004043,3989,2625,787,141,9,257,6,20,1364
4019004044,3958,3003,531,80,26,115,3,35,955
4019004046,4574,2926,922,274,23,183,3,30,1648
4019004047,2901,2202,428,51,12,66,7,24,699
4019004048,4577,3061,944,179,20,96,22,29,1516
4019004049,3144,2027,665,121,23,97,7,21,1117
4019004050,1901,1495,248,15,4,40,0,14,406
4019004051,5103,4182,554,32,20,83,4,22,921
4019004052,2026,1672,219,16,7,31,0,13,354
4019004053,3084,2349,485,63,21,39,1,26,735
4019004054,1496,1181,189,11,10,27,2,7,315
4019004055,3404,2461,533,92,14,113,10,15,943
4019004056,2274,1234,642,133,20,72,9,16,1040
4019004057,4768,2931,1252,220,25,132,8,14,1837
4019004058,4393,2661,1131,237,21,110,9,16,1732
4019004061,5242,3873,845,92,19,77,7,31,1369
4019004062,8543,4682,2548,451,38,283,33,37,3861
4019004063,7483,4617,1752,296,39,315,17,35,2866
4019004065,3729,2152,1056,135,34,136,9,25,1577
4019004066,2972,1737,775,162,16,93,3,14,1235
4019004067,2898,1738,713,173,18,95,0,11,1160
4019004068,4869,3190,1094,164,52,135,6,35,1679
4019004069,4060,2237,1137,328,30,89,20,16,1823
4019004070,3273,1782,876,291,35,77,14,16,1491
4019004071,4885,2981,1106,332,38,157,6,18,1904
4019004072,2461,1550,568,107,24,61,11,13,911
4019004073,6077,3389,1699,313,43,280,33,39,2688
4019004074,1885,1156,495,64,8,46,11,14,729
4019004075,2703,1504,615,257,15,98,14,13,1199
4019004076,5177,2512,1670,432,39,178,25,24,2665
4019004077,3162,2006,733,124,16,104,2,9,1156
4019004078,3263,2040,769,144,24,110,10,14,1223
4019004079,3058,2197,460,69,16,142,6,22,861
4019004080,3805,3014,457,36,8,122,1,16,791
4019004081,5402,3961,941,107,23,98,6,25,1441
4019004082,4270,2955,798,146,15,127,7,15,1315
4019004109,5908,4137,1332,48,14,53,18,36,1771
4019004110,3348,297,2851,52,31,70,1,0,3051
4019004112,2715,512,1995,88,28,28,1,0,2203
4019004114,4834,724,3979,15,33,17,4,12,4110
4019004115,6672,1080,5137,195,87,64,2,15,5592
4019004116,2593,481,1833,138,35,46,6,4,2112
4019004117,6164,917,4664,285,99,96,0,4,5247
4019004118,5274,1562,2836,406,81,162,6,27,3712
4019004122,4056,434,3143,244,120,27,0,26,3622
4019004126,7335,4548,1829,283,42,125,12,60,2787
4019004127,5516,3589,1493,88,27,78,1,18,1927
4019004128,3689,2256,1164,53,11,38,0,13,1433
4019004129,4107,3086,818,25,12,49,1,15,1021
4019004130,2411,2238,89,21,0,17,0,5,173
4019004131,6779,1681,4042,403,40,324,23,25,5098
4019004132,4643,1924,1807,385,36,189,19,19,2719
4019004133,2500,2363,74,3,6,11,0,3,137
4019004307,3389,2984,290,11,17,25,1,0,405
4019004310,2405,556,1706,24,41,25,4,10,1849
4019004311,4216,987,2909,59,117,25,2,17,3229
4019004312,5659,1149,4064,85,204,48,3,16,4510
4019004313,4529,2540,1630,34,110,25,2,22,1989
4019004316,3106,1706,1201,24,56,14,3,25,1400
4019004317,3160,2742,293,18,9,24,0,12,418
4019004320,2527,517,1858,5,92,5,0,18,2010
4019004321,4569,695,3548,78,137,41,2,4,3874
4019004322,6341,1127,4705,149,215,33,0,27,5214
4019004323,4056,1693,1860,138,25,118,23,34,2363
4019004324,3020,2804,134,9,4,18,0,2,216
4019004325,1914,1727,120,6,2,20,3,3,187
4019004326,4054,1587,2077,99,16,84,24,17,2467
4019004327,5257,2983,1808,110,56,78,14,18,2274
4019004328,3425,3246,92,10,4,18,0,4,179
4019004330,1806,1641,94,7,0,13,2,8,165
4019004332,1818,1690,74,4,8,12,0,0,128
4019004333,3894,774,2822,65,82,37,0,9,3120
4019004335,8429,3866,3611,319,66,151,9,54,4563
4019004336,4208,1972,1784,119,16,90,7,22,2236
4019004337,2360,1901,316,22,9,35,1,6,459
4019004338,1411,1309,61,1,1,11,0,3,102
4019004339,6219,1234,4313,177,229,106,14,36,4985
4019004340,6585,1276,4656,213,219,50,17,23,5309
4019004404,3500,2880,425,34,32,32,0,2,620
4019004407,5925,826,4280,339,282,44,6,14,5099
4019004412,3292,1523,1436,79,16,125,9,14,1769
4019004413,3159,1293,1517,108,28,108,2,13,1866
4019004414,3110,992,1693,99,83,115,19,11,2118
4019004415,1602,663,810,40,11,29,2,5,939
4019004418,3429,2352,765,54,16,103,1,20,1077
4019004419,5798,4144,1220,76,52,22,0,27,1654
4019004422,5711,2533,2694,167,58,98,3,11,3178
4019004423,4108,3197,640,16,44,17,9,20,911
4019004424,3857,1775,1707,31,130,13,1,29,2082
4019004425,6305,4649,1176,31,68,49,2,29,1656
4019004426,2673,1450,836,76,17,134,6,37,1223
4019004428,3187,2339,626,33,10,49,0,28,848
4019004430,3274,1644,1259,120,101,44,3,14,1630
4019004431,6579,3947,1876,186,39,149,8,47,2632
4019004432,3363,1147,1620,199,111,165,6,33,2216
4019004433,3713,1923,1408,87,22,120,1,18,1790
4019004434,3208,1520,1485,35,43,22,4,20,1688
4019004435,3618,1773,1572,75,45,42,0,17,1845
4019004436,4883,3513,923,108,23,135,2,9,1370
4019004437,3086,1712,922,92,17,184,2,16,1374
4019004438,3542,2144,948,70,14,164,1,27,1398
4019004439,3208,1904,810,91,17,252,6,7,1304
4019004440,4758,2893,1320,65,32,219,10,17,1865
4019004505,3961,1705,1886,73,46,133,5,6,2256
4019004506,5076,2216,2545,51,32,79,0,25,2860
4019004508,4331,2229,1755,99,65,63,6,14,2102
4019004510,4195,1761,1585,214,67,385,18,15,2434
4019004511,4607,1997,1921,198,95,165,16,24,2610
4019004512,4198,2061,1841,50,50,49,9,10,2137
4019004513,3151,1483,1437,49,41,54,0,5,1668
4019004514,3669,1444,1932,79,25,38,11,17,2225
4019004515,3866,1137,2248,115,47,183,2,13,2729
4019004610,6655,3556,2171,160,64,395,14,42,3099
4019004613,4017,2238,1323,136,31,92,15,12,1779
4019004614,3436,2549,621,42,20,78,4,8,887
4019004615,3377,2376,619,53,20,154,6,12,1001
4019004616,4496,2881,976,108,28,357,12,11,1615
4019004617,3249,2069,786,117,19,113,5,14,1180
4019004618,3404,2007,911,67,22,265,0,4,1397
4019004619,3413,2621,478,56,6,79,12,23,792
4019004620,1852,1281,413,25,11,34,0,14,571
4019004621,2452,1967,318,17,8,60,3,8,485
4019004622,2996,2047,669,68,13,83,3,12,949
4019004623,6316,4252,1357,154,40,267,8,22,2064
4019004624,6024,3581,1778,129,31,227,4,21,2443
4019004625,2030,1152,590,54,13,137,4,5,878
4019004626,3574,1979,1052,160,36,154,10,15,1595
4019004627,2735,1590,865,39,8,94,8,16,1145
4019004628,1245,848,262,19,8,40,10,3,397
4019004630,2162,1414,530,42,26,45,12,10,748
4019004631,3623,2320,955,80,14,87,4,10,1303
4019004632,2642,1779,596,47,14,104,0,13,863
4019004633,2989,2119,580,37,3,102,3,11,870
4019004634,1892,1325,329,27,11,84,2,22,567
4019004635,5188,4032,594,79,6,278,0,17,1156
4019004636,7100,5221,1132,93,18,286,15,18,1879
4019004639,5243,3347,1192,141,26,253,1,24,1896
4019004640,6933,5054,1005,113,20,414,1,22,1879
4019004641,3847,2912,544,71,17,145,8,14,935
4019004642,4918,3963,447,58,13,273,1,24,955
4019004643,4158,3732,226,30,7,64,1,14,426
4019004644,2579,1652,651,61,28,58,0,24,927
4019004645,5591,3358,1629,111,44,145,0,38,2233
4019004646,4688,2849,1295,108,51,152,13,17,1839
4019004647,3835,2250,1293,58,13,47,1,32,1585
4019004648,6691,4440,1606,144,28,140,21,11,2251
4019004649,1630,1333,172,14,8,39,0,4,297
4019004650,5778,4576,716,112,19,169,4,26,1202
4019004710,4323,2708,929,108,44,328,3,19,1615
4019004711,4789,3444,585,64,14,463,3,35,1345
4019004712,3393,2355,510,72,10,267,12,16,1038
4019004713,4005,3204,441,13,29,163,6,29,801
4019004714,5573,4125,752,69,5,376,2,20,1448
4019004715,4647,2966,1394,40,27,28,4,15,1681
4019004717,2231,1761,201,38,1,133,3,7,470
4019004718,2273,1570,357,40,6,139,6,17,703
4019004720,1387,1106,132,19,9,64,0,9,281
4019004721,3893,2770,610,83,26,219,3,16,1123
4019004722,2531,2077,264,5,4,85,1,7,454
4019004723,4808,3324,635,76,14,439,9,29,1484
4019004724,2507,1897,326,40,3,152,2,14,610
4019004725,2957,1894,643,93,23,143,12,14,1063
4019004726,4047,3019,543,35,6,246,1,33,1028
4019004727,2886,2166,465,34,9,50,8,7,720
4019004728,3604,2752,420,92,15,178,12,13,852
4019004729,2827,2313,230,49,8,130,6,7,514
4019004730,2935,2245,285,27,5,264,0,15,690
4019005200,3207,1677,1145,25,194,63,3,9,1530
4019005300,3871,2780,638,121,95,69,12,10,1091
4019005400,3585,1367,1798,140,95,47,4,13,2218
4019940800,3997,36,169,4,3747,0,0,0,3961
4019940900,2210,264,578,8,1315,0,2,0,1946
4019941000,3759,143,1019,8,2519,0,6,2,3616
4019941100,2421,27,94,4,2272,0,1,0,2394
4019980001,3,0,3,0,0,0,0,0,3
4019980002,1,0,0,0,0,0,0,0,1
4019980100,1918,961,473,334,133,16,1,0,957
4019980200,4855,1750,1909,942,200,23,7,0,3105
4019980300,5,0,3,0,0,0,0,0,5
4019980400,1646,574,739,230,92,9,0,0,1072
4021000201,5996,5087,530,42,35,67,2,21,909
4021000204,13220,9507,2372,345,109,219,60,68,3713
4021000206,8458,5931,1634,307,50,158,16,55,2527
4021000208,4709,2827,1278,240,58,52,22,23,1882
4021000211,5432,3043,1508,381,72,102,33,18,2389
4021000212,7918,4554,2185,520,77,148,17,36,3364
4021000215,3246,2324,704,26,37,36,5,12,922
4021000216,4786,3302,1028,136,26,46,8,11,1484
4021000217,6653,3872,2300,109,46,40,4,31,2781
4021000218,5585,3321,1561,242,39,143,10,25,2264
4021000219,3353,2105,905,138,25,41,11,21,1248
4021000220,3914,2517,918,184,39,52,12,15,1397
4021000221,5751,3603,1340,351,76,119,15,15,2148
4021000222,6462,3812,1757,368,61,160,16,15,2650
4021000223,5045,3057,1300,240,18,126,19,20,1988
4021000224,7934,4690,2123,417,96,180,11,44,3244
4021000225,2886,1786,726,102,30,89,15,4,1100
4021000226,6855,4030,1849,380,50,111,26,46,2825
4021000227,4377,2654,1083,258,48,69,14,22,1723
4021000228,2130,1323,449,169,14,28,7,15,807
4021000229,5567,3874,1027,247,32,94,32,19,1693
4021000307,2568,2160,206,14,9,36,2,16,408
4021000309,3118,2543,370,20,23,23,5,5,575
4021000310,3183,2618,380,17,55,21,3,3,565
4021000311,2877,2414,275,17,9,26,2,9,463
4021000312,3850,2483,1056,36,34,59,6,24,1367
4021000313,4733,3682,788,30,49,41,13,6,1051
4021000315,5072,3792,866,80,43,36,10,13,1280
4021000316,7422,6645,431,45,23,59,4,26,777
4021000317,2394,2056,242,11,14,12,0,5,338
4021000319,1677,1608,21,11,3,2,0,1,69
4021000320,2130,1699,320,10,21,7,0,11,431
4021000321,3444,2565,668,37,25,14,5,2,879
4021000322,3238,2146,819,49,31,44,2,21,1092
4021000323,2035,1654,281,10,14,22,0,5,381
4021000324,4905,3854,733,79,28,51,1,14,1051
4021000325,2187,1679,338,24,18,40,2,8,508
4021000400,2418,670,1646,23,17,12,2,2,1748
4021000603,6079,5081,665,49,25,96,6,20,998
4021000604,4731,4486,99,20,6,30,0,0,245
4021000700,3114,1442,1510,12,27,10,5,22,1672
4021000802,5548,4447,756,65,55,44,7,20,1101
4021000804,1963,1412,449,10,11,38,3,5,551
4021000805,5715,4196,917,206,47,82,4,30,1519
4021000806,6583,4091,1577,423,79,107,14,19,2492
4021000807,3069,1336,1100,389,116,29,6,1,1733
4021000808,6168,2434,2409,880,364,22,11,4,3734
4021000902,2240,1041,883,113,69,16,0,8,1199
4021000903,6544,3027,1982,342,541,5,5,0,3517
4021000904,875,397,380,30,22,10,0,2,478
4021001000,4802,1660,2299,454,179,38,4,21,3142
4021001100,8146,3545,3309,615,235,57,5,44,4601
4021001200,4173,2410,1296,182,80,21,5,18,1763
4021001303,1490,982,387,7,38,17,0,7,508
4021001305,6307,3246,2366,234,162,84,15,13,3061
4021001306,5819,2332,2570,304,199,129,48,29,3487
4021001307,5238,2969,1610,248,120,90,10,7,2269
4021001308,2465,774,1458,58,65,28,3,7,1691
4021001309,5565,2458,2311,263,77,209,7,24,3107
4021001310,5082,2651,1733,235,121,121,7,26,2431
4021001403,4681,1788,2141,223,280,60,21,18,2893
4021001404,4009,1769,1782,158,70,97,0,14,2240
4021001405,3890,2562,913,151,59,72,17,10,1328
4021001406,4874,1388,2747,293,203,36,18,15,3486
4021001407,1795,919,700,37,42,33,1,2,876
4021001408,2872,2180,482,75,19,40,8,2,692
4021001500,3270,738,2114,155,149,17,9,7,2532
4021001600,5373,2394,2597,98,118,20,1,15,2979
4021001701,886,498,299,23,27,9,0,5,388
4021001704,7461,3294,2266,1095,85,223,34,46,4167
4021001705,7885,4091,1953,874,139,265,38,58,3794
4021001706,5494,2846,1393,598,90,195,38,35,2648
4021001707,4289,1831,1286,632,80,151,31,15,2458
4021001709,7624,3737,2200,885,148,191,55,48,3887
4021001712,5168,2365,1585,589,153,94,15,52,2803
4021001713,3087,1389,1033,374,68,53,9,19,1698
4021001714,4621,1926,1576,663,98,87,11,17,2695
4021001715,4773,2440,1380,475,73,139,20,21,2333
4021001716,5408,2762,1404,648,102,165,35,27,2646
4021001717,2343,2068,100,68,7,46,1,13,275
4021001900,2415,798,1237,194,51,32,11,19,1617
4021002001,4394,2544,1561,89,66,23,4,3,1850
4021002004,3918,483,2971,225,168,5,2,6,3435
4021002005,6407,1175,3520,616,113,180,104,24,5232
4021002104,4218,2443,1324,175,89,27,6,12,1775
4021002105,5365,2709,2020,252,96,36,0,24,2656
4021002106,1042,525,415,17,41,9,0,6,517
4021002107,3180,1943,957,60,29,38,4,15,1237
4021002200,4068,2105,1719,8,43,21,9,22,1963
4021002300,2109,1181,815,12,13,8,0,8,928
4021002400,1420,452,906,3,15,4,2,5,968
4021941200,7117,74,833,9,6094,3,0,1,7043
4021941300,3381,21,404,5,2908,2,0,0,3360
4021941401,4806,2174,1616,46,735,21,0,35,2632
4021941402,2377,490,1201,33,593,20,0,5,1887
4023966000,2965,2202,635,7,7,10,3,9,763
4023966101,3068,1894,1058,15,24,17,2,12,1174
4023966103,1209,53,1140,4,0,4,0,4,1156
4023966106,2091,246,1799,6,7,15,2,6,1845
4023966107,1647,230,1366,9,0,24,0,6,1417
4023966108,6249,283,5857,16,6,52,3,15,5966
4023966109,3261,866,2315,13,8,17,0,14,2395
4023966110,1547,114,1429,0,1,0,0,0,1433
4023966111,6011,573,5360,4,6,19,2,21,5438
4023966200,4751,162,4474,16,3,74,0,9,4589
4023966301,4243,211,3975,9,13,15,0,10,4032
4023966302,3379,85,3264,1,0,4,0,22,3294
4023966401,3230,85,3108,7,0,1,1,11,3145
4023966402,4018,115,3852,7,3,19,0,11,3903
4025000205,1423,1186,142,5,12,16,2,2,237
4025000206,5103,4280,478,21,22,32,12,40,823
4025000207,1709,1392,198,1,21,6,1,3,317
4025000208,1796,1146,527,11,22,5,5,4,650
4025000209,6439,4953,1022,30,45,62,8,26,1486
4025000210,1527,1184,216,8,20,15,2,13,343
4025000211,6231,4480,1310,15,50,29,0,21,1751
4025000301,5195,4198,470,53,30,193,6,28,997
4025000302,1350,1158,87,1,11,13,3,6,192
4025000403,1413,1088,193,12,24,16,6,9,325
4025000404,2223,1843,203,6,14,75,0,6,380
4025000405,3658,3175,245,22,17,67,2,21,483
4025000406,1946,1633,172,2,12,37,2,2,313
4025000407,3770,3215,236,16,20,89,6,22,555
4025000501,1537,1189,193,15,15,27,2,8,348
4025000502,3947,3189,380,8,127,64,2,24,758
4025000604,5016,3648,950,41,57,71,7,18,1368
4025000608,3543,2462,845,23,26,31,2,10,1081
4025000609,4869,2882,1682,26,65,39,3,9,1987
4025000611,1516,875,498,4,26,8,3,1,641
4025000612,1766,916,704,4,18,24,0,15,850
4025000613,8626,6628,1242,100,54,200,17,38,1998
4025000614,1537,806,607,22,8,23,3,2,731
4025000615,5699,3774,1382,54,66,106,19,23,1925
4025000616,2015,1547,349,18,13,20,4,1,468
4025000617,3168,2530,447,20,32,18,4,12,638
4025000618,1719,1455,119,14,12,55,3,8,264
4025000619,4451,3735,439,26,25,46,5,28,716
4025000701,2236,1922,161,8,26,13,9,8,314
4025000702,2197,1686,329,6,80,12,2,11,511
4025000802,3754,3149,302,39,40,41,1,23,605
4025000803,1228,968,153,11,13,25,0,10,260
4025000804,2587,2256,171,14,13,24,4,10,331
4025000901,1228,912,209,15,26,16,3,10,316
4025000902,3240,2392,588,46,67,27,6,10,848
4025001002,3765,3231,306,19,22,36,2,13,534
4025001003,1343,1104,137,8,11,22,0,3,239
4025001004,3659,3178,266,19,17,21,4,9,481
4025001103,1354,1199,90,6,0,17,0,7,155
4025001104,2990,2563,221,15,16,30,1,18,427
4025001105,1821,1623,117,2,6,10,0,0,198
4025001106,2281,1903,234,16,21,9,0,17,378
4025001201,3239,2881,185,10,11,24,0,25,358
4025001202,4127,3617,288,12,20,21,1,38,510
4025001300,2191,1409,575,4,52,37,2,14,782
4025001401,2410,1973,204,15,29,15,2,15,437
4025001402,3980,3485,244,15,27,29,2,26,495
4025001403,3427,2819,369,24,26,19,0,11,608
4025001501,2309,1969,184,6,19,28,0,3,340
4025001502,4416,3615,462,17,27,21,9,29,801
4025001601,6837,4282,1241,51,860,49,3,13,2555
4025001602,4156,3212,643,12,67,17,8,21,944
4025001604,1689,1136,373,6,27,20,0,9,553
4025001605,4712,3578,635,14,217,29,6,18,1134
4025001701,6013,4805,788,40,53,57,8,32,1208
4025001703,2595,2099,279,22,34,53,5,14,496
4025001704,1106,932,114,1,5,13,0,0,174
4025001705,3533,3042,240,22,22,78,5,17,491
4025001801,3259,2687,305,19,27,72,0,24,572
4025001803,1843,1363,348,10,7,51,2,9,480
4025001804,2819,2200,417,16,11,67,1,16,619
4025001901,2383,1798,282,12,155,15,4,12,585
4025001902,3678,2926,419,34,66,40,6,20,752
4025001903,6362,5338,599,38,38,105,9,20,1024
4025001904,6574,5453,699,41,28,53,1,22,1121
4025002001,5190,3325,1526,36,67,34,2,27,1865
4025002002,5195,3174,1629,40,65,30,10,34,2021
4025002003,4070,2833,911,36,37,38,4,29,1237
4025002005,1964,1709,164,4,10,12,0,2,255
4025002006,1593,1226,272,4,8,15,6,2,367
4025002007,5333,4057,967,31,32,56,12,12,1276
4025002100,2331,1700,408,21,50,14,0,8,631
4027000100,2093,478,1442,55,63,13,2,2,1615
4027000200,3082,529,2337,73,54,13,0,15,2553
4027000301,2922,379,2383,80,18,8,0,13,2543
4027000302,3557,369,3012,87,40,9,1,4,3188
4027000402,3704,306,3322,6,21,6,7,4,3398
4027000403,1324,312,921,39,13,8,3,2,1012
4027000404,4024,681,3183,45,51,10,0,11,3343
4027000501,2619,1046,1309,73,19,63,5,11,1573
4027000502,2507,1113,1236,37,16,23,5,24,1394
4027000600,5096,1369,3368,118,64,42,1,7,3727
4027000700,3859,487,3181,75,30,15,2,19,3372
4027000800,4935,1483,3026,128,50,116,2,6,3452
4027000901,3431,1162,2060,53,23,48,1,12,2269
4027000902,2859,855,1728,76,22,67,4,12,2004
4027000903,3485,1110,2136,59,37,74,7,6,2375
4027000907,6615,1291,4770,160,35,172,19,38,5324
4027000908,4648,1461,2670,90,22,231,18,16,3187
4027000909,5456,709,4467,69,30,107,0,22,4747
4027000910,2786,637,1892,62,17,121,7,7,2149
4027001001,2649,1422,1065,38,9,57,0,14,1227
4027001003,1341,463,772,45,4,17,3,3,878
4027001004,2167,596,1359,60,49,37,0,8,1571
4027001100,4871,1605,2867,103,76,73,1,19,3266
4027001200,4081,1535,2252,38,34,51,6,29,2546
4027010907,5428,3280,1702,97,41,99,17,25,2148
4027010910,1769,1507,198,0,10,2,0,4,262
4027010911,6700,2677,3472,122,41,124,9,47,4023
4027010913,1173,333,785,7,19,7,0,2,840
4027010914,533,303,194,5,8,7,3,0,230
4027010915,2081,1216,760,9,1,16,2,8,865
4027010916,833,455,358,7,0,1,0,0,378
4027011000,1612,622,869,7,64,19,0,3,990
4027011107,3061,1579,1184,38,32,61,4,37,1482
4027011108,3700,1912,1476,90,18,77,6,29,1788
4027011112,2610,2158,352,2,19,15,1,2,452
4027011114,1828,1446,293,10,11,10,0,0,382
4027011116,1635,877,657,15,15,19,0,4,758
4027011117,3651,1255,2203,43,26,40,0,3,2396
4027011118,1238,1050,136,1,7,11,0,0,188
4027011119,2155,1588,411,9,30,27,7,10,567
4027011120,1692,1140,475,26,2,15,2,3,552
4027011121,6467,2707,3243,103,45,118,23,25,3760
4027011122,1440,950,364,7,14,13,5,10,490
4027011123,1454,914,471,6,7,5,0,2,540
4027011124,1682,1408,198,6,6,13,0,4,274
4027011125,1672,1425,160,15,11,12,2,0,247
4027011202,1106,564,502,9,2,4,3,0,542
4027011203,1423,683,686,7,7,4,1,5,740
4027011204,1753,1190,472,18,8,11,0,9,563
4027011403,3940,42,3871,8,1,5,1,8,3898
4027011405,4535,53,4472,0,1,1,1,3,4482
4027011407,6872,49,6790,2,2,2,2,13,6823
4027011408,3810,42,3743,2,5,0,1,6,3768
4027011501,2007,227,1348,9,381,9,0,2,1780
4027011503,5386,137,5197,7,20,14,0,0,5249
4027011505,4480,75,4366,7,6,4,1,2,4405
4027011506,3958,68,3866,6,0,10,0,3,3890
4027011601,4797,25,4747,1,1,0,0,14,4772
4027011602,3571,29,3525,0,4,0,0,10,3542
4027011700,1313,857,389,13,4,15,0,1,456
4027011801,9640,2447,5630,887,201,33,8,9,7193
4027011802,3083,322,2700,12,7,6,8,4,2761
4027012100,725,312,305,23,7,25,0,7,413
4027980003,0,0,0,0,0,0,0,0,0
4027980004,5,1,1,0,0,0,0,0,4
4027980005,503,352,146,2,0,2,0,0,151
4027980006,2449,1448,528,177,7,84,14,4,1001